"","연도","시도","시군구","입학_전체","입학_남","입학_여"
"1","2021","서울","종로구",772,375,397
"2","2021","서울","중구",817,412,405
"3","2021","서울","용산구",1099,561,538
"4","2021","서울","성동구",1886,976,910
"5","2021","서울","광진구",2146,1118,1028
"6","2021","서울","동대문구",2167,1107,1060
"7","2021","서울","중랑구",2215,1127,1088
"8","2021","서울","성북구",3175,1627,1548
"9","2021","서울","강북구",1394,711,683
"10","2021","서울","도봉구",2249,1135,1114
"11","2021","서울","노원구",3751,1925,1826
"12","2021","서울","은평구",3074,1601,1473
"13","2021","서울","서대문구",2225,1098,1127
"14","2021","서울","마포구",2298,1129,1169
"15","2021","서울","양천구",3389,1722,1667
"16","2021","서울","강서구",4005,1959,2046
"17","2021","서울","구로구",2799,1413,1386
"18","2021","서울","금천구",1314,668,646
"19","2021","서울","영등포구",2400,1276,1124
"20","2021","서울","동작구",2525,1309,1216
"21","2021","서울","관악구",2174,1120,1054
"22","2021","서울","서초구",3413,1755,1658
"23","2021","서울","강남구",3618,1890,1728
"24","2021","서울","송파구",5022,2610,2412
"25","2021","서울","강동구",3763,1940,1823
"26","2021","부산","중구",218,114,104
"27","2021","부산","서구",604,308,296
"28","2021","부산","동구",385,196,189
"29","2021","부산","영도구",532,273,259
"30","2021","부산","부산진구",2579,1306,1273
"31","2021","부산","동래구",2081,1091,990
"32","2021","부산","남구",1922,993,929
"33","2021","부산","북구",2001,1020,981
"34","2021","부산","해운대구",3026,1575,1451
"35","2021","부산","사하구",2071,1099,972
"36","2021","부산","금정구",1527,803,724
"37","2021","부산","강서구",2176,1118,1058
"38","2021","부산","연제구",1550,778,772
"39","2021","부산","수영구",1015,522,493
"40","2021","부산","사상구",1177,594,583
"41","2021","부산","기장군",2259,1163,1096
"42","2021","대구","중구",759,383,376
"43","2021","대구","동구",2785,1409,1376
"44","2021","대구","서구",802,416,386
"45","2021","대구","남구",655,334,321
"46","2021","대구","북구",3551,1806,1745
"47","2021","대구","수성구",3365,1726,1639
"48","2021","대구","달서구",4632,2361,2271
"49","2021","대구","달성군",3094,1565,1529
"50","2021","인천","중구",1424,700,724
"51","2021","인천","동구",568,313,255
"52","2021","인천","연수구",4277,2213,2064
"53","2021","인천","미추홀구",2689,1359,1330
"54","2021","인천","남동구",4469,2291,2178
"55","2021","인천","부평구",3668,1876,1792
"56","2021","인천","계양구",2101,1071,1030
"57","2021","인천","서구",5154,2665,2489
"58","2021","인천","강화군",340,180,160
"59","2021","인천","옹진군",75,36,39
"60","2021","광주","동구",622,333,289
"61","2021","광주","서구",2359,1215,1144
"62","2021","광주","남구",2223,1107,1116
"63","2021","광주","북구",3694,1889,1805
"64","2021","광주","광산구",5298,2728,2570
"65","2021","대전","동구",1660,873,787
"66","2021","대전","중구",1656,823,833
"67","2021","대전","서구",4042,2094,1948
"68","2021","대전","유성구",3770,1951,1819
"69","2021","대전","대덕구",1216,656,560
"70","2021","울산","중구",1851,937,914
"71","2021","울산","남구",2587,1339,1248
"72","2021","울산","동구",1762,899,863
"73","2021","울산","북구",2747,1415,1332
"74","2021","울산","울주군",2010,1043,967
"75","2021","세종","세종시",5091,2646,2445
"76","2021","경기","수원시",10595,5465,5130
"77","2021","경기","성남시",7207,3657,3550
"78","2021","경기","부천시",6286,3208,3078
"79","2021","경기","안양시",4228,2167,2061
"80","2021","경기","과천시",646,332,314
"81","2021","경기","안산시",5081,2574,2507
"82","2021","경기","용인시",11029,5609,5420
"83","2021","경기","군포시",2188,1133,1055
"84","2021","경기","의왕시",1245,660,585
"85","2021","경기","시흥시",5492,2799,2693
"86","2021","경기","평택시",5350,2742,2608
"87","2021","경기","화성시",11358,5694,5664
"88","2021","경기","오산시",2682,1336,1346
"89","2021","경기","광명시",2529,1288,1241
"90","2021","경기","광주시",3745,1926,1819
"91","2021","경기","하남시",3362,1718,1644
"92","2021","경기","김포시",6219,3119,3100
"93","2021","경기","이천시",2032,1089,943
"94","2021","경기","안성시",1552,777,775
"95","2021","경기","여주시",763,395,368
"96","2021","경기","양평군",791,422,369
"97","2021","경기","고양시",8557,4393,4164
"98","2021","경기","남양주시",7065,3610,3455
"99","2021","경기","구리시",1553,813,740
"100","2021","경기","의정부시",3573,1825,1748
"101","2021","경기","파주시",4941,2514,2427
"102","2021","경기","동두천시",726,399,327
"103","2021","경기","양주시",2219,1154,1065
"104","2021","경기","포천시",878,428,450
"105","2021","경기","가평군",330,180,150
"106","2021","경기","연천군",261,129,132
"107","2021","강원","춘천시",2327,1205,1122
"108","2021","강원","원주시",2931,1485,1446
"109","2021","강원","강릉시",1401,713,688
"110","2021","강원","동해시",745,383,362
"111","2021","강원","태백시",289,153,136
"112","2021","강원","속초시",624,321,303
"113","2021","강원","삼척시",380,199,181
"114","2021","강원","홍천군",337,159,178
"115","2021","강원","횡성군",225,112,113
"116","2021","강원","영월군",180,104,76
"117","2021","강원","평창군",178,77,101
"118","2021","강원","정선군",214,110,104
"119","2021","강원","철원군",351,183,168
"120","2021","강원","화천군",175,102,73
"121","2021","강원","양구군",155,86,69
"122","2021","강원","인제군",221,111,110
"123","2021","강원","고성군",164,84,80
"124","2021","강원","양양군",142,68,74
"125","2021","충북","청주시",7946,4023,3923
"126","2021","충북","충주시",1530,759,771
"127","2021","충북","제천시",956,480,476
"128","2021","충북","보은군",148,77,71
"129","2021","충북","옥천군",299,147,152
"130","2021","충북","영동군",227,107,120
"131","2021","충북","진천군",866,454,412
"132","2021","충북","괴산군",166,86,80
"133","2021","충북","음성군",634,332,302
"134","2021","충북","단양군",118,66,52
"135","2021","충북","증평군",332,146,186
"136","2021","충남","천안시",6685,3417,3268
"137","2021","충남","공주시",609,330,279
"138","2021","충남","보령시",674,310,364
"139","2021","충남","아산시",3507,1788,1719
"140","2021","충남","서산시",1719,896,823
"141","2021","충남","논산시",850,418,432
"142","2021","충남","계룡시",426,212,214
"143","2021","충남","금산군",256,135,121
"144","2021","충남","부여군",331,175,156
"145","2021","충남","서천군",261,134,127
"146","2021","충남","청양군",123,60,63
"147","2021","충남","홍성군",829,439,390
"148","2021","충남","예산군",406,210,196
"149","2021","충남","태안군",322,156,166
"150","2021","충남","당진시",1718,854,864
"151","2021","전북","전주시",6138,3146,2992
"152","2021","전북","군산시",2392,1248,1144
"153","2021","전북","익산시",2059,1065,994
"154","2021","전북","정읍시",721,355,366
"155","2021","전북","남원시",544,290,254
"156","2021","전북","김제시",487,259,228
"157","2021","전북","완주군",666,331,335
"158","2021","전북","진안군",107,51,56
"159","2021","전북","무주군",142,88,54
"160","2021","전북","장수군",127,62,65
"161","2021","전북","임실군",119,58,61
"162","2021","전북","순창군",129,72,57
"163","2021","전북","고창군",312,173,139
"164","2021","전북","부안군",271,139,132
"165","2021","전남","목포시",2172,1111,1061
"166","2021","전남","여수시",2202,1123,1079
"167","2021","전남","순천시",2529,1251,1278
"168","2021","전남","나주시",1059,551,508
"169","2021","전남","광양시",1358,670,688
"170","2021","전남","담양군",234,115,119
"171","2021","전남","곡성군",103,55,48
"172","2021","전남","구례군",110,58,52
"173","2021","전남","고흥군",249,120,129
"174","2021","전남","보성군",160,87,73
"175","2021","전남","화순군",357,191,166
"176","2021","전남","장흥군",213,107,106
"177","2021","전남","강진군",178,80,98
"178","2021","전남","해남군",374,179,195
"179","2021","전남","영암군",323,160,163
"180","2021","전남","무안군",864,460,404
"181","2021","전남","함평군",121,60,61
"182","2021","전남","영광군",294,150,144
"183","2021","전남","장성군",309,168,141
"184","2021","전남","완도군",350,186,164
"185","2021","전남","진도군",167,90,77
"186","2021","전남","신안군",128,62,66
"187","2021","경북","포항시",4412,2275,2137
"188","2021","경북","경주시",1776,927,849
"189","2021","경북","김천시",1078,549,529
"190","2021","경북","안동시",1177,606,571
"191","2021","경북","구미시",4702,2430,2272
"192","2021","경북","영주시",640,359,281
"193","2021","경북","영천시",510,275,235
"194","2021","경북","상주시",525,279,246
"195","2021","경북","문경시",387,197,190
"196","2021","경북","경산시",2209,1098,1111
"197","2021","경북","군위군",62,32,30
"198","2021","경북","의성군",170,92,78
"199","2021","경북","청송군",97,42,55
"200","2021","경북","영양군",73,27,46
"201","2021","경북","영덕군",169,86,83
"202","2021","경북","청도군",147,74,73
"203","2021","경북","고령군",158,87,71
"204","2021","경북","성주군",148,71,77
"205","2021","경북","칠곡군",1016,538,478
"206","2021","경북","예천군",358,196,162
"207","2021","경북","봉화군",127,71,56
"208","2021","경북","울진군",301,143,158
"209","2021","경북","울릉군",42,19,23
"210","2021","경남","창원시",9200,4781,4419
"211","2021","경남","진주시",3308,1713,1595
"212","2021","경남","통영시",1169,594,575
"213","2021","경남","사천시",917,447,470
"214","2021","경남","김해시",5514,2847,2667
"215","2021","경남","밀양시",607,309,298
"216","2021","경남","거제시",3106,1604,1502
"217","2021","경남","양산시",3839,1998,1841
"218","2021","경남","의령군",103,64,39
"219","2021","경남","함안군",473,236,237
"220","2021","경남","창녕군",323,172,151
"221","2021","경남","고성군",304,137,167
"222","2021","경남","남해군",187,110,77
"223","2021","경남","하동군",183,112,71
"224","2021","경남","산청군",112,62,50
"225","2021","경남","함양군",210,110,100
"226","2021","경남","거창군",459,227,232
"227","2021","경남","합천군",156,78,78
"228","2021","제주","제주시",5119,2621,2498
"229","2021","제주","서귀포시",1495,749,746
"230","2020","서울","종로구",764,381,383
"231","2020","서울","중구",901,455,446
"232","2020","서울","용산구",1087,548,539
"233","2020","서울","성동구",1926,1002,924
"234","2020","서울","광진구",2250,1127,1123
"235","2020","서울","동대문구",2127,1118,1009
"236","2020","서울","중랑구",2377,1219,1158
"237","2020","서울","성북구",3145,1560,1585
"238","2020","서울","강북구",1528,806,722
"239","2020","서울","도봉구",2247,1148,1099
"240","2020","서울","노원구",3856,1998,1858
"241","2020","서울","은평구",3171,1664,1507
"242","2020","서울","서대문구",2188,1106,1082
"243","2020","서울","마포구",2193,1083,1110
"244","2020","서울","양천구",3518,1822,1696
"245","2020","서울","강서구",4327,2193,2134
"246","2020","서울","구로구",3039,1565,1474
"247","2020","서울","금천구",1345,682,663
"248","2020","서울","영등포구",2282,1182,1100
"249","2020","서울","동작구",2557,1295,1262
"250","2020","서울","관악구",2310,1143,1167
"251","2020","서울","서초구",3452,1812,1640
"252","2020","서울","강남구",3906,2056,1850
"253","2020","서울","송파구",4982,2553,2429
"254","2020","서울","강동구",3420,1811,1609
"255","2020","부산","중구",210,115,95
"256","2020","부산","서구",555,315,240
"257","2020","부산","동구",422,224,198
"258","2020","부산","영도구",585,296,289
"259","2020","부산","부산진구",2372,1181,1191
"260","2020","부산","동래구",2034,1055,979
"261","2020","부산","남구",1994,1028,966
"262","2020","부산","북구",2027,1022,1005
"263","2020","부산","해운대구",3100,1621,1479
"264","2020","부산","사하구",2133,1082,1051
"265","2020","부산","금정구",1525,762,763
"266","2020","부산","강서구",1958,1009,949
"267","2020","부산","연제구",1559,760,799
"268","2020","부산","수영구",965,515,450
"269","2020","부산","사상구",1279,628,651
"270","2020","부산","기장군",2041,1072,969
"271","2020","대구","중구",719,363,356
"272","2020","대구","동구",2726,1360,1366
"273","2020","대구","서구",869,428,441
"274","2020","대구","남구",719,353,366
"275","2020","대구","북구",3461,1756,1705
"276","2020","대구","수성구",3342,1701,1641
"277","2020","대구","달서구",4658,2370,2288
"278","2020","대구","달성군",2883,1482,1401
"279","2020","인천","중구",1388,712,676
"280","2020","인천","동구",541,287,254
"281","2020","인천","연수구",3950,2010,1940
"282","2020","인천","미추홀구",2818,1453,1365
"283","2020","인천","남동구",4652,2333,2319
"284","2020","인천","부평구",3632,1836,1796
"285","2020","인천","계양구",2091,1092,999
"286","2020","인천","서구",5334,2714,2620
"287","2020","인천","강화군",332,165,167
"288","2020","인천","옹진군",97,53,44
"289","2020","광주","동구",569,295,274
"290","2020","광주","서구",2558,1318,1240
"291","2020","광주","남구",2160,1087,1073
"292","2020","광주","북구",3635,1901,1734
"293","2020","광주","광산구",4610,2333,2277
"294","2020","대전","동구",1641,805,836
"295","2020","대전","중구",1776,909,867
"296","2020","대전","서구",4191,2170,2021
"297","2020","대전","유성구",3715,1863,1852
"298","2020","대전","대덕구",1261,657,604
"299","2020","울산","중구",1924,983,941
"300","2020","울산","남구",2523,1269,1254
"301","2020","울산","동구",1683,870,813
"302","2020","울산","북구",2709,1392,1317
"303","2020","울산","울주군",2003,1005,998
"304","2020","세종","세종시",4877,2495,2382
"305","2020","경기","수원시",10736,5516,5220
"306","2020","경기","성남시",7248,3696,3552
"307","2020","경기","부천시",6184,3184,3000
"308","2020","경기","안양시",4137,2142,1995
"309","2020","경기","과천시",483,253,230
"310","2020","경기","안산시",5067,2586,2481
"311","2020","경기","용인시",10978,5538,5440
"312","2020","경기","군포시",2337,1192,1145
"313","2020","경기","의왕시",1282,603,679
"314","2020","경기","시흥시",4951,2539,2412
"315","2020","경기","평택시",5064,2519,2545
"316","2020","경기","화성시",11080,5713,5367
"317","2020","경기","오산시",2683,1377,1306
"318","2020","경기","광명시",2629,1357,1272
"319","2020","경기","광주시",3325,1690,1635
"320","2020","경기","하남시",3020,1516,1504
"321","2020","경기","김포시",5401,2748,2653
"322","2020","경기","이천시",2033,1018,1015
"323","2020","경기","안성시",1685,891,794
"324","2020","경기","여주시",797,423,374
"325","2020","경기","양평군",745,380,365
"326","2020","경기","고양시",8590,4350,4240
"327","2020","경기","남양주시",7002,3615,3387
"328","2020","경기","구리시",1590,841,749
"329","2020","경기","의정부시",3543,1843,1700
"330","2020","경기","파주시",4612,2341,2271
"331","2020","경기","동두천시",735,380,355
"332","2020","경기","양주시",2059,1053,1006
"333","2020","경기","포천시",920,493,427
"334","2020","경기","가평군",354,188,166
"335","2020","경기","연천군",282,142,140
"336","2020","강원","춘천시",2379,1218,1161
"337","2020","강원","원주시",3005,1530,1475
"338","2020","강원","강릉시",1448,767,681
"339","2020","강원","동해시",760,389,371
"340","2020","강원","태백시",282,159,123
"341","2020","강원","속초시",581,276,305
"342","2020","강원","삼척시",401,202,199
"343","2020","강원","홍천군",386,197,189
"344","2020","강원","횡성군",220,114,106
"345","2020","강원","영월군",168,88,80
"346","2020","강원","평창군",211,120,91
"347","2020","강원","정선군",188,93,95
"348","2020","강원","철원군",299,141,158
"349","2020","강원","화천군",182,94,88
"350","2020","강원","양구군",166,83,83
"351","2020","강원","인제군",249,121,128
"352","2020","강원","고성군",150,77,73
"353","2020","강원","양양군",137,75,62
"354","2020","충북","청주시",8129,4144,3985
"355","2020","충북","충주시",1594,865,729
"356","2020","충북","제천시",931,475,456
"357","2020","충북","보은군",146,67,79
"358","2020","충북","옥천군",272,148,124
"359","2020","충북","영동군",226,114,112
"360","2020","충북","진천군",846,418,428
"361","2020","충북","괴산군",144,63,81
"362","2020","충북","음성군",668,339,329
"363","2020","충북","단양군",116,59,57
"364","2020","충북","증평군",356,184,172
"365","2020","충남","천안시",6790,3460,3330
"366","2020","충남","공주시",667,351,316
"367","2020","충남","보령시",641,339,302
"368","2020","충남","아산시",3635,1896,1739
"369","2020","충남","서산시",1654,810,844
"370","2020","충남","논산시",795,413,382
"371","2020","충남","계룡시",413,187,226
"372","2020","충남","금산군",298,168,130
"373","2020","충남","부여군",314,175,139
"374","2020","충남","서천군",257,124,133
"375","2020","충남","청양군",143,75,68
"376","2020","충남","홍성군",859,462,397
"377","2020","충남","예산군",438,228,210
"378","2020","충남","태안군",360,177,183
"379","2020","충남","당진시",1702,850,852
"380","2020","전북","전주시",6164,3140,3024
"381","2020","전북","군산시",2515,1283,1232
"382","2020","전북","익산시",2158,1150,1008
"383","2020","전북","정읍시",700,365,335
"384","2020","전북","남원시",533,275,258
"385","2020","전북","김제시",500,270,230
"386","2020","전북","완주군",705,344,361
"387","2020","전북","진안군",116,50,66
"388","2020","전북","무주군",124,66,58
"389","2020","전북","장수군",136,75,61
"390","2020","전북","임실군",140,65,75
"391","2020","전북","순창군",131,73,58
"392","2020","전북","고창군",273,144,129
"393","2020","전북","부안군",283,149,134
"394","2020","전남","목포시",2399,1219,1180
"395","2020","전남","여수시",2306,1204,1102
"396","2020","전남","순천시",2631,1334,1297
"397","2020","전남","나주시",994,525,469
"398","2020","전남","광양시",1445,732,713
"399","2020","전남","담양군",200,99,101
"400","2020","전남","곡성군",113,65,48
"401","2020","전남","구례군",138,70,68
"402","2020","전남","고흥군",260,146,114
"403","2020","전남","보성군",172,88,84
"404","2020","전남","화순군",379,199,180
"405","2020","전남","장흥군",222,100,122
"406","2020","전남","강진군",181,94,87
"407","2020","전남","해남군",378,175,203
"408","2020","전남","영암군",412,205,207
"409","2020","전남","무안군",702,361,341
"410","2020","전남","함평군",151,78,73
"411","2020","전남","영광군",310,151,159
"412","2020","전남","장성군",272,139,133
"413","2020","전남","완도군",315,161,154
"414","2020","전남","진도군",170,92,78
"415","2020","전남","신안군",145,78,67
"416","2020","경북","포항시",4483,2300,2183
"417","2020","경북","경주시",1767,938,829
"418","2020","경북","김천시",1117,600,517
"419","2020","경북","안동시",1319,688,631
"420","2020","경북","구미시",4547,2364,2183
"421","2020","경북","영주시",667,334,333
"422","2020","경북","영천시",541,271,270
"423","2020","경북","상주시",563,288,275
"424","2020","경북","문경시",415,223,192
"425","2020","경북","경산시",2227,1118,1109
"426","2020","경북","군위군",64,43,21
"427","2020","경북","의성군",162,84,78
"428","2020","경북","청송군",104,45,59
"429","2020","경북","영양군",77,46,31
"430","2020","경북","영덕군",169,89,80
"431","2020","경북","청도군",145,74,71
"432","2020","경북","고령군",151,74,77
"433","2020","경북","성주군",161,79,82
"434","2020","경북","칠곡군",1126,603,523
"435","2020","경북","예천군",394,203,191
"436","2020","경북","봉화군",132,67,65
"437","2020","경북","울진군",295,144,151
"438","2020","경북","울릉군",50,22,28
"439","2020","경남","창원시",9362,4854,4508
"440","2020","경남","진주시",3120,1671,1449
"441","2020","경남","통영시",1102,566,536
"442","2020","경남","사천시",903,475,428
"443","2020","경남","김해시",5593,2821,2772
"444","2020","경남","밀양시",604,296,308
"445","2020","경남","거제시",3027,1570,1457
"446","2020","경남","양산시",3692,1863,1829
"447","2020","경남","의령군",96,52,44
"448","2020","경남","함안군",501,243,258
"449","2020","경남","창녕군",354,192,162
"450","2020","경남","고성군",310,143,167
"451","2020","경남","남해군",149,71,78
"452","2020","경남","하동군",167,95,72
"453","2020","경남","산청군",137,76,61
"454","2020","경남","함양군",215,104,111
"455","2020","경남","거창군",397,206,191
"456","2020","경남","합천군",182,95,87
"457","2020","제주","제주시",4989,2568,2421
"458","2020","제주","서귀포시",1435,703,732
"459","2019","서울","종로구",5463,2790,2673
"460","2019","서울","중구",5181,2544,2637
"461","2019","서울","용산구",7273,3726,3547
"462","2019","서울","성동구",11789,5950,5839
"463","2019","서울","광진구",14977,7707,7270
"464","2019","서울","동대문구",13684,7086,6598
"465","2019","서울","중랑구",15176,7764,7412
"466","2019","서울","성북구",21051,10833,10218
"467","2019","서울","강북구",10392,5285,5107
"468","2019","서울","도봉구",15561,8011,7550
"469","2019","서울","노원구",26994,13778,13216
"470","2019","서울","은평구",21613,11144,10469
"471","2019","서울","서대문구",12993,6569,6424
"472","2019","서울","마포구",15272,7773,7499
"473","2019","서울","양천구",24414,12643,11771
"474","2019","서울","강서구",27134,13964,13170
"475","2019","서울","구로구",18674,9381,9293
"476","2019","서울","금천구",8880,4543,4337
"477","2019","서울","영등포구",13891,7084,6807
"478","2019","서울","동작구",16257,8380,7877
"479","2019","서울","관악구",15246,7838,7408
"480","2019","서울","서초구",23064,11840,11224
"481","2019","서울","강남구",25484,13336,12148
"482","2019","서울","송파구",32208,16516,15692
"483","2019","서울","강동구",19622,10331,9291
"484","2019","부산","중구",1315,677,638
"485","2019","부산","서구",3808,1940,1868
"486","2019","부산","동구",2481,1272,1209
"487","2019","부산","영도구",3948,2020,1928
"488","2019","부산","부산진구",15421,7782,7639
"489","2019","부산","동래구",12889,6734,6155
"490","2019","부산","남구",12911,6618,6293
"491","2019","부산","북구",13103,6760,6343
"492","2019","부산","해운대구",20100,10392,9708
"493","2019","부산","사하구",14643,7495,7148
"494","2019","부산","금정구",9904,5145,4759
"495","2019","부산","강서구",9321,4760,4561
"496","2019","부산","연제구",9672,4980,4692
"497","2019","부산","수영구",6128,3187,2941
"498","2019","부산","사상구",8359,4289,4070
"499","2019","부산","기장군",11586,5916,5670
"500","2019","대구","중구",4350,2321,2029
"501","2019","대구","동구",17437,9037,8400
"502","2019","대구","서구",5879,2952,2927
"503","2019","대구","남구",4417,2306,2111
"504","2019","대구","북구",22719,11689,11030
"505","2019","대구","수성구",23583,12190,11393
"506","2019","대구","달서구",31654,16244,15410
"507","2019","대구","달성군",16083,8249,7834
"508","2019","인천","중구",8201,4230,3971
"509","2019","인천","동구",3770,1914,1856
"510","2019","인천","연수구",23208,11931,11277
"511","2019","인천","미추홀구",18165,9414,8751
"512","2019","인천","남동구",30078,15358,14720
"513","2019","인천","부평구",25048,12877,12171
"514","2019","인천","계양구",15339,7840,7499
"515","2019","인천","서구",33997,17433,16564
"516","2019","인천","강화군",2431,1260,1171
"517","2019","인천","옹진군",616,306,310
"518","2019","광주","동구",3227,1662,1565
"519","2019","광주","서구",17016,8830,8186
"520","2019","광주","남구",13419,6857,6562
"521","2019","광주","북구",23940,12558,11382
"522","2019","광주","광산구",31388,16159,15229
"523","2019","대전","동구",11381,5841,5540
"524","2019","대전","중구",12375,6383,5992
"525","2019","대전","서구",26760,13734,13026
"526","2019","대전","유성구",23402,12030,11372
"527","2019","대전","대덕구",8825,4580,4245
"528","2019","울산","중구",12405,6558,5847
"529","2019","울산","남구",16416,8599,7817
"530","2019","울산","동구",10508,5462,5046
"531","2019","울산","북구",15535,7976,7559
"532","2019","울산","울주군",13648,6944,6704
"533","2019","세종","세종시",27892,14134,13758
"534","2019","경기","수원시",69546,35869,33677
"535","2019","경기","성남시",46942,24230,22712
"536","2019","경기","부천시",41053,20964,20089
"537","2019","경기","안양시",28467,14669,13798
"538","2019","경기","과천시",2826,1458,1368
"539","2019","경기","안산시",34954,17936,17018
"540","2019","경기","용인시",70018,35792,34226
"541","2019","경기","군포시",15126,7833,7293
"542","2019","경기","의왕시",7490,3894,3596
"543","2019","경기","시흥시",29619,15170,14449
"544","2019","경기","평택시",30978,15903,15075
"545","2019","경기","화성시",63581,32457,31124
"546","2019","경기","오산시",16571,8551,8020
"547","2019","경기","광명시",18420,9385,9035
"548","2019","경기","광주시",19866,10089,9777
"549","2019","경기","하남시",16083,8197,7886
"550","2019","경기","김포시",31544,16049,15495
"551","2019","경기","이천시",13184,6780,6404
"552","2019","경기","안성시",10917,5588,5329
"553","2019","경기","여주시",5428,2813,2615
"554","2019","경기","양평군",5251,2704,2547
"555","2019","경기","고양시",54934,28165,26769
"556","2019","경기","남양주시",44661,22934,21727
"557","2019","경기","구리시",10213,5297,4916
"558","2019","경기","의정부시",22730,11706,11024
"559","2019","경기","파주시",29748,15187,14561
"560","2019","경기","동두천시",5014,2518,2496
"561","2019","경기","양주시",13531,6845,6686
"562","2019","경기","포천시",6727,3508,3219
"563","2019","경기","가평군",2583,1302,1281
"564","2019","경기","연천군",1739,911,828
"565","2019","강원","춘천시",15001,7770,7231
"566","2019","강원","원주시",19972,10209,9763
"567","2019","강원","강릉시",10110,5244,4866
"568","2019","강원","동해시",5019,2597,2422
"569","2019","강원","태백시",2261,1123,1138
"570","2019","강원","속초시",3901,1976,1925
"571","2019","강원","삼척시",2792,1462,1330
"572","2019","강원","홍천군",2846,1412,1434
"573","2019","강원","횡성군",1684,872,812
"574","2019","강원","영월군",1323,697,626
"575","2019","강원","평창군",1595,824,771
"576","2019","강원","정선군",1466,762,704
"577","2019","강원","철원군",2109,1109,1000
"578","2019","강원","화천군",1078,523,555
"579","2019","강원","양구군",1090,558,532
"580","2019","강원","인제군",1500,789,711
"581","2019","강원","고성군",929,498,431
"582","2019","강원","양양군",941,495,446
"583","2019","충북","청주시",50790,26138,24652
"584","2019","충북","충주시",10534,5378,5156
"585","2019","충북","제천시",6432,3248,3184
"586","2019","충북","보은군",1143,616,527
"587","2019","충북","옥천군",2170,1125,1045
"588","2019","충북","영동군",1711,911,800
"589","2019","충북","진천군",5169,2670,2499
"590","2019","충북","괴산군",1056,509,547
"591","2019","충북","음성군",4559,2390,2169
"592","2019","충북","단양군",1011,538,473
"593","2019","충북","증평군",2134,1122,1012
"594","2019","충남","천안시",42059,21677,20382
"595","2019","충남","공주시",4460,2310,2150
"596","2019","충남","보령시",4621,2339,2282
"597","2019","충남","아산시",22801,11732,11069
"598","2019","충남","서산시",10488,5451,5037
"599","2019","충남","논산시",5709,2975,2734
"600","2019","충남","계룡시",3161,1646,1515
"601","2019","충남","금산군",2260,1175,1085
"602","2019","충남","부여군",2345,1239,1106
"603","2019","충남","서천군",1787,895,892
"604","2019","충남","청양군",959,493,466
"605","2019","충남","홍성군",5734,2917,2817
"606","2019","충남","예산군",3007,1581,1426
"607","2019","충남","태안군",2420,1256,1164
"608","2019","충남","당진시",10613,5539,5074
"609","2019","전북","전주시",39670,20378,19292
"610","2019","전북","군산시",15877,8183,7694
"611","2019","전북","익산시",15461,7871,7590
"612","2019","전북","정읍시",5195,2722,2473
"613","2019","전북","남원시",3870,2019,1851
"614","2019","전북","김제시",3644,1834,1810
"615","2019","전북","완주군",4981,2655,2326
"616","2019","전북","진안군",877,448,429
"617","2019","전북","무주군",1018,510,508
"618","2019","전북","장수군",989,500,489
"619","2019","전북","임실군",1004,522,482
"620","2019","전북","순창군",1102,570,532
"621","2019","전북","고창군",2123,1117,1006
"622","2019","전북","부안군",1920,981,939
"623","2019","전남","목포시",15912,8112,7800
"624","2019","전남","여수시",14847,7500,7347
"625","2019","전남","순천시",16890,8754,8136
"626","2019","전남","나주시",6027,3041,2986
"627","2019","전남","광양시",9439,4850,4589
"628","2019","전남","담양군",1466,777,689
"629","2019","전남","곡성군",920,485,435
"630","2019","전남","구례군",956,483,473
"631","2019","전남","고흥군",1927,993,934
"632","2019","전남","보성군",1326,648,678
"633","2019","전남","화순군",2877,1482,1395
"634","2019","전남","장흥군",1454,745,709
"635","2019","전남","강진군",1341,697,644
"636","2019","전남","해남군",2793,1406,1387
"637","2019","전남","영암군",2499,1270,1229
"638","2019","전남","무안군",4745,2416,2329
"639","2019","전남","함평군",1002,536,466
"640","2019","전남","영광군",2296,1161,1135
"641","2019","전남","장성군",1907,1007,900
"642","2019","전남","완도군",2127,1088,1039
"643","2019","전남","진도군",1196,603,593
"644","2019","전남","신안군",1005,497,508
"645","2019","경북","포항시",27728,14444,13284
"646","2019","경북","경주시",11792,6044,5748
"647","2019","경북","김천시",6779,3523,3256
"648","2019","경북","안동시",8479,4425,4054
"649","2019","경북","구미시",28266,14671,13595
"650","2019","경북","영주시",4915,2483,2432
"651","2019","경북","영천시",3573,1882,1691
"652","2019","경북","상주시",3935,2056,1879
"653","2019","경북","문경시",2908,1556,1352
"654","2019","경북","경산시",13424,6898,6526
"655","2019","경북","군위군",499,281,218
"656","2019","경북","의성군",1146,582,564
"657","2019","경북","청송군",636,323,313
"658","2019","경북","영양군",510,284,226
"659","2019","경북","영덕군",1139,597,542
"660","2019","경북","청도군",1123,560,563
"661","2019","경북","고령군",1127,587,540
"662","2019","경북","성주군",1214,628,586
"663","2019","경북","칠곡군",7082,3652,3430
"664","2019","경북","예천군",1870,1013,857
"665","2019","경북","봉화군",956,496,460
"666","2019","경북","울진군",1973,1054,919
"667","2019","경북","울릉군",300,153,147
"668","2019","경남","창원시",59495,30739,28756
"669","2019","경남","진주시",20467,10688,9779
"670","2019","경남","통영시",8476,4361,4115
"671","2019","경남","사천시",6461,3327,3134
"672","2019","경남","김해시",35967,18329,17638
"673","2019","경남","밀양시",4233,2190,2043
"674","2019","경남","거제시",18759,9703,9056
"675","2019","경남","양산시",22021,11297,10724
"676","2019","경남","의령군",779,412,367
"677","2019","경남","함안군",3684,1874,1810
"678","2019","경남","창녕군",2320,1228,1092
"679","2019","경남","고성군",2256,1200,1056
"680","2019","경남","남해군",1348,737,611
"681","2019","경남","하동군",1519,819,700
"682","2019","경남","산청군",1059,588,471
"683","2019","경남","함양군",1471,782,689
"684","2019","경남","거창군",3035,1581,1454
"685","2019","경남","합천군",1256,663,593
"686","2019","제주","제주시",31399,16203,15196
"687","2019","제주","서귀포시",9669,4970,4699
"688","2018","서울","종로구",5507,2844,2663
"689","2018","서울","중구",5226,2557,2669
"690","2018","서울","용산구",7460,3833,3627
"691","2018","서울","성동구",11922,6068,5854
"692","2018","서울","광진구",15016,7669,7347
"693","2018","서울","동대문구",13721,7093,6628
"694","2018","서울","중랑구",15336,7847,7489
"695","2018","서울","성북구",21564,11091,10473
"696","2018","서울","강북구",10654,5434,5220
"697","2018","서울","도봉구",15962,8250,7712
"698","2018","서울","노원구",27558,14096,13462
"699","2018","서울","은평구",22028,11388,10640
"700","2018","서울","서대문구",13027,6618,6409
"701","2018","서울","마포구",15432,7851,7581
"702","2018","서울","양천구",24481,12664,11817
"703","2018","서울","강서구",26949,13868,13081
"704","2018","서울","구로구",18820,9557,9263
"705","2018","서울","금천구",8883,4534,4349
"706","2018","서울","영등포구",13881,7132,6749
"707","2018","서울","동작구",16366,8460,7906
"708","2018","서울","관악구",15768,8130,7638
"709","2018","서울","서초구",23182,11835,11347
"710","2018","서울","강남구",24858,12992,11866
"711","2018","서울","송파구",31368,16179,15189
"712","2018","서울","강동구",19831,10474,9357
"713","2018","부산","중구",1364,686,678
"714","2018","부산","서구",3756,1910,1846
"715","2018","부산","동구",2505,1278,1227
"716","2018","부산","영도구",4051,2044,2007
"717","2018","부산","부산진구",15439,7813,7626
"718","2018","부산","동래구",12547,6571,5976
"719","2018","부산","남구",12330,6325,6005
"720","2018","부산","북구",13114,6786,6328
"721","2018","부산","해운대구",20170,10367,9803
"722","2018","부산","사하구",14621,7487,7134
"723","2018","부산","금정구",9916,5178,4738
"724","2018","부산","강서구",8025,4051,3974
"725","2018","부산","연제구",9498,4939,4559
"726","2018","부산","수영구",6153,3191,2962
"727","2018","부산","사상구",8349,4301,4048
"728","2018","부산","기장군",10937,5610,5327
"729","2018","대구","중구",4306,2272,2034
"730","2018","대구","동구",17150,8888,8262
"731","2018","대구","서구",6003,3035,2968
"732","2018","대구","남구",4570,2418,2152
"733","2018","대구","북구",22867,11779,11088
"734","2018","대구","수성구",23630,12218,11412
"735","2018","대구","달서구",31660,16314,15346
"736","2018","대구","달성군",14974,7684,7290
"737","2018","인천","중구",7528,3871,3657
"738","2018","인천","동구",3898,2011,1887
"739","2018","인천","미추홀구",17945,9262,8683
"740","2018","인천","연수구",21898,11283,10615
"741","2018","인천","남동구",30053,15403,14650
"742","2018","인천","부평구",25430,13134,12296
"743","2018","인천","계양구",15952,8120,7832
"744","2018","인천","서구",33036,16880,16156
"745","2018","인천","강화군",2496,1284,1212
"746","2018","인천","옹진군",635,315,320
"747","2018","광주","동구",3211,1668,1543
"748","2018","광주","서구",17233,8975,8258
"749","2018","광주","남구",13118,6649,6469
"750","2018","광주","북구",23808,12476,11332
"751","2018","광주","광산구",31252,16074,15178
"752","2018","대전","동구",11558,5966,5592
"753","2018","대전","중구",12650,6498,6152
"754","2018","대전","서구",26789,13717,13072
"755","2018","대전","유성구",23219,11985,11234
"756","2018","대전","대덕구",9237,4826,4411
"757","2018","울산","중구",12371,6531,5840
"758","2018","울산","남구",16401,8601,7800
"759","2018","울산","동구",10353,5415,4938
"760","2018","울산","북구",14646,7501,7145
"761","2018","울산","울주군",13519,6989,6530
"762","2018","세종","세종시",24865,12613,12252
"763","2018","경기","수원시",69067,35569,33498
"764","2018","경기","성남시",47386,24342,23044
"765","2018","경기","부천시",41572,21265,20307
"766","2018","경기","안양시",29276,15109,14167
"767","2018","경기","과천시",2799,1467,1332
"768","2018","경기","안산시",35622,18306,17316
"769","2018","경기","용인시",68419,35146,33273
"770","2018","경기","군포시",15530,8057,7473
"771","2018","경기","의왕시",7397,3862,3535
"772","2018","경기","시흥시",27185,13894,13291
"773","2018","경기","평택시",29706,15233,14473
"774","2018","경기","화성시",58143,29652,28491
"775","2018","경기","오산시",16320,8384,7936
"776","2018","경기","광명시",19063,9708,9355
"777","2018","경기","광주시",18814,9546,9268
"778","2018","경기","하남시",14275,7199,7076
"779","2018","경기","김포시",28484,14622,13862
"780","2018","경기","이천시",13080,6781,6299
"781","2018","경기","안성시",10821,5597,5224
"782","2018","경기","여주시",5526,2841,2685
"783","2018","경기","양평군",5272,2688,2584
"784","2018","경기","고양시",54797,28071,26726
"785","2018","경기","남양주시",43187,22224,20963
"786","2018","경기","구리시",10151,5306,4845
"787","2018","경기","의정부시",22370,11523,10847
"788","2018","경기","파주시",28569,14559,14010
"789","2018","경기","동두천시",5179,2589,2590
"790","2018","경기","양주시",13088,6668,6420
"791","2018","경기","포천시",7046,3699,3347
"792","2018","경기","가평군",2587,1345,1242
"793","2018","경기","연천군",1768,928,840
"794","2018","강원","춘천시",14773,7648,7125
"795","2018","강원","원주시",19636,10088,9548
"796","2018","강원","강릉시",10120,5325,4795
"797","2018","강원","동해시",4977,2593,2384
"798","2018","강원","태백시",2307,1149,1158
"799","2018","강원","속초시",3892,1981,1911
"800","2018","강원","삼척시",2767,1451,1316
"801","2018","강원","홍천군",2904,1448,1456
"802","2018","강원","횡성군",1697,883,814
"803","2018","강원","영월군",1371,707,664
"804","2018","강원","평창군",1658,871,787
"805","2018","강원","정선군",1469,746,723
"806","2018","강원","철원군",2249,1190,1059
"807","2018","강원","화천군",1087,533,554
"808","2018","강원","양구군",1100,559,541
"809","2018","강원","인제군",1547,815,732
"810","2018","강원","고성군",939,507,432
"811","2018","강원","양양군",919,475,444
"812","2018","충북","청주시",49823,25634,24189
"813","2018","충북","충주시",10445,5383,5062
"814","2018","충북","제천시",6399,3239,3160
"815","2018","충북","보은군",1142,627,515
"816","2018","충북","옥천군",2233,1177,1056
"817","2018","충북","영동군",1738,931,807
"818","2018","충북","진천군",4604,2387,2217
"819","2018","충북","괴산군",1065,499,566
"820","2018","충북","음성군",4754,2465,2289
"821","2018","충북","단양군",1047,559,488
"822","2018","충북","증평군",2094,1108,986
"823","2018","충남","천안시",40495,21030,19465
"824","2018","충남","공주시",4525,2322,2203
"825","2018","충남","보령시",4740,2403,2337
"826","2018","충남","아산시",21973,11292,10681
"827","2018","충남","서산시",10195,5320,4875
"828","2018","충남","논산시",5817,3002,2815
"829","2018","충남","계룡시",3299,1721,1578
"830","2018","충남","금산군",2314,1211,1103
"831","2018","충남","부여군",2374,1264,1110
"832","2018","충남","서천군",1845,922,923
"833","2018","충남","청양군",987,508,479
"834","2018","충남","홍성군",5732,2923,2809
"835","2018","충남","예산군",3048,1576,1472
"836","2018","충남","태안군",2492,1300,1192
"837","2018","충남","당진시",10316,5419,4897
"838","2018","전북","전주시",38967,20028,18939
"839","2018","전북","군산시",15783,8108,7675
"840","2018","전북","익산시",15688,7964,7724
"841","2018","전북","정읍시",5248,2767,2481
"842","2018","전북","남원시",4014,2079,1935
"843","2018","전북","김제시",3713,1884,1829
"844","2018","전북","완주군",5052,2685,2367
"845","2018","전북","진안군",904,471,433
"846","2018","전북","무주군",1037,520,517
"847","2018","전북","장수군",979,492,487
"848","2018","전북","임실군",1001,516,485
"849","2018","전북","순창군",1134,585,549
"850","2018","전북","고창군",2130,1114,1016
"851","2018","전북","부안군",1956,998,958
"852","2018","전남","목포시",15777,8085,7692
"853","2018","전남","여수시",14882,7572,7310
"854","2018","전남","순천시",16738,8657,8081
"855","2018","전남","나주시",5491,2790,2701
"856","2018","전남","광양시",9249,4741,4508
"857","2018","전남","담양군",1440,755,685
"858","2018","전남","곡성군",967,511,456
"859","2018","전남","구례군",996,522,474
"860","2018","전남","고흥군",1980,1031,949
"861","2018","전남","보성군",1399,678,721
"862","2018","전남","화순군",2925,1522,1403
"863","2018","전남","장흥군",1438,764,674
"864","2018","전남","강진군",1346,686,660
"865","2018","전남","해남군",2838,1451,1387
"866","2018","전남","영암군",2532,1313,1219
"867","2018","전남","무안군",4602,2301,2301
"868","2018","전남","함평군",998,521,477
"869","2018","전남","영광군",2306,1170,1136
"870","2018","전남","장성군",1946,1031,915
"871","2018","전남","완도군",2110,1095,1015
"872","2018","전남","진도군",1200,606,594
"873","2018","전남","신안군",974,487,487
"874","2018","경북","포항시",27068,14119,12949
"875","2018","경북","경주시",11785,6061,5724
"876","2018","경북","김천시",6586,3473,3113
"877","2018","경북","안동시",8655,4496,4159
"878","2018","경북","구미시",27681,14388,13293
"879","2018","경북","영주시",4927,2485,2442
"880","2018","경북","영천시",3553,1876,1677
"881","2018","경북","상주시",3973,2073,1900
"882","2018","경북","문경시",2907,1589,1318
"883","2018","경북","경산시",12992,6745,6247
"884","2018","경북","군위군",496,272,224
"885","2018","경북","의성군",1209,620,589
"886","2018","경북","청송군",623,324,299
"887","2018","경북","영양군",523,278,245
"888","2018","경북","영덕군",1170,605,565
"889","2018","경북","청도군",1119,560,559
"890","2018","경북","고령군",1189,623,566
"891","2018","경북","성주군",1215,651,564
"892","2018","경북","칠곡군",6969,3618,3351
"893","2018","경북","예천군",1326,734,592
"894","2018","경북","봉화군",995,499,496
"895","2018","경북","울진군",2039,1085,954
"896","2018","경북","울릉군",290,153,137
"897","2018","경남","창원시",58415,30253,28162
"898","2018","경남","진주시",20019,10491,9528
"899","2018","경남","통영시",8333,4277,4056
"900","2018","경남","사천시",6469,3302,3167
"901","2018","경남","김해시",35453,18177,17276
"902","2018","경남","밀양시",4219,2171,2048
"903","2018","경남","거제시",18201,9367,8834
"904","2018","경남","양산시",21028,10724,10304
"905","2018","경남","의령군",765,390,375
"906","2018","경남","함안군",3713,1902,1811
"907","2018","경남","창녕군",2280,1215,1065
"908","2018","경남","고성군",2240,1206,1034
"909","2018","경남","남해군",1368,755,613
"910","2018","경남","하동군",1598,868,730
"911","2018","경남","산청군",1097,602,495
"912","2018","경남","함양군",1534,793,741
"913","2018","경남","거창군",3015,1559,1456
"914","2018","경남","합천군",1269,660,609
"915","2018","제주","제주시",30597,15823,14774
"916","2018","제주","서귀포시",9499,4916,4583
"917","2017","서울","종로구",5561,2864,2697
"918","2017","서울","중구",5283,2613,2670
"919","2017","서울","용산구",7624,3906,3718
"920","2017","서울","성동구",12047,6150,5897
"921","2017","서울","광진구",15029,7726,7303
"922","2017","서울","동대문구",13930,7215,6715
"923","2017","서울","중랑구",15419,7906,7513
"924","2017","서울","성북구",21897,11265,10632
"925","2017","서울","강북구",10878,5540,5338
"926","2017","서울","도봉구",16242,8381,7861
"927","2017","서울","노원구",28364,14557,13807
"928","2017","서울","은평구",22409,11596,10813
"929","2017","서울","서대문구",13193,6698,6495
"930","2017","서울","마포구",15850,8092,7758
"931","2017","서울","양천구",24526,12695,11831
"932","2017","서울","강서구",26594,13652,12942
"933","2017","서울","구로구",18965,9696,9269
"934","2017","서울","금천구",9030,4599,4431
"935","2017","서울","영등포구",13905,7220,6685
"936","2017","서울","동작구",16698,8659,8039
"937","2017","서울","관악구",16227,8325,7902
"938","2017","서울","서초구",22939,11725,11214
"939","2017","서울","강남구",24371,12738,11633
"940","2017","서울","송파구",31191,16040,15151
"941","2017","서울","강동구",20161,10606,9555
"942","2017","부산","중구",1396,703,693
"943","2017","부산","서구",3694,1854,1840
"944","2017","부산","동구",2456,1239,1217
"945","2017","부산","영도구",4086,2093,1993
"946","2017","부산","부산진구",15375,7838,7537
"947","2017","부산","동래구",12486,6555,5931
"948","2017","부산","남구",12130,6268,5862
"949","2017","부산","북구",13403,6967,6436
"950","2017","부산","해운대구",20391,10502,9889
"951","2017","부산","사하구",14394,7348,7046
"952","2017","부산","금정구",9690,5121,4569
"953","2017","부산","강서구",6962,3527,3435
"954","2017","부산","연제구",9440,4906,4534
"955","2017","부산","수영구",6154,3212,2942
"956","2017","부산","사상구",8431,4345,4086
"957","2017","부산","기장군",10375,5338,5037
"958","2017","대구","중구",4144,2179,1965
"959","2017","대구","동구",17060,8862,8198
"960","2017","대구","서구",6161,3102,3059
"961","2017","대구","남구",4758,2515,2243
"962","2017","대구","북구",23118,11982,11136
"963","2017","대구","수성구",23967,12514,11453
"964","2017","대구","달서구",32135,16644,15491
"965","2017","대구","달성군",13365,6893,6472
"966","2017","인천","중구",7346,3777,3569
"967","2017","인천","동구",4015,2050,1965
"968","2017","인천","미추홀구",17540,8982,8558
"969","2017","인천","연수구",20803,10682,10121
"970","2017","인천","남동구",29429,15094,14335
"971","2017","인천","부평구",26138,13439,12699
"972","2017","인천","계양구",16403,8385,8018
"973","2017","인천","서구",31686,16274,15412
"974","2017","인천","강화군",2513,1296,1217
"975","2017","인천","옹진군",597,309,288
"976","2017","광주","동구",3165,1682,1483
"977","2017","광주","서구",17461,9047,8414
"978","2017","광주","남구",12820,6518,6302
"979","2017","광주","북구",23464,12337,11127
"980","2017","광주","광산구",31279,16054,15225
"981","2017","대전","동구",11794,6114,5680
"982","2017","대전","중구",13082,6706,6376
"983","2017","대전","서구",26732,13715,13017
"984","2017","대전","유성구",23055,11886,11169
"985","2017","대전","대덕구",9577,4984,4593
"986","2017","울산","중구",12074,6374,5700
"987","2017","울산","남구",16491,8642,7849
"988","2017","울산","동구",10053,5283,4770
"989","2017","울산","북구",13844,7099,6745
"990","2017","울산","울주군",13554,7011,6543
"991","2017","세종","세종시",20764,10483,10281
"992","2017","경기","수원시",68095,34899,33196
"993","2017","경기","성남시",47213,24211,23002
"994","2017","경기","부천시",40820,20958,19862
"995","2017","경기","안양시",29890,15445,14445
"996","2017","경기","과천시",2973,1570,1403
"997","2017","경기","안산시",36926,18975,17951
"998","2017","경기","용인시",67328,34771,32557
"999","2017","경기","군포시",15850,8215,7635
"1000","2017","경기","의왕시",7487,3920,3567
"1001","2017","경기","시흥시",25140,12774,12366
"1002","2017","경기","평택시",28674,14697,13977
"1003","2017","경기","화성시",52593,26796,25797
"1004","2017","경기","오산시",15696,8125,7571
"1005","2017","경기","광명시",19436,9928,9508
"1006","2017","경기","광주시",17608,8903,8705
"1007","2017","경기","하남시",12281,6326,5955
"1008","2017","경기","김포시",25578,13196,12382
"1009","2017","경기","이천시",12988,6766,6222
"1010","2017","경기","안성시",10734,5551,5183
"1011","2017","경기","여주시",5548,2850,2698
"1012","2017","경기","양평군",5118,2631,2487
"1013","2017","경기","고양시",54467,27983,26484
"1014","2017","경기","남양주시",41985,21634,20351
"1015","2017","경기","구리시",9780,5166,4614
"1016","2017","경기","의정부시",21918,11297,10621
"1017","2017","경기","파주시",27888,14219,13669
"1018","2017","경기","동두천시",5231,2619,2612
"1019","2017","경기","양주시",13026,6720,6306
"1020","2017","경기","포천시",7217,3788,3429
"1021","2017","경기","가평군",2651,1390,1261
"1022","2017","경기","연천군",1802,949,853
"1023","2017","강원","춘천시",14701,7616,7085
"1024","2017","강원","원주시",19531,10056,9475
"1025","2017","강원","강릉시",10151,5346,4805
"1026","2017","강원","동해시",5062,2624,2438
"1027","2017","강원","태백시",2323,1166,1157
"1028","2017","강원","속초시",3870,1948,1922
"1029","2017","강원","삼척시",2783,1458,1325
"1030","2017","강원","홍천군",2938,1494,1444
"1031","2017","강원","횡성군",1694,873,821
"1032","2017","강원","영월군",1387,744,643
"1033","2017","강원","평창군",1708,909,799
"1034","2017","강원","정선군",1516,757,759
"1035","2017","강원","철원군",2326,1206,1120
"1036","2017","강원","화천군",1117,558,559
"1037","2017","강원","양구군",1104,563,541
"1038","2017","강원","인제군",1590,835,755
"1039","2017","강원","고성군",959,517,442
"1040","2017","강원","양양군",962,489,473
"1041","2017","충북","청주시",49407,25530,23877
"1042","2017","충북","충주시",10225,5266,4959
"1043","2017","충북","제천시",6326,3205,3121
"1044","2017","충북","보은군",1158,638,520
"1045","2017","충북","옥천군",2200,1143,1057
"1046","2017","충북","영동군",1745,937,808
"1047","2017","충북","진천군",4153,2157,1996
"1048","2017","충북","괴산군",1095,524,571
"1049","2017","충북","음성군",4744,2474,2270
"1050","2017","충북","단양군",1103,598,505
"1051","2017","충북","증평군",2084,1112,972
"1052","2017","충남","천안시",39092,20215,18877
"1053","2017","충남","공주시",4601,2356,2245
"1054","2017","충남","보령시",4726,2458,2268
"1055","2017","충남","아산시",20778,10715,10063
"1056","2017","충남","서산시",10006,5220,4786
"1057","2017","충남","논산시",5834,3025,2809
"1058","2017","충남","계룡시",3258,1678,1580
"1059","2017","충남","금산군",2313,1213,1100
"1060","2017","충남","부여군",2481,1301,1180
"1061","2017","충남","서천군",1895,942,953
"1062","2017","충남","청양군",992,505,487
"1063","2017","충남","홍성군",5521,2776,2745
"1064","2017","충남","예산군",3040,1578,1462
"1065","2017","충남","태안군",2489,1297,1192
"1066","2017","충남","당진시",9937,5221,4716
"1067","2017","전북","전주시",38417,19953,18464
"1068","2017","전북","군산시",15680,8040,7640
"1069","2017","전북","익산시",15896,8135,7761
"1070","2017","전북","정읍시",5277,2776,2501
"1071","2017","전북","남원시",4115,2120,1995
"1072","2017","전북","김제시",3637,1873,1764
"1073","2017","전북","완주군",5100,2685,2415
"1074","2017","전북","진안군",908,468,440
"1075","2017","전북","무주군",1076,527,549
"1076","2017","전북","장수군",985,500,485
"1077","2017","전북","임실군",1025,523,502
"1078","2017","전북","순창군",1159,605,554
"1079","2017","전북","고창군",2108,1109,999
"1080","2017","전북","부안군",2000,1019,981
"1081","2017","전남","목포시",15569,7983,7586
"1082","2017","전남","여수시",14692,7497,7195
"1083","2017","전남","순천시",16662,8637,8025
"1084","2017","전남","나주시",5071,2640,2431
"1085","2017","전남","광양시",9076,4659,4417
"1086","2017","전남","담양군",1455,756,699
"1087","2017","전남","곡성군",982,526,456
"1088","2017","전남","구례군",1042,552,490
"1089","2017","전남","고흥군",2060,1077,983
"1090","2017","전남","보성군",1396,678,718
"1091","2017","전남","화순군",2960,1543,1417
"1092","2017","전남","장흥군",1500,793,707
"1093","2017","전남","강진군",1359,695,664
"1094","2017","전남","해남군",2899,1485,1414
"1095","2017","전남","영암군",2562,1344,1218
"1096","2017","전남","무안군",4490,2263,2227
"1097","2017","전남","함평군",1000,525,475
"1098","2017","전남","영광군",2305,1198,1107
"1099","2017","전남","장성군",1928,1010,918
"1100","2017","전남","완도군",2101,1079,1022
"1101","2017","전남","진도군",1187,618,569
"1102","2017","전남","신안군",937,475,462
"1103","2017","경북","포항시",26717,13929,12788
"1104","2017","경북","경주시",11757,6068,5689
"1105","2017","경북","김천시",6449,3365,3084
"1106","2017","경북","안동시",8235,4284,3951
"1107","2017","경북","구미시",26881,13928,12953
"1108","2017","경북","영주시",4982,2566,2416
"1109","2017","경북","영천시",3573,1892,1681
"1110","2017","경북","상주시",4033,2105,1928
"1111","2017","경북","문경시",2918,1578,1340
"1112","2017","경북","경산시",12565,6524,6041
"1113","2017","경북","군위군",506,267,239
"1114","2017","경북","의성군",1250,656,594
"1115","2017","경북","청송군",657,334,323
"1116","2017","경북","영양군",553,286,267
"1117","2017","경북","영덕군",1205,623,582
"1118","2017","경북","청도군",1153,572,581
"1119","2017","경북","고령군",1233,658,575
"1120","2017","경북","성주군",1225,666,559
"1121","2017","경북","칠곡군",7001,3701,3300
"1122","2017","경북","예천군",1377,758,619
"1123","2017","경북","봉화군",994,506,488
"1124","2017","경북","울진군",2094,1126,968
"1125","2017","경북","울릉군",284,146,138
"1126","2017","경남","창원시",57188,29712,27476
"1127","2017","경남","진주시",19689,10277,9412
"1128","2017","경남","통영시",8135,4213,3922
"1129","2017","경남","사천시",6417,3273,3144
"1130","2017","경남","김해시",35186,18258,16928
"1131","2017","경남","밀양시",4248,2168,2080
"1132","2017","경남","거제시",17487,9009,8478
"1133","2017","경남","양산시",19371,9876,9495
"1134","2017","경남","의령군",802,428,374
"1135","2017","경남","함안군",3704,1923,1781
"1136","2017","경남","창녕군",2215,1200,1015
"1137","2017","경남","고성군",2222,1169,1053
"1138","2017","경남","남해군",1422,771,651
"1139","2017","경남","하동군",1645,877,768
"1140","2017","경남","산청군",1125,597,528
"1141","2017","경남","함양군",1591,828,763
"1142","2017","경남","거창군",2916,1513,1403
"1143","2017","경남","합천군",1256,650,606
"1144","2017","제주","제주시",29884,15526,14358
"1145","2017","제주","서귀포시",9017,4676,4341
