,연도,시도,행정구역,코드,학제,date.x,성별,학생수,인구수_2년전_4세,인구수_1년전_5세,4세대비5세변동치,5세대비1학년변동치,4세대비1학년변동치,4세대비5세변동률,5세대비1학년변동률,4세대비1학년변동률
1,2021,서울,종로구,1111000000,초등학교,2021-04-01,전체,799,865,841,-24,-42,-66,-0.027745665,-0.049940547,-0.076300578
2,2021,서울,종로구,1111000000,초등학교,2021-04-01,여자,407,417,406,-11,1,-10,-0.026378897,0.002463054,-0.023980815
3,2021,서울,종로구,1111000000,초등학교,2021-04-01,남자,392,448,435,-13,-43,-56,-0.029017857,-0.098850575,-0.125
4,2021,서울,중구,1114000000,초등학교,2021-04-01,전체,786,777,733,-44,53,9,-0.056628057,0.072305593,0.011583012
5,2021,서울,중구,1114000000,초등학교,2021-04-01,여자,393,378,355,-23,38,15,-0.060846561,0.107042254,0.03968254
6,2021,서울,중구,1114000000,초등학교,2021-04-01,남자,393,399,378,-21,15,-6,-0.052631579,0.03968254,-0.015037594
7,2021,서울,용산구,1117000000,초등학교,2021-04-01,전체,1107,1494,1443,-51,-336,-387,-0.034136546,-0.232848233,-0.259036145
8,2021,서울,용산구,1117000000,초등학교,2021-04-01,여자,550,726,707,-19,-157,-176,-0.026170799,-0.222065064,-0.242424242
9,2021,서울,용산구,1117000000,초등학교,2021-04-01,남자,557,768,736,-32,-179,-211,-0.041666667,-0.243206522,-0.274739583
10,2021,서울,성동구,1120000000,초등학교,2021-04-01,전체,1866,2477,2333,-144,-467,-611,-0.058134841,-0.200171453,-0.246669358
11,2021,서울,성동구,1120000000,초등학교,2021-04-01,여자,913,1212,1152,-60,-239,-299,-0.04950495,-0.207465278,-0.24669967
12,2021,서울,성동구,1120000000,초등학교,2021-04-01,남자,953,1265,1181,-84,-228,-312,-0.066403162,-0.193056732,-0.246640316
13,2021,서울,광진구,1121500000,초등학교,2021-04-01,전체,2146,2355,2233,-122,-87,-209,-0.051804671,-0.038961039,-0.088747346
14,2021,서울,광진구,1121500000,초등학교,2021-04-01,여자,1028,1146,1095,-51,-67,-118,-0.044502618,-0.061187215,-0.102966841
15,2021,서울,광진구,1121500000,초등학교,2021-04-01,남자,1118,1209,1138,-71,-20,-91,-0.05872622,-0.017574692,-0.075268817
16,2021,서울,동대문구,1123000000,초등학교,2021-04-01,전체,2147,2368,2321,-47,-174,-221,-0.019847973,-0.074967686,-0.093327703
17,2021,서울,동대문구,1123000000,초등학교,2021-04-01,여자,1052,1158,1147,-11,-95,-106,-0.009499136,-0.08282476,-0.091537133
18,2021,서울,동대문구,1123000000,초등학교,2021-04-01,남자,1095,1210,1174,-36,-79,-115,-0.029752066,-0.067291312,-0.095041322
19,2021,서울,중랑구,1126000000,초등학교,2021-04-01,전체,2185,2636,2467,-169,-282,-451,-0.064112291,-0.114308877,-0.171092564
20,2021,서울,중랑구,1126000000,초등학교,2021-04-01,여자,1071,1276,1180,-96,-109,-205,-0.07523511,-0.092372881,-0.160658307
21,2021,서울,중랑구,1126000000,초등학교,2021-04-01,남자,1114,1360,1287,-73,-173,-246,-0.053676471,-0.134421134,-0.180882353
22,2021,서울,성북구,1129000000,초등학교,2021-04-01,전체,3134,3176,3198,22,-64,-42,0.006926952,-0.020012508,-0.013224181
23,2021,서울,성북구,1129000000,초등학교,2021-04-01,여자,1533,1527,1556,29,-23,6,0.018991487,-0.014781491,0.003929273
24,2021,서울,성북구,1129000000,초등학교,2021-04-01,남자,1601,1649,1642,-7,-41,-48,-0.004244997,-0.024969549,-0.029108551
25,2021,서울,강북구,1130500000,초등학교,2021-04-01,전체,1389,1877,1778,-99,-389,-488,-0.05274374,-0.218785152,-0.259989345
26,2021,서울,강북구,1130500000,초등학교,2021-04-01,여자,682,872,815,-57,-133,-190,-0.065366972,-0.163190184,-0.217889908
27,2021,서울,강북구,1130500000,초등학교,2021-04-01,남자,707,1005,963,-42,-256,-298,-0.041791045,-0.265835929,-0.296517413
28,2021,서울,도봉구,1132000000,초등학교,2021-04-01,전체,2248,2297,2200,-97,48,-49,-0.042228994,0.021818182,-0.021332172
29,2021,서울,도봉구,1132000000,초등학교,2021-04-01,여자,1109,1097,1050,-47,59,12,-0.04284412,0.056190476,0.010938924
30,2021,서울,도봉구,1132000000,초등학교,2021-04-01,남자,1139,1200,1150,-50,-11,-61,-0.041666667,-0.009565217,-0.050833333
31,2021,서울,노원구,1135000000,초등학교,2021-04-01,전체,3743,3806,3770,-36,-27,-63,-0.009458749,-0.007161804,-0.016552811
32,2021,서울,노원구,1135000000,초등학교,2021-04-01,여자,1823,1881,1878,-3,-55,-58,-0.001594896,-0.029286475,-0.030834662
33,2021,서울,노원구,1135000000,초등학교,2021-04-01,남자,1920,1925,1892,-33,28,-5,-0.017142857,0.014799154,-0.002597403
34,2021,서울,은평구,1138000000,초등학교,2021-04-01,전체,3041,3549,3398,-151,-357,-508,-0.042547196,-0.105061801,-0.143138912
35,2021,서울,은평구,1138000000,초등학교,2021-04-01,여자,1458,1738,1640,-98,-182,-280,-0.056386651,-0.11097561,-0.161104718
36,2021,서울,은평구,1138000000,초등학교,2021-04-01,남자,1583,1811,1758,-53,-175,-228,-0.029265599,-0.099544937,-0.125897294
37,2021,서울,서대문구,1141000000,초등학교,2021-04-01,전체,2203,2248,2254,6,-51,-45,0.002669039,-0.022626442,-0.020017794
38,2021,서울,서대문구,1141000000,초등학교,2021-04-01,여자,1117,1114,1127,13,-10,3,0.011669659,-0.008873114,0.002692998
39,2021,서울,서대문구,1141000000,초등학교,2021-04-01,남자,1086,1134,1127,-7,-41,-48,-0.00617284,-0.036379769,-0.042328042
40,2021,서울,마포구,1144000000,초등학교,2021-04-01,전체,2272,2779,2707,-72,-435,-507,-0.0259086,-0.160694496,-0.182439727
41,2021,서울,마포구,1144000000,초등학교,2021-04-01,여자,1141,1358,1318,-40,-177,-217,-0.029455081,-0.134294385,-0.159793814
42,2021,서울,마포구,1144000000,초등학교,2021-04-01,남자,1131,1421,1389,-32,-258,-290,-0.022519353,-0.18574514,-0.204081633
43,2021,서울,양천구,1147000000,초등학교,2021-04-01,전체,3397,3370,3443,73,-46,27,0.021661721,-0.013360441,0.008011869
44,2021,서울,양천구,1147000000,초등학교,2021-04-01,여자,1668,1630,1676,46,-8,38,0.028220859,-0.00477327,0.023312883
45,2021,서울,양천구,1147000000,초등학교,2021-04-01,남자,1729,1740,1767,27,-38,-11,0.015517241,-0.021505376,-0.006321839
46,2021,서울,강서구,1150000000,초등학교,2021-04-01,전체,4031,4738,4437,-301,-406,-707,-0.063528915,-0.091503268,-0.14921908
47,2021,서울,강서구,1150000000,초등학교,2021-04-01,여자,2039,2402,2239,-163,-200,-363,-0.067860117,-0.089325592,-0.151124063
48,2021,서울,강서구,1150000000,초등학교,2021-04-01,남자,1992,2336,2198,-138,-206,-344,-0.059075342,-0.093721565,-0.147260274
49,2021,서울,구로구,1153000000,초등학교,2021-04-01,전체,2777,3166,3143,-23,-366,-389,-0.007264687,-0.116449252,-0.122867972
50,2021,서울,구로구,1153000000,초등학교,2021-04-01,여자,1370,1563,1546,-17,-176,-193,-0.01087652,-0.113842173,-0.123480486
51,2021,서울,구로구,1153000000,초등학교,2021-04-01,남자,1407,1603,1597,-6,-190,-196,-0.003742982,-0.118973075,-0.122270742
52,2021,서울,금천구,1154500000,초등학교,2021-04-01,전체,1308,1516,1409,-107,-101,-208,-0.070580475,-0.071682044,-0.137203166
53,2021,서울,금천구,1154500000,초등학교,2021-04-01,여자,637,772,711,-61,-74,-135,-0.079015544,-0.104078762,-0.174870466
54,2021,서울,금천구,1154500000,초등학교,2021-04-01,남자,671,744,698,-46,-27,-73,-0.061827957,-0.038681948,-0.09811828
55,2021,서울,영등포구,1156000000,초등학교,2021-04-01,전체,2427,2806,2691,-115,-264,-379,-0.040983607,-0.098104794,-0.135067712
56,2021,서울,영등포구,1156000000,초등학교,2021-04-01,여자,1137,1352,1305,-47,-168,-215,-0.034763314,-0.128735632,-0.159023669
57,2021,서울,영등포구,1156000000,초등학교,2021-04-01,남자,1290,1454,1386,-68,-96,-164,-0.046767538,-0.069264069,-0.112792297
58,2021,서울,동작구,1159000000,초등학교,2021-04-01,전체,2523,3003,2871,-132,-348,-480,-0.043956044,-0.121212121,-0.15984016
59,2021,서울,동작구,1159000000,초등학교,2021-04-01,여자,1217,1466,1394,-72,-177,-249,-0.049113233,-0.12697274,-0.169849932
60,2021,서울,동작구,1159000000,초등학교,2021-04-01,남자,1306,1537,1477,-60,-171,-231,-0.039037085,-0.11577522,-0.150292778
61,2021,서울,관악구,1162000000,초등학교,2021-04-01,전체,2158,2801,2608,-193,-450,-643,-0.068903963,-0.172546012,-0.229560871
62,2021,서울,관악구,1162000000,초등학교,2021-04-01,여자,1038,1346,1252,-94,-214,-308,-0.069836553,-0.170926518,-0.228826152
63,2021,서울,관악구,1162000000,초등학교,2021-04-01,남자,1120,1455,1356,-99,-236,-335,-0.068041237,-0.174041298,-0.23024055
64,2021,서울,서초구,1165000000,초등학교,2021-04-01,전체,3399,3623,3723,100,-324,-224,0.027601435,-0.087026591,-0.061827215
65,2021,서울,서초구,1165000000,초등학교,2021-04-01,여자,1643,1727,1782,55,-139,-84,0.031847134,-0.078002245,-0.048639259
66,2021,서울,서초구,1165000000,초등학교,2021-04-01,남자,1756,1896,1941,45,-185,-140,0.023734177,-0.095311695,-0.073839662
67,2021,서울,강남구,1168000000,초등학교,2021-04-01,전체,3604,3784,3945,161,-341,-180,0.042547569,-0.08643853,-0.04756871
68,2021,서울,강남구,1168000000,초등학교,2021-04-01,여자,1721,1842,1906,64,-185,-121,0.034744843,-0.09706191,-0.065689468
69,2021,서울,강남구,1168000000,초등학교,2021-04-01,남자,1883,1942,2039,97,-156,-59,0.049948507,-0.076508092,-0.03038105
70,2021,서울,송파구,1171000000,초등학교,2021-04-01,전체,4988,5682,5576,-106,-588,-694,-0.018655403,-0.105451937,-0.122140092
71,2021,서울,송파구,1171000000,초등학교,2021-04-01,여자,2426,2742,2698,-44,-272,-316,-0.016046681,-0.100815419,-0.115244347
72,2021,서울,송파구,1171000000,초등학교,2021-04-01,남자,2562,2940,2878,-62,-316,-378,-0.021088435,-0.109798471,-0.128571429
73,2021,서울,강동구,1174000000,초등학교,2021-04-01,전체,3752,3280,3831,551,-79,472,0.167987805,-0.020621248,0.143902439
74,2021,서울,강동구,1174000000,초등학교,2021-04-01,여자,1827,1603,1858,255,-31,224,0.159076731,-0.016684607,0.139737991
75,2021,서울,강동구,1174000000,초등학교,2021-04-01,남자,1925,1677,1973,296,-48,248,0.176505665,-0.024328434,0.147883125
76,2021,부산,중구,2611000000,초등학교,2021-04-01,전체,217,189,175,-14,42,28,-0.074074074,0.24,0.148148148
77,2021,부산,중구,2611000000,초등학교,2021-04-01,여자,104,92,87,-5,17,12,-0.054347826,0.195402299,0.130434783
78,2021,부산,중구,2611000000,초등학교,2021-04-01,남자,113,97,88,-9,25,16,-0.092783505,0.284090909,0.164948454
79,2021,부산,서구,2614000000,초등학교,2021-04-01,전체,606,598,607,9,-1,8,0.015050167,-0.001647446,0.013377926
80,2021,부산,서구,2614000000,초등학교,2021-04-01,여자,298,284,286,2,12,14,0.007042254,0.041958042,0.049295775
81,2021,부산,서구,2614000000,초등학교,2021-04-01,남자,308,314,321,7,-13,-6,0.022292994,-0.040498442,-0.01910828
82,2021,부산,동구,2617000000,초등학교,2021-04-01,전체,387,433,453,20,-66,-46,0.046189376,-0.145695364,-0.106235566
83,2021,부산,동구,2617000000,초등학교,2021-04-01,여자,188,214,218,4,-30,-26,0.018691589,-0.137614679,-0.121495327
84,2021,부산,동구,2617000000,초등학교,2021-04-01,남자,199,219,235,16,-36,-20,0.073059361,-0.153191489,-0.091324201
85,2021,부산,영도구,2620000000,초등학교,2021-04-01,전체,533,583,570,-13,-37,-50,-0.022298456,-0.064912281,-0.085763293
86,2021,부산,영도구,2620000000,초등학교,2021-04-01,여자,258,280,271,-9,-13,-22,-0.032142857,-0.04797048,-0.078571429
87,2021,부산,영도구,2620000000,초등학교,2021-04-01,남자,275,303,299,-4,-24,-28,-0.01320132,-0.080267559,-0.092409241
88,2021,부산,부산진구,2623000000,초등학교,2021-04-01,전체,2573,2428,2389,-39,184,145,-0.016062603,0.077019674,0.059719934
89,2021,부산,부산진구,2623000000,초등학교,2021-04-01,여자,1273,1174,1159,-15,114,99,-0.012776831,0.098360656,0.084327087
90,2021,부산,부산진구,2623000000,초등학교,2021-04-01,남자,1300,1254,1230,-24,70,46,-0.019138756,0.056910569,0.036682616
91,2021,부산,동래구,2626000000,초등학교,2021-04-01,전체,2086,2044,2269,225,-183,42,0.110078278,-0.08065227,0.020547945
92,2021,부산,동래구,2626000000,초등학교,2021-04-01,여자,990,979,1094,115,-104,11,0.117466803,-0.095063985,0.011235955
93,2021,부산,동래구,2626000000,초등학교,2021-04-01,남자,1096,1065,1175,110,-79,31,0.103286385,-0.067234043,0.029107981
94,2021,부산,남구,2629000000,초등학교,2021-04-01,전체,1927,2117,2087,-30,-160,-190,-0.014170997,-0.076665069,-0.089749646
95,2021,부산,남구,2629000000,초등학교,2021-04-01,여자,930,1012,996,-16,-66,-82,-0.015810277,-0.06626506,-0.081027668
96,2021,부산,남구,2629000000,초등학교,2021-04-01,남자,997,1105,1091,-14,-94,-108,-0.012669683,-0.086159487,-0.097737557
97,2021,부산,북구,2632000000,초등학교,2021-04-01,전체,2002,2217,2169,-48,-167,-215,-0.02165088,-0.076994006,-0.096977898
98,2021,부산,북구,2632000000,초등학교,2021-04-01,여자,984,1091,1087,-4,-103,-107,-0.003666361,-0.09475621,-0.09807516
99,2021,부산,북구,2632000000,초등학교,2021-04-01,남자,1018,1126,1082,-44,-64,-108,-0.039076377,-0.059149723,-0.095914742
100,2021,부산,해운대구,2635000000,초등학교,2021-04-01,전체,3032,3167,3180,13,-148,-135,0.004104831,-0.046540881,-0.042627092
101,2021,부산,해운대구,2635000000,초등학교,2021-04-01,여자,1455,1549,1568,19,-113,-94,0.012265978,-0.072066327,-0.060684312
102,2021,부산,해운대구,2635000000,초등학교,2021-04-01,남자,1577,1618,1612,-6,-35,-41,-0.003708282,-0.021712159,-0.025339926
103,2021,부산,사하구,2638000000,초등학교,2021-04-01,전체,2090,2389,2313,-76,-223,-299,-0.031812474,-0.096411587,-0.125156969
104,2021,부산,사하구,2638000000,초등학교,2021-04-01,여자,980,1187,1148,-39,-168,-207,-0.032855939,-0.146341463,-0.174389217
105,2021,부산,사하구,2638000000,초등학교,2021-04-01,남자,1110,1202,1165,-37,-55,-92,-0.03078203,-0.0472103,-0.076539101
106,2021,부산,금정구,2641000000,초등학교,2021-04-01,전체,1528,1588,1574,-14,-46,-60,-0.008816121,-0.029224905,-0.037783375
107,2021,부산,금정구,2641000000,초등학교,2021-04-01,여자,727,771,766,-5,-39,-44,-0.006485084,-0.050913838,-0.057068742
108,2021,부산,금정구,2641000000,초등학교,2021-04-01,남자,801,817,808,-9,-7,-16,-0.011015912,-0.008663366,-0.019583843
109,2021,부산,강서구,2644000000,초등학교,2021-04-01,전체,2197,2140,2188,48,9,57,0.022429907,0.004113346,0.026635514
110,2021,부산,강서구,2644000000,초등학교,2021-04-01,여자,1072,1036,1054,18,18,36,0.017374517,0.017077799,0.034749035
111,2021,부산,강서구,2644000000,초등학교,2021-04-01,남자,1125,1104,1134,30,-9,21,0.027173913,-0.007936508,0.019021739
112,2021,부산,연제구,2647000000,초등학교,2021-04-01,전체,1556,1665,1662,-3,-106,-109,-0.001801802,-0.06377858,-0.065465465
113,2021,부산,연제구,2647000000,초등학교,2021-04-01,여자,777,825,826,1,-49,-48,0.001212121,-0.059322034,-0.058181818
114,2021,부산,연제구,2647000000,초등학교,2021-04-01,남자,779,840,836,-4,-57,-61,-0.004761905,-0.068181818,-0.072619048
115,2021,부산,수영구,2650000000,초등학교,2021-04-01,전체,1017,1117,1153,36,-136,-100,0.032229185,-0.117953166,-0.089525515
116,2021,부산,수영구,2650000000,초등학교,2021-04-01,여자,494,561,567,6,-73,-67,0.010695187,-0.128747795,-0.11942959
117,2021,부산,수영구,2650000000,초등학교,2021-04-01,남자,523,556,586,30,-63,-33,0.053956835,-0.107508532,-0.059352518
118,2021,부산,사상구,2653000000,초등학교,2021-04-01,전체,1166,1519,1440,-79,-274,-353,-0.0520079,-0.190277778,-0.23238973
119,2021,부산,사상구,2653000000,초등학교,2021-04-01,여자,573,772,729,-43,-156,-199,-0.055699482,-0.21399177,-0.257772021
120,2021,부산,사상구,2653000000,초등학교,2021-04-01,남자,593,747,711,-36,-118,-154,-0.048192771,-0.165963432,-0.206157965
121,2021,부산,기장군,2671000000,초등학교,2021-04-01,전체,2256,2185,2217,32,39,71,0.014645309,0.01759134,0.032494279
122,2021,부산,기장군,2671000000,초등학교,2021-04-01,여자,1091,1038,1064,26,27,53,0.02504817,0.02537594,0.05105973
123,2021,부산,기장군,2671000000,초등학교,2021-04-01,남자,1165,1147,1153,6,12,18,0.005231037,0.010407632,0.015693112
124,2021,대구,중구,2711000000,초등학교,2021-04-01,전체,762,608,580,-28,182,154,-0.046052632,0.313793103,0.253289474
125,2021,대구,중구,2711000000,초등학교,2021-04-01,여자,377,316,300,-16,77,61,-0.050632911,0.256666667,0.193037975
126,2021,대구,중구,2711000000,초등학교,2021-04-01,남자,385,292,280,-12,105,93,-0.04109589,0.375,0.318493151
127,2021,대구,동구,2714000000,초등학교,2021-04-01,전체,2792,3085,2947,-138,-155,-293,-0.044732577,-0.05259586,-0.094975689
128,2021,대구,동구,2714000000,초등학교,2021-04-01,여자,1381,1489,1421,-68,-40,-108,-0.045668234,-0.028149191,-0.072531901
129,2021,대구,동구,2714000000,초등학교,2021-04-01,남자,1411,1596,1526,-70,-115,-185,-0.043859649,-0.075360419,-0.115914787
130,2021,대구,서구,2717000000,초등학교,2021-04-01,전체,804,900,844,-56,-40,-96,-0.062222222,-0.047393365,-0.106666667
131,2021,대구,서구,2717000000,초등학교,2021-04-01,여자,386,453,430,-23,-44,-67,-0.050772627,-0.102325581,-0.14790287
132,2021,대구,서구,2717000000,초등학교,2021-04-01,남자,418,447,414,-33,4,-29,-0.073825503,0.009661836,-0.064876957
133,2021,대구,남구,2720000000,초등학교,2021-04-01,전체,657,740,759,19,-102,-83,0.025675676,-0.134387352,-0.112162162
134,2021,대구,남구,2720000000,초등학교,2021-04-01,여자,322,361,367,6,-45,-39,0.016620499,-0.122615804,-0.108033241
135,2021,대구,남구,2720000000,초등학교,2021-04-01,남자,335,379,392,13,-57,-44,0.034300792,-0.145408163,-0.116094987
136,2021,대구,북구,2723000000,초등학교,2021-04-01,전체,3524,3795,3831,36,-307,-271,0.009486166,-0.080135735,-0.07140975
137,2021,대구,북구,2723000000,초등학교,2021-04-01,여자,1729,1819,1841,22,-112,-90,0.012094557,-0.060836502,-0.049477735
138,2021,대구,북구,2723000000,초등학교,2021-04-01,남자,1795,1976,1990,14,-195,-181,0.00708502,-0.09798995,-0.09159919
139,2021,대구,수성구,2726000000,초등학교,2021-04-01,전체,3367,3064,3285,221,82,303,0.072127937,0.024961948,0.098890339
140,2021,대구,수성구,2726000000,초등학교,2021-04-01,여자,1642,1522,1627,105,15,120,0.068988173,0.009219422,0.078843627
141,2021,대구,수성구,2726000000,초등학교,2021-04-01,남자,1725,1542,1658,116,67,183,0.075226978,0.040410133,0.118677043
142,2021,대구,달서구,2729000000,초등학교,2021-04-01,전체,4623,4772,4772,0,-149,-149,0,-0.031223806,-0.031223806
143,2021,대구,달서구,2729000000,초등학교,2021-04-01,여자,2263,2349,2341,-8,-78,-86,-0.003405705,-0.033319094,-0.036611324
144,2021,대구,달서구,2729000000,초등학교,2021-04-01,남자,2360,2423,2431,8,-71,-63,0.003301692,-0.029206088,-0.026000825
145,2021,대구,달성군,2771000000,초등학교,2021-04-01,전체,3089,3275,3244,-31,-155,-186,-0.009465649,-0.047780518,-0.056793893
146,2021,대구,달성군,2771000000,초등학교,2021-04-01,여자,1526,1625,1612,-13,-86,-99,-0.008,-0.053349876,-0.060923077
147,2021,대구,달성군,2771000000,초등학교,2021-04-01,남자,1563,1650,1632,-18,-69,-87,-0.010909091,-0.042279412,-0.052727273
148,2021,인천,중구,2811000000,초등학교,2021-04-01,전체,1426,1193,1290,97,136,233,0.081307628,0.105426357,0.195305951
149,2021,인천,중구,2811000000,초등학교,2021-04-01,여자,726,586,625,39,101,140,0.066552901,0.1616,0.23890785
150,2021,인천,중구,2811000000,초등학교,2021-04-01,남자,700,607,665,58,35,93,0.095551895,0.052631579,0.153212521
151,2021,인천,동구,2814000000,초등학교,2021-04-01,전체,564,469,472,3,92,95,0.006396588,0.194915254,0.202558635
152,2021,인천,동구,2814000000,초등학교,2021-04-01,여자,257,216,217,1,40,41,0.00462963,0.184331797,0.189814815
153,2021,인천,동구,2814000000,초등학교,2021-04-01,남자,307,253,255,2,52,54,0.007905138,0.203921569,0.213438735
154,2021,인천,연수구,2818500000,초등학교,2021-04-01,전체,4278,3678,4021,343,257,600,0.093257205,0.063914449,0.163132137
155,2021,인천,연수구,2818500000,초등학교,2021-04-01,여자,2068,1765,1944,179,124,303,0.101416431,0.063786008,0.171671388
156,2021,인천,연수구,2818500000,초등학교,2021-04-01,남자,2210,1913,2077,164,133,297,0.085729221,0.064034665,0.155253528
157,2021,인천,미추홀구,2817700000,초등학교,2021-04-01,전체,2700,3288,3113,-175,-413,-588,-0.053223844,-0.132669451,-0.178832117
158,2021,인천,미추홀구,2817700000,초등학교,2021-04-01,여자,1333,1624,1551,-73,-218,-291,-0.044950739,-0.140554481,-0.179187192
159,2021,인천,미추홀구,2817700000,초등학교,2021-04-01,남자,1367,1664,1562,-102,-195,-297,-0.061298077,-0.124839949,-0.178485577
160,2021,인천,남동구,2820000000,초등학교,2021-04-01,전체,4447,5051,4932,-119,-485,-604,-0.023559691,-0.098337388,-0.119580281
161,2021,인천,남동구,2820000000,초등학교,2021-04-01,여자,2169,2514,2439,-75,-270,-345,-0.029832936,-0.110701107,-0.137231504
162,2021,인천,남동구,2820000000,초등학교,2021-04-01,남자,2278,2537,2493,-44,-215,-259,-0.017343319,-0.086241476,-0.102089082
163,2021,인천,부평구,2823700000,초등학교,2021-04-01,전체,3663,4026,3818,-208,-155,-363,-0.051664183,-0.040597171,-0.090163934
164,2021,인천,부평구,2823700000,초등학교,2021-04-01,여자,1798,1970,1883,-87,-85,-172,-0.044162437,-0.045140733,-0.087309645
165,2021,인천,부평구,2823700000,초등학교,2021-04-01,남자,1865,2056,1935,-121,-70,-191,-0.05885214,-0.036175711,-0.092898833
166,2021,인천,계양구,2824500000,초등학교,2021-04-01,전체,2099,2208,2128,-80,-29,-109,-0.036231884,-0.01362782,-0.049365942
167,2021,인천,계양구,2824500000,초등학교,2021-04-01,여자,1034,1072,1028,-44,6,-38,-0.041044776,0.005836576,-0.035447761
168,2021,인천,계양구,2824500000,초등학교,2021-04-01,남자,1065,1136,1100,-36,-35,-71,-0.031690141,-0.031818182,-0.0625
169,2021,인천,서구,2826000000,초등학교,2021-04-01,전체,5137,5720,5675,-45,-538,-583,-0.007867133,-0.094801762,-0.101923077
170,2021,인천,서구,2826000000,초등학교,2021-04-01,여자,2488,2747,2738,-9,-250,-259,-0.003276301,-0.091307524,-0.094284674
171,2021,인천,서구,2826000000,초등학교,2021-04-01,남자,2649,2973,2937,-36,-288,-324,-0.012108981,-0.098059244,-0.108980827
172,2021,인천,강화군,2871000000,초등학교,2021-04-01,전체,340,329,338,9,2,11,0.027355623,0.00591716,0.03343465
173,2021,인천,강화군,2871000000,초등학교,2021-04-01,여자,158,171,174,3,-16,-13,0.01754386,-0.091954023,-0.076023392
174,2021,인천,강화군,2871000000,초등학교,2021-04-01,남자,182,158,164,6,18,24,0.037974684,0.109756098,0.151898734
175,2021,인천,옹진군,2872000000,초등학교,2021-04-01,전체,76,103,92,-11,-16,-27,-0.106796117,-0.173913043,-0.262135922
176,2021,인천,옹진군,2872000000,초등학교,2021-04-01,여자,38,62,51,-11,-13,-24,-0.177419355,-0.254901961,-0.387096774
177,2021,인천,옹진군,2872000000,초등학교,2021-04-01,남자,38,41,41,0,-3,-3,0,-0.073170732,-0.073170732
178,2021,광주,동구,2911000000,초등학교,2021-04-01,전체,624,705,778,73,-154,-81,0.103546099,-0.197943445,-0.114893617
179,2021,광주,동구,2911000000,초등학교,2021-04-01,여자,288,322,359,37,-71,-34,0.114906832,-0.197771588,-0.105590062
180,2021,광주,동구,2911000000,초등학교,2021-04-01,남자,336,383,419,36,-83,-47,0.093994778,-0.198090692,-0.122715405
181,2021,광주,서구,2914000000,초등학교,2021-04-01,전체,2372,2396,2399,3,-27,-24,0.001252087,-0.011254689,-0.010016694
182,2021,광주,서구,2914000000,초등학교,2021-04-01,여자,1145,1183,1177,-6,-32,-38,-0.005071851,-0.027187766,-0.032121724
183,2021,광주,서구,2914000000,초등학교,2021-04-01,남자,1227,1213,1222,9,5,14,0.007419621,0.004091653,0.011541632
184,2021,광주,남구,2915500000,초등학교,2021-04-01,전체,2243,1919,2012,93,231,324,0.048462741,0.114811133,0.168837936
185,2021,광주,남구,2915500000,초등학교,2021-04-01,여자,1128,915,960,45,168,213,0.049180328,0.175,0.232786885
186,2021,광주,남구,2915500000,초등학교,2021-04-01,남자,1115,1004,1052,48,63,111,0.047808765,0.059885932,0.110557769
187,2021,광주,북구,2917000000,초등학교,2021-04-01,전체,3694,3739,3684,-55,10,-45,-0.014709815,0.002714441,-0.012035304
188,2021,광주,북구,2917000000,초등학교,2021-04-01,여자,1819,1839,1797,-42,22,-20,-0.022838499,0.012242627,-0.010875476
189,2021,광주,북구,2917000000,초등학교,2021-04-01,남자,1875,1900,1887,-13,-12,-25,-0.006842105,-0.0063593,-0.013157895
190,2021,광주,광산구,2920000000,초등학교,2021-04-01,전체,4412,4563,4599,36,-187,-151,0.007889546,-0.040661013,-0.033092264
191,2021,광주,광산구,2920000000,초등학교,2021-04-01,여자,2128,2200,2228,28,-100,-72,0.012727273,-0.044883303,-0.032727273
192,2021,광주,광산구,2920000000,초등학교,2021-04-01,남자,2284,2363,2371,8,-87,-79,0.003385527,-0.036693378,-0.033432078
193,2021,대전,동구,3011000000,초등학교,2021-04-01,전체,1659,1783,1717,-66,-58,-124,-0.037016265,-0.033779849,-0.069545709
194,2021,대전,동구,3011000000,초등학교,2021-04-01,여자,777,846,814,-32,-37,-69,-0.037825059,-0.045454545,-0.081560284
195,2021,대전,동구,3011000000,초등학교,2021-04-01,남자,882,937,903,-34,-21,-55,-0.036286019,-0.023255814,-0.058697972
196,2021,대전,중구,3014000000,초등학교,2021-04-01,전체,1654,1789,1715,-74,-61,-135,-0.04136389,-0.035568513,-0.075461151
197,2021,대전,중구,3014000000,초등학교,2021-04-01,여자,834,867,831,-36,3,-33,-0.041522491,0.003610108,-0.038062284
198,2021,대전,중구,3014000000,초등학교,2021-04-01,남자,820,922,884,-38,-64,-102,-0.041214751,-0.07239819,-0.110629067
199,2021,대전,서구,3017000000,초등학교,2021-04-01,전체,4014,4260,4309,49,-295,-246,0.011502347,-0.06846136,-0.057746479
200,2021,대전,서구,3017000000,초등학교,2021-04-01,여자,1935,2082,2087,5,-152,-147,0.002401537,-0.072831816,-0.070605187
201,2021,대전,서구,3017000000,초등학교,2021-04-01,남자,2079,2178,2222,44,-143,-99,0.02020202,-0.064356436,-0.045454545
202,2021,대전,유성구,3020000000,초등학교,2021-04-01,전체,3774,4027,3970,-57,-196,-253,-0.014154457,-0.049370277,-0.062825925
203,2021,대전,유성구,3020000000,초등학교,2021-04-01,여자,1811,1928,1921,-7,-110,-117,-0.003630705,-0.057261843,-0.060684647
204,2021,대전,유성구,3020000000,초등학교,2021-04-01,남자,1963,2099,2049,-50,-86,-136,-0.023820867,-0.041971694,-0.064792758
205,2021,대전,대덕구,3023000000,초등학교,2021-04-01,전체,1211,1261,1202,-59,9,-50,-0.046788263,0.007487521,-0.039651071
206,2021,대전,대덕구,3023000000,초등학교,2021-04-01,여자,559,588,552,-36,7,-29,-0.06122449,0.012681159,-0.049319728
207,2021,대전,대덕구,3023000000,초등학교,2021-04-01,남자,652,673,650,-23,2,-21,-0.034175334,0.003076923,-0.031203566
208,2021,울산,중구,3111000000,초등학교,2021-04-01,전체,1858,1965,1912,-53,-54,-107,-0.02697201,-0.028242678,-0.054452926
209,2021,울산,중구,3111000000,초등학교,2021-04-01,여자,917,962,937,-25,-20,-45,-0.025987526,-0.021344717,-0.046777547
210,2021,울산,중구,3111000000,초등학교,2021-04-01,남자,941,1003,975,-28,-34,-62,-0.027916251,-0.034871795,-0.061814556
211,2021,울산,남구,3114000000,초등학교,2021-04-01,전체,2587,2725,2708,-17,-121,-138,-0.006238532,-0.044682422,-0.050642202
212,2021,울산,남구,3114000000,초등학교,2021-04-01,여자,1242,1304,1302,-2,-60,-62,-0.001533742,-0.046082949,-0.047546012
213,2021,울산,남구,3114000000,초등학교,2021-04-01,남자,1345,1421,1406,-15,-61,-76,-0.010555947,-0.043385491,-0.053483462
214,2021,울산,동구,3117000000,초등학교,2021-04-01,전체,1769,1862,1793,-69,-24,-93,-0.037056928,-0.013385388,-0.049946294
215,2021,울산,동구,3117000000,초등학교,2021-04-01,여자,864,918,875,-43,-11,-54,-0.046840959,-0.012571429,-0.058823529
216,2021,울산,동구,3117000000,초등학교,2021-04-01,남자,905,944,918,-26,-13,-39,-0.027542373,-0.01416122,-0.041313559
217,2021,울산,북구,3120000000,초등학교,2021-04-01,전체,2733,2792,2867,75,-134,-59,0.026862464,-0.046738751,-0.021131805
218,2021,울산,북구,3120000000,초등학교,2021-04-01,여자,1324,1373,1399,26,-75,-49,0.018936635,-0.053609721,-0.035688274
219,2021,울산,북구,3120000000,초등학교,2021-04-01,남자,1409,1419,1468,49,-59,-10,0.03453136,-0.040190736,-0.007047216
220,2021,울산,울주군,3171000000,초등학교,2021-04-01,전체,2026,2012,2011,-1,15,14,-0.000497018,0.007458976,0.00695825
221,2021,울산,울주군,3171000000,초등학교,2021-04-01,여자,962,936,934,-2,28,26,-0.002136752,0.029978587,0.027777778
222,2021,울산,울주군,3171000000,초등학교,2021-04-01,남자,1064,1076,1077,1,-13,-12,0.000929368,-0.012070566,-0.011152416
223,2021,세종,세종시,3611000000,초등학교,2021-04-01,전체,5088,4639,5040,401,48,449,0.086441043,0.00952381,0.096788101
224,2021,세종,세종시,3611000000,초등학교,2021-04-01,전체,5088,4639,5040,401,48,449,0.086441043,0.00952381,0.096788101
225,2021,세종,세종시,3611000000,초등학교,2021-04-01,전체,5088,4639,5040,401,48,449,0.086441043,0.00952381,0.096788101
226,2021,세종,세종시,3611000000,초등학교,2021-04-01,전체,5088,4639,5040,401,48,449,0.086441043,0.00952381,0.096788101
227,2021,세종,세종시,3611000000,초등학교,2021-04-01,여자,2447,2252,2428,176,19,195,0.078152753,0.007825371,0.086589698
228,2021,세종,세종시,3611000000,초등학교,2021-04-01,여자,2447,2252,2428,176,19,195,0.078152753,0.007825371,0.086589698
229,2021,세종,세종시,3611000000,초등학교,2021-04-01,여자,2447,2252,2428,176,19,195,0.078152753,0.007825371,0.086589698
230,2021,세종,세종시,3611000000,초등학교,2021-04-01,여자,2447,2252,2428,176,19,195,0.078152753,0.007825371,0.086589698
231,2021,세종,세종시,3611000000,초등학교,2021-04-01,남자,2641,2387,2612,225,29,254,0.094260578,0.011102603,0.106409719
232,2021,세종,세종시,3611000000,초등학교,2021-04-01,남자,2641,2387,2612,225,29,254,0.094260578,0.011102603,0.106409719
233,2021,세종,세종시,3611000000,초등학교,2021-04-01,남자,2641,2387,2612,225,29,254,0.094260578,0.011102603,0.106409719
234,2021,세종,세종시,3611000000,초등학교,2021-04-01,남자,2641,2387,2612,225,29,254,0.094260578,0.011102603,0.106409719
235,2021,경기,수원시,4111000000,초등학교,2021-04-01,전체,10618,11351,11169,-182,-551,-733,-0.01603383,-0.049332975,-0.064575808
236,2021,경기,수원시,4111000000,초등학교,2021-04-01,여자,5126,5472,5396,-76,-270,-346,-0.013888889,-0.050037064,-0.063230994
237,2021,경기,수원시,4111000000,초등학교,2021-04-01,남자,5492,5879,5773,-106,-281,-387,-0.018030277,-0.048674866,-0.065827522
238,2021,경기,성남시,4113000000,초등학교,2021-04-01,전체,7180,7673,7688,15,-508,-493,0.001954907,-0.066077003,-0.064251271
239,2021,경기,성남시,4113000000,초등학교,2021-04-01,여자,3539,3844,3837,-7,-298,-305,-0.00182102,-0.077664842,-0.079344433
240,2021,경기,성남시,4113000000,초등학교,2021-04-01,남자,3641,3829,3851,22,-210,-188,0.005745625,-0.054531291,-0.049098981
241,2021,경기,부천시,4119000000,초등학교,2021-04-01,전체,6281,6812,6567,-245,-286,-531,-0.035965942,-0.043551089,-0.077950675
242,2021,경기,부천시,4119000000,초등학교,2021-04-01,여자,3088,3312,3206,-106,-118,-224,-0.032004831,-0.036805989,-0.06763285
243,2021,경기,부천시,4119000000,초등학교,2021-04-01,남자,3193,3500,3361,-139,-168,-307,-0.039714286,-0.049985123,-0.087714286
244,2021,경기,안양시,4117000000,초등학교,2021-04-01,전체,4229,4469,4342,-127,-113,-240,-0.028417991,-0.026024873,-0.053703289
245,2021,경기,안양시,4117000000,초등학교,2021-04-01,여자,2066,2232,2160,-72,-94,-166,-0.032258065,-0.043518519,-0.07437276
246,2021,경기,안양시,4117000000,초등학교,2021-04-01,남자,2163,2237,2182,-55,-19,-74,-0.0245865,-0.008707608,-0.033080018
247,2021,경기,과천시,4129000000,초등학교,2021-04-01,전체,647,434,480,46,167,213,0.105990783,0.347916667,0.49078341
248,2021,경기,과천시,4129000000,초등학교,2021-04-01,여자,315,213,234,21,81,102,0.098591549,0.346153846,0.478873239
249,2021,경기,과천시,4129000000,초등학교,2021-04-01,남자,332,221,246,25,86,111,0.113122172,0.349593496,0.502262443
250,2021,경기,안산시,4127000000,초등학교,2021-04-01,전체,5078,4993,4897,-96,181,85,-0.019226918,0.036961405,0.017023833
251,2021,경기,안산시,4127000000,초등학교,2021-04-01,여자,2507,2522,2460,-62,47,-15,-0.024583664,0.019105691,-0.005947661
252,2021,경기,안산시,4127000000,초등학교,2021-04-01,남자,2571,2471,2437,-34,134,100,-0.013759611,0.054985638,0.040469446
253,2021,경기,용인시,4146000000,초등학교,2021-04-01,전체,11033,11102,11410,308,-377,-69,0.027742749,-0.033041192,-0.006215096
254,2021,경기,용인시,4146000000,초등학교,2021-04-01,여자,5432,5341,5487,146,-55,91,0.027335705,-0.010023692,0.017038008
255,2021,경기,용인시,4146000000,초등학교,2021-04-01,남자,5601,5761,5923,162,-322,-160,0.028120118,-0.054364342,-0.027772956
256,2021,경기,군포시,4141000000,초등학교,2021-04-01,전체,2187,2379,2304,-75,-117,-192,-0.031525851,-0.05078125,-0.080706179
257,2021,경기,군포시,4141000000,초등학교,2021-04-01,여자,1056,1168,1115,-53,-59,-112,-0.045376712,-0.052914798,-0.095890411
258,2021,경기,군포시,4141000000,초등학교,2021-04-01,남자,1131,1211,1189,-22,-58,-80,-0.018166804,-0.048780488,-0.066061107
259,2021,경기,의왕시,4143000000,초등학교,2021-04-01,전체,1240,1387,1501,114,-261,-147,0.082191781,-0.173884077,-0.105984138
260,2021,경기,의왕시,4143000000,초등학교,2021-04-01,여자,582,667,714,47,-132,-85,0.070464768,-0.18487395,-0.127436282
261,2021,경기,의왕시,4143000000,초등학교,2021-04-01,남자,658,720,787,67,-129,-62,0.093055556,-0.163913596,-0.086111111
262,2021,경기,시흥시,4139000000,초등학교,2021-04-01,전체,5478,4901,5166,265,312,577,0.054070598,0.06039489,0.117731075
263,2021,경기,시흥시,4139000000,초등학교,2021-04-01,여자,2700,2363,2500,137,200,337,0.057977148,0.08,0.14261532
264,2021,경기,시흥시,4139000000,초등학교,2021-04-01,남자,2778,2538,2666,128,112,240,0.050433412,0.042010503,0.094562648
265,2021,경기,평택시,4122000000,초등학교,2021-04-01,전체,5362,4974,5189,215,173,388,0.043224769,0.033339757,0.078005629
266,2021,경기,평택시,4122000000,초등학교,2021-04-01,여자,2615,2443,2527,84,88,172,0.034383954,0.034823902,0.070405239
267,2021,경기,평택시,4122000000,초등학교,2021-04-01,남자,2747,2531,2662,131,85,216,0.051758198,0.031930879,0.085341762
268,2021,경기,화성시,4159000000,초등학교,2021-04-01,전체,11404,11009,11573,564,-169,395,0.051230811,-0.014602955,0.035879735
269,2021,경기,화성시,4159000000,초등학교,2021-04-01,여자,5690,5373,5686,313,4,317,0.058254234,0.000703482,0.058998697
270,2021,경기,화성시,4159000000,초등학교,2021-04-01,남자,5714,5636,5887,251,-173,78,0.044535131,-0.029386784,0.013839603
271,2021,경기,오산시,4137000000,초등학교,2021-04-01,전체,2681,2682,2725,43,-44,-1,0.016032811,-0.016146789,-0.000372856
272,2021,경기,오산시,4137000000,초등학교,2021-04-01,여자,1352,1317,1350,33,2,35,0.025056948,0.001481481,0.02657555
273,2021,경기,오산시,4137000000,초등학교,2021-04-01,남자,1329,1365,1375,10,-46,-36,0.007326007,-0.033454545,-0.026373626
274,2021,경기,광명시,4121000000,초등학교,2021-04-01,전체,2528,2787,2748,-39,-220,-259,-0.013993541,-0.080058224,-0.092931468
275,2021,경기,광명시,4121000000,초등학교,2021-04-01,여자,1244,1362,1344,-18,-100,-118,-0.013215859,-0.074404762,-0.086637298
276,2021,경기,광명시,4121000000,초등학교,2021-04-01,남자,1284,1425,1404,-21,-120,-141,-0.014736842,-0.085470085,-0.098947368
277,2021,경기,광주시,4161000000,초등학교,2021-04-01,전체,3656,3963,3945,-18,-289,-307,-0.004542014,-0.073257288,-0.077466566
278,2021,경기,광주시,4161000000,초등학교,2021-04-01,여자,1765,1903,1892,-11,-127,-138,-0.005780347,-0.067124736,-0.072517078
279,2021,경기,광주시,4161000000,초등학교,2021-04-01,남자,1891,2060,2053,-7,-162,-169,-0.003398058,-0.078908914,-0.082038835
280,2021,경기,하남시,4145000000,초등학교,2021-04-01,전체,3373,3193,3394,201,-21,180,0.062950204,-0.00618739,0.056373317
281,2021,경기,하남시,4145000000,초등학교,2021-04-01,여자,1655,1607,1705,98,-50,48,0.060983199,-0.029325513,0.029869322
282,2021,경기,하남시,4145000000,초등학교,2021-04-01,남자,1718,1586,1689,103,29,132,0.064943253,0.017169923,0.083228247
283,2021,경기,김포시,4157000000,초등학교,2021-04-01,전체,6216,5716,5883,167,333,500,0.029216235,0.056603774,0.087473758
284,2021,경기,김포시,4157000000,초등학교,2021-04-01,여자,3086,2763,2850,87,236,323,0.031487514,0.082807018,0.116901918
285,2021,경기,김포시,4157000000,초등학교,2021-04-01,남자,3130,2953,3033,80,97,177,0.027091094,0.031981536,0.059939045
286,2021,경기,이천시,4150000000,초등학교,2021-04-01,전체,2037,2226,2181,-45,-144,-189,-0.020215633,-0.066024759,-0.08490566
287,2021,경기,이천시,4150000000,초등학교,2021-04-01,여자,945,1065,1051,-14,-106,-120,-0.01314554,-0.100856327,-0.112676056
288,2021,경기,이천시,4150000000,초등학교,2021-04-01,남자,1092,1161,1130,-31,-38,-69,-0.02670112,-0.033628319,-0.059431525
289,2021,경기,안성시,4155000000,초등학교,2021-04-01,전체,1547,1572,1560,-12,-13,-25,-0.007633588,-0.008333333,-0.015903308
290,2021,경기,안성시,4155000000,초등학교,2021-04-01,여자,768,757,747,-10,21,11,-0.01321004,0.02811245,0.014531044
291,2021,경기,안성시,4155000000,초등학교,2021-04-01,남자,779,815,813,-2,-34,-36,-0.002453988,-0.041820418,-0.044171779
292,2021,경기,여주시,4167000000,초등학교,2021-04-01,전체,766,801,807,6,-41,-35,0.007490637,-0.050805452,-0.043695381
293,2021,경기,여주시,4167000000,초등학교,2021-04-01,여자,370,367,368,1,2,3,0.002724796,0.005434783,0.008174387
294,2021,경기,여주시,4167000000,초등학교,2021-04-01,남자,396,434,439,5,-43,-38,0.011520737,-0.097949886,-0.087557604
295,2021,경기,양평군,4183000000,초등학교,2021-04-01,전체,783,781,797,16,-14,2,0.020486556,-0.017565872,0.002560819
296,2021,경기,양평군,4183000000,초등학교,2021-04-01,여자,364,378,384,6,-20,-14,0.015873016,-0.052083333,-0.037037037
297,2021,경기,양평군,4183000000,초등학교,2021-04-01,남자,419,403,413,10,6,16,0.024813896,0.014527845,0.039702233
298,2021,경기,고양시,4128000000,초등학교,2021-04-01,전체,8568,8709,9111,402,-543,-141,0.046159146,-0.059598288,-0.016190148
299,2021,경기,고양시,4128000000,초등학교,2021-04-01,여자,4163,4240,4431,191,-268,-77,0.04504717,-0.060482961,-0.018160377
300,2021,경기,고양시,4128000000,초등학교,2021-04-01,남자,4405,4469,4680,211,-275,-64,0.047214142,-0.058760684,-0.014320877
301,2021,경기,남양주시,4136000000,초등학교,2021-04-01,전체,7088,7010,7297,287,-209,78,0.040941512,-0.028641908,0.011126961
302,2021,경기,남양주시,4136000000,초등학교,2021-04-01,여자,3469,3358,3515,157,-46,111,0.04675402,-0.013086771,0.03305539
303,2021,경기,남양주시,4136000000,초등학교,2021-04-01,남자,3619,3652,3782,130,-163,-33,0.035596933,-0.043098889,-0.009036145
304,2021,경기,구리시,4131000000,초등학교,2021-04-01,전체,1556,1858,1797,-61,-241,-302,-0.032831001,-0.13411241,-0.162540366
305,2021,경기,구리시,4131000000,초등학교,2021-04-01,여자,742,917,876,-41,-134,-175,-0.044711014,-0.152968037,-0.190839695
306,2021,경기,구리시,4131000000,초등학교,2021-04-01,남자,814,941,921,-20,-107,-127,-0.021253985,-0.116178067,-0.134962806
307,2021,경기,의정부시,4115000000,초등학교,2021-04-01,전체,3562,3746,3757,11,-195,-184,0.002936466,-0.051903114,-0.04911906
308,2021,경기,의정부시,4115000000,초등학교,2021-04-01,여자,1742,1842,1849,7,-107,-100,0.003800217,-0.057869118,-0.054288817
309,2021,경기,의정부시,4115000000,초등학교,2021-04-01,남자,1820,1904,1908,4,-88,-84,0.00210084,-0.046121593,-0.044117647
310,2021,경기,파주시,4148000000,초등학교,2021-04-01,전체,4954,5030,4998,-32,-44,-76,-0.006361829,-0.008803521,-0.015109344
311,2021,경기,파주시,4148000000,초등학교,2021-04-01,여자,2436,2479,2477,-2,-41,-43,-0.000806777,-0.016552281,-0.017345704
312,2021,경기,파주시,4148000000,초등학교,2021-04-01,남자,2518,2551,2521,-30,-3,-33,-0.011760094,-0.001190004,-0.012936103
313,2021,경기,동두천시,4125000000,초등학교,2021-04-01,전체,725,746,719,-27,6,-21,-0.036193029,0.008344924,-0.028150134
314,2021,경기,동두천시,4125000000,초등학교,2021-04-01,여자,326,340,329,-11,-3,-14,-0.032352941,-0.009118541,-0.041176471
315,2021,경기,동두천시,4125000000,초등학교,2021-04-01,남자,399,406,390,-16,9,-7,-0.039408867,0.023076923,-0.017241379
316,2021,경기,양주시,4163000000,초등학교,2021-04-01,전체,2209,1990,2062,72,147,219,0.036180905,0.07129001,0.110050251
317,2021,경기,양주시,4163000000,초등학교,2021-04-01,여자,1054,973,1006,33,48,81,0.033915725,0.047713718,0.083247688
318,2021,경기,양주시,4163000000,초등학교,2021-04-01,남자,1155,1017,1056,39,99,138,0.038348083,0.09375,0.135693215
319,2021,경기,포천시,4165000000,초등학교,2021-04-01,전체,887,1007,976,-31,-89,-120,-0.030784508,-0.091188525,-0.119165839
320,2021,경기,포천시,4165000000,초등학교,2021-04-01,여자,449,506,494,-12,-45,-57,-0.023715415,-0.091093117,-0.112648221
321,2021,경기,포천시,4165000000,초등학교,2021-04-01,남자,438,501,482,-19,-44,-63,-0.037924152,-0.091286307,-0.125748503
322,2021,경기,가평군,4182000000,초등학교,2021-04-01,전체,330,361,343,-18,-13,-31,-0.049861496,-0.037900875,-0.085872576
323,2021,경기,가평군,4182000000,초등학교,2021-04-01,여자,149,170,167,-3,-18,-21,-0.017647059,-0.107784431,-0.123529412
324,2021,경기,가평군,4182000000,초등학교,2021-04-01,남자,181,191,176,-15,5,-10,-0.078534031,0.028409091,-0.052356021
325,2021,경기,연천군,4180000000,초등학교,2021-04-01,전체,264,303,294,-9,-30,-39,-0.02970297,-0.102040816,-0.128712871
326,2021,경기,연천군,4180000000,초등학교,2021-04-01,여자,136,159,142,-17,-6,-23,-0.106918239,-0.042253521,-0.144654088
327,2021,경기,연천군,4180000000,초등학교,2021-04-01,남자,128,144,152,8,-24,-16,0.055555556,-0.157894737,-0.111111111
328,2021,강원,춘천시,4211000000,초등학교,2021-04-01,전체,2319,2268,2335,67,-16,51,0.029541446,-0.006852248,0.022486772
329,2021,강원,춘천시,4211000000,초등학교,2021-04-01,여자,1117,1123,1148,25,-31,-6,0.022261799,-0.027003484,-0.005342832
330,2021,강원,춘천시,4211000000,초등학교,2021-04-01,남자,1202,1145,1187,42,15,57,0.036681223,0.0126369,0.049781659
331,2021,강원,원주시,4213000000,초등학교,2021-04-01,전체,2924,2905,2981,76,-57,19,0.02616179,-0.0191211,0.006540448
332,2021,강원,원주시,4213000000,초등학교,2021-04-01,여자,1441,1433,1462,29,-21,8,0.020237264,-0.014363885,0.005582694
333,2021,강원,원주시,4213000000,초등학교,2021-04-01,남자,1483,1472,1519,47,-36,11,0.031929348,-0.023699803,0.007472826
334,2021,강원,강릉시,4215000000,초등학교,2021-04-01,전체,1383,1410,1438,28,-55,-27,0.019858156,-0.038247566,-0.019148936
335,2021,강원,강릉시,4215000000,초등학교,2021-04-01,여자,682,722,737,15,-55,-40,0.020775623,-0.074626866,-0.055401662
336,2021,강원,강릉시,4215000000,초등학교,2021-04-01,남자,701,688,701,13,0,13,0.018895349,0,0.018895349
337,2021,강원,동해시,4217000000,초등학교,2021-04-01,전체,747,695,703,8,44,52,0.011510791,0.062588905,0.074820144
338,2021,강원,동해시,4217000000,초등학교,2021-04-01,여자,364,313,319,6,45,51,0.019169329,0.141065831,0.162939297
339,2021,강원,동해시,4217000000,초등학교,2021-04-01,남자,383,382,384,2,-1,1,0.005235602,-0.002604167,0.002617801
340,2021,강원,태백시,4219000000,초등학교,2021-04-01,전체,290,296,295,-1,-5,-6,-0.003378378,-0.016949153,-0.02027027
341,2021,강원,태백시,4219000000,초등학교,2021-04-01,여자,137,152,149,-3,-12,-15,-0.019736842,-0.080536913,-0.098684211
342,2021,강원,태백시,4219000000,초등학교,2021-04-01,남자,153,144,146,2,7,9,0.013888889,0.047945205,0.0625
343,2021,강원,속초시,4221000000,초등학교,2021-04-01,전체,627,674,696,22,-69,-47,0.03264095,-0.099137931,-0.069732938
344,2021,강원,속초시,4221000000,초등학교,2021-04-01,여자,306,333,335,2,-29,-27,0.006006006,-0.086567164,-0.081081081
345,2021,강원,속초시,4221000000,초등학교,2021-04-01,남자,321,341,361,20,-40,-20,0.058651026,-0.110803324,-0.058651026
346,2021,강원,삼척시,4223000000,초등학교,2021-04-01,전체,382,423,409,-14,-27,-41,-0.033096927,-0.06601467,-0.096926714
347,2021,강원,삼척시,4223000000,초등학교,2021-04-01,여자,182,211,200,-11,-18,-29,-0.052132701,-0.09,-0.137440758
348,2021,강원,삼척시,4223000000,초등학교,2021-04-01,남자,200,212,209,-3,-9,-12,-0.014150943,-0.043062201,-0.056603774
349,2021,강원,홍천군,4272000000,초등학교,2021-04-01,전체,332,392,374,-18,-42,-60,-0.045918367,-0.112299465,-0.153061224
350,2021,강원,홍천군,4272000000,초등학교,2021-04-01,여자,178,189,177,-12,1,-11,-0.063492063,0.005649718,-0.058201058
351,2021,강원,홍천군,4272000000,초등학교,2021-04-01,남자,154,203,197,-6,-43,-49,-0.02955665,-0.218274112,-0.24137931
352,2021,강원,횡성군,4273000000,초등학교,2021-04-01,전체,226,251,243,-8,-17,-25,-0.03187251,-0.069958848,-0.099601594
353,2021,강원,횡성군,4273000000,초등학교,2021-04-01,여자,112,136,130,-6,-18,-24,-0.044117647,-0.138461538,-0.176470588
354,2021,강원,횡성군,4273000000,초등학교,2021-04-01,남자,114,115,113,-2,1,-1,-0.017391304,0.008849558,-0.008695652
355,2021,강원,영월군,4275000000,초등학교,2021-04-01,전체,179,197,189,-8,-10,-18,-0.040609137,-0.052910053,-0.091370558
356,2021,강원,영월군,4275000000,초등학교,2021-04-01,여자,77,91,88,-3,-11,-14,-0.032967033,-0.125,-0.153846154
357,2021,강원,영월군,4275000000,초등학교,2021-04-01,남자,102,106,101,-5,1,-4,-0.047169811,0.00990099,-0.037735849
358,2021,강원,평창군,4276000000,초등학교,2021-04-01,전체,178,203,204,1,-26,-25,0.004926108,-0.12745098,-0.123152709
359,2021,강원,평창군,4276000000,초등학교,2021-04-01,여자,101,116,117,1,-16,-15,0.00862069,-0.136752137,-0.129310345
360,2021,강원,평창군,4276000000,초등학교,2021-04-01,남자,77,87,87,0,-10,-10,0,-0.114942529,-0.114942529
361,2021,강원,정선군,4277000000,초등학교,2021-04-01,전체,211,190,189,-1,22,21,-0.005263158,0.116402116,0.110526316
362,2021,강원,정선군,4277000000,초등학교,2021-04-01,여자,105,91,93,2,12,14,0.021978022,0.129032258,0.153846154
363,2021,강원,정선군,4277000000,초등학교,2021-04-01,남자,106,99,96,-3,10,7,-0.03030303,0.104166667,0.070707071
364,2021,강원,철원군,4278000000,초등학교,2021-04-01,전체,352,360,354,-6,-2,-8,-0.016666667,-0.005649718,-0.022222222
365,2021,강원,철원군,4278000000,초등학교,2021-04-01,여자,169,172,172,0,-3,-3,0,-0.01744186,-0.01744186
366,2021,강원,철원군,4278000000,초등학교,2021-04-01,남자,183,188,182,-6,1,-5,-0.031914894,0.005494505,-0.026595745
367,2021,강원,화천군,4279000000,초등학교,2021-04-01,전체,176,213,211,-2,-35,-37,-0.009389671,-0.165876777,-0.17370892
368,2021,강원,화천군,4279000000,초등학교,2021-04-01,여자,73,100,100,0,-27,-27,0,-0.27,-0.27
369,2021,강원,화천군,4279000000,초등학교,2021-04-01,남자,103,113,111,-2,-8,-10,-0.017699115,-0.072072072,-0.088495575
370,2021,강원,양구군,4280000000,초등학교,2021-04-01,전체,155,192,180,-12,-25,-37,-0.0625,-0.138888889,-0.192708333
371,2021,강원,양구군,4280000000,초등학교,2021-04-01,여자,69,102,97,-5,-28,-33,-0.049019608,-0.288659794,-0.323529412
372,2021,강원,양구군,4280000000,초등학교,2021-04-01,남자,86,90,83,-7,3,-4,-0.077777778,0.036144578,-0.044444444
373,2021,강원,인제군,4281000000,초등학교,2021-04-01,전체,220,254,244,-10,-24,-34,-0.039370079,-0.098360656,-0.133858268
374,2021,강원,인제군,4281000000,초등학교,2021-04-01,여자,109,119,116,-3,-7,-10,-0.025210084,-0.060344828,-0.084033613
375,2021,강원,인제군,4281000000,초등학교,2021-04-01,남자,111,135,128,-7,-17,-24,-0.051851852,-0.1328125,-0.177777778
376,2021,강원,고성군,4282000000,초등학교,2021-04-01,전체,167,136,122,-14,45,31,-0.102941176,0.368852459,0.227941176
377,2021,강원,고성군,4282000000,초등학교,2021-04-01,여자,80,67,61,-6,19,13,-0.089552239,0.31147541,0.194029851
378,2021,강원,고성군,4282000000,초등학교,2021-04-01,남자,87,69,61,-8,26,18,-0.115942029,0.426229508,0.260869565
379,2021,강원,양양군,4283000000,초등학교,2021-04-01,전체,142,153,163,10,-21,-11,0.065359477,-0.128834356,-0.071895425
380,2021,강원,양양군,4283000000,초등학교,2021-04-01,여자,74,71,81,10,-7,3,0.14084507,-0.086419753,0.042253521
381,2021,강원,양양군,4283000000,초등학교,2021-04-01,남자,68,82,82,0,-14,-14,0,-0.170731707,-0.170731707
382,2021,충북,청주시,4311000000,초등학교,2021-04-01,전체,7889,8030,8031,1,-142,-141,0.000124533,-0.017681484,-0.017559153
383,2021,충북,청주시,4311000000,초등학교,2021-04-01,여자,3919,4019,4034,15,-115,-100,0.003732272,-0.028507685,-0.024881811
384,2021,충북,청주시,4311000000,초등학교,2021-04-01,남자,3970,4011,3997,-14,-27,-41,-0.003490401,-0.006755066,-0.01022189
385,2021,충북,충주시,4313000000,초등학교,2021-04-01,전체,1525,1537,1543,6,-18,-12,0.003903709,-0.011665587,-0.007807417
386,2021,충북,충주시,4313000000,초등학교,2021-04-01,여자,781,777,785,8,-4,4,0.01029601,-0.005095541,0.005148005
387,2021,충북,충주시,4313000000,초등학교,2021-04-01,남자,744,760,758,-2,-14,-16,-0.002631579,-0.018469657,-0.021052632
388,2021,충북,제천시,4315000000,초등학교,2021-04-01,전체,952,973,969,-4,-17,-21,-0.004110997,-0.01754386,-0.021582734
389,2021,충북,제천시,4315000000,초등학교,2021-04-01,여자,483,479,472,-7,11,4,-0.014613779,0.023305085,0.008350731
390,2021,충북,제천시,4315000000,초등학교,2021-04-01,남자,469,494,497,3,-28,-25,0.006072874,-0.056338028,-0.050607287
391,2021,충북,보은군,4372000000,초등학교,2021-04-01,전체,148,154,146,-8,2,-6,-0.051948052,0.01369863,-0.038961039
392,2021,충북,보은군,4372000000,초등학교,2021-04-01,여자,70,72,67,-5,3,-2,-0.069444444,0.044776119,-0.027777778
393,2021,충북,보은군,4372000000,초등학교,2021-04-01,남자,78,82,79,-3,-1,-4,-0.036585366,-0.012658228,-0.048780488
394,2021,충북,옥천군,4373000000,초등학교,2021-04-01,전체,298,291,287,-4,11,7,-0.013745704,0.038327526,0.024054983
395,2021,충북,옥천군,4373000000,초등학교,2021-04-01,여자,152,138,137,-1,15,14,-0.007246377,0.109489051,0.101449275
396,2021,충북,옥천군,4373000000,초등학교,2021-04-01,남자,146,153,150,-3,-4,-7,-0.019607843,-0.026666667,-0.045751634
397,2021,충북,영동군,4374000000,초등학교,2021-04-01,전체,227,230,233,3,-6,-3,0.013043478,-0.025751073,-0.013043478
398,2021,충북,영동군,4374000000,초등학교,2021-04-01,여자,120,115,120,5,0,5,0.043478261,0,0.043478261
399,2021,충북,영동군,4374000000,초등학교,2021-04-01,남자,107,115,113,-2,-6,-8,-0.017391304,-0.053097345,-0.069565217
400,2021,충북,진천군,4375000000,초등학교,2021-04-01,전체,866,813,825,12,41,53,0.014760148,0.04969697,0.065190652
401,2021,충북,진천군,4375000000,초등학교,2021-04-01,여자,412,392,401,9,11,20,0.022959184,0.027431421,0.051020408
402,2021,충북,진천군,4375000000,초등학교,2021-04-01,남자,454,421,424,3,30,33,0.007125891,0.070754717,0.078384798
403,2021,충북,괴산군,4376000000,초등학교,2021-04-01,전체,166,134,143,9,23,32,0.067164179,0.160839161,0.23880597
404,2021,충북,괴산군,4376000000,초등학교,2021-04-01,여자,79,63,65,2,14,16,0.031746032,0.215384615,0.253968254
405,2021,충북,괴산군,4376000000,초등학교,2021-04-01,남자,87,71,78,7,9,16,0.098591549,0.115384615,0.225352113
406,2021,충북,음성군,4377000000,초등학교,2021-04-01,전체,633,694,673,-21,-40,-61,-0.030259366,-0.059435364,-0.087896254
407,2021,충북,음성군,4377000000,초등학교,2021-04-01,여자,294,342,319,-23,-25,-48,-0.067251462,-0.078369906,-0.140350877
408,2021,충북,음성군,4377000000,초등학교,2021-04-01,남자,339,352,354,2,-15,-13,0.005681818,-0.042372881,-0.036931818
409,2021,충북,단양군,4380000000,초등학교,2021-04-01,전체,119,137,132,-5,-13,-18,-0.03649635,-0.098484848,-0.131386861
410,2021,충북,단양군,4380000000,초등학교,2021-04-01,여자,52,60,59,-1,-7,-8,-0.016666667,-0.118644068,-0.133333333
411,2021,충북,단양군,4380000000,초등학교,2021-04-01,남자,67,77,73,-4,-6,-10,-0.051948052,-0.082191781,-0.12987013
412,2021,충북,증평군,4374500000,초등학교,2021-04-01,전체,331,380,369,-11,-38,-49,-0.028947368,-0.10298103,-0.128947368
413,2021,충북,증평군,4374500000,초등학교,2021-04-01,여자,186,206,201,-5,-15,-20,-0.024271845,-0.074626866,-0.097087379
414,2021,충북,증평군,4374500000,초등학교,2021-04-01,남자,145,174,168,-6,-23,-29,-0.034482759,-0.136904762,-0.166666667
415,2021,충남,천안시,4413000000,초등학교,2021-04-01,전체,6716,6833,6806,-27,-90,-117,-0.003951412,-0.013223626,-0.017122786
416,2021,충남,천안시,4413000000,초등학교,2021-04-01,여자,3287,3391,3375,-16,-88,-104,-0.004718372,-0.026074074,-0.030669419
417,2021,충남,천안시,4413000000,초등학교,2021-04-01,남자,3429,3442,3431,-11,-2,-13,-0.003195816,-0.00058292,-0.003776874
418,2021,충남,공주시,4415000000,초등학교,2021-04-01,전체,617,641,643,2,-26,-24,0.003120125,-0.040435459,-0.037441498
419,2021,충남,공주시,4415000000,초등학교,2021-04-01,여자,279,309,314,5,-35,-30,0.01618123,-0.111464968,-0.097087379
420,2021,충남,공주시,4415000000,초등학교,2021-04-01,남자,338,332,329,-3,9,6,-0.009036145,0.027355623,0.018072289
421,2021,충남,보령시,4418000000,초등학교,2021-04-01,전체,670,702,708,6,-38,-32,0.008547009,-0.053672316,-0.045584046
422,2021,충남,보령시,4418000000,초등학교,2021-04-01,여자,363,367,377,10,-14,-4,0.027247956,-0.037135279,-0.010899183
423,2021,충남,보령시,4418000000,초등학교,2021-04-01,남자,307,335,331,-4,-24,-28,-0.011940299,-0.072507553,-0.08358209
424,2021,충남,아산시,4420000000,초등학교,2021-04-01,전체,3511,3714,3657,-57,-146,-203,-0.015347334,-0.039923435,-0.054658051
425,2021,충남,아산시,4420000000,초등학교,2021-04-01,여자,1717,1825,1793,-32,-76,-108,-0.017534247,-0.042387061,-0.059178082
426,2021,충남,아산시,4420000000,초등학교,2021-04-01,남자,1794,1889,1864,-25,-70,-95,-0.013234516,-0.037553648,-0.050291159
427,2021,충남,서산시,4421000000,초등학교,2021-04-01,전체,1721,1714,1710,-4,11,7,-0.002333722,0.006432749,0.004084014
428,2021,충남,서산시,4421000000,초등학교,2021-04-01,여자,825,836,834,-2,-9,-11,-0.002392344,-0.010791367,-0.013157895
429,2021,충남,서산시,4421000000,초등학교,2021-04-01,남자,896,878,876,-2,20,18,-0.002277904,0.02283105,0.020501139
430,2021,충남,논산시,4423000000,초등학교,2021-04-01,전체,845,834,825,-9,20,11,-0.010791367,0.024242424,0.013189448
431,2021,충남,논산시,4423000000,초등학교,2021-04-01,여자,425,417,412,-5,13,8,-0.011990408,0.031553398,0.019184652
432,2021,충남,논산시,4423000000,초등학교,2021-04-01,남자,420,417,413,-4,7,3,-0.009592326,0.016949153,0.007194245
433,2021,충남,계룡시,4425000000,초등학교,2021-04-01,전체,431,430,436,6,-5,1,0.013953488,-0.01146789,0.002325581
434,2021,충남,계룡시,4425000000,초등학교,2021-04-01,여자,217,227,227,0,-10,-10,0,-0.044052863,-0.044052863
435,2021,충남,계룡시,4425000000,초등학교,2021-04-01,남자,214,203,209,6,5,11,0.02955665,0.023923445,0.054187192
436,2021,충남,금산군,4471000000,초등학교,2021-04-01,전체,256,246,248,2,8,10,0.008130081,0.032258065,0.040650407
437,2021,충남,금산군,4471000000,초등학교,2021-04-01,여자,120,119,118,-1,2,1,-0.008403361,0.016949153,0.008403361
438,2021,충남,금산군,4471000000,초등학교,2021-04-01,남자,136,127,130,3,6,9,0.023622047,0.046153846,0.070866142
439,2021,충남,부여군,4476000000,초등학교,2021-04-01,전체,334,356,359,3,-25,-22,0.008426966,-0.069637883,-0.061797753
440,2021,충남,부여군,4476000000,초등학교,2021-04-01,여자,156,162,159,-3,-3,-6,-0.018518519,-0.018867925,-0.037037037
441,2021,충남,부여군,4476000000,초등학교,2021-04-01,남자,178,194,200,6,-22,-16,0.030927835,-0.11,-0.082474227
442,2021,충남,서천군,4477000000,초등학교,2021-04-01,전체,266,272,267,-5,-1,-6,-0.018382353,-0.003745318,-0.022058824
443,2021,충남,서천군,4477000000,초등학교,2021-04-01,여자,128,133,129,-4,-1,-5,-0.030075188,-0.007751938,-0.037593985
444,2021,충남,서천군,4477000000,초등학교,2021-04-01,남자,138,139,138,-1,0,-1,-0.007194245,0,-0.007194245
445,2021,충남,청양군,4479000000,초등학교,2021-04-01,전체,123,132,133,1,-10,-9,0.007575758,-0.07518797,-0.068181818
446,2021,충남,청양군,4479000000,초등학교,2021-04-01,여자,67,71,74,3,-7,-4,0.042253521,-0.094594595,-0.056338028
447,2021,충남,청양군,4479000000,초등학교,2021-04-01,남자,56,61,59,-2,-3,-5,-0.032786885,-0.050847458,-0.081967213
448,2021,충남,홍성군,4480000000,초등학교,2021-04-01,전체,832,868,873,5,-41,-36,0.005760369,-0.04696449,-0.041474654
449,2021,충남,홍성군,4480000000,초등학교,2021-04-01,여자,392,422,422,0,-30,-30,0,-0.071090047,-0.071090047
450,2021,충남,홍성군,4480000000,초등학교,2021-04-01,남자,440,446,451,5,-11,-6,0.011210762,-0.024390244,-0.013452915
451,2021,충남,예산군,4481000000,초등학교,2021-04-01,전체,413,371,370,-1,43,42,-0.002695418,0.116216216,0.113207547
452,2021,충남,예산군,4481000000,초등학교,2021-04-01,여자,200,168,166,-2,34,32,-0.011904762,0.204819277,0.19047619
453,2021,충남,예산군,4481000000,초등학교,2021-04-01,남자,213,203,204,1,9,10,0.004926108,0.044117647,0.049261084
454,2021,충남,태안군,4482500000,초등학교,2021-04-01,전체,322,327,320,-7,2,-5,-0.021406728,0.00625,-0.01529052
455,2021,충남,태안군,4482500000,초등학교,2021-04-01,여자,165,169,155,-14,10,-4,-0.082840237,0.064516129,-0.023668639
456,2021,충남,태안군,4482500000,초등학교,2021-04-01,남자,157,158,165,7,-8,-1,0.044303797,-0.048484848,-0.006329114
457,2021,충남,당진시,4427000000,초등학교,2021-04-01,전체,1715,1752,1737,-15,-22,-37,-0.008561644,-0.012665515,-0.021118721
458,2021,충남,당진시,4427000000,초등학교,2021-04-01,여자,866,868,861,-7,5,-2,-0.008064516,0.005807201,-0.002304147
459,2021,충남,당진시,4427000000,초등학교,2021-04-01,남자,849,884,876,-8,-27,-35,-0.009049774,-0.030821918,-0.03959276
460,2021,전북,전주시,4511000000,초등학교,2021-04-01,전체,6132,5889,6046,157,86,243,0.026659874,0.014224281,0.041263372
461,2021,전북,전주시,4511000000,초등학교,2021-04-01,여자,2984,2873,2960,87,24,111,0.030281935,0.008108108,0.038635573
462,2021,전북,전주시,4511000000,초등학교,2021-04-01,남자,3148,3016,3086,70,62,132,0.023209549,0.020090732,0.043766578
463,2021,전북,군산시,4513000000,초등학교,2021-04-01,전체,2388,2525,2470,-55,-82,-137,-0.021782178,-0.033198381,-0.054257426
464,2021,전북,군산시,4513000000,초등학교,2021-04-01,여자,1143,1243,1218,-25,-75,-100,-0.020112631,-0.061576355,-0.080450523
465,2021,전북,군산시,4513000000,초등학교,2021-04-01,남자,1245,1282,1252,-30,-7,-37,-0.023400936,-0.005591054,-0.028861154
466,2021,전북,익산시,4514000000,초등학교,2021-04-01,전체,2050,2202,2163,-39,-113,-152,-0.017711172,-0.052242256,-0.069028156
467,2021,전북,익산시,4514000000,초등학교,2021-04-01,여자,991,1012,987,-25,4,-21,-0.024703557,0.004052685,-0.020750988
468,2021,전북,익산시,4514000000,초등학교,2021-04-01,남자,1059,1190,1176,-14,-117,-131,-0.011764706,-0.099489796,-0.110084034
469,2021,전북,정읍시,4518000000,초등학교,2021-04-01,전체,721,743,739,-4,-18,-22,-0.00538358,-0.02435724,-0.02960969
470,2021,전북,정읍시,4518000000,초등학교,2021-04-01,여자,367,360,358,-2,9,7,-0.005555556,0.025139665,0.019444444
471,2021,전북,정읍시,4518000000,초등학교,2021-04-01,남자,354,383,381,-2,-27,-29,-0.005221932,-0.070866142,-0.075718016
472,2021,전북,남원시,4519000000,초등학교,2021-04-01,전체,521,546,547,1,-26,-25,0.001831502,-0.047531993,-0.045787546
473,2021,전북,남원시,4519000000,초등학교,2021-04-01,여자,243,252,253,1,-10,-9,0.003968254,-0.039525692,-0.035714286
474,2021,전북,남원시,4519000000,초등학교,2021-04-01,남자,278,294,294,0,-16,-16,0,-0.054421769,-0.054421769
475,2021,전북,김제시,4521000000,초등학교,2021-04-01,전체,486,482,476,-6,10,4,-0.012448133,0.021008403,0.008298755
476,2021,전북,김제시,4521000000,초등학교,2021-04-01,여자,226,233,232,-1,-6,-7,-0.004291845,-0.025862069,-0.030042918
477,2021,전북,김제시,4521000000,초등학교,2021-04-01,남자,260,249,244,-5,16,11,-0.020080321,0.06557377,0.044176707
478,2021,전북,완주군,4571000000,초등학교,2021-04-01,전체,664,842,820,-22,-156,-178,-0.026128266,-0.190243902,-0.211401425
479,2021,전북,완주군,4571000000,초등학교,2021-04-01,여자,334,427,410,-17,-76,-93,-0.039812646,-0.185365854,-0.217798595
480,2021,전북,완주군,4571000000,초등학교,2021-04-01,남자,330,415,410,-5,-80,-85,-0.012048193,-0.195121951,-0.204819277
481,2021,전북,진안군,4572000000,초등학교,2021-04-01,전체,107,133,120,-13,-13,-26,-0.097744361,-0.108333333,-0.195488722
482,2021,전북,진안군,4572000000,초등학교,2021-04-01,여자,56,73,63,-10,-7,-17,-0.136986301,-0.111111111,-0.232876712
483,2021,전북,진안군,4572000000,초등학교,2021-04-01,남자,51,60,57,-3,-6,-9,-0.05,-0.105263158,-0.15
484,2021,전북,무주군,4573000000,초등학교,2021-04-01,전체,142,135,134,-1,8,7,-0.007407407,0.059701493,0.051851852
485,2021,전북,무주군,4573000000,초등학교,2021-04-01,여자,54,44,45,1,9,10,0.022727273,0.2,0.227272727
486,2021,전북,무주군,4573000000,초등학교,2021-04-01,남자,88,91,89,-2,-1,-3,-0.021978022,-0.011235955,-0.032967033
487,2021,전북,장수군,4574000000,초등학교,2021-04-01,전체,127,137,131,-6,-4,-10,-0.04379562,-0.030534351,-0.072992701
488,2021,전북,장수군,4574000000,초등학교,2021-04-01,여자,65,73,69,-4,-4,-8,-0.054794521,-0.057971014,-0.109589041
489,2021,전북,장수군,4574000000,초등학교,2021-04-01,남자,62,64,62,-2,0,-2,-0.03125,0,-0.03125
490,2021,전북,임실군,4575000000,초등학교,2021-04-01,전체,117,169,138,-31,-21,-52,-0.183431953,-0.152173913,-0.307692308
491,2021,전북,임실군,4575000000,초등학교,2021-04-01,여자,58,72,63,-9,-5,-14,-0.125,-0.079365079,-0.194444444
492,2021,전북,임실군,4575000000,초등학교,2021-04-01,남자,59,97,75,-22,-16,-38,-0.226804124,-0.213333333,-0.391752577
493,2021,전북,순창군,4577000000,초등학교,2021-04-01,전체,130,141,130,-11,0,-11,-0.078014184,0,-0.078014184
494,2021,전북,순창군,4577000000,초등학교,2021-04-01,여자,57,67,61,-6,-4,-10,-0.089552239,-0.06557377,-0.149253731
495,2021,전북,순창군,4577000000,초등학교,2021-04-01,남자,73,74,69,-5,4,-1,-0.067567568,0.057971014,-0.013513514
496,2021,전북,고창군,4579000000,초등학교,2021-04-01,전체,311,290,292,2,19,21,0.006896552,0.065068493,0.072413793
497,2021,전북,고창군,4579000000,초등학교,2021-04-01,여자,138,144,147,3,-9,-6,0.020833333,-0.06122449,-0.041666667
498,2021,전북,고창군,4579000000,초등학교,2021-04-01,남자,173,146,145,-1,28,27,-0.006849315,0.193103448,0.184931507
499,2021,전북,부안군,4580000000,초등학교,2021-04-01,전체,269,303,298,-5,-29,-34,-0.01650165,-0.097315436,-0.112211221
500,2021,전북,부안군,4580000000,초등학교,2021-04-01,여자,131,151,146,-5,-15,-20,-0.033112583,-0.102739726,-0.132450331
501,2021,전북,부안군,4580000000,초등학교,2021-04-01,남자,138,152,152,0,-14,-14,0,-0.092105263,-0.092105263
502,2021,전남,목포시,4611000000,초등학교,2021-04-01,전체,2166,2131,2158,27,8,35,0.012670108,0.003707136,0.016424214
503,2021,전남,목포시,4611000000,초등학교,2021-04-01,여자,1054,1009,1019,10,35,45,0.009910803,0.034347399,0.044598612
504,2021,전남,목포시,4611000000,초등학교,2021-04-01,남자,1112,1122,1139,17,-27,-10,0.015151515,-0.023705004,-0.008912656
505,2021,전남,여수시,4613000000,초등학교,2021-04-01,전체,2192,2359,2321,-38,-129,-167,-0.016108521,-0.055579492,-0.070792709
506,2021,전남,여수시,4613000000,초등학교,2021-04-01,여자,1069,1142,1122,-20,-53,-73,-0.017513135,-0.047237077,-0.063922942
507,2021,전남,여수시,4613000000,초등학교,2021-04-01,남자,1123,1217,1199,-18,-76,-94,-0.014790468,-0.063386155,-0.077239113
508,2021,전남,순천시,4615000000,초등학교,2021-04-01,전체,2528,2528,2592,64,-64,0,0.025316456,-0.024691358,0
509,2021,전남,순천시,4615000000,초등학교,2021-04-01,여자,1279,1261,1295,34,-16,18,0.026962728,-0.012355212,0.014274385
510,2021,전남,순천시,4615000000,초등학교,2021-04-01,남자,1249,1267,1297,30,-48,-18,0.023677979,-0.037008481,-0.014206788
511,2021,전남,나주시,4617000000,초등학교,2021-04-01,전체,1056,1098,1050,-48,6,-42,-0.043715847,0.005714286,-0.038251366
512,2021,전남,나주시,4617000000,초등학교,2021-04-01,여자,504,526,505,-21,-1,-22,-0.039923954,-0.001980198,-0.041825095
513,2021,전남,나주시,4617000000,초등학교,2021-04-01,남자,552,572,545,-27,7,-20,-0.047202797,0.012844037,-0.034965035
514,2021,전남,광양시,4623000000,초등학교,2021-04-01,전체,1357,1510,1493,-17,-136,-153,-0.011258278,-0.091091762,-0.101324503
515,2021,전남,광양시,4623000000,초등학교,2021-04-01,여자,686,737,735,-2,-49,-51,-0.002713704,-0.066666667,-0.069199457
516,2021,전남,광양시,4623000000,초등학교,2021-04-01,남자,671,773,758,-15,-87,-102,-0.019404916,-0.114775726,-0.131953428
517,2021,전남,담양군,4671000000,초등학교,2021-04-01,전체,237,258,242,-16,-5,-21,-0.062015504,-0.020661157,-0.081395349
518,2021,전남,담양군,4671000000,초등학교,2021-04-01,여자,118,134,121,-13,-3,-16,-0.097014925,-0.024793388,-0.119402985
519,2021,전남,담양군,4671000000,초등학교,2021-04-01,남자,119,124,121,-3,-2,-5,-0.024193548,-0.016528926,-0.040322581
520,2021,전남,곡성군,4672000000,초등학교,2021-04-01,전체,103,132,126,-6,-23,-29,-0.045454545,-0.182539683,-0.21969697
521,2021,전남,곡성군,4672000000,초등학교,2021-04-01,여자,48,62,59,-3,-11,-14,-0.048387097,-0.186440678,-0.225806452
522,2021,전남,곡성군,4672000000,초등학교,2021-04-01,남자,55,70,67,-3,-12,-15,-0.042857143,-0.179104478,-0.214285714
523,2021,전남,구례군,4673000000,초등학교,2021-04-01,전체,111,122,118,-4,-7,-11,-0.032786885,-0.059322034,-0.090163934
524,2021,전남,구례군,4673000000,초등학교,2021-04-01,여자,53,60,59,-1,-6,-7,-0.016666667,-0.101694915,-0.116666667
525,2021,전남,구례군,4673000000,초등학교,2021-04-01,남자,58,62,59,-3,-1,-4,-0.048387097,-0.016949153,-0.064516129
526,2021,전남,고흥군,4677000000,초등학교,2021-04-01,전체,248,262,270,8,-22,-14,0.030534351,-0.081481481,-0.053435115
527,2021,전남,고흥군,4677000000,초등학교,2021-04-01,여자,128,135,143,8,-15,-7,0.059259259,-0.104895105,-0.051851852
528,2021,전남,고흥군,4677000000,초등학교,2021-04-01,남자,120,127,127,0,-7,-7,0,-0.05511811,-0.05511811
529,2021,전남,보성군,4678000000,초등학교,2021-04-01,전체,163,208,190,-18,-27,-45,-0.086538462,-0.142105263,-0.216346154
530,2021,전남,보성군,4678000000,초등학교,2021-04-01,여자,74,98,89,-9,-15,-24,-0.091836735,-0.168539326,-0.244897959
531,2021,전남,보성군,4678000000,초등학교,2021-04-01,남자,89,110,101,-9,-12,-21,-0.081818182,-0.118811881,-0.190909091
532,2021,전남,화순군,4679000000,초등학교,2021-04-01,전체,357,357,364,7,-7,0,0.019607843,-0.019230769,0
533,2021,전남,화순군,4679000000,초등학교,2021-04-01,여자,166,181,184,3,-18,-15,0.016574586,-0.097826087,-0.082872928
534,2021,전남,화순군,4679000000,초등학교,2021-04-01,남자,191,176,180,4,11,15,0.022727273,0.061111111,0.085227273
535,2021,전남,장흥군,4680000000,초등학교,2021-04-01,전체,213,227,215,-12,-2,-14,-0.052863436,-0.009302326,-0.061674009
536,2021,전남,장흥군,4680000000,초등학교,2021-04-01,여자,107,119,115,-4,-8,-12,-0.033613445,-0.069565217,-0.100840336
537,2021,전남,장흥군,4680000000,초등학교,2021-04-01,남자,106,108,100,-8,6,-2,-0.074074074,0.06,-0.018518519
538,2021,전남,강진군,4681000000,초등학교,2021-04-01,전체,177,199,187,-12,-10,-22,-0.060301508,-0.053475936,-0.110552764
539,2021,전남,강진군,4681000000,초등학교,2021-04-01,여자,96,104,99,-5,-3,-8,-0.048076923,-0.03030303,-0.076923077
540,2021,전남,강진군,4681000000,초등학교,2021-04-01,남자,81,95,88,-7,-7,-14,-0.073684211,-0.079545455,-0.147368421
541,2021,전남,해남군,4682000000,초등학교,2021-04-01,전체,374,418,382,-36,-8,-44,-0.086124402,-0.020942408,-0.105263158
542,2021,전남,해남군,4682000000,초등학교,2021-04-01,여자,195,213,196,-17,-1,-18,-0.079812207,-0.005102041,-0.084507042
543,2021,전남,해남군,4682000000,초등학교,2021-04-01,남자,179,205,186,-19,-7,-26,-0.092682927,-0.037634409,-0.126829268
544,2021,전남,영암군,4683000000,초등학교,2021-04-01,전체,326,406,386,-20,-60,-80,-0.049261084,-0.155440415,-0.197044335
545,2021,전남,영암군,4683000000,초등학교,2021-04-01,여자,165,202,191,-11,-26,-37,-0.054455446,-0.136125654,-0.183168317
546,2021,전남,영암군,4683000000,초등학교,2021-04-01,남자,161,204,195,-9,-34,-43,-0.044117647,-0.174358974,-0.210784314
547,2021,전남,무안군,4684000000,초등학교,2021-04-01,전체,867,792,795,3,72,75,0.003787879,0.090566038,0.09469697
548,2021,전남,무안군,4684000000,초등학교,2021-04-01,여자,406,375,377,2,29,31,0.005333333,0.076923077,0.082666667
549,2021,전남,무안군,4684000000,초등학교,2021-04-01,남자,461,417,418,1,43,44,0.002398082,0.102870813,0.105515588
550,2021,전남,함평군,4686000000,초등학교,2021-04-01,전체,121,169,157,-12,-36,-48,-0.071005917,-0.229299363,-0.284023669
551,2021,전남,함평군,4686000000,초등학교,2021-04-01,여자,61,92,87,-5,-26,-31,-0.054347826,-0.298850575,-0.336956522
552,2021,전남,함평군,4686000000,초등학교,2021-04-01,남자,60,77,70,-7,-10,-17,-0.090909091,-0.142857143,-0.220779221
553,2021,전남,영광군,4687000000,초등학교,2021-04-01,전체,294,337,318,-19,-24,-43,-0.056379822,-0.075471698,-0.127596439
554,2021,전남,영광군,4687000000,초등학교,2021-04-01,여자,143,158,154,-4,-11,-15,-0.025316456,-0.071428571,-0.094936709
555,2021,전남,영광군,4687000000,초등학교,2021-04-01,남자,151,179,164,-15,-13,-28,-0.083798883,-0.079268293,-0.156424581
556,2021,전남,장성군,4688000000,초등학교,2021-04-01,전체,307,311,305,-6,2,-4,-0.019292605,0.006557377,-0.012861736
557,2021,전남,장성군,4688000000,초등학교,2021-04-01,여자,138,161,160,-1,-22,-23,-0.00621118,-0.1375,-0.142857143
558,2021,전남,장성군,4688000000,초등학교,2021-04-01,남자,169,150,145,-5,24,19,-0.033333333,0.165517241,0.126666667
559,2021,전남,완도군,4689000000,초등학교,2021-04-01,전체,347,345,336,-9,11,2,-0.026086957,0.032738095,0.005797101
560,2021,전남,완도군,4689000000,초등학교,2021-04-01,여자,162,157,151,-6,11,5,-0.038216561,0.072847682,0.031847134
561,2021,전남,완도군,4689000000,초등학교,2021-04-01,남자,185,188,185,-3,0,-3,-0.015957447,0,-0.015957447
562,2021,전남,진도군,4690000000,초등학교,2021-04-01,전체,168,185,181,-4,-13,-17,-0.021621622,-0.071823204,-0.091891892
563,2021,전남,진도군,4690000000,초등학교,2021-04-01,여자,76,82,80,-2,-4,-6,-0.024390244,-0.05,-0.073170732
564,2021,전남,진도군,4690000000,초등학교,2021-04-01,남자,92,103,101,-2,-9,-11,-0.019417476,-0.089108911,-0.106796117
565,2021,전남,신안군,4691000000,초등학교,2021-04-01,전체,128,177,170,-7,-42,-49,-0.039548023,-0.247058824,-0.276836158
566,2021,전남,신안군,4691000000,초등학교,2021-04-01,여자,67,82,80,-2,-13,-15,-0.024390244,-0.1625,-0.182926829
567,2021,전남,신안군,4691000000,초등학교,2021-04-01,남자,61,95,90,-5,-29,-34,-0.052631579,-0.322222222,-0.357894737
568,2021,경북,포항시,4711000000,초등학교,2021-04-01,전체,4408,4510,4536,26,-128,-102,0.005764967,-0.028218695,-0.022616408
569,2021,경북,포항시,4711000000,초등학교,2021-04-01,여자,2135,2172,2204,32,-69,-37,0.014732965,-0.031306715,-0.017034991
570,2021,경북,포항시,4711000000,초등학교,2021-04-01,남자,2273,2338,2332,-6,-59,-65,-0.002566296,-0.025300172,-0.02780154
571,2021,경북,경주시,4713000000,초등학교,2021-04-01,전체,1774,1741,1761,20,13,33,0.011487651,0.007382169,0.018954624
572,2021,경북,경주시,4713000000,초등학교,2021-04-01,여자,854,829,840,11,14,25,0.013268999,0.016666667,0.030156815
573,2021,경북,경주시,4713000000,초등학교,2021-04-01,남자,920,912,921,9,-1,8,0.009868421,-0.001085776,0.00877193
574,2021,경북,김천시,4715000000,초등학교,2021-04-01,전체,1077,1141,1117,-24,-40,-64,-0.021034181,-0.035810206,-0.056091148
575,2021,경북,김천시,4715000000,초등학교,2021-04-01,여자,530,553,547,-6,-17,-23,-0.01084991,-0.031078611,-0.04159132
576,2021,경북,김천시,4715000000,초등학교,2021-04-01,남자,547,588,570,-18,-23,-41,-0.030612245,-0.040350877,-0.069727891
577,2021,경북,안동시,4717000000,초등학교,2021-04-01,전체,1176,1128,1117,-11,59,48,-0.009751773,0.052820054,0.042553191
578,2021,경북,안동시,4717000000,초등학교,2021-04-01,여자,571,552,546,-6,25,19,-0.010869565,0.045787546,0.03442029
579,2021,경북,안동시,4717000000,초등학교,2021-04-01,남자,605,576,571,-5,34,29,-0.008680556,0.059544658,0.050347222
580,2021,경북,구미시,4719000000,초등학교,2021-04-01,전체,4685,4947,4906,-41,-221,-262,-0.008287851,-0.045046881,-0.052961391
581,2021,경북,구미시,4719000000,초등학교,2021-04-01,여자,2265,2413,2403,-10,-138,-148,-0.004144219,-0.057428215,-0.061334438
582,2021,경북,구미시,4719000000,초등학교,2021-04-01,남자,2420,2534,2503,-31,-83,-114,-0.012233623,-0.033160208,-0.044988161
583,2021,경북,영주시,4721000000,초등학교,2021-04-01,전체,665,673,671,-2,-6,-8,-0.002971768,-0.008941878,-0.011887073
584,2021,경북,영주시,4721000000,초등학교,2021-04-01,여자,300,310,314,4,-14,-10,0.012903226,-0.044585987,-0.032258065
585,2021,경북,영주시,4721000000,초등학교,2021-04-01,남자,365,363,357,-6,8,2,-0.016528926,0.022408964,0.005509642
586,2021,경북,영천시,4723000000,초등학교,2021-04-01,전체,511,600,578,-22,-67,-89,-0.036666667,-0.115916955,-0.148333333
587,2021,경북,영천시,4723000000,초등학교,2021-04-01,여자,235,308,296,-12,-61,-73,-0.038961039,-0.206081081,-0.237012987
588,2021,경북,영천시,4723000000,초등학교,2021-04-01,남자,276,292,282,-10,-6,-16,-0.034246575,-0.021276596,-0.054794521
589,2021,경북,상주시,4725000000,초등학교,2021-04-01,전체,521,551,550,-1,-29,-30,-0.001814882,-0.052727273,-0.054446461
590,2021,경북,상주시,4725000000,초등학교,2021-04-01,여자,242,256,259,3,-17,-14,0.01171875,-0.065637066,-0.0546875
591,2021,경북,상주시,4725000000,초등학교,2021-04-01,남자,279,295,291,-4,-12,-16,-0.013559322,-0.041237113,-0.054237288
592,2021,경북,문경시,4728000000,초등학교,2021-04-01,전체,389,429,424,-5,-35,-40,-0.011655012,-0.08254717,-0.093240093
593,2021,경북,문경시,4728000000,초등학교,2021-04-01,여자,191,207,206,-1,-15,-16,-0.004830918,-0.072815534,-0.077294686
594,2021,경북,문경시,4728000000,초등학교,2021-04-01,남자,198,222,218,-4,-20,-24,-0.018018018,-0.091743119,-0.108108108
595,2021,경북,경산시,4729000000,초등학교,2021-04-01,전체,2210,2394,2376,-18,-166,-184,-0.007518797,-0.06986532,-0.076858814
596,2021,경북,경산시,4729000000,초등학교,2021-04-01,여자,1112,1159,1150,-9,-38,-47,-0.007765315,-0.033043478,-0.0405522
597,2021,경북,경산시,4729000000,초등학교,2021-04-01,남자,1098,1235,1226,-9,-128,-137,-0.007287449,-0.104404568,-0.110931174
598,2021,경북,군위군,4772000000,초등학교,2021-04-01,전체,62,76,71,-5,-9,-14,-0.065789474,-0.126760563,-0.184210526
599,2021,경북,군위군,4772000000,초등학교,2021-04-01,여자,30,39,35,-4,-5,-9,-0.102564103,-0.142857143,-0.230769231
600,2021,경북,군위군,4772000000,초등학교,2021-04-01,남자,32,37,36,-1,-4,-5,-0.027027027,-0.111111111,-0.135135135
601,2021,경북,의성군,4773000000,초등학교,2021-04-01,전체,170,177,172,-5,-2,-7,-0.028248588,-0.011627907,-0.039548023
602,2021,경북,의성군,4773000000,초등학교,2021-04-01,여자,79,84,81,-3,-2,-5,-0.035714286,-0.024691358,-0.05952381
603,2021,경북,의성군,4773000000,초등학교,2021-04-01,남자,91,93,91,-2,0,-2,-0.021505376,0,-0.021505376
604,2021,경북,청송군,4775000000,초등학교,2021-04-01,전체,97,122,116,-6,-19,-25,-0.049180328,-0.163793103,-0.204918033
605,2021,경북,청송군,4775000000,초등학교,2021-04-01,여자,55,65,62,-3,-7,-10,-0.046153846,-0.112903226,-0.153846154
606,2021,경북,청송군,4775000000,초등학교,2021-04-01,남자,42,57,54,-3,-12,-15,-0.052631579,-0.222222222,-0.263157895
607,2021,경북,영양군,4776000000,초등학교,2021-04-01,전체,71,95,89,-6,-18,-24,-0.063157895,-0.202247191,-0.252631579
608,2021,경북,영양군,4776000000,초등학교,2021-04-01,여자,44,58,52,-6,-8,-14,-0.103448276,-0.153846154,-0.24137931
609,2021,경북,영양군,4776000000,초등학교,2021-04-01,남자,27,37,37,0,-10,-10,0,-0.27027027,-0.27027027
610,2021,경북,영덕군,4777000000,초등학교,2021-04-01,전체,167,206,195,-11,-28,-39,-0.053398058,-0.143589744,-0.189320388
611,2021,경북,영덕군,4777000000,초등학교,2021-04-01,여자,81,95,90,-5,-9,-14,-0.052631579,-0.1,-0.147368421
612,2021,경북,영덕군,4777000000,초등학교,2021-04-01,남자,86,111,105,-6,-19,-25,-0.054054054,-0.180952381,-0.225225225
613,2021,경북,청도군,4782000000,초등학교,2021-04-01,전체,148,158,160,2,-12,-10,0.012658228,-0.075,-0.063291139
614,2021,경북,청도군,4782000000,초등학교,2021-04-01,여자,73,74,75,1,-2,-1,0.013513514,-0.026666667,-0.013513514
615,2021,경북,청도군,4782000000,초등학교,2021-04-01,남자,75,84,85,1,-10,-9,0.011904762,-0.117647059,-0.107142857
616,2021,경북,고령군,4783000000,초등학교,2021-04-01,전체,157,170,158,-12,-1,-13,-0.070588235,-0.006329114,-0.076470588
617,2021,경북,고령군,4783000000,초등학교,2021-04-01,여자,70,77,68,-9,2,-7,-0.116883117,0.029411765,-0.090909091
618,2021,경북,고령군,4783000000,초등학교,2021-04-01,남자,87,93,90,-3,-3,-6,-0.032258065,-0.033333333,-0.064516129
619,2021,경북,성주군,4784000000,초등학교,2021-04-01,전체,147,215,191,-24,-44,-68,-0.111627907,-0.230366492,-0.31627907
620,2021,경북,성주군,4784000000,초등학교,2021-04-01,여자,77,100,92,-8,-15,-23,-0.08,-0.163043478,-0.23
621,2021,경북,성주군,4784000000,초등학교,2021-04-01,남자,70,115,99,-16,-29,-45,-0.139130435,-0.292929293,-0.391304348
622,2021,경북,칠곡군,4785000000,초등학교,2021-04-01,전체,1016,1150,1102,-48,-86,-134,-0.04173913,-0.078039927,-0.116521739
623,2021,경북,칠곡군,4785000000,초등학교,2021-04-01,여자,475,540,517,-23,-42,-65,-0.042592593,-0.081237911,-0.12037037
624,2021,경북,칠곡군,4785000000,초등학교,2021-04-01,남자,541,610,585,-25,-44,-69,-0.040983607,-0.075213675,-0.113114754
625,2021,경북,예천군,4790000000,초등학교,2021-04-01,전체,361,458,484,26,-123,-97,0.056768559,-0.254132231,-0.211790393
626,2021,경북,예천군,4790000000,초등학교,2021-04-01,여자,163,218,222,4,-59,-55,0.018348624,-0.265765766,-0.252293578
627,2021,경북,예천군,4790000000,초등학교,2021-04-01,남자,198,240,262,22,-64,-42,0.091666667,-0.244274809,-0.175
628,2021,경북,봉화군,4792000000,초등학교,2021-04-01,전체,127,180,157,-23,-30,-53,-0.127777778,-0.191082803,-0.294444444
629,2021,경북,봉화군,4792000000,초등학교,2021-04-01,여자,56,74,66,-8,-10,-18,-0.108108108,-0.151515152,-0.243243243
630,2021,경북,봉화군,4792000000,초등학교,2021-04-01,남자,71,106,91,-15,-20,-35,-0.141509434,-0.21978022,-0.330188679
631,2021,경북,울진군,4793000000,초등학교,2021-04-01,전체,296,334,321,-13,-25,-38,-0.038922156,-0.07788162,-0.113772455
632,2021,경북,울진군,4793000000,초등학교,2021-04-01,여자,157,164,162,-2,-5,-7,-0.012195122,-0.030864198,-0.042682927
633,2021,경북,울진군,4793000000,초등학교,2021-04-01,남자,139,170,159,-11,-20,-31,-0.064705882,-0.125786164,-0.182352941
634,2021,경북,울릉군,4794000000,초등학교,2021-04-01,전체,43,48,39,-9,4,-5,-0.1875,0.102564103,-0.104166667
635,2021,경북,울릉군,4794000000,초등학교,2021-04-01,여자,24,24,20,-4,4,0,-0.166666667,0.2,0
636,2021,경북,울릉군,4794000000,초등학교,2021-04-01,남자,19,24,19,-5,0,-5,-0.208333333,0,-0.208333333
637,2021,경남,진주시,4817000000,초등학교,2021-04-01,전체,3329,3173,3211,38,118,156,0.011976048,0.036748676,0.049164828
638,2021,경남,진주시,4817000000,초등학교,2021-04-01,여자,1605,1581,1604,23,1,24,0.014547755,0.000623441,0.015180266
639,2021,경남,진주시,4817000000,초등학교,2021-04-01,남자,1724,1592,1607,15,117,132,0.009422111,0.072806472,0.082914573
640,2021,경남,통영시,4822000000,초등학교,2021-04-01,전체,1168,1186,1166,-20,2,-18,-0.016863406,0.001715266,-0.015177066
641,2021,경남,통영시,4822000000,초등학교,2021-04-01,여자,573,568,564,-4,9,5,-0.007042254,0.015957447,0.008802817
642,2021,경남,통영시,4822000000,초등학교,2021-04-01,남자,595,618,602,-16,-7,-23,-0.025889968,-0.011627907,-0.037216828
643,2021,경남,사천시,4824000000,초등학교,2021-04-01,전체,926,922,909,-13,17,4,-0.014099783,0.01870187,0.004338395
644,2021,경남,사천시,4824000000,초등학교,2021-04-01,여자,473,443,435,-8,38,30,-0.018058691,0.087356322,0.06772009
645,2021,경남,사천시,4824000000,초등학교,2021-04-01,남자,453,479,474,-5,-21,-26,-0.010438413,-0.044303797,-0.054279749
646,2021,경남,김해시,4825000000,초등학교,2021-04-01,전체,5522,5511,5566,55,-44,11,0.00998004,-0.007905138,0.001996008
647,2021,경남,김해시,4825000000,초등학교,2021-04-01,여자,2668,2680,2689,9,-21,-12,0.003358209,-0.007809595,-0.004477612
648,2021,경남,김해시,4825000000,초등학교,2021-04-01,남자,2854,2831,2877,46,-23,23,0.016248675,-0.007994439,0.008124338
649,2021,경남,밀양시,4827000000,초등학교,2021-04-01,전체,610,594,601,7,9,16,0.011784512,0.014975042,0.026936027
650,2021,경남,밀양시,4827000000,초등학교,2021-04-01,여자,298,306,310,4,-12,-8,0.013071895,-0.038709677,-0.026143791
651,2021,경남,밀양시,4827000000,초등학교,2021-04-01,남자,312,288,291,3,21,24,0.010416667,0.072164948,0.083333333
652,2021,경남,거제시,4831000000,초등학교,2021-04-01,전체,3108,3360,3292,-68,-184,-252,-0.020238095,-0.055893074,-0.075
653,2021,경남,거제시,4831000000,초등학교,2021-04-01,여자,1502,1674,1631,-43,-129,-172,-0.025686977,-0.079092581,-0.102747909
654,2021,경남,거제시,4831000000,초등학교,2021-04-01,남자,1606,1686,1661,-25,-55,-80,-0.014827995,-0.033112583,-0.047449585
655,2021,경남,양산시,4833000000,초등학교,2021-04-01,전체,3867,4020,4004,-16,-137,-153,-0.0039801,-0.034215784,-0.038059701
656,2021,경남,양산시,4833000000,초등학교,2021-04-01,여자,1852,1940,1961,21,-109,-88,0.010824742,-0.055583886,-0.045360825
657,2021,경남,양산시,4833000000,초등학교,2021-04-01,남자,2015,2080,2043,-37,-28,-65,-0.017788462,-0.013705335,-0.03125
658,2021,경남,의령군,4872000000,초등학교,2021-04-01,전체,103,126,123,-3,-20,-23,-0.023809524,-0.162601626,-0.182539683
659,2021,경남,의령군,4872000000,초등학교,2021-04-01,여자,41,41,39,-2,2,0,-0.048780488,0.051282051,0
660,2021,경남,의령군,4872000000,초등학교,2021-04-01,남자,62,85,84,-1,-22,-23,-0.011764706,-0.261904762,-0.270588235
661,2021,경남,함안군,4873000000,초등학교,2021-04-01,전체,475,475,468,-7,7,0,-0.014736842,0.014957265,0
662,2021,경남,함안군,4873000000,초등학교,2021-04-01,여자,237,236,237,1,0,1,0.004237288,0,0.004237288
663,2021,경남,함안군,4873000000,초등학교,2021-04-01,남자,238,239,231,-8,7,-1,-0.033472803,0.03030303,-0.0041841
664,2021,경남,창녕군,4874000000,초등학교,2021-04-01,전체,324,353,346,-7,-22,-29,-0.019830028,-0.063583815,-0.082152975
665,2021,경남,창녕군,4874000000,초등학교,2021-04-01,여자,151,176,174,-2,-23,-25,-0.011363636,-0.132183908,-0.142045455
666,2021,경남,창녕군,4874000000,초등학교,2021-04-01,남자,173,177,172,-5,1,-4,-0.028248588,0.005813953,-0.02259887
667,2021,경남,고성군,4882000000,초등학교,2021-04-01,전체,305,325,315,-10,-10,-20,-0.030769231,-0.031746032,-0.061538462
668,2021,경남,고성군,4882000000,초등학교,2021-04-01,여자,167,171,166,-5,1,-4,-0.029239766,0.006024096,-0.023391813
669,2021,경남,고성군,4882000000,초등학교,2021-04-01,남자,138,154,149,-5,-11,-16,-0.032467532,-0.073825503,-0.103896104
670,2021,경남,남해군,4884000000,초등학교,2021-04-01,전체,188,186,188,2,0,2,0.010752688,0,0.010752688
671,2021,경남,남해군,4884000000,초등학교,2021-04-01,여자,78,78,76,-2,2,0,-0.025641026,0.026315789,0
672,2021,경남,남해군,4884000000,초등학교,2021-04-01,남자,110,108,112,4,-2,2,0.037037037,-0.017857143,0.018518519
673,2021,경남,하동군,4885000000,초등학교,2021-04-01,전체,183,252,238,-14,-55,-69,-0.055555556,-0.231092437,-0.273809524
674,2021,경남,하동군,4885000000,초등학교,2021-04-01,여자,71,116,104,-12,-33,-45,-0.103448276,-0.317307692,-0.387931034
675,2021,경남,하동군,4885000000,초등학교,2021-04-01,남자,112,136,134,-2,-22,-24,-0.014705882,-0.164179104,-0.176470588
676,2021,경남,산청군,4886000000,초등학교,2021-04-01,전체,112,155,141,-14,-29,-43,-0.090322581,-0.205673759,-0.277419355
677,2021,경남,산청군,4886000000,초등학교,2021-04-01,여자,50,78,71,-7,-21,-28,-0.08974359,-0.295774648,-0.358974359
678,2021,경남,산청군,4886000000,초등학교,2021-04-01,남자,62,77,70,-7,-8,-15,-0.090909091,-0.114285714,-0.194805195
679,2021,경남,함양군,4887000000,초등학교,2021-04-01,전체,210,211,207,-4,3,-1,-0.018957346,0.014492754,-0.004739336
680,2021,경남,함양군,4887000000,초등학교,2021-04-01,여자,101,108,107,-1,-6,-7,-0.009259259,-0.056074766,-0.064814815
681,2021,경남,함양군,4887000000,초등학교,2021-04-01,남자,109,103,100,-3,9,6,-0.029126214,0.09,0.058252427
682,2021,경남,거창군,4888000000,초등학교,2021-04-01,전체,453,437,423,-14,30,16,-0.032036613,0.070921986,0.036613272
683,2021,경남,거창군,4888000000,초등학교,2021-04-01,여자,228,219,213,-6,15,9,-0.02739726,0.070422535,0.04109589
684,2021,경남,거창군,4888000000,초등학교,2021-04-01,남자,225,218,210,-8,15,7,-0.036697248,0.071428571,0.032110092
685,2021,경남,합천군,4889000000,초등학교,2021-04-01,전체,155,174,176,2,-21,-19,0.011494253,-0.119318182,-0.109195402
686,2021,경남,합천군,4889000000,초등학교,2021-04-01,여자,77,82,85,3,-8,-5,0.036585366,-0.094117647,-0.06097561
687,2021,경남,합천군,4889000000,초등학교,2021-04-01,남자,78,92,91,-1,-13,-14,-0.010869565,-0.142857143,-0.152173913
688,2021,제주,제주시,5011000000,초등학교,2021-04-01,전체,5130,4905,4950,45,180,225,0.009174312,0.036363636,0.04587156
689,2021,제주,제주시,5011000000,초등학교,2021-04-01,여자,2501,2406,2454,48,47,95,0.019950125,0.019152404,0.039484622
690,2021,제주,제주시,5011000000,초등학교,2021-04-01,남자,2629,2499,2496,-3,133,130,-0.00120048,0.053285256,0.052020808
691,2021,제주,서귀포시,5013000000,초등학교,2021-04-01,전체,1495,1553,1595,42,-100,-58,0.02704443,-0.062695925,-0.03734707
692,2021,제주,서귀포시,5013000000,초등학교,2021-04-01,여자,747,769,774,5,-27,-22,0.006501951,-0.034883721,-0.028608583
693,2021,제주,서귀포시,5013000000,초등학교,2021-04-01,남자,748,784,821,37,-73,-36,0.047193878,-0.088915956,-0.045918367
694,2015,서울,종로구,1111000000,초등학교,2015-04-01,전체,976,1006,1009,3,-33,-30,0.002982107,-0.032705649,-0.029821074
695,2015,서울,종로구,1111000000,초등학교,2015-04-01,여자,472,488,488,0,-16,-16,0,-0.032786885,-0.032786885
696,2015,서울,종로구,1111000000,초등학교,2015-04-01,남자,504,518,521,3,-17,-14,0.005791506,-0.032629559,-0.027027027
697,2015,서울,중구,1114000000,초등학교,2015-04-01,전체,977,886,805,-81,172,91,-0.091422122,0.213664596,0.102708804
698,2015,서울,중구,1114000000,초등학교,2015-04-01,여자,496,445,398,-47,98,51,-0.105617978,0.246231156,0.114606742
699,2015,서울,중구,1114000000,초등학교,2015-04-01,남자,481,441,407,-34,74,40,-0.077097506,0.181818182,0.090702948
700,2015,서울,용산구,1117000000,초등학교,2015-04-01,전체,1414,1858,1796,-62,-382,-444,-0.033369214,-0.212694878,-0.238966631
701,2015,서울,용산구,1117000000,초등학교,2015-04-01,여자,714,944,927,-17,-213,-230,-0.018008475,-0.229773463,-0.243644068
702,2015,서울,용산구,1117000000,초등학교,2015-04-01,남자,700,914,869,-45,-169,-214,-0.049234136,-0.19447641,-0.234135667
703,2015,서울,성동구,1120000000,초등학교,2015-04-01,전체,2147,2441,2362,-79,-215,-294,-0.032363785,-0.091024555,-0.120442442
704,2015,서울,성동구,1120000000,초등학교,2015-04-01,여자,1040,1187,1150,-37,-110,-147,-0.031171019,-0.095652174,-0.123841618
705,2015,서울,성동구,1120000000,초등학교,2015-04-01,남자,1107,1254,1212,-42,-105,-147,-0.033492823,-0.086633663,-0.11722488
706,2015,서울,광진구,1121500000,초등학교,2015-04-01,전체,2601,2615,2532,-83,69,-14,-0.031739962,0.027251185,-0.005353728
707,2015,서울,광진구,1121500000,초등학교,2015-04-01,여자,1237,1265,1221,-44,16,-28,-0.034782609,0.013104013,-0.022134387
708,2015,서울,광진구,1121500000,초등학교,2015-04-01,남자,1364,1350,1311,-39,53,14,-0.028888889,0.040427155,0.01037037
709,2015,서울,동대문구,1123000000,초등학교,2015-04-01,전체,2596,2692,2644,-48,-48,-96,-0.017830609,-0.018154312,-0.035661218
710,2015,서울,동대문구,1123000000,초등학교,2015-04-01,여자,1267,1327,1298,-29,-31,-60,-0.021853806,-0.023882897,-0.04521477
711,2015,서울,동대문구,1123000000,초등학교,2015-04-01,남자,1329,1365,1346,-19,-17,-36,-0.013919414,-0.012630015,-0.026373626
712,2015,서울,중랑구,1126000000,초등학교,2015-04-01,전체,2812,3082,3019,-63,-207,-270,-0.020441272,-0.06856575,-0.087605451
713,2015,서울,중랑구,1126000000,초등학교,2015-04-01,여자,1389,1505,1468,-37,-79,-116,-0.024584718,-0.053814714,-0.077076412
714,2015,서울,중랑구,1126000000,초등학교,2015-04-01,남자,1423,1577,1551,-26,-128,-154,-0.016487001,-0.082527402,-0.097653773
715,2015,서울,성북구,1129000000,초등학교,2015-04-01,전체,3876,4069,3973,-96,-97,-193,-0.02359302,-0.0244148,-0.047431801
716,2015,서울,성북구,1129000000,초등학교,2015-04-01,여자,1871,1978,1951,-27,-80,-107,-0.013650152,-0.041004613,-0.054095046
717,2015,서울,성북구,1129000000,초등학교,2015-04-01,남자,2005,2091,2022,-69,-17,-86,-0.032998565,-0.008407517,-0.041128647
718,2015,서울,강북구,1130500000,초등학교,2015-04-01,전체,1855,2540,2417,-123,-562,-685,-0.048425197,-0.232519652,-0.269685039
719,2015,서울,강북구,1130500000,초등학교,2015-04-01,여자,927,1282,1214,-68,-287,-355,-0.053042122,-0.236408567,-0.276911076
720,2015,서울,강북구,1130500000,초등학교,2015-04-01,남자,928,1258,1203,-55,-275,-330,-0.043720191,-0.228595179,-0.262321145
721,2015,서울,도봉구,1132000000,초등학교,2015-04-01,전체,2813,2687,2620,-67,193,126,-0.024934872,0.073664122,0.046892445
722,2015,서울,도봉구,1132000000,초등학교,2015-04-01,여자,1349,1307,1291,-16,58,42,-0.012241775,0.044926414,0.03213466
723,2015,서울,도봉구,1132000000,초등학교,2015-04-01,남자,1464,1380,1329,-51,135,84,-0.036956522,0.101580135,0.060869565
724,2015,서울,노원구,1135000000,초등학교,2015-04-01,전체,4895,4832,4734,-98,161,63,-0.020281457,0.034009294,0.013038079
725,2015,서울,노원구,1135000000,초등학교,2015-04-01,여자,2388,2404,2341,-63,47,-16,-0.026206323,0.02007689,-0.006655574
726,2015,서울,노원구,1135000000,초등학교,2015-04-01,남자,2507,2428,2393,-35,114,79,-0.014415157,0.047638947,0.032537068
727,2015,서울,은평구,1138000000,초등학교,2015-04-01,전체,3960,4302,4167,-135,-207,-342,-0.031380753,-0.049676026,-0.079497908
728,2015,서울,은평구,1138000000,초등학교,2015-04-01,여자,1898,2059,1990,-69,-92,-161,-0.033511413,-0.046231156,-0.078193298
729,2015,서울,은평구,1138000000,초등학교,2015-04-01,남자,2062,2243,2177,-66,-115,-181,-0.029424877,-0.052824989,-0.080695497
730,2015,서울,서대문구,1141000000,초등학교,2015-04-01,전체,2109,2256,2196,-60,-87,-147,-0.026595745,-0.039617486,-0.065159574
731,2015,서울,서대문구,1141000000,초등학교,2015-04-01,여자,1029,1070,1057,-13,-28,-41,-0.012149533,-0.026490066,-0.038317757
732,2015,서울,서대문구,1141000000,초등학교,2015-04-01,남자,1080,1186,1139,-47,-59,-106,-0.039629005,-0.051799824,-0.089376054
733,2015,서울,마포구,1144000000,초등학교,2015-04-01,전체,2917,3262,3183,-79,-266,-345,-0.024218271,-0.08356896,-0.105763335
734,2015,서울,마포구,1144000000,초등학교,2015-04-01,여자,1412,1559,1535,-24,-123,-147,-0.015394484,-0.080130293,-0.094291212
735,2015,서울,마포구,1144000000,초등학교,2015-04-01,남자,1505,1703,1648,-55,-143,-198,-0.032295948,-0.086771845,-0.116265414
736,2015,서울,양천구,1147000000,초등학교,2015-04-01,전체,4071,3822,3914,92,157,249,0.024071167,0.040112417,0.065149137
737,2015,서울,양천구,1147000000,초등학교,2015-04-01,여자,1975,1859,1904,45,71,116,0.024206563,0.037289916,0.062399139
738,2015,서울,양천구,1147000000,초등학교,2015-04-01,남자,2096,1963,2010,47,86,133,0.023942944,0.04278607,0.067753439
739,2015,서울,강서구,1150000000,초등학교,2015-04-01,전체,4757,4663,4591,-72,166,94,-0.015440703,0.0361577,0.020158696
740,2015,서울,강서구,1150000000,초등학교,2015-04-01,여자,2324,2279,2233,-46,91,45,-0.020184291,0.040752351,0.019745502
741,2015,서울,강서구,1150000000,초등학교,2015-04-01,남자,2433,2384,2358,-26,75,49,-0.01090604,0.031806616,0.020553691
742,2015,서울,구로구,1153000000,초등학교,2015-04-01,전체,3516,4034,3917,-117,-401,-518,-0.029003471,-0.102374266,-0.128408528
743,2015,서울,구로구,1153000000,초등학교,2015-04-01,여자,1728,1996,1950,-46,-222,-268,-0.023046092,-0.113846154,-0.134268537
744,2015,서울,구로구,1153000000,초등학교,2015-04-01,남자,1788,2038,1967,-71,-179,-250,-0.034838077,-0.091001525,-0.122669284
745,2015,서울,금천구,1154500000,초등학교,2015-04-01,전체,1550,1731,1636,-95,-86,-181,-0.054881571,-0.052567237,-0.104563836
746,2015,서울,금천구,1154500000,초등학교,2015-04-01,여자,753,851,809,-42,-56,-98,-0.049353702,-0.069221261,-0.115158637
747,2015,서울,금천구,1154500000,초등학교,2015-04-01,남자,797,880,827,-53,-30,-83,-0.060227273,-0.036275695,-0.094318182
748,2015,서울,영등포구,1156000000,초등학교,2015-04-01,전체,2589,3099,2939,-160,-350,-510,-0.051629558,-0.119088125,-0.164569216
749,2015,서울,영등포구,1156000000,초등학교,2015-04-01,여자,1265,1560,1484,-76,-219,-295,-0.048717949,-0.147574124,-0.189102564
750,2015,서울,영등포구,1156000000,초등학교,2015-04-01,남자,1324,1539,1455,-84,-131,-215,-0.054580897,-0.090034364,-0.139701105
751,2015,서울,동작구,1159000000,초등학교,2015-04-01,전체,2904,3239,3177,-62,-273,-335,-0.01914171,-0.085930123,-0.103426984
752,2015,서울,동작구,1159000000,초등학교,2015-04-01,여자,1429,1607,1571,-36,-142,-178,-0.022401991,-0.090388288,-0.110765401
753,2015,서울,동작구,1159000000,초등학교,2015-04-01,남자,1475,1632,1606,-26,-131,-157,-0.015931373,-0.081569116,-0.09620098
754,2015,서울,관악구,1162000000,초등학교,2015-04-01,전체,3014,3557,3354,-203,-340,-543,-0.057070565,-0.101371497,-0.152656733
755,2015,서울,관악구,1162000000,초등학교,2015-04-01,여자,1454,1697,1590,-107,-136,-243,-0.063052445,-0.085534591,-0.143193872
756,2015,서울,관악구,1162000000,초등학교,2015-04-01,남자,1560,1860,1764,-96,-204,-300,-0.051612903,-0.115646259,-0.161290323
757,2015,서울,서초구,1165000000,초등학교,2015-04-01,전체,3926,3839,4001,162,-75,87,0.042198489,-0.018745314,0.022662152
758,2015,서울,서초구,1165000000,초등학교,2015-04-01,여자,1928,1881,1975,94,-47,47,0.049973418,-0.023797468,0.024986709
759,2015,서울,서초구,1165000000,초등학교,2015-04-01,남자,1998,1958,2026,68,-28,40,0.034729316,-0.013820336,0.020429009
760,2015,서울,강남구,1168000000,초등학교,2015-04-01,전체,3970,4050,4114,64,-144,-80,0.015802469,-0.035002431,-0.019753086
761,2015,서울,강남구,1168000000,초등학교,2015-04-01,여자,1881,1924,1954,30,-73,-43,0.015592516,-0.037359263,-0.022349272
762,2015,서울,강남구,1168000000,초등학교,2015-04-01,남자,2089,2126,2160,34,-71,-37,0.015992474,-0.03287037,-0.017403575
763,2015,서울,송파구,1171000000,초등학교,2015-04-01,전체,5204,5431,5633,202,-429,-227,0.037193887,-0.076158353,-0.041797091
764,2015,서울,송파구,1171000000,초등학교,2015-04-01,여자,2489,2626,2720,94,-231,-137,0.035795887,-0.084926471,-0.052170602
765,2015,서울,송파구,1171000000,초등학교,2015-04-01,남자,2715,2805,2913,108,-198,-90,0.038502674,-0.067971164,-0.032085561
766,2015,서울,강동구,1174000000,초등학교,2015-04-01,전체,3665,4091,3978,-113,-313,-426,-0.027621608,-0.078682755,-0.104131019
767,2015,서울,강동구,1174000000,초등학교,2015-04-01,여자,1741,2026,1949,-77,-208,-285,-0.038005923,-0.106721396,-0.140671273
768,2015,서울,강동구,1174000000,초등학교,2015-04-01,남자,1924,2065,2029,-36,-105,-141,-0.017433414,-0.05174963,-0.068280872
769,2015,부산,중구,2611000000,초등학교,2015-04-01,전체,250,217,214,-3,36,33,-0.013824885,0.168224299,0.152073733
770,2015,부산,중구,2611000000,초등학교,2015-04-01,여자,112,102,98,-4,14,10,-0.039215686,0.142857143,0.098039216
771,2015,부산,중구,2611000000,초등학교,2015-04-01,남자,138,115,116,1,22,23,0.008695652,0.189655172,0.2
772,2015,부산,서구,2614000000,초등학교,2015-04-01,전체,599,641,622,-19,-23,-42,-0.029641186,-0.036977492,-0.065522621
773,2015,부산,서구,2614000000,초등학교,2015-04-01,여자,316,297,291,-6,25,19,-0.02020202,0.085910653,0.063973064
774,2015,부산,서구,2614000000,초등학교,2015-04-01,남자,283,344,331,-13,-48,-61,-0.037790698,-0.145015106,-0.177325581
775,2015,부산,동구,2617000000,초등학교,2015-04-01,전체,428,508,497,-11,-69,-80,-0.021653543,-0.138832998,-0.157480315
776,2015,부산,동구,2617000000,초등학교,2015-04-01,여자,209,245,246,1,-37,-36,0.004081633,-0.150406504,-0.146938776
777,2015,부산,동구,2617000000,초등학교,2015-04-01,남자,219,263,251,-12,-32,-44,-0.045627376,-0.12749004,-0.16730038
778,2015,부산,영도구,2620000000,초등학교,2015-04-01,전체,731,813,766,-47,-35,-82,-0.057810578,-0.045691906,-0.100861009
779,2015,부산,영도구,2620000000,초등학교,2015-04-01,여자,360,413,386,-27,-26,-53,-0.065375303,-0.067357513,-0.128329298
780,2015,부산,영도구,2620000000,초등학교,2015-04-01,남자,371,400,380,-20,-9,-29,-0.05,-0.023684211,-0.0725
781,2015,부산,부산진구,2623000000,초등학교,2015-04-01,전체,2724,2796,2679,-117,45,-72,-0.041845494,0.016797312,-0.025751073
782,2015,부산,부산진구,2623000000,초등학교,2015-04-01,여자,1303,1356,1289,-67,14,-53,-0.049410029,0.010861133,-0.039085546
783,2015,부산,부산진구,2623000000,초등학교,2015-04-01,남자,1421,1440,1390,-50,31,-19,-0.034722222,0.022302158,-0.013194444
784,2015,부산,동래구,2626000000,초등학교,2015-04-01,전체,2021,1907,2033,126,-12,114,0.066072365,-0.005902607,0.059779759
785,2015,부산,동래구,2626000000,초등학교,2015-04-01,여자,967,933,972,39,-5,34,0.041800643,-0.005144033,0.036441586
786,2015,부산,동래구,2626000000,초등학교,2015-04-01,남자,1054,974,1061,87,-7,80,0.089322382,-0.006597549,0.082135524
787,2015,부산,남구,2629000000,초등학교,2015-04-01,전체,2073,2037,2083,46,-10,36,0.022582229,-0.004800768,0.017673049
788,2015,부산,남구,2629000000,초등학교,2015-04-01,여자,1032,1017,1047,30,-15,15,0.029498525,-0.014326648,0.014749263
789,2015,부산,남구,2629000000,초등학교,2015-04-01,남자,1041,1020,1036,16,5,21,0.015686275,0.004826255,0.020588235
790,2015,부산,북구,2632000000,초등학교,2015-04-01,전체,2252,2361,2314,-47,-62,-109,-0.019906819,-0.026793431,-0.046166878
791,2015,부산,북구,2632000000,초등학교,2015-04-01,여자,1087,1126,1100,-26,-13,-39,-0.023090586,-0.011818182,-0.034635879
792,2015,부산,북구,2632000000,초등학교,2015-04-01,남자,1165,1235,1214,-21,-49,-70,-0.017004049,-0.040362438,-0.056680162
793,2015,부산,해운대구,2635000000,초등학교,2015-04-01,전체,3424,3490,3450,-40,-26,-66,-0.011461318,-0.007536232,-0.018911175
794,2015,부산,해운대구,2635000000,초등학교,2015-04-01,여자,1650,1652,1636,-16,14,-2,-0.00968523,0.008557457,-0.001210654
795,2015,부산,해운대구,2635000000,초등학교,2015-04-01,남자,1774,1838,1814,-24,-40,-64,-0.013057671,-0.022050717,-0.034820457
796,2015,부산,사하구,2638000000,초등학교,2015-04-01,전체,2545,2833,2740,-93,-195,-288,-0.032827391,-0.071167883,-0.101659019
797,2015,부산,사하구,2638000000,초등학교,2015-04-01,여자,1260,1394,1354,-40,-94,-134,-0.028694405,-0.069423929,-0.096126255
798,2015,부산,사하구,2638000000,초등학교,2015-04-01,남자,1285,1439,1386,-53,-101,-154,-0.036831133,-0.072871573,-0.107018763
799,2015,부산,금정구,2641000000,초등학교,2015-04-01,전체,1612,1574,1551,-23,61,38,-0.014612452,0.039329465,0.024142313
800,2015,부산,금정구,2641000000,초등학교,2015-04-01,여자,758,732,735,3,23,26,0.004098361,0.031292517,0.035519126
801,2015,부산,금정구,2641000000,초등학교,2015-04-01,남자,854,842,816,-26,38,12,-0.03087886,0.046568627,0.014251781
802,2015,부산,강서구,2644000000,초등학교,2015-04-01,전체,898,626,741,115,157,272,0.18370607,0.211875843,0.434504792
803,2015,부산,강서구,2644000000,초등학교,2015-04-01,여자,460,316,372,56,88,144,0.17721519,0.23655914,0.455696203
804,2015,부산,강서구,2644000000,초등학교,2015-04-01,남자,438,310,369,59,69,128,0.190322581,0.18699187,0.412903226
805,2015,부산,연제구,2647000000,초등학교,2015-04-01,전체,1570,1547,1544,-3,26,23,-0.001939237,0.016839378,0.014867485
806,2015,부산,연제구,2647000000,초등학교,2015-04-01,여자,764,745,734,-11,30,19,-0.014765101,0.040871935,0.025503356
807,2015,부산,연제구,2647000000,초등학교,2015-04-01,남자,806,802,810,8,-4,4,0.009975062,-0.004938272,0.004987531
808,2015,부산,수영구,2650000000,초등학교,2015-04-01,전체,1102,1162,1118,-44,-16,-60,-0.037865749,-0.01431127,-0.051635112
809,2015,부산,수영구,2650000000,초등학교,2015-04-01,여자,545,580,557,-23,-12,-35,-0.039655172,-0.021543986,-0.060344828
810,2015,부산,수영구,2650000000,초등학교,2015-04-01,남자,557,582,561,-21,-4,-25,-0.036082474,-0.007130125,-0.042955326
811,2015,부산,사상구,2653000000,초등학교,2015-04-01,전체,1562,1773,1705,-68,-143,-211,-0.038353074,-0.083870968,-0.119007332
812,2015,부산,사상구,2653000000,초등학교,2015-04-01,여자,771,887,853,-34,-82,-116,-0.038331454,-0.096131301,-0.130777903
813,2015,부산,사상구,2653000000,초등학교,2015-04-01,남자,791,886,852,-34,-61,-95,-0.038374718,-0.071596244,-0.107223476
814,2015,부산,기장군,2671000000,초등학교,2015-04-01,전체,1720,1380,1635,255,85,340,0.184782609,0.051987768,0.246376812
815,2015,부산,기장군,2671000000,초등학교,2015-04-01,여자,840,669,795,126,45,171,0.188340807,0.056603774,0.255605381
816,2015,부산,기장군,2671000000,초등학교,2015-04-01,남자,880,711,840,129,40,169,0.181434599,0.047619048,0.23769339
817,2015,대구,중구,2711000000,초등학교,2015-04-01,전체,725,508,479,-29,246,217,-0.057086614,0.513569937,0.427165354
818,2015,대구,중구,2711000000,초등학교,2015-04-01,여자,345,248,233,-15,112,97,-0.060483871,0.480686695,0.391129032
819,2015,대구,중구,2711000000,초등학교,2015-04-01,남자,380,260,246,-14,134,120,-0.053846154,0.544715447,0.461538462
820,2015,대구,동구,2714000000,초등학교,2015-04-01,전체,2929,2892,2910,18,19,37,0.006224066,0.00652921,0.012793914
821,2015,대구,동구,2714000000,초등학교,2015-04-01,여자,1444,1387,1406,19,38,57,0.01369863,0.027027027,0.04109589
822,2015,대구,동구,2714000000,초등학교,2015-04-01,남자,1485,1505,1504,-1,-19,-20,-0.000664452,-0.012632979,-0.013289037
823,2015,대구,서구,2717000000,초등학교,2015-04-01,전체,1080,1278,1209,-69,-129,-198,-0.05399061,-0.106699752,-0.154929577
824,2015,대구,서구,2717000000,초등학교,2015-04-01,여자,532,644,616,-28,-84,-112,-0.043478261,-0.136363636,-0.173913043
825,2015,대구,서구,2717000000,초등학교,2015-04-01,남자,548,634,593,-41,-45,-86,-0.06466877,-0.075885329,-0.135646688
826,2015,대구,남구,2720000000,초등학교,2015-04-01,전체,832,1019,987,-32,-155,-187,-0.031403337,-0.15704154,-0.183513248
827,2015,대구,남구,2720000000,초등학교,2015-04-01,여자,387,475,457,-18,-70,-88,-0.037894737,-0.153172867,-0.185263158
828,2015,대구,남구,2720000000,초등학교,2015-04-01,남자,445,544,530,-14,-85,-99,-0.025735294,-0.160377358,-0.181985294
829,2015,대구,북구,2723000000,초등학교,2015-04-01,전체,4014,4258,4167,-91,-153,-244,-0.021371536,-0.036717063,-0.057303899
830,2015,대구,북구,2723000000,초등학교,2015-04-01,여자,1929,2038,2007,-31,-78,-109,-0.015210991,-0.038863976,-0.053483808
831,2015,대구,북구,2723000000,초등학교,2015-04-01,남자,2085,2220,2160,-60,-75,-135,-0.027027027,-0.034722222,-0.060810811
832,2015,대구,수성구,2726000000,초등학교,2015-04-01,전체,3821,3479,3766,287,55,342,0.08249497,0.014604355,0.09830411
833,2015,대구,수성구,2726000000,초등학교,2015-04-01,여자,1831,1636,1765,129,66,195,0.078850856,0.037393768,0.119193154
834,2015,대구,수성구,2726000000,초등학교,2015-04-01,남자,1990,1843,2001,158,-11,147,0.085729788,-0.005497251,0.079761259
835,2015,대구,달서구,2729000000,초등학교,2015-04-01,전체,5526,5186,5283,97,243,340,0.018704204,0.045996593,0.065561126
836,2015,대구,달서구,2729000000,초등학교,2015-04-01,여자,2620,2472,2497,25,123,148,0.010113269,0.049259111,0.05987055
837,2015,대구,달서구,2729000000,초등학교,2015-04-01,남자,2906,2714,2786,72,120,192,0.026529108,0.043072505,0.070744289
838,2015,대구,달성군,2771000000,초등학교,2015-04-01,전체,1896,2061,1994,-67,-98,-165,-0.032508491,-0.049147442,-0.080058224
839,2015,대구,달성군,2771000000,초등학교,2015-04-01,여자,910,973,950,-23,-40,-63,-0.023638232,-0.042105263,-0.064748201
840,2015,대구,달성군,2771000000,초등학교,2015-04-01,남자,986,1088,1044,-44,-58,-102,-0.040441176,-0.055555556,-0.09375
841,2015,인천,중구,2811000000,초등학교,2015-04-01,전체,1244,992,1045,53,199,252,0.053427419,0.190430622,0.254032258
842,2015,인천,중구,2811000000,초등학교,2015-04-01,여자,621,507,524,17,97,114,0.033530572,0.185114504,0.224852071
843,2015,인천,중구,2811000000,초등학교,2015-04-01,남자,623,485,521,36,102,138,0.074226804,0.195777351,0.284536082
844,2015,인천,동구,2814000000,초등학교,2015-04-01,전체,754,678,647,-31,107,76,-0.045722714,0.165378671,0.112094395
845,2015,인천,동구,2814000000,초등학교,2015-04-01,여자,376,331,321,-10,55,45,-0.03021148,0.171339564,0.135951662
846,2015,인천,동구,2814000000,초등학교,2015-04-01,남자,378,347,326,-21,52,31,-0.060518732,0.159509202,0.089337176
847,2015,인천,미추홀구,2817700000,초등학교,2015-04-01,전체,2972,3460,3359,-101,-387,-488,-0.029190751,-0.115212861,-0.141040462
848,2015,인천,미추홀구,2817700000,초등학교,2015-04-01,여자,1427,1659,1623,-36,-196,-232,-0.021699819,-0.120764017,-0.139843279
849,2015,인천,미추홀구,2817700000,초등학교,2015-04-01,남자,1545,1801,1736,-65,-191,-256,-0.036091061,-0.110023041,-0.142143254
850,2015,인천,연수구,2818500000,초등학교,2015-04-01,전체,3134,2681,2961,280,173,453,0.104438642,0.058426207,0.168966803
851,2015,인천,연수구,2818500000,초등학교,2015-04-01,여자,1504,1218,1364,146,140,286,0.119868637,0.102639296,0.234811166
852,2015,인천,연수구,2818500000,초등학교,2015-04-01,남자,1630,1463,1597,134,33,167,0.091592618,0.020663745,0.114149009
853,2015,인천,남동구,2820000000,초등학교,2015-04-01,전체,4980,5186,5201,15,-221,-206,0.002892403,-0.042491828,-0.039722329
854,2015,인천,남동구,2820000000,초등학교,2015-04-01,여자,2472,2557,2565,8,-93,-85,0.003128666,-0.03625731,-0.033242081
855,2015,인천,남동구,2820000000,초등학교,2015-04-01,남자,2508,2629,2636,7,-128,-121,0.002662609,-0.048558422,-0.046025105
856,2015,인천,부평구,2823700000,초등학교,2015-04-01,전체,4537,4920,4737,-183,-200,-383,-0.037195122,-0.042220815,-0.077845528
857,2015,인천,부평구,2823700000,초등학교,2015-04-01,여자,2179,2355,2273,-82,-94,-176,-0.034819533,-0.041355037,-0.074734607
858,2015,인천,부평구,2823700000,초등학교,2015-04-01,남자,2358,2565,2464,-101,-106,-207,-0.039376218,-0.043019481,-0.080701754
859,2015,인천,계양구,2824500000,초등학교,2015-04-01,전체,2964,3090,3055,-35,-91,-126,-0.011326861,-0.029787234,-0.040776699
860,2015,인천,계양구,2824500000,초등학교,2015-04-01,여자,1476,1521,1524,3,-48,-45,0.001972387,-0.031496063,-0.029585799
861,2015,인천,계양구,2824500000,초등학교,2015-04-01,남자,1488,1569,1531,-38,-43,-81,-0.024219248,-0.028086218,-0.051625239
862,2015,인천,서구,2826000000,초등학교,2015-04-01,전체,5471,5414,5575,161,-104,57,0.029737717,-0.018654709,0.01052826
863,2015,인천,서구,2826000000,초등학교,2015-04-01,여자,2726,2621,2720,99,6,105,0.037771843,0.002205882,0.040061045
864,2015,인천,서구,2826000000,초등학교,2015-04-01,남자,2745,2793,2855,62,-110,-48,0.022198353,-0.038528897,-0.017185822
865,2015,인천,강화군,2871000000,초등학교,2015-04-01,전체,382,359,368,9,14,23,0.025069638,0.038043478,0.064066852
866,2015,인천,강화군,2871000000,초등학교,2015-04-01,여자,196,175,182,7,14,21,0.04,0.076923077,0.12
867,2015,인천,강화군,2871000000,초등학교,2015-04-01,남자,186,184,186,2,0,2,0.010869565,0,0.010869565
868,2015,인천,옹진군,2872000000,초등학교,2015-04-01,전체,107,149,162,13,-55,-42,0.087248322,-0.339506173,-0.281879195
869,2015,인천,옹진군,2872000000,초등학교,2015-04-01,여자,52,74,76,2,-24,-22,0.027027027,-0.315789474,-0.297297297
870,2015,인천,옹진군,2872000000,초등학교,2015-04-01,남자,55,75,86,11,-31,-20,0.146666667,-0.360465116,-0.266666667
871,2015,광주,동구,2911000000,초등학교,2015-04-01,전체,530,647,624,-23,-94,-117,-0.035548686,-0.150641026,-0.180834621
872,2015,광주,동구,2911000000,초등학교,2015-04-01,여자,260,306,295,-11,-35,-46,-0.035947712,-0.118644068,-0.150326797
873,2015,광주,동구,2911000000,초등학교,2015-04-01,남자,270,341,329,-12,-59,-71,-0.035190616,-0.179331307,-0.208211144
874,2015,광주,서구,2914000000,초등학교,2015-04-01,전체,2852,3046,2960,-86,-108,-194,-0.028233749,-0.036486486,-0.063690085
875,2015,광주,서구,2914000000,초등학교,2015-04-01,여자,1397,1483,1441,-42,-44,-86,-0.028320971,-0.030534351,-0.05799056
876,2015,광주,서구,2914000000,초등학교,2015-04-01,남자,1455,1563,1519,-44,-64,-108,-0.028150992,-0.042132982,-0.069097889
877,2015,광주,남구,2915500000,초등학교,2015-04-01,전체,2076,1786,1854,68,222,290,0.038073908,0.1197411,0.16237402
878,2015,광주,남구,2915500000,초등학교,2015-04-01,여자,1000,884,916,32,84,116,0.036199095,0.091703057,0.131221719
879,2015,광주,남구,2915500000,초등학교,2015-04-01,남자,1076,902,938,36,138,174,0.039911308,0.147121535,0.192904656
880,2015,광주,북구,2917000000,초등학교,2015-04-01,전체,3986,3955,3979,24,7,31,0.006068268,0.001759236,0.00783818
881,2015,광주,북구,2917000000,초등학교,2015-04-01,여자,1935,1887,1921,34,14,48,0.018018018,0.007287871,0.025437202
882,2015,광주,북구,2917000000,초등학교,2015-04-01,남자,2051,2068,2058,-10,-7,-17,-0.00483559,-0.003401361,-0.008220503
883,2015,광주,광산구,2920000000,초등학교,2015-04-01,전체,5397,5251,5352,101,45,146,0.019234432,0.008408072,0.027804228
884,2015,광주,광산구,2920000000,초등학교,2015-04-01,여자,2658,2651,2677,26,-19,7,0.00980762,-0.007097497,0.002640513
885,2015,광주,광산구,2920000000,초등학교,2015-04-01,남자,2739,2600,2675,75,64,139,0.028846154,0.023925234,0.053461538
886,2015,대전,동구,3011000000,초등학교,2015-04-01,전체,2140,2430,2342,-88,-202,-290,-0.036213992,-0.086251067,-0.119341564
887,2015,대전,동구,3011000000,초등학교,2015-04-01,여자,1035,1166,1126,-40,-91,-131,-0.034305317,-0.080817052,-0.112349914
888,2015,대전,동구,3011000000,초등학교,2015-04-01,남자,1105,1264,1216,-48,-111,-159,-0.037974684,-0.091282895,-0.125791139
889,2015,대전,중구,3014000000,초등학교,2015-04-01,전체,2374,2329,2343,14,31,45,0.006011164,0.013230901,0.019321597
890,2015,대전,중구,3014000000,초등학교,2015-04-01,여자,1119,1088,1111,23,8,31,0.021139706,0.00720072,0.028492647
891,2015,대전,중구,3014000000,초등학교,2015-04-01,남자,1255,1241,1232,-9,23,14,-0.007252216,0.018668831,0.011281225
892,2015,대전,서구,3017000000,초등학교,2015-04-01,전체,4476,4441,4485,44,-9,35,0.009907678,-0.002006689,0.007881108
893,2015,대전,서구,3017000000,초등학교,2015-04-01,여자,2160,2079,2104,25,56,81,0.012025012,0.02661597,0.038961039
894,2015,대전,서구,3017000000,초등학교,2015-04-01,남자,2316,2362,2381,19,-65,-46,0.00804403,-0.027299454,-0.019475021
895,2015,대전,유성구,3020000000,초등학교,2015-04-01,전체,4122,3919,4030,111,92,203,0.028323552,0.022828784,0.051798928
896,2015,대전,유성구,3020000000,초등학교,2015-04-01,여자,1998,1878,1933,55,65,120,0.029286475,0.033626487,0.063897764
897,2015,대전,유성구,3020000000,초등학교,2015-04-01,남자,2124,2041,2097,56,27,83,0.027437531,0.012875536,0.04066634
898,2015,대전,대덕구,3023000000,초등학교,2015-04-01,전체,1721,1821,1796,-25,-75,-100,-0.01372872,-0.041759465,-0.054914882
899,2015,대전,대덕구,3023000000,초등학교,2015-04-01,여자,872,906,886,-20,-14,-34,-0.022075055,-0.015801354,-0.037527594
900,2015,대전,대덕구,3023000000,초등학교,2015-04-01,남자,849,915,910,-5,-61,-66,-0.005464481,-0.067032967,-0.072131148
901,2015,울산,중구,3111000000,초등학교,2015-04-01,전체,2063,1868,1943,75,120,195,0.040149893,0.061760165,0.104389722
902,2015,울산,중구,3111000000,초등학교,2015-04-01,여자,1004,899,941,42,63,105,0.046718576,0.066950053,0.11679644
903,2015,울산,중구,3111000000,초등학교,2015-04-01,남자,1059,969,1002,33,57,90,0.034055728,0.056886228,0.092879257
904,2015,울산,남구,3114000000,초등학교,2015-04-01,전체,2840,2985,3015,30,-175,-145,0.010050251,-0.058043118,-0.048576214
905,2015,울산,남구,3114000000,초등학교,2015-04-01,여자,1358,1435,1449,14,-91,-77,0.009756098,-0.062801932,-0.053658537
906,2015,울산,남구,3114000000,초등학교,2015-04-01,남자,1482,1550,1566,16,-84,-68,0.010322581,-0.053639847,-0.043870968
907,2015,울산,동구,3117000000,초등학교,2015-04-01,전체,1775,1875,1854,-21,-79,-100,-0.0112,-0.042610572,-0.053333333
908,2015,울산,동구,3117000000,초등학교,2015-04-01,여자,834,873,863,-10,-29,-39,-0.011454754,-0.033603708,-0.04467354
909,2015,울산,동구,3117000000,초등학교,2015-04-01,남자,941,1002,991,-11,-50,-61,-0.010978044,-0.050454087,-0.060878244
910,2015,울산,북구,3120000000,초등학교,2015-04-01,전체,2349,2426,2412,-14,-63,-77,-0.005770816,-0.026119403,-0.031739489
911,2015,울산,북구,3120000000,초등학교,2015-04-01,여자,1138,1143,1153,10,-15,-5,0.008748906,-0.01300954,-0.004374453
912,2015,울산,북구,3120000000,초등학교,2015-04-01,남자,1211,1283,1259,-24,-48,-72,-0.018706157,-0.038125496,-0.056118472
913,2015,울산,울주군,3171000000,초등학교,2015-04-01,전체,2325,2213,2196,-17,129,112,-0.00768188,0.058743169,0.050610032
914,2015,울산,울주군,3171000000,초등학교,2015-04-01,여자,1103,1100,1082,-18,21,3,-0.016363636,0.019408503,0.002727273
915,2015,울산,울주군,3171000000,초등학교,2015-04-01,남자,1222,1113,1114,1,108,109,0.000898473,0.096947935,0.097933513
916,2015,세종,세종시,3611000000,초등학교,2015-04-01,전체,2578,1274,1518,244,1060,1304,0.191522763,0.69828722,1.023547881
917,2015,세종,세종시,3611000000,초등학교,2015-04-01,전체,2578,1274,1518,244,1060,1304,0.191522763,0.69828722,1.023547881
918,2015,세종,세종시,3611000000,초등학교,2015-04-01,전체,2578,1274,1518,244,1060,1304,0.191522763,0.69828722,1.023547881
919,2015,세종,세종시,3611000000,초등학교,2015-04-01,전체,2578,1274,1518,244,1060,1304,0.191522763,0.69828722,1.023547881
920,2015,세종,세종시,3611000000,초등학교,2015-04-01,여자,1291,624,752,128,539,667,0.205128205,0.716755319,1.068910256
921,2015,세종,세종시,3611000000,초등학교,2015-04-01,여자,1291,624,752,128,539,667,0.205128205,0.716755319,1.068910256
922,2015,세종,세종시,3611000000,초등학교,2015-04-01,여자,1291,624,752,128,539,667,0.205128205,0.716755319,1.068910256
923,2015,세종,세종시,3611000000,초등학교,2015-04-01,여자,1291,624,752,128,539,667,0.205128205,0.716755319,1.068910256
924,2015,세종,세종시,3611000000,초등학교,2015-04-01,남자,1287,650,766,116,521,637,0.178461538,0.680156658,0.98
925,2015,세종,세종시,3611000000,초등학교,2015-04-01,남자,1287,650,766,116,521,637,0.178461538,0.680156658,0.98
926,2015,세종,세종시,3611000000,초등학교,2015-04-01,남자,1287,650,766,116,521,637,0.178461538,0.680156658,0.98
927,2015,세종,세종시,3611000000,초등학교,2015-04-01,남자,1287,650,766,116,521,637,0.178461538,0.680156658,0.98
928,2015,경기,수원시,4111000000,초등학교,2015-04-01,전체,11849,11296,11691,395,158,553,0.03496813,0.013514669,0.048955382
929,2015,경기,수원시,4111000000,초등학교,2015-04-01,여자,5760,5439,5641,202,119,321,0.03713918,0.02109555,0.059018202
930,2015,경기,수원시,4111000000,초등학교,2015-04-01,남자,6089,5857,6050,193,39,232,0.032952023,0.006446281,0.039610722
931,2015,경기,성남시,4113000000,초등학교,2015-04-01,전체,7921,8378,8334,-44,-413,-457,-0.00525185,-0.049556036,-0.054547625
932,2015,경기,성남시,4113000000,초등학교,2015-04-01,여자,3854,4100,4072,-28,-218,-246,-0.006829268,-0.053536346,-0.06
933,2015,경기,성남시,4113000000,초등학교,2015-04-01,남자,4067,4278,4262,-16,-195,-211,-0.003740065,-0.045753168,-0.049322113
934,2015,경기,부천시,4119000000,초등학교,2015-04-01,전체,7048,7493,7312,-181,-264,-445,-0.024155879,-0.036105033,-0.059388763
935,2015,경기,부천시,4119000000,초등학교,2015-04-01,여자,3439,3654,3562,-92,-123,-215,-0.025177887,-0.034531162,-0.058839628
936,2015,경기,부천시,4119000000,초등학교,2015-04-01,남자,3609,3839,3750,-89,-141,-230,-0.023183121,-0.0376,-0.059911435
937,2015,경기,안양시,4117000000,초등학교,2015-04-01,전체,5127,5263,5172,-91,-45,-136,-0.017290519,-0.008700696,-0.025840775
938,2015,경기,안양시,4117000000,초등학교,2015-04-01,여자,2501,2523,2484,-39,17,-22,-0.015457788,0.0068438,-0.008719778
939,2015,경기,안양시,4117000000,초등학교,2015-04-01,남자,2626,2740,2688,-52,-62,-114,-0.018978102,-0.023065476,-0.041605839
940,2015,경기,과천시,4129000000,초등학교,2015-04-01,전체,554,581,589,8,-35,-27,0.013769363,-0.05942275,-0.046471601
941,2015,경기,과천시,4129000000,초등학교,2015-04-01,여자,276,282,285,3,-9,-6,0.010638298,-0.031578947,-0.021276596
942,2015,경기,과천시,4129000000,초등학교,2015-04-01,남자,278,299,304,5,-26,-21,0.016722408,-0.085526316,-0.070234114
943,2015,경기,안산시,4127000000,초등학교,2015-04-01,전체,6508,6558,6478,-80,30,-50,-0.012198841,0.004631059,-0.007624276
944,2015,경기,안산시,4127000000,초등학교,2015-04-01,여자,3154,3228,3165,-63,-11,-74,-0.019516729,-0.003475513,-0.022924411
945,2015,경기,안산시,4127000000,초등학교,2015-04-01,남자,3354,3330,3313,-17,41,24,-0.005105105,0.01237549,0.007207207
946,2015,경기,용인시,4146000000,초등학교,2015-04-01,전체,11757,11736,12023,287,-266,21,0.024454669,-0.022124262,0.001789366
947,2015,경기,용인시,4146000000,초등학교,2015-04-01,여자,5680,5697,5859,162,-179,-17,0.028436019,-0.030551289,-0.002984027
948,2015,경기,용인시,4146000000,초등학교,2015-04-01,남자,6077,6039,6164,125,-87,38,0.020698791,-0.014114212,0.006292433
949,2015,경기,군포시,4141000000,초등학교,2015-04-01,전체,2892,3029,2973,-56,-81,-137,-0.01848795,-0.027245207,-0.045229449
950,2015,경기,군포시,4141000000,초등학교,2015-04-01,여자,1385,1505,1463,-42,-78,-120,-0.027906977,-0.053315106,-0.079734219
951,2015,경기,군포시,4141000000,초등학교,2015-04-01,남자,1507,1524,1510,-14,-3,-17,-0.009186352,-0.001986755,-0.011154856
952,2015,경기,의왕시,4143000000,초등학교,2015-04-01,전체,1397,1651,1627,-24,-230,-254,-0.014536644,-0.141364474,-0.153846154
953,2015,경기,의왕시,4143000000,초등학교,2015-04-01,여자,668,792,782,-10,-114,-124,-0.012626263,-0.145780051,-0.156565657
954,2015,경기,의왕시,4143000000,초등학교,2015-04-01,남자,729,859,845,-14,-116,-130,-0.016298021,-0.137278107,-0.151338766
955,2015,경기,시흥시,4139000000,초등학교,2015-04-01,전체,4152,4309,4203,-106,-51,-157,-0.024599675,-0.01213419,-0.036435368
956,2015,경기,시흥시,4139000000,초등학교,2015-04-01,여자,1973,2051,1983,-68,-10,-78,-0.033154559,-0.005042864,-0.038030229
957,2015,경기,시흥시,4139000000,초등학교,2015-04-01,남자,2179,2258,2220,-38,-41,-79,-0.016829052,-0.018468468,-0.034986714
958,2015,경기,평택시,4122000000,초등학교,2015-04-01,전체,4718,4608,4690,82,28,110,0.017795139,0.005970149,0.023871528
959,2015,경기,평택시,4122000000,초등학교,2015-04-01,여자,2317,2255,2292,37,25,62,0.016407982,0.010907504,0.027494457
960,2015,경기,평택시,4122000000,초등학교,2015-04-01,남자,2401,2353,2398,45,3,48,0.019124522,0.001251043,0.02039949
961,2015,경기,화성시,4159000000,초등학교,2015-04-01,전체,8225,8226,8084,-142,141,-1,-0.017262339,0.01744186,-0.000121566
962,2015,경기,화성시,4159000000,초등학교,2015-04-01,여자,4014,3945,3892,-53,122,69,-0.013434728,0.031346351,0.017490494
963,2015,경기,화성시,4159000000,초등학교,2015-04-01,남자,4211,4281,4192,-89,19,-70,-0.020789535,0.004532443,-0.01635132
964,2015,경기,오산시,4137000000,초등학교,2015-04-01,전체,2971,2926,2986,60,-15,45,0.02050581,-0.005023443,0.015379357
965,2015,경기,오산시,4137000000,초등학교,2015-04-01,여자,1371,1368,1392,24,-21,3,0.01754386,-0.015086207,0.002192982
966,2015,경기,오산시,4137000000,초등학교,2015-04-01,남자,1600,1558,1594,36,6,42,0.023106547,0.003764115,0.026957638
967,2015,경기,광명시,4121000000,초등학교,2015-04-01,전체,3612,3879,3770,-109,-158,-267,-0.028100026,-0.041909814,-0.068832173
968,2015,경기,광명시,4121000000,초등학교,2015-04-01,여자,1790,1917,1847,-70,-57,-127,-0.036515389,-0.030860855,-0.066249348
969,2015,경기,광명시,4121000000,초등학교,2015-04-01,남자,1822,1962,1923,-39,-101,-140,-0.019877676,-0.052522101,-0.071355759
970,2015,경기,광주시,4161000000,초등학교,2015-04-01,전체,2939,3041,3064,23,-125,-102,0.007563302,-0.040796345,-0.033541598
971,2015,경기,광주시,4161000000,초등학교,2015-04-01,여자,1478,1471,1485,14,-7,7,0.009517335,-0.004713805,0.004758668
972,2015,경기,광주시,4161000000,초등학교,2015-04-01,남자,1461,1570,1579,9,-118,-109,0.005732484,-0.074730842,-0.069426752
973,2015,경기,하남시,4145000000,초등학교,2015-04-01,전체,1390,1310,1293,-17,97,80,-0.012977099,0.075019335,0.061068702
974,2015,경기,하남시,4145000000,초등학교,2015-04-01,여자,681,678,665,-13,16,3,-0.019174041,0.02406015,0.004424779
975,2015,경기,하남시,4145000000,초등학교,2015-04-01,남자,709,632,628,-4,81,77,-0.006329114,0.128980892,0.121835443
976,2015,경기,김포시,4157000000,초등학교,2015-04-01,전체,4265,3594,3936,342,329,671,0.095158598,0.083587398,0.186700056
977,2015,경기,김포시,4157000000,초등학교,2015-04-01,여자,2107,1762,1919,157,188,345,0.089103292,0.097967692,0.195800227
978,2015,경기,김포시,4157000000,초등학교,2015-04-01,남자,2158,1832,2017,185,141,326,0.100982533,0.069905801,0.177947598
979,2015,경기,이천시,4150000000,초등학교,2015-04-01,전체,2168,2220,2199,-21,-31,-52,-0.009459459,-0.014097317,-0.023423423
980,2015,경기,이천시,4150000000,초등학교,2015-04-01,여자,1027,1055,1045,-10,-18,-28,-0.009478673,-0.01722488,-0.026540284
981,2015,경기,이천시,4150000000,초등학교,2015-04-01,남자,1141,1165,1154,-11,-13,-24,-0.00944206,-0.011265165,-0.020600858
982,2015,경기,안성시,4155000000,초등학교,2015-04-01,전체,1926,1975,1958,-17,-32,-49,-0.008607595,-0.016343207,-0.024810127
983,2015,경기,안성시,4155000000,초등학교,2015-04-01,여자,936,957,949,-8,-13,-21,-0.008359457,-0.01369863,-0.021943574
984,2015,경기,안성시,4155000000,초등학교,2015-04-01,남자,990,1018,1009,-9,-19,-28,-0.008840864,-0.018830525,-0.027504912
985,2015,경기,여주시,4167000000,초등학교,2015-04-01,전체,884,967,NA,NA,NA,-83,NA,NA,-0.085832472
986,2015,경기,여주시,4167000000,초등학교,2015-04-01,여자,409,459,NA,NA,NA,-50,NA,NA,-0.108932462
987,2015,경기,여주시,4167000000,초등학교,2015-04-01,남자,475,508,NA,NA,NA,-33,NA,NA,-0.06496063
988,2015,경기,양평군,4183000000,초등학교,2015-04-01,전체,816,775,821,46,-5,41,0.059354839,-0.006090134,0.052903226
989,2015,경기,양평군,4183000000,초등학교,2015-04-01,여자,406,381,399,18,7,25,0.047244094,0.01754386,0.065616798
990,2015,경기,양평군,4183000000,초등학교,2015-04-01,남자,410,394,422,28,-12,16,0.07106599,-0.028436019,0.040609137
991,2015,경기,고양시,4128000000,초등학교,2015-04-01,전체,9234,8903,9281,378,-47,331,0.042457599,-0.005064109,0.037178479
992,2015,경기,고양시,4128000000,초등학교,2015-04-01,여자,4519,4423,4598,175,-79,96,0.039565905,-0.017181383,0.021704725
993,2015,경기,고양시,4128000000,초등학교,2015-04-01,남자,4715,4480,4683,203,32,235,0.0453125,0.006833227,0.052455357
994,2015,경기,남양주시,4136000000,초등학교,2015-04-01,전체,7243,7370,7514,144,-271,-127,0.01953867,-0.03606601,-0.017232022
995,2015,경기,남양주시,4136000000,초등학교,2015-04-01,여자,3468,3562,3629,67,-161,-94,0.018809657,-0.044364839,-0.026389669
996,2015,경기,남양주시,4136000000,초등학교,2015-04-01,남자,3775,3808,3885,77,-110,-33,0.020220588,-0.028314028,-0.008665966
997,2015,경기,구리시,4131000000,초등학교,2015-04-01,전체,1607,1798,1738,-60,-131,-191,-0.033370412,-0.075373993,-0.106229143
998,2015,경기,구리시,4131000000,초등학교,2015-04-01,여자,823,887,858,-29,-35,-64,-0.032694476,-0.040792541,-0.072153326
999,2015,경기,구리시,4131000000,초등학교,2015-04-01,남자,784,911,880,-31,-96,-127,-0.03402854,-0.109090909,-0.139407245
1000,2015,경기,의정부시,4115000000,초등학교,2015-04-01,전체,3574,3914,3895,-19,-321,-340,-0.004854369,-0.08241335,-0.086867655
1001,2015,경기,의정부시,4115000000,초등학교,2015-04-01,여자,1718,1949,1931,-18,-213,-231,-0.009235505,-0.110305541,-0.118522319
1002,2015,경기,의정부시,4115000000,초등학교,2015-04-01,남자,1856,1965,1964,-1,-108,-109,-0.000508906,-0.054989817,-0.055470738
1003,2015,경기,파주시,4148000000,초등학교,2015-04-01,전체,4757,4774,4758,-16,-1,-17,-0.003351487,-0.000210172,-0.003560955
1004,2015,경기,파주시,4148000000,초등학교,2015-04-01,여자,2301,2279,2288,9,13,22,0.0039491,0.005681818,0.009653357
1005,2015,경기,파주시,4148000000,초등학교,2015-04-01,남자,2456,2495,2470,-25,-14,-39,-0.01002004,-0.005668016,-0.015631263
1006,2015,경기,동두천시,4125000000,초등학교,2015-04-01,전체,866,927,901,-26,-35,-61,-0.028047465,-0.038845727,-0.065803668
1007,2015,경기,동두천시,4125000000,초등학교,2015-04-01,여자,452,494,487,-7,-35,-42,-0.01417004,-0.071868583,-0.085020243
1008,2015,경기,동두천시,4125000000,초등학교,2015-04-01,남자,414,433,414,-19,0,-19,-0.043879908,0,-0.043879908
1009,2015,경기,양주시,4163000000,초등학교,2015-04-01,전체,2212,2266,2218,-48,-6,-54,-0.021182701,-0.00270514,-0.023830538
1010,2015,경기,양주시,4163000000,초등학교,2015-04-01,여자,1101,1123,1103,-20,-2,-22,-0.017809439,-0.001813237,-0.019590383
1011,2015,경기,양주시,4163000000,초등학교,2015-04-01,남자,1111,1143,1115,-28,-4,-32,-0.024496938,-0.003587444,-0.0279965
1012,2015,경기,포천시,4165000000,초등학교,2015-04-01,전체,1240,1181,1183,2,57,59,0.00169348,0.048182587,0.049957663
1013,2015,경기,포천시,4165000000,초등학교,2015-04-01,여자,587,585,589,4,-2,2,0.006837607,-0.003395586,0.003418803
1014,2015,경기,포천시,4165000000,초등학교,2015-04-01,남자,653,596,594,-2,59,57,-0.003355705,0.099326599,0.095637584
1015,2015,경기,가평군,4182000000,초등학교,2015-04-01,전체,438,435,437,2,1,3,0.004597701,0.00228833,0.006896552
1016,2015,경기,가평군,4182000000,초등학교,2015-04-01,여자,214,206,209,3,5,8,0.014563107,0.023923445,0.038834951
1017,2015,경기,가평군,4182000000,초등학교,2015-04-01,남자,224,229,228,-1,-4,-5,-0.004366812,-0.01754386,-0.021834061
1018,2015,경기,연천군,4180000000,초등학교,2015-04-01,전체,300,317,309,-8,-9,-17,-0.025236593,-0.029126214,-0.05362776
1019,2015,경기,연천군,4180000000,초등학교,2015-04-01,여자,143,152,147,-5,-4,-9,-0.032894737,-0.027210884,-0.059210526
1020,2015,경기,연천군,4180000000,초등학교,2015-04-01,남자,157,165,162,-3,-5,-8,-0.018181818,-0.030864198,-0.048484848
1021,2015,강원,춘천시,4211000000,초등학교,2015-04-01,전체,2436,2382,2384,2,52,54,0.000839631,0.021812081,0.022670025
1022,2015,강원,춘천시,4211000000,초등학교,2015-04-01,여자,1159,1115,1125,10,34,44,0.00896861,0.030222222,0.039461883
1023,2015,강원,춘천시,4211000000,초등학교,2015-04-01,남자,1277,1267,1259,-8,18,10,-0.006314128,0.014297061,0.00789266
1024,2015,강원,원주시,4213000000,초등학교,2015-04-01,전체,3085,3039,3083,44,2,46,0.014478447,0.000648719,0.015136558
1025,2015,강원,원주시,4213000000,초등학교,2015-04-01,여자,1516,1433,1456,23,60,83,0.016050244,0.041208791,0.057920447
1026,2015,강원,원주시,4213000000,초등학교,2015-04-01,남자,1569,1606,1627,21,-58,-37,0.013075965,-0.035648433,-0.023038605
1027,2015,강원,강릉시,4215000000,초등학교,2015-04-01,전체,1627,1629,1641,12,-14,-2,0.007366483,-0.008531383,-0.001227747
1028,2015,강원,강릉시,4215000000,초등학교,2015-04-01,여자,777,801,810,9,-33,-24,0.011235955,-0.040740741,-0.029962547
1029,2015,강원,강릉시,4215000000,초등학교,2015-04-01,남자,850,828,831,3,19,22,0.003623188,0.022864019,0.026570048
1030,2015,강원,동해시,4217000000,초등학교,2015-04-01,전체,836,815,816,1,20,21,0.001226994,0.024509804,0.025766871
1031,2015,강원,동해시,4217000000,초등학교,2015-04-01,여자,384,378,381,3,3,6,0.007936508,0.007874016,0.015873016
1032,2015,강원,동해시,4217000000,초등학교,2015-04-01,남자,452,437,435,-2,17,15,-0.004576659,0.03908046,0.034324943
1033,2015,강원,태백시,4219000000,초등학교,2015-04-01,전체,399,425,410,-15,-11,-26,-0.035294118,-0.026829268,-0.061176471
1034,2015,강원,태백시,4219000000,초등학교,2015-04-01,여자,195,212,208,-4,-13,-17,-0.018867925,-0.0625,-0.080188679
1035,2015,강원,태백시,4219000000,초등학교,2015-04-01,남자,204,213,202,-11,2,-9,-0.051643192,0.00990099,-0.042253521
1036,2015,강원,속초시,4221000000,초등학교,2015-04-01,전체,644,632,642,10,2,12,0.015822785,0.003115265,0.018987342
1037,2015,강원,속초시,4221000000,초등학교,2015-04-01,여자,332,328,328,0,4,4,0,0.012195122,0.012195122
1038,2015,강원,속초시,4221000000,초등학교,2015-04-01,남자,312,304,314,10,-2,8,0.032894737,-0.006369427,0.026315789
1039,2015,강원,삼척시,4223000000,초등학교,2015-04-01,전체,447,471,484,13,-37,-24,0.027600849,-0.076446281,-0.050955414
1040,2015,강원,삼척시,4223000000,초등학교,2015-04-01,여자,231,234,238,4,-7,-3,0.017094017,-0.029411765,-0.012820513
1041,2015,강원,삼척시,4223000000,초등학교,2015-04-01,남자,216,237,246,9,-30,-21,0.037974684,-0.12195122,-0.088607595
1042,2015,강원,홍천군,4272000000,초등학교,2015-04-01,전체,494,507,512,5,-18,-13,0.009861933,-0.03515625,-0.025641026
1043,2015,강원,홍천군,4272000000,초등학교,2015-04-01,여자,253,248,250,2,3,5,0.008064516,0.012,0.02016129
1044,2015,강원,홍천군,4272000000,초등학교,2015-04-01,남자,241,259,262,3,-21,-18,0.011583012,-0.080152672,-0.069498069
1045,2015,강원,횡성군,4273000000,초등학교,2015-04-01,전체,293,298,299,1,-6,-5,0.003355705,-0.02006689,-0.016778523
1046,2015,강원,횡성군,4273000000,초등학교,2015-04-01,여자,137,142,142,0,-5,-5,0,-0.035211268,-0.035211268
1047,2015,강원,횡성군,4273000000,초등학교,2015-04-01,남자,156,156,157,1,-1,0,0.006410256,-0.006369427,0
1048,2015,강원,영월군,4275000000,초등학교,2015-04-01,전체,232,233,229,-4,3,-1,-0.017167382,0.013100437,-0.004291845
1049,2015,강원,영월군,4275000000,초등학교,2015-04-01,여자,112,118,106,-12,6,-6,-0.101694915,0.056603774,-0.050847458
1050,2015,강원,영월군,4275000000,초등학교,2015-04-01,남자,120,115,123,8,-3,5,0.069565217,-0.024390244,0.043478261
1051,2015,강원,평창군,4276000000,초등학교,2015-04-01,전체,312,319,320,1,-8,-7,0.003134796,-0.025,-0.021943574
1052,2015,강원,평창군,4276000000,초등학교,2015-04-01,여자,156,160,157,-3,-1,-4,-0.01875,-0.006369427,-0.025
1053,2015,강원,평창군,4276000000,초등학교,2015-04-01,남자,156,159,163,4,-7,-3,0.025157233,-0.042944785,-0.018867925
1054,2015,강원,정선군,4277000000,초등학교,2015-04-01,전체,238,270,267,-3,-29,-32,-0.011111111,-0.108614232,-0.118518519
1055,2015,강원,정선군,4277000000,초등학교,2015-04-01,여자,124,138,131,-7,-7,-14,-0.050724638,-0.053435115,-0.101449275
1056,2015,강원,정선군,4277000000,초등학교,2015-04-01,남자,114,132,136,4,-22,-18,0.03030303,-0.161764706,-0.136363636
1057,2015,강원,철원군,4278000000,초등학교,2015-04-01,전체,418,455,437,-18,-19,-37,-0.03956044,-0.043478261,-0.081318681
1058,2015,강원,철원군,4278000000,초등학교,2015-04-01,여자,197,229,220,-9,-23,-32,-0.03930131,-0.104545455,-0.139737991
1059,2015,강원,철원군,4278000000,초등학교,2015-04-01,남자,221,226,217,-9,4,-5,-0.039823009,0.01843318,-0.022123894
1060,2015,강원,화천군,4279000000,초등학교,2015-04-01,전체,191,240,224,-16,-33,-49,-0.066666667,-0.147321429,-0.204166667
1061,2015,강원,화천군,4279000000,초등학교,2015-04-01,여자,92,106,101,-5,-9,-14,-0.047169811,-0.089108911,-0.132075472
1062,2015,강원,화천군,4279000000,초등학교,2015-04-01,남자,99,134,123,-11,-24,-35,-0.082089552,-0.195121951,-0.26119403
1063,2015,강원,양구군,4280000000,초등학교,2015-04-01,전체,197,198,195,-3,2,-1,-0.015151515,0.01025641,-0.005050505
1064,2015,강원,양구군,4280000000,초등학교,2015-04-01,여자,91,100,97,-3,-6,-9,-0.03,-0.06185567,-0.09
1065,2015,강원,양구군,4280000000,초등학교,2015-04-01,남자,106,98,98,0,8,8,0,0.081632653,0.081632653
1066,2015,강원,인제군,4281000000,초등학교,2015-04-01,전체,282,312,306,-6,-24,-30,-0.019230769,-0.078431373,-0.096153846
1067,2015,강원,인제군,4281000000,초등학교,2015-04-01,여자,144,155,157,2,-13,-11,0.012903226,-0.082802548,-0.070967742
1068,2015,강원,인제군,4281000000,초등학교,2015-04-01,남자,138,157,149,-8,-11,-19,-0.050955414,-0.073825503,-0.121019108
1069,2015,강원,고성군,4282000000,초등학교,2015-04-01,전체,160,144,148,4,12,16,0.027777778,0.081081081,0.111111111
1070,2015,강원,고성군,4282000000,초등학교,2015-04-01,여자,66,69,74,5,-8,-3,0.072463768,-0.108108108,-0.043478261
1071,2015,강원,고성군,4282000000,초등학교,2015-04-01,남자,94,75,74,-1,20,19,-0.013333333,0.27027027,0.253333333
1072,2015,강원,양양군,4283000000,초등학교,2015-04-01,전체,150,170,165,-5,-15,-20,-0.029411765,-0.090909091,-0.117647059
1073,2015,강원,양양군,4283000000,초등학교,2015-04-01,여자,63,79,79,0,-16,-16,0,-0.202531646,-0.202531646
1074,2015,강원,양양군,4283000000,초등학교,2015-04-01,남자,87,91,86,-5,1,-4,-0.054945055,0.011627907,-0.043956044
1075,2015,충북,청주시,4311000000,초등학교,2015-04-01,전체,8391,6833,6851,18,1540,1558,0.002634275,0.224784703,0.228011122
1076,2015,충북,청주시,4311000000,초등학교,2015-04-01,여자,4088,3325,3346,21,742,763,0.006315789,0.221757322,0.229473684
1077,2015,충북,청주시,4311000000,초등학교,2015-04-01,남자,4303,3508,3505,-3,798,795,-0.000855188,0.22767475,0.226624857
1078,2015,충북,충주시,4313000000,초등학교,2015-04-01,전체,1701,1616,1616,0,85,85,0,0.05259901,0.05259901
1079,2015,충북,충주시,4313000000,초등학교,2015-04-01,여자,799,739,742,3,57,60,0.00405954,0.076819407,0.081190798
1080,2015,충북,충주시,4313000000,초등학교,2015-04-01,남자,902,877,874,-3,28,25,-0.003420753,0.032036613,0.028506271
1081,2015,충북,제천시,4315000000,초등학교,2015-04-01,전체,1079,1076,1079,3,0,3,0.002788104,0,0.002788104
1082,2015,충북,제천시,4315000000,초등학교,2015-04-01,여자,507,508,514,6,-7,-1,0.011811024,-0.013618677,-0.001968504
1083,2015,충북,제천시,4315000000,초등학교,2015-04-01,남자,572,568,565,-3,7,4,-0.00528169,0.012389381,0.007042254
1084,2015,충북,보은군,4372000000,초등학교,2015-04-01,전체,180,177,177,0,3,3,0,0.016949153,0.016949153
1085,2015,충북,보은군,4372000000,초등학교,2015-04-01,여자,80,74,76,2,4,6,0.027027027,0.052631579,0.081081081
1086,2015,충북,보은군,4372000000,초등학교,2015-04-01,남자,100,103,101,-2,-1,-3,-0.019417476,-0.00990099,-0.029126214
1087,2015,충북,옥천군,4373000000,초등학교,2015-04-01,전체,357,350,353,3,4,7,0.008571429,0.011331445,0.02
1088,2015,충북,옥천군,4373000000,초등학교,2015-04-01,여자,174,178,178,0,-4,-4,0,-0.02247191,-0.02247191
1089,2015,충북,옥천군,4373000000,초등학교,2015-04-01,남자,183,172,175,3,8,11,0.01744186,0.045714286,0.063953488
1090,2015,충북,영동군,4374000000,초등학교,2015-04-01,전체,294,311,316,5,-22,-17,0.01607717,-0.069620253,-0.054662379
1091,2015,충북,영동군,4374000000,초등학교,2015-04-01,여자,135,146,150,4,-15,-11,0.02739726,-0.1,-0.075342466
1092,2015,충북,영동군,4374000000,초등학교,2015-04-01,남자,159,165,166,1,-7,-6,0.006060606,-0.042168675,-0.036363636
1093,2015,충북,진천군,4375000000,초등학교,2015-04-01,전체,670,595,611,16,59,75,0.026890756,0.096563011,0.12605042
1094,2015,충북,진천군,4375000000,초등학교,2015-04-01,여자,301,263,266,3,35,38,0.011406844,0.131578947,0.144486692
1095,2015,충북,진천군,4375000000,초등학교,2015-04-01,남자,369,332,345,13,24,37,0.039156627,0.069565217,0.111445783
1096,2015,충북,괴산군,4376000000,초등학교,2015-04-01,전체,189,208,218,10,-29,-19,0.048076923,-0.133027523,-0.091346154
1097,2015,충북,괴산군,4376000000,초등학교,2015-04-01,여자,110,110,112,2,-2,0,0.018181818,-0.017857143,0
1098,2015,충북,괴산군,4376000000,초등학교,2015-04-01,남자,79,98,106,8,-27,-19,0.081632653,-0.254716981,-0.193877551
1099,2015,충북,음성군,4377000000,초등학교,2015-04-01,전체,797,826,810,-16,-13,-29,-0.01937046,-0.016049383,-0.035108959
1100,2015,충북,음성군,4377000000,초등학교,2015-04-01,여자,384,381,369,-12,15,3,-0.031496063,0.040650407,0.007874016
1101,2015,충북,음성군,4377000000,초등학교,2015-04-01,남자,413,445,441,-4,-28,-32,-0.008988764,-0.063492063,-0.071910112
1102,2015,충북,단양군,4380000000,초등학교,2015-04-01,전체,182,183,186,3,-4,-1,0.016393443,-0.021505376,-0.005464481
1103,2015,충북,단양군,4380000000,초등학교,2015-04-01,여자,96,87,87,0,9,9,0,0.103448276,0.103448276
1104,2015,충북,단양군,4380000000,초등학교,2015-04-01,남자,86,96,99,3,-13,-10,0.03125,-0.131313131,-0.104166667
1105,2015,충북,증평군,4374500000,초등학교,2015-04-01,전체,352,409,403,-6,-51,-57,-0.014669927,-0.126550868,-0.139364303
1106,2015,충북,증평군,4374500000,초등학교,2015-04-01,여자,169,186,186,0,-17,-17,0,-0.091397849,-0.091397849
1107,2015,충북,증평군,4374500000,초등학교,2015-04-01,남자,183,223,217,-6,-34,-40,-0.02690583,-0.156682028,-0.179372197
1108,2015,충남,천안시,4413000000,초등학교,2015-04-01,전체,6599,6523,6503,-20,96,76,-0.003066074,0.014762417,0.011651081
1109,2015,충남,천안시,4413000000,초등학교,2015-04-01,여자,3174,3115,3102,-13,72,59,-0.004173355,0.023210832,0.01894061
1110,2015,충남,천안시,4413000000,초등학교,2015-04-01,남자,3425,3408,3401,-7,24,17,-0.002053991,0.007056748,0.004988263
1111,2015,충남,공주시,4415000000,초등학교,2015-04-01,전체,797,834,836,2,-39,-37,0.002398082,-0.046650718,-0.044364508
1112,2015,충남,공주시,4415000000,초등학교,2015-04-01,여자,402,418,416,-2,-14,-16,-0.004784689,-0.033653846,-0.038277512
1113,2015,충남,공주시,4415000000,초등학교,2015-04-01,남자,395,416,420,4,-25,-21,0.009615385,-0.05952381,-0.050480769
1114,2015,충남,보령시,4418000000,초등학교,2015-04-01,전체,836,799,816,17,20,37,0.021276596,0.024509804,0.046307885
1115,2015,충남,보령시,4418000000,초등학교,2015-04-01,여자,412,399,395,-4,17,13,-0.010025063,0.043037975,0.032581454
1116,2015,충남,보령시,4418000000,초등학교,2015-04-01,남자,424,400,421,21,3,24,0.0525,0.007125891,0.06
1117,2015,충남,아산시,4420000000,초등학교,2015-04-01,전체,3494,3728,3734,6,-240,-234,0.001609442,-0.064274237,-0.06276824
1118,2015,충남,아산시,4420000000,초등학교,2015-04-01,여자,1712,1829,1817,-12,-105,-117,-0.006560962,-0.057787562,-0.063969382
1119,2015,충남,아산시,4420000000,초등학교,2015-04-01,남자,1782,1899,1917,18,-135,-117,0.009478673,-0.070422535,-0.061611374
1120,2015,충남,서산시,4421000000,초등학교,2015-04-01,전체,1724,1703,1726,23,-2,21,0.013505578,-0.001158749,0.01233118
1121,2015,충남,서산시,4421000000,초등학교,2015-04-01,여자,823,793,814,21,9,30,0.026481715,0.011056511,0.037831021
1122,2015,충남,서산시,4421000000,초등학교,2015-04-01,남자,901,910,912,2,-11,-9,0.002197802,-0.012061404,-0.00989011
1123,2015,충남,논산시,4423000000,초등학교,2015-04-01,전체,1009,955,951,-4,58,54,-0.004188482,0.060988433,0.056544503
1124,2015,충남,논산시,4423000000,초등학교,2015-04-01,여자,497,487,478,-9,19,10,-0.018480493,0.039748954,0.020533881
1125,2015,충남,논산시,4423000000,초등학교,2015-04-01,남자,512,468,473,5,39,44,0.010683761,0.082452431,0.094017094
1126,2015,충남,계룡시,4425000000,초등학교,2015-04-01,전체,441,468,472,4,-31,-27,0.008547009,-0.065677966,-0.057692308
1127,2015,충남,계룡시,4425000000,초등학교,2015-04-01,여자,212,220,207,-13,5,-8,-0.059090909,0.024154589,-0.036363636
1128,2015,충남,계룡시,4425000000,초등학교,2015-04-01,남자,229,248,265,17,-36,-19,0.068548387,-0.135849057,-0.076612903
1129,2015,충남,금산군,4471000000,초등학교,2015-04-01,전체,378,385,385,0,-7,-7,0,-0.018181818,-0.018181818
1130,2015,충남,금산군,4471000000,초등학교,2015-04-01,여자,178,191,191,0,-13,-13,0,-0.068062827,-0.068062827
1131,2015,충남,금산군,4471000000,초등학교,2015-04-01,남자,200,194,194,0,6,6,0,0.030927835,0.030927835
1132,2015,충남,부여군,4476000000,초등학교,2015-04-01,전체,408,422,421,-1,-13,-14,-0.002369668,-0.03087886,-0.033175355
1133,2015,충남,부여군,4476000000,초등학교,2015-04-01,여자,198,199,200,1,-2,-1,0.005025126,-0.01,-0.005025126
1134,2015,충남,부여군,4476000000,초등학교,2015-04-01,남자,210,223,221,-2,-11,-13,-0.00896861,-0.049773756,-0.058295964
1135,2015,충남,서천군,4477000000,초등학교,2015-04-01,전체,315,324,324,0,-9,-9,0,-0.027777778,-0.027777778
1136,2015,충남,서천군,4477000000,초등학교,2015-04-01,여자,161,163,156,-7,5,-2,-0.042944785,0.032051282,-0.012269939
1137,2015,충남,서천군,4477000000,초등학교,2015-04-01,남자,154,161,168,7,-14,-7,0.043478261,-0.083333333,-0.043478261
1138,2015,충남,청양군,4479000000,초등학교,2015-04-01,전체,171,171,171,0,0,0,0,0,0
1139,2015,충남,청양군,4479000000,초등학교,2015-04-01,여자,72,79,78,-1,-6,-7,-0.012658228,-0.076923077,-0.088607595
1140,2015,충남,청양군,4479000000,초등학교,2015-04-01,남자,99,92,93,1,6,7,0.010869565,0.064516129,0.076086957
1141,2015,충남,홍성군,4480000000,초등학교,2015-04-01,전체,827,757,773,16,54,70,0.021136063,0.069857697,0.092470277
1142,2015,충남,홍성군,4480000000,초등학교,2015-04-01,여자,415,372,383,11,32,43,0.029569892,0.083550914,0.115591398
1143,2015,충남,홍성군,4480000000,초등학교,2015-04-01,남자,412,385,390,5,22,27,0.012987013,0.056410256,0.07012987
1144,2015,충남,예산군,4481000000,초등학교,2015-04-01,전체,512,537,531,-6,-19,-25,-0.011173184,-0.035781544,-0.046554935
1145,2015,충남,예산군,4481000000,초등학교,2015-04-01,여자,256,255,251,-4,5,1,-0.015686275,0.019920319,0.003921569
1146,2015,충남,예산군,4481000000,초등학교,2015-04-01,남자,256,282,280,-2,-24,-26,-0.007092199,-0.085714286,-0.092198582
1147,2015,충남,태안군,4482500000,초등학교,2015-04-01,전체,429,431,434,3,-5,-2,0.006960557,-0.011520737,-0.004640371
1148,2015,충남,태안군,4482500000,초등학교,2015-04-01,여자,212,204,207,3,5,8,0.014705882,0.024154589,0.039215686
1149,2015,충남,태안군,4482500000,초등학교,2015-04-01,남자,217,227,227,0,-10,-10,0,-0.044052863,-0.044052863
1150,2015,충남,당진시,4427000000,초등학교,2015-04-01,전체,1734,1702,1745,43,-11,32,0.025264395,-0.006303725,0.01880141
1151,2015,충남,당진시,4427000000,초등학교,2015-04-01,여자,809,812,834,22,-25,-3,0.027093596,-0.029976019,-0.003694581
1152,2015,충남,당진시,4427000000,초등학교,2015-04-01,남자,925,890,911,21,14,35,0.023595506,0.015367728,0.039325843
1153,2015,전북,전주시,4511000000,초등학교,2015-04-01,전체,6339,6078,6224,146,115,261,0.02402106,0.018476864,0.042941757
1154,2015,전북,전주시,4511000000,초등학교,2015-04-01,여자,3098,2975,3033,58,65,123,0.019495798,0.021430926,0.041344538
1155,2015,전북,전주시,4511000000,초등학교,2015-04-01,남자,3241,3103,3191,88,50,138,0.028359652,0.015669069,0.044473091
1156,2015,전북,군산시,4513000000,초등학교,2015-04-01,전체,2618,2651,2640,-11,-22,-33,-0.004149378,-0.008333333,-0.012448133
1157,2015,전북,군산시,4513000000,초등학교,2015-04-01,여자,1239,1282,1271,-11,-32,-43,-0.008580343,-0.025177026,-0.033541342
1158,2015,전북,군산시,4513000000,초등학교,2015-04-01,남자,1379,1369,1369,0,10,10,0,0.007304602,0.007304602
1159,2015,전북,익산시,4514000000,초등학교,2015-04-01,전체,2674,2619,2626,7,48,55,0.002672776,0.018278751,0.021000382
1160,2015,전북,익산시,4514000000,초등학교,2015-04-01,여자,1281,1254,1247,-7,34,27,-0.005582137,0.027265437,0.0215311
1161,2015,전북,익산시,4514000000,초등학교,2015-04-01,남자,1393,1365,1379,14,14,28,0.01025641,0.010152284,0.020512821
1162,2015,전북,정읍시,4518000000,초등학교,2015-04-01,전체,866,867,870,3,-4,-1,0.003460208,-0.004597701,-0.001153403
1163,2015,전북,정읍시,4518000000,초등학교,2015-04-01,여자,413,411,412,1,1,2,0.00243309,0.002427184,0.00486618
1164,2015,전북,정읍시,4518000000,초등학교,2015-04-01,남자,453,456,458,2,-5,-3,0.004385965,-0.010917031,-0.006578947
1165,2015,전북,남원시,4519000000,초등학교,2015-04-01,전체,729,722,732,10,-3,7,0.013850416,-0.004098361,0.009695291
1166,2015,전북,남원시,4519000000,초등학교,2015-04-01,여자,347,321,331,10,16,26,0.031152648,0.048338369,0.080996885
1167,2015,전북,남원시,4519000000,초등학교,2015-04-01,남자,382,401,401,0,-19,-19,0,-0.047381546,-0.047381546
1168,2015,전북,김제시,4521000000,초등학교,2015-04-01,전체,606,607,602,-5,4,-1,-0.008237232,0.006644518,-0.001647446
1169,2015,전북,김제시,4521000000,초등학교,2015-04-01,여자,290,271,268,-3,22,19,-0.011070111,0.082089552,0.070110701
1170,2015,전북,김제시,4521000000,초등학교,2015-04-01,남자,316,336,334,-2,-18,-20,-0.005952381,-0.053892216,-0.05952381
1171,2015,전북,완주군,4571000000,초등학교,2015-04-01,전체,904,913,925,12,-21,-9,0.013143483,-0.022702703,-0.009857612
1172,2015,전북,완주군,4571000000,초등학교,2015-04-01,여자,427,429,432,3,-5,-2,0.006993007,-0.011574074,-0.004662005
1173,2015,전북,완주군,4571000000,초등학교,2015-04-01,남자,477,484,493,9,-16,-7,0.018595041,-0.032454361,-0.01446281
1174,2015,전북,진안군,4572000000,초등학교,2015-04-01,전체,135,184,171,-13,-36,-49,-0.070652174,-0.210526316,-0.266304348
1175,2015,전북,진안군,4572000000,초등학교,2015-04-01,여자,67,87,85,-2,-18,-20,-0.022988506,-0.211764706,-0.229885057
1176,2015,전북,진안군,4572000000,초등학교,2015-04-01,남자,68,97,86,-11,-18,-29,-0.113402062,-0.209302326,-0.298969072
1177,2015,전북,무주군,4573000000,초등학교,2015-04-01,전체,167,199,194,-5,-27,-32,-0.025125628,-0.139175258,-0.16080402
1178,2015,전북,무주군,4573000000,초등학교,2015-04-01,여자,84,109,107,-2,-23,-25,-0.018348624,-0.214953271,-0.229357798
1179,2015,전북,무주군,4573000000,초등학교,2015-04-01,남자,83,90,87,-3,-4,-7,-0.033333333,-0.045977011,-0.077777778
1180,2015,전북,장수군,4574000000,초등학교,2015-04-01,전체,187,164,166,2,21,23,0.012195122,0.126506024,0.140243902
1181,2015,전북,장수군,4574000000,초등학교,2015-04-01,여자,95,78,80,2,15,17,0.025641026,0.1875,0.217948718
1182,2015,전북,장수군,4574000000,초등학교,2015-04-01,남자,92,86,86,0,6,6,0,0.069767442,0.069767442
1183,2015,전북,임실군,4575000000,초등학교,2015-04-01,전체,203,212,216,4,-13,-9,0.018867925,-0.060185185,-0.04245283
1184,2015,전북,임실군,4575000000,초등학교,2015-04-01,여자,100,99,104,5,-4,1,0.050505051,-0.038461538,0.01010101
1185,2015,전북,임실군,4575000000,초등학교,2015-04-01,남자,103,113,112,-1,-9,-10,-0.008849558,-0.080357143,-0.088495575
1186,2015,전북,순창군,4577000000,초등학교,2015-04-01,전체,187,199,206,7,-19,-12,0.035175879,-0.09223301,-0.060301508
1187,2015,전북,순창군,4577000000,초등학교,2015-04-01,여자,102,110,109,-1,-7,-8,-0.009090909,-0.064220183,-0.072727273
1188,2015,전북,순창군,4577000000,초등학교,2015-04-01,남자,85,89,97,8,-12,-4,0.08988764,-0.12371134,-0.04494382
1189,2015,전북,고창군,4579000000,초등학교,2015-04-01,전체,351,380,388,8,-37,-29,0.021052632,-0.095360825,-0.076315789
1190,2015,전북,고창군,4579000000,초등학교,2015-04-01,여자,174,190,190,0,-16,-16,0,-0.084210526,-0.084210526
1191,2015,전북,고창군,4579000000,초등학교,2015-04-01,남자,177,190,198,8,-21,-13,0.042105263,-0.106060606,-0.068421053
1192,2015,전북,부안군,4580000000,초등학교,2015-04-01,전체,335,316,324,8,11,19,0.025316456,0.033950617,0.060126582
1193,2015,전북,부안군,4580000000,초등학교,2015-04-01,여자,162,161,162,1,0,1,0.00621118,0,0.00621118
1194,2015,전북,부안군,4580000000,초등학교,2015-04-01,남자,173,155,162,7,11,18,0.04516129,0.067901235,0.116129032
1195,2015,전남,목포시,4611000000,초등학교,2015-04-01,전체,2631,2519,2436,-83,195,112,-0.032949583,0.080049261,0.044462088
1196,2015,전남,목포시,4611000000,초등학교,2015-04-01,여자,1273,1192,1164,-28,109,81,-0.023489933,0.093642612,0.06795302
1197,2015,전남,목포시,4611000000,초등학교,2015-04-01,남자,1358,1327,1272,-55,86,31,-0.041446873,0.067610063,0.023360965
1198,2015,전남,여수시,4613000000,초등학교,2015-04-01,전체,2485,2514,2500,-14,-15,-29,-0.005568815,-0.006,-0.011535402
1199,2015,전남,여수시,4613000000,초등학교,2015-04-01,여자,1193,1248,1227,-21,-34,-55,-0.016826923,-0.027709861,-0.044070513
1200,2015,전남,여수시,4613000000,초등학교,2015-04-01,남자,1292,1266,1273,7,19,26,0.005529226,0.014925373,0.020537125
1201,2015,전남,순천시,4615000000,초등학교,2015-04-01,전체,2710,2537,2647,110,63,173,0.043358297,0.023800529,0.068190777
1202,2015,전남,순천시,4615000000,초등학교,2015-04-01,여자,1310,1214,1268,54,42,96,0.044481054,0.033123028,0.07907743
1203,2015,전남,순천시,4615000000,초등학교,2015-04-01,남자,1400,1323,1379,56,21,77,0.042328042,0.015228426,0.058201058
1204,2015,전남,나주시,4617000000,초등학교,2015-04-01,전체,630,557,562,5,68,73,0.008976661,0.120996441,0.131059246
1205,2015,전남,나주시,4617000000,초등학교,2015-04-01,여자,297,277,275,-2,22,20,-0.007220217,0.08,0.072202166
1206,2015,전남,나주시,4617000000,초등학교,2015-04-01,남자,333,280,287,7,46,53,0.025,0.160278746,0.189285714
1207,2015,전남,광양시,4623000000,초등학교,2015-04-01,전체,1533,1598,1583,-15,-50,-65,-0.009386733,-0.031585597,-0.040675845
1208,2015,전남,광양시,4623000000,초등학교,2015-04-01,여자,748,790,779,-11,-31,-42,-0.013924051,-0.039794608,-0.053164557
1209,2015,전남,광양시,4623000000,초등학교,2015-04-01,남자,785,808,804,-4,-19,-23,-0.004950495,-0.023631841,-0.028465347
1210,2015,전남,담양군,4671000000,초등학교,2015-04-01,전체,241,271,264,-7,-23,-30,-0.025830258,-0.087121212,-0.110701107
1211,2015,전남,담양군,4671000000,초등학교,2015-04-01,여자,105,110,113,3,-8,-5,0.027272727,-0.07079646,-0.045454545
1212,2015,전남,담양군,4671000000,초등학교,2015-04-01,남자,136,161,151,-10,-15,-25,-0.062111801,-0.099337748,-0.155279503
1213,2015,전남,곡성군,4672000000,초등학교,2015-04-01,전체,177,194,193,-1,-16,-17,-0.005154639,-0.082901554,-0.087628866
1214,2015,전남,곡성군,4672000000,초등학교,2015-04-01,여자,72,80,79,-1,-7,-8,-0.0125,-0.088607595,-0.1
1215,2015,전남,곡성군,4672000000,초등학교,2015-04-01,남자,105,114,114,0,-9,-9,0,-0.078947368,-0.078947368
1216,2015,전남,구례군,4673000000,초등학교,2015-04-01,전체,170,172,167,-5,3,-2,-0.029069767,0.017964072,-0.011627907
1217,2015,전남,구례군,4673000000,초등학교,2015-04-01,여자,73,83,78,-5,-5,-10,-0.060240964,-0.064102564,-0.120481928
1218,2015,전남,구례군,4673000000,초등학교,2015-04-01,남자,97,89,89,0,8,8,0,0.08988764,0.08988764
1219,2015,전남,고흥군,4677000000,초등학교,2015-04-01,전체,312,326,318,-8,-6,-14,-0.024539877,-0.018867925,-0.042944785
1220,2015,전남,고흥군,4677000000,초등학교,2015-04-01,여자,155,173,171,-2,-16,-18,-0.011560694,-0.093567251,-0.104046243
1221,2015,전남,고흥군,4677000000,초등학교,2015-04-01,남자,157,153,147,-6,10,4,-0.039215686,0.068027211,0.026143791
1222,2015,전남,보성군,4678000000,초등학교,2015-04-01,전체,222,290,258,-32,-36,-68,-0.110344828,-0.139534884,-0.234482759
1223,2015,전남,보성군,4678000000,초등학교,2015-04-01,여자,117,158,138,-20,-21,-41,-0.126582278,-0.152173913,-0.259493671
1224,2015,전남,보성군,4678000000,초등학교,2015-04-01,남자,105,132,120,-12,-15,-27,-0.090909091,-0.125,-0.204545455
1225,2015,전남,화순군,4679000000,초등학교,2015-04-01,전체,484,515,493,-22,-9,-31,-0.042718447,-0.018255578,-0.060194175
1226,2015,전남,화순군,4679000000,초등학교,2015-04-01,여자,242,251,239,-12,3,-9,-0.047808765,0.012552301,-0.035856574
1227,2015,전남,화순군,4679000000,초등학교,2015-04-01,남자,242,264,254,-10,-12,-22,-0.037878788,-0.047244094,-0.083333333
1228,2015,전남,장흥군,4680000000,초등학교,2015-04-01,전체,240,265,269,4,-29,-25,0.01509434,-0.107806691,-0.094339623
1229,2015,전남,장흥군,4680000000,초등학교,2015-04-01,여자,124,137,135,-2,-11,-13,-0.01459854,-0.081481481,-0.094890511
1230,2015,전남,장흥군,4680000000,초등학교,2015-04-01,남자,116,128,134,6,-18,-12,0.046875,-0.134328358,-0.09375
1231,2015,전남,강진군,4681000000,초등학교,2015-04-01,전체,239,297,280,-17,-41,-58,-0.057239057,-0.146428571,-0.195286195
1232,2015,전남,강진군,4681000000,초등학교,2015-04-01,여자,111,141,129,-12,-18,-30,-0.085106383,-0.139534884,-0.212765957
1233,2015,전남,강진군,4681000000,초등학교,2015-04-01,남자,128,156,151,-5,-23,-28,-0.032051282,-0.152317881,-0.179487179
1234,2015,전남,해남군,4682000000,초등학교,2015-04-01,전체,517,527,526,-1,-9,-10,-0.001897533,-0.017110266,-0.018975332
1235,2015,전남,해남군,4682000000,초등학교,2015-04-01,여자,243,255,252,-3,-9,-12,-0.011764706,-0.035714286,-0.047058824
1236,2015,전남,해남군,4682000000,초등학교,2015-04-01,남자,274,272,274,2,0,2,0.007352941,0,0.007352941
1237,2015,전남,영암군,4683000000,초등학교,2015-04-01,전체,445,542,493,-49,-48,-97,-0.090405904,-0.097363083,-0.17896679
1238,2015,전남,영암군,4683000000,초등학교,2015-04-01,여자,202,240,224,-16,-22,-38,-0.066666667,-0.098214286,-0.158333333
1239,2015,전남,영암군,4683000000,초등학교,2015-04-01,남자,243,302,269,-33,-26,-59,-0.109271523,-0.096654275,-0.195364238
1240,2015,전남,무안군,4684000000,초등학교,2015-04-01,전체,787,768,870,102,-83,19,0.1328125,-0.095402299,0.024739583
1241,2015,전남,무안군,4684000000,초등학교,2015-04-01,여자,379,373,418,45,-39,6,0.120643432,-0.093301435,0.016085791
1242,2015,전남,무안군,4684000000,초등학교,2015-04-01,남자,408,395,452,57,-44,13,0.144303797,-0.097345133,0.032911392
1243,2015,전남,함평군,4686000000,초등학교,2015-04-01,전체,162,202,198,-4,-36,-40,-0.01980198,-0.181818182,-0.198019802
1244,2015,전남,함평군,4686000000,초등학교,2015-04-01,여자,75,102,100,-2,-25,-27,-0.019607843,-0.25,-0.264705882
1245,2015,전남,함평군,4686000000,초등학교,2015-04-01,남자,87,100,98,-2,-11,-13,-0.02,-0.112244898,-0.13
1246,2015,전남,영광군,4687000000,초등학교,2015-04-01,전체,391,376,385,9,6,15,0.02393617,0.015584416,0.039893617
1247,2015,전남,영광군,4687000000,초등학교,2015-04-01,여자,192,182,191,9,1,10,0.049450549,0.005235602,0.054945055
1248,2015,전남,영광군,4687000000,초등학교,2015-04-01,남자,199,194,194,0,5,5,0,0.025773196,0.025773196
1249,2015,전남,장성군,4688000000,초등학교,2015-04-01,전체,346,349,354,5,-8,-3,0.014326648,-0.02259887,-0.008595989
1250,2015,전남,장성군,4688000000,초등학교,2015-04-01,여자,165,176,181,5,-16,-11,0.028409091,-0.08839779,-0.0625
1251,2015,전남,장성군,4688000000,초등학교,2015-04-01,남자,181,173,173,0,8,8,0,0.046242775,0.046242775
1252,2015,전남,완도군,4689000000,초등학교,2015-04-01,전체,308,314,311,-3,-3,-6,-0.00955414,-0.009646302,-0.01910828
1253,2015,전남,완도군,4689000000,초등학교,2015-04-01,여자,138,137,142,5,-4,1,0.03649635,-0.028169014,0.00729927
1254,2015,전남,완도군,4689000000,초등학교,2015-04-01,남자,170,177,169,-8,1,-7,-0.04519774,0.00591716,-0.039548023
1255,2015,전남,진도군,4690000000,초등학교,2015-04-01,전체,183,230,229,-1,-46,-47,-0.004347826,-0.200873362,-0.204347826
1256,2015,전남,진도군,4690000000,초등학교,2015-04-01,여자,84,109,110,1,-26,-25,0.009174312,-0.236363636,-0.229357798
1257,2015,전남,진도군,4690000000,초등학교,2015-04-01,남자,99,121,119,-2,-20,-22,-0.016528926,-0.168067227,-0.181818182
1258,2015,전남,신안군,4691000000,초등학교,2015-04-01,전체,173,202,213,11,-40,-29,0.054455446,-0.187793427,-0.143564356
1259,2015,전남,신안군,4691000000,초등학교,2015-04-01,여자,86,100,101,1,-15,-14,0.01,-0.148514851,-0.14
1260,2015,전남,신안군,4691000000,초등학교,2015-04-01,남자,87,102,112,10,-25,-15,0.098039216,-0.223214286,-0.147058824
1261,2015,경북,포항시,4711000000,초등학교,2015-04-01,전체,4423,4497,4507,10,-84,-74,0.002223705,-0.018637675,-0.016455415
1262,2015,경북,포항시,4711000000,초등학교,2015-04-01,여자,2161,2215,2211,-4,-50,-54,-0.001805869,-0.022614202,-0.024379233
1263,2015,경북,포항시,4711000000,초등학교,2015-04-01,남자,2262,2282,2296,14,-34,-20,0.006134969,-0.014808362,-0.008764242
1264,2015,경북,경주시,4713000000,초등학교,2015-04-01,전체,1973,2027,2007,-20,-34,-54,-0.009866798,-0.016940708,-0.026640355
1265,2015,경북,경주시,4713000000,초등학교,2015-04-01,여자,966,993,985,-8,-19,-27,-0.008056395,-0.01928934,-0.027190332
1266,2015,경북,경주시,4713000000,초등학교,2015-04-01,남자,1007,1034,1022,-12,-15,-27,-0.011605416,-0.014677104,-0.026112186
1267,2015,경북,김천시,4715000000,초등학교,2015-04-01,전체,1077,1036,1035,-1,42,41,-0.000965251,0.04057971,0.03957529
1268,2015,경북,김천시,4715000000,초등학교,2015-04-01,여자,500,497,504,7,-4,3,0.014084507,-0.007936508,0.006036217
1269,2015,경북,김천시,4715000000,초등학교,2015-04-01,남자,577,539,531,-8,46,38,-0.014842301,0.086629002,0.070500928
1270,2015,경북,안동시,4717000000,초등학교,2015-04-01,전체,1318,1344,1336,-8,-18,-26,-0.005952381,-0.013473054,-0.019345238
1271,2015,경북,안동시,4717000000,초등학교,2015-04-01,여자,644,679,675,-4,-31,-35,-0.005891016,-0.045925926,-0.051546392
1272,2015,경북,안동시,4717000000,초등학교,2015-04-01,남자,674,665,661,-4,13,9,-0.006015038,0.019667171,0.013533835
1273,2015,경북,구미시,4719000000,초등학교,2015-04-01,전체,4723,4715,4652,-63,71,8,-0.013361612,0.015262253,0.001696713
1274,2015,경북,구미시,4719000000,초등학교,2015-04-01,여자,2301,2250,2217,-33,84,51,-0.014666667,0.037889039,0.022666667
1275,2015,경북,구미시,4719000000,초등학교,2015-04-01,남자,2422,2465,2435,-30,-13,-43,-0.012170385,-0.005338809,-0.017444219
1276,2015,경북,영주시,4721000000,초등학교,2015-04-01,전체,816,775,778,3,38,41,0.003870968,0.048843188,0.052903226
1277,2015,경북,영주시,4721000000,초등학교,2015-04-01,여자,414,372,377,5,37,42,0.01344086,0.098143236,0.112903226
1278,2015,경북,영주시,4721000000,초등학교,2015-04-01,남자,402,403,401,-2,1,-1,-0.004962779,0.002493766,-0.00248139
1279,2015,경북,영천시,4723000000,초등학교,2015-04-01,전체,578,595,583,-12,-5,-17,-0.020168067,-0.008576329,-0.028571429
1280,2015,경북,영천시,4723000000,초등학교,2015-04-01,여자,265,272,265,-7,0,-7,-0.025735294,0,-0.025735294
1281,2015,경북,영천시,4723000000,초등학교,2015-04-01,남자,313,323,318,-5,-5,-10,-0.015479876,-0.01572327,-0.030959752
1282,2015,경북,상주시,4725000000,초등학교,2015-04-01,전체,712,656,663,7,49,56,0.010670732,0.073906486,0.085365854
1283,2015,경북,상주시,4725000000,초등학교,2015-04-01,여자,340,339,335,-4,5,1,-0.01179941,0.014925373,0.002949853
1284,2015,경북,상주시,4725000000,초등학교,2015-04-01,남자,372,317,328,11,44,55,0.034700315,0.134146341,0.173501577
1285,2015,경북,문경시,4728000000,초등학교,2015-04-01,전체,484,477,482,5,2,7,0.01048218,0.004149378,0.014675052
1286,2015,경북,문경시,4728000000,초등학교,2015-04-01,여자,228,221,229,8,-1,7,0.036199095,-0.004366812,0.031674208
1287,2015,경북,문경시,4728000000,초등학교,2015-04-01,남자,256,256,253,-3,3,0,-0.01171875,0.011857708,0
1288,2015,경북,경산시,4729000000,초등학교,2015-04-01,전체,2156,2287,2241,-46,-85,-131,-0.020113686,-0.037929496,-0.05728028
1289,2015,경북,경산시,4729000000,초등학교,2015-04-01,여자,1024,1111,1094,-17,-70,-87,-0.01530153,-0.063985375,-0.078307831
1290,2015,경북,경산시,4729000000,초등학교,2015-04-01,남자,1132,1176,1147,-29,-15,-44,-0.024659864,-0.013077594,-0.037414966
1291,2015,경북,군위군,4772000000,초등학교,2015-04-01,전체,93,88,89,1,4,5,0.011363636,0.04494382,0.056818182
1292,2015,경북,군위군,4772000000,초등학교,2015-04-01,여자,41,44,43,-1,-2,-3,-0.022727273,-0.046511628,-0.068181818
1293,2015,경북,군위군,4772000000,초등학교,2015-04-01,남자,52,44,46,2,6,8,0.045454545,0.130434783,0.181818182
1294,2015,경북,의성군,4773000000,초등학교,2015-04-01,전체,220,225,216,-9,4,-5,-0.04,0.018518519,-0.022222222
1295,2015,경북,의성군,4773000000,초등학교,2015-04-01,여자,85,88,87,-1,-2,-3,-0.011363636,-0.022988506,-0.034090909
1296,2015,경북,의성군,4773000000,초등학교,2015-04-01,남자,135,137,129,-8,6,-2,-0.058394161,0.046511628,-0.01459854
1297,2015,경북,청송군,4775000000,초등학교,2015-04-01,전체,123,132,130,-2,-7,-9,-0.015151515,-0.053846154,-0.068181818
1298,2015,경북,청송군,4775000000,초등학교,2015-04-01,여자,49,55,54,-1,-5,-6,-0.018181818,-0.092592593,-0.109090909
1299,2015,경북,청송군,4775000000,초등학교,2015-04-01,남자,74,77,76,-1,-2,-3,-0.012987013,-0.026315789,-0.038961039
1300,2015,경북,영양군,4776000000,초등학교,2015-04-01,전체,105,89,86,-3,19,16,-0.033707865,0.220930233,0.179775281
1301,2015,경북,영양군,4776000000,초등학교,2015-04-01,여자,51,39,37,-2,14,12,-0.051282051,0.378378378,0.307692308
1302,2015,경북,영양군,4776000000,초등학교,2015-04-01,남자,54,50,49,-1,5,4,-0.02,0.102040816,0.08
1303,2015,경북,영덕군,4777000000,초등학교,2015-04-01,전체,168,186,186,0,-18,-18,0,-0.096774194,-0.096774194
1304,2015,경북,영덕군,4777000000,초등학교,2015-04-01,여자,82,77,79,2,3,5,0.025974026,0.037974684,0.064935065
1305,2015,경북,영덕군,4777000000,초등학교,2015-04-01,남자,86,109,107,-2,-21,-23,-0.018348624,-0.196261682,-0.211009174
1306,2015,경북,청도군,4782000000,초등학교,2015-04-01,전체,176,165,174,9,2,11,0.054545455,0.011494253,0.066666667
1307,2015,경북,청도군,4782000000,초등학교,2015-04-01,여자,84,73,79,6,5,11,0.082191781,0.063291139,0.150684932
1308,2015,경북,청도군,4782000000,초등학교,2015-04-01,남자,92,92,95,3,-3,0,0.032608696,-0.031578947,0
1309,2015,경북,고령군,4783000000,초등학교,2015-04-01,전체,230,231,228,-3,2,-1,-0.012987013,0.00877193,-0.004329004
1310,2015,경북,고령군,4783000000,초등학교,2015-04-01,여자,99,100,96,-4,3,-1,-0.04,0.03125,-0.01
1311,2015,경북,고령군,4783000000,초등학교,2015-04-01,남자,131,131,132,1,-1,0,0.007633588,-0.007575758,0
1312,2015,경북,성주군,4784000000,초등학교,2015-04-01,전체,207,227,226,-1,-19,-20,-0.004405286,-0.084070796,-0.088105727
1313,2015,경북,성주군,4784000000,초등학교,2015-04-01,여자,93,119,116,-3,-23,-26,-0.025210084,-0.198275862,-0.218487395
1314,2015,경북,성주군,4784000000,초등학교,2015-04-01,남자,114,108,110,2,4,6,0.018518519,0.036363636,0.055555556
1315,2015,경북,칠곡군,4785000000,초등학교,2015-04-01,전체,1235,1311,1284,-27,-49,-76,-0.020594966,-0.038161994,-0.057971014
1316,2015,경북,칠곡군,4785000000,초등학교,2015-04-01,여자,600,615,595,-20,5,-15,-0.032520325,0.008403361,-0.024390244
1317,2015,경북,칠곡군,4785000000,초등학교,2015-04-01,남자,635,696,689,-7,-54,-61,-0.010057471,-0.078374456,-0.087643678
1318,2015,경북,예천군,4790000000,초등학교,2015-04-01,전체,243,284,276,-8,-33,-41,-0.028169014,-0.119565217,-0.144366197
1319,2015,경북,예천군,4790000000,초등학교,2015-04-01,여자,99,125,120,-5,-21,-26,-0.04,-0.175,-0.208
1320,2015,경북,예천군,4790000000,초등학교,2015-04-01,남자,144,159,156,-3,-12,-15,-0.018867925,-0.076923077,-0.094339623
1321,2015,경북,봉화군,4792000000,초등학교,2015-04-01,전체,175,218,208,-10,-33,-43,-0.04587156,-0.158653846,-0.197247706
1322,2015,경북,봉화군,4792000000,초등학교,2015-04-01,여자,73,89,88,-1,-15,-16,-0.011235955,-0.170454545,-0.179775281
1323,2015,경북,봉화군,4792000000,초등학교,2015-04-01,남자,102,129,120,-9,-18,-27,-0.069767442,-0.15,-0.209302326
1324,2015,경북,울진군,4793000000,초등학교,2015-04-01,전체,368,415,396,-19,-28,-47,-0.045783133,-0.070707071,-0.113253012
1325,2015,경북,울진군,4793000000,초등학교,2015-04-01,여자,179,209,193,-16,-14,-30,-0.076555024,-0.07253886,-0.14354067
1326,2015,경북,울진군,4793000000,초등학교,2015-04-01,남자,189,206,203,-3,-14,-17,-0.014563107,-0.068965517,-0.082524272
1327,2015,경북,울릉군,4794000000,초등학교,2015-04-01,전체,57,53,59,6,-2,4,0.113207547,-0.033898305,0.075471698
1328,2015,경북,울릉군,4794000000,초등학교,2015-04-01,여자,25,28,35,7,-10,-3,0.25,-0.285714286,-0.107142857
1329,2015,경북,울릉군,4794000000,초등학교,2015-04-01,남자,32,25,24,-1,8,7,-0.04,0.333333333,0.28
1330,2015,경남,진주시,4817000000,초등학교,2015-04-01,전체,3261,2919,2974,55,287,342,0.018842069,0.096503026,0.117163412
1331,2015,경남,진주시,4817000000,초등학교,2015-04-01,여자,1582,1386,1421,35,161,196,0.025252525,0.113300493,0.141414141
1332,2015,경남,진주시,4817000000,초등학교,2015-04-01,남자,1679,1533,1553,20,126,146,0.013046314,0.08113329,0.095238095
1333,2015,경남,통영시,4822000000,초등학교,2015-04-01,전체,1439,1482,1489,7,-50,-43,0.004723347,-0.033579584,-0.029014845
1334,2015,경남,통영시,4822000000,초등학교,2015-04-01,여자,725,739,742,3,-17,-14,0.00405954,-0.022911051,-0.01894452
1335,2015,경남,통영시,4822000000,초등학교,2015-04-01,남자,714,743,747,4,-33,-29,0.00538358,-0.044176707,-0.039030956
1336,2015,경남,사천시,4824000000,초등학교,2015-04-01,전체,1166,1203,1202,-1,-36,-37,-0.000831255,-0.029950083,-0.030756442
1337,2015,경남,사천시,4824000000,초등학교,2015-04-01,여자,564,563,574,11,-10,1,0.019538188,-0.017421603,0.001776199
1338,2015,경남,사천시,4824000000,초등학교,2015-04-01,남자,602,640,628,-12,-26,-38,-0.01875,-0.041401274,-0.059375
1339,2015,경남,김해시,4825000000,초등학교,2015-04-01,전체,6072,5938,6117,179,-45,134,0.03014483,-0.007356547,0.022566521
1340,2015,경남,김해시,4825000000,초등학교,2015-04-01,여자,2945,2938,3033,95,-88,7,0.032334922,-0.029014177,0.002382573
1341,2015,경남,김해시,4825000000,초등학교,2015-04-01,남자,3127,3000,3084,84,43,127,0.028,0.013942931,0.042333333
1342,2015,경남,밀양시,4827000000,초등학교,2015-04-01,전체,739,709,727,18,12,30,0.02538787,0.01650619,0.042313117
1343,2015,경남,밀양시,4827000000,초등학교,2015-04-01,여자,375,343,354,11,21,32,0.032069971,0.059322034,0.093294461
1344,2015,경남,밀양시,4827000000,초등학교,2015-04-01,남자,364,366,373,7,-9,-2,0.019125683,-0.024128686,-0.005464481
1345,2015,경남,거제시,4831000000,초등학교,2015-04-01,전체,3028,3044,3041,-3,-13,-16,-0.000985545,-0.00427491,-0.005256242
1346,2015,경남,거제시,4831000000,초등학교,2015-04-01,여자,1482,1445,1441,-4,41,37,-0.002768166,0.028452464,0.025605536
1347,2015,경남,거제시,4831000000,초등학교,2015-04-01,남자,1546,1599,1600,1,-54,-53,0.000625391,-0.03375,-0.033145716
1348,2015,경남,양산시,4833000000,초등학교,2015-04-01,전체,3213,2938,3060,122,153,275,0.041524847,0.05,0.093601089
1349,2015,경남,양산시,4833000000,초등학교,2015-04-01,여자,1542,1400,1462,62,80,142,0.044285714,0.054719562,0.101428571
1350,2015,경남,양산시,4833000000,초등학교,2015-04-01,남자,1671,1538,1598,60,73,133,0.039011704,0.045682103,0.086475943
1351,2015,경남,의령군,4872000000,초등학교,2015-04-01,전체,131,172,157,-15,-26,-41,-0.087209302,-0.165605096,-0.238372093
1352,2015,경남,의령군,4872000000,초등학교,2015-04-01,여자,66,84,70,-14,-4,-18,-0.166666667,-0.057142857,-0.214285714
1353,2015,경남,의령군,4872000000,초등학교,2015-04-01,남자,65,88,87,-1,-22,-23,-0.011363636,-0.252873563,-0.261363636
1354,2015,경남,함안군,4873000000,초등학교,2015-04-01,전체,686,636,637,1,49,50,0.001572327,0.076923077,0.078616352
1355,2015,경남,함안군,4873000000,초등학교,2015-04-01,여자,326,319,327,8,-1,7,0.02507837,-0.003058104,0.021943574
1356,2015,경남,함안군,4873000000,초등학교,2015-04-01,남자,360,317,310,-7,50,43,-0.022082019,0.161290323,0.135646688
1357,2015,경남,창녕군,4874000000,초등학교,2015-04-01,전체,379,415,415,0,-36,-36,0,-0.086746988,-0.086746988
1358,2015,경남,창녕군,4874000000,초등학교,2015-04-01,여자,178,188,191,3,-13,-10,0.015957447,-0.068062827,-0.053191489
1359,2015,경남,창녕군,4874000000,초등학교,2015-04-01,남자,201,227,224,-3,-23,-26,-0.013215859,-0.102678571,-0.114537445
1360,2015,경남,고성군,4882000000,초등학교,2015-04-01,전체,397,419,395,-24,2,-22,-0.057279236,0.005063291,-0.052505967
1361,2015,경남,고성군,4882000000,초등학교,2015-04-01,여자,190,206,191,-15,-1,-16,-0.072815534,-0.005235602,-0.077669903
1362,2015,경남,고성군,4882000000,초등학교,2015-04-01,남자,207,213,204,-9,3,-6,-0.042253521,0.014705882,-0.028169014
1363,2015,경남,남해군,4884000000,초등학교,2015-04-01,전체,237,238,229,-9,8,-1,-0.037815126,0.034934498,-0.004201681
1364,2015,경남,남해군,4884000000,초등학교,2015-04-01,여자,106,113,105,-8,1,-7,-0.07079646,0.00952381,-0.061946903
1365,2015,경남,남해군,4884000000,초등학교,2015-04-01,남자,131,125,124,-1,7,6,-0.008,0.056451613,0.048
1366,2015,경남,하동군,4885000000,초등학교,2015-04-01,전체,268,286,284,-2,-16,-18,-0.006993007,-0.056338028,-0.062937063
1367,2015,경남,하동군,4885000000,초등학교,2015-04-01,여자,130,145,142,-3,-12,-15,-0.020689655,-0.084507042,-0.103448276
1368,2015,경남,하동군,4885000000,초등학교,2015-04-01,남자,138,141,142,1,-4,-3,0.007092199,-0.028169014,-0.021276596
1369,2015,경남,산청군,4886000000,초등학교,2015-04-01,전체,175,172,180,8,-5,3,0.046511628,-0.027777778,0.01744186
1370,2015,경남,산청군,4886000000,초등학교,2015-04-01,여자,68,78,84,6,-16,-10,0.076923077,-0.19047619,-0.128205128
1371,2015,경남,산청군,4886000000,초등학교,2015-04-01,남자,107,94,96,2,11,13,0.021276596,0.114583333,0.138297872
1372,2015,경남,함양군,4887000000,초등학교,2015-04-01,전체,283,290,292,2,-9,-7,0.006896552,-0.030821918,-0.024137931
1373,2015,경남,함양군,4887000000,초등학교,2015-04-01,여자,140,161,159,-2,-19,-21,-0.01242236,-0.119496855,-0.130434783
1374,2015,경남,함양군,4887000000,초등학교,2015-04-01,남자,143,129,133,4,10,14,0.031007752,0.07518797,0.108527132
1375,2015,경남,거창군,4888000000,초등학교,2015-04-01,전체,483,476,494,18,-11,7,0.037815126,-0.022267206,0.014705882
1376,2015,경남,거창군,4888000000,초등학교,2015-04-01,여자,231,233,244,11,-13,-2,0.0472103,-0.053278689,-0.008583691
1377,2015,경남,거창군,4888000000,초등학교,2015-04-01,남자,252,243,250,7,2,9,0.028806584,0.008,0.037037037
1378,2015,경남,합천군,4889000000,초등학교,2015-04-01,전체,226,265,262,-3,-36,-39,-0.011320755,-0.13740458,-0.147169811
1379,2015,경남,합천군,4889000000,초등학교,2015-04-01,여자,106,126,126,0,-20,-20,0,-0.158730159,-0.158730159
1380,2015,경남,합천군,4889000000,초등학교,2015-04-01,남자,120,139,136,-3,-16,-19,-0.021582734,-0.117647059,-0.136690647
1381,2015,제주,제주시,5011000000,초등학교,2015-04-01,전체,4796,4566,4717,151,79,230,0.033070521,0.016747933,0.050372317
1382,2015,제주,제주시,5011000000,초등학교,2015-04-01,여자,2329,2198,2262,64,67,131,0.029117379,0.029619805,0.059599636
1383,2015,제주,제주시,5011000000,초등학교,2015-04-01,남자,2467,2368,2455,87,12,99,0.036739865,0.004887984,0.041807432
1384,2015,제주,서귀포시,5013000000,초등학교,2015-04-01,전체,1407,1306,1372,66,35,101,0.050535988,0.025510204,0.077335375
1385,2015,제주,서귀포시,5013000000,초등학교,2015-04-01,여자,684,642,671,29,13,42,0.04517134,0.019374069,0.065420561
1386,2015,제주,서귀포시,5013000000,초등학교,2015-04-01,남자,723,664,701,37,22,59,0.055722892,0.031383738,0.088855422
1387,2016,서울,종로구,1111000000,초등학교,2016-04-01,전체,876,891,840,-51,36,-15,-0.057239057,0.042857143,-0.016835017
1388,2016,서울,종로구,1111000000,초등학교,2016-04-01,여자,422,413,385,-28,37,9,-0.06779661,0.096103896,0.021791768
1389,2016,서울,종로구,1111000000,초등학교,2016-04-01,남자,454,478,455,-23,-1,-24,-0.048117155,-0.002197802,-0.050209205
1390,2016,서울,중구,1114000000,초등학교,2016-04-01,전체,883,848,803,-45,80,35,-0.053066038,0.099626401,0.041273585
1391,2016,서울,중구,1114000000,초등학교,2016-04-01,여자,440,422,396,-26,44,18,-0.061611374,0.111111111,0.042654028
1392,2016,서울,중구,1114000000,초등학교,2016-04-01,남자,443,426,407,-19,36,17,-0.044600939,0.088452088,0.039906103
1393,2016,서울,용산구,1117000000,초등학교,2016-04-01,전체,1286,1676,1586,-90,-300,-390,-0.053699284,-0.189155107,-0.232696897
1394,2016,서울,용산구,1117000000,초등학교,2016-04-01,여자,628,840,806,-34,-178,-212,-0.04047619,-0.220843672,-0.252380952
1395,2016,서울,용산구,1117000000,초등학교,2016-04-01,남자,658,836,780,-56,-122,-178,-0.066985646,-0.156410256,-0.21291866
1396,2016,서울,성동구,1120000000,초등학교,2016-04-01,전체,1995,2223,2113,-110,-118,-228,-0.049482681,-0.05584477,-0.102564103
1397,2016,서울,성동구,1120000000,초등학교,2016-04-01,여자,989,1102,1044,-58,-55,-113,-0.052631579,-0.052681992,-0.102540835
1398,2016,서울,성동구,1120000000,초등학교,2016-04-01,남자,1006,1121,1069,-52,-63,-115,-0.046387154,-0.058933583,-0.102586976
1399,2016,서울,광진구,1121500000,초등학교,2016-04-01,전체,2407,2509,2401,-108,6,-102,-0.043045038,0.002498959,-0.040653647
1400,2016,서울,광진구,1121500000,초등학교,2016-04-01,여자,1161,1182,1139,-43,22,-21,-0.036379019,0.019315189,-0.017766497
1401,2016,서울,광진구,1121500000,초등학교,2016-04-01,남자,1246,1327,1262,-65,-16,-81,-0.048982668,-0.012678288,-0.06103994
1402,2016,서울,동대문구,1123000000,초등학교,2016-04-01,전체,2348,2637,2613,-24,-265,-289,-0.009101251,-0.101415997,-0.109594236
1403,2016,서울,동대문구,1123000000,초등학교,2016-04-01,여자,1130,1305,1283,-22,-153,-175,-0.016858238,-0.119251754,-0.134099617
1404,2016,서울,동대문구,1123000000,초등학교,2016-04-01,남자,1218,1332,1330,-2,-112,-114,-0.001501502,-0.084210526,-0.085585586
1405,2016,서울,중랑구,1126000000,초등학교,2016-04-01,전체,2563,2914,2843,-71,-280,-351,-0.024365134,-0.098487513,-0.120452986
1406,2016,서울,중랑구,1126000000,초등학교,2016-04-01,여자,1282,1439,1388,-51,-106,-157,-0.035441279,-0.076368876,-0.109103544
1407,2016,서울,중랑구,1126000000,초등학교,2016-04-01,남자,1281,1475,1455,-20,-174,-194,-0.013559322,-0.119587629,-0.131525424
1408,2016,서울,성북구,1129000000,초등학교,2016-04-01,전체,3592,3929,3791,-138,-199,-337,-0.035123441,-0.052492746,-0.085772461
1409,2016,서울,성북구,1129000000,초등학교,2016-04-01,여자,1751,1932,1854,-78,-103,-181,-0.040372671,-0.055555556,-0.0936853
1410,2016,서울,성북구,1129000000,초등학교,2016-04-01,남자,1841,1997,1937,-60,-96,-156,-0.030045068,-0.049561177,-0.078117176
1411,2016,서울,강북구,1130500000,초등학교,2016-04-01,전체,1778,2317,2174,-143,-396,-539,-0.061717738,-0.182152714,-0.232628399
1412,2016,서울,강북구,1130500000,초등학교,2016-04-01,여자,880,1097,1043,-54,-163,-217,-0.04922516,-0.156279962,-0.197812215
1413,2016,서울,강북구,1130500000,초등학교,2016-04-01,남자,898,1220,1131,-89,-233,-322,-0.07295082,-0.206012378,-0.263934426
1414,2016,서울,도봉구,1132000000,초등학교,2016-04-01,전체,2684,2574,2545,-29,139,110,-0.011266511,0.054616896,0.042735043
1415,2016,서울,도봉구,1132000000,초등학교,2016-04-01,여자,1324,1250,1224,-26,100,74,-0.0208,0.081699346,0.0592
1416,2016,서울,도봉구,1132000000,초등학교,2016-04-01,남자,1360,1324,1321,-3,39,36,-0.002265861,0.029523089,0.027190332
1417,2016,서울,노원구,1135000000,초등학교,2016-04-01,전체,4329,4350,4247,-103,82,-21,-0.023678161,0.019307747,-0.004827586
1418,2016,서울,노원구,1135000000,초등학교,2016-04-01,여자,2109,2142,2070,-72,39,-33,-0.033613445,0.01884058,-0.015406162
1419,2016,서울,노원구,1135000000,초등학교,2016-04-01,남자,2220,2208,2177,-31,43,12,-0.014039855,0.019751952,0.005434783
1420,2016,서울,은평구,1138000000,초등학교,2016-04-01,전체,3737,4003,3954,-49,-217,-266,-0.012240819,-0.054881133,-0.066450162
1421,2016,서울,은평구,1138000000,초등학교,2016-04-01,여자,1813,1952,1935,-17,-122,-139,-0.008709016,-0.063049096,-0.071209016
1422,2016,서울,은평구,1138000000,초등학교,2016-04-01,남자,1924,2051,2019,-32,-95,-127,-0.015602145,-0.047052997,-0.061921014
1423,2016,서울,서대문구,1141000000,초등학교,2016-04-01,전체,2213,2173,2075,-98,138,40,-0.045098942,0.066506024,0.018407731
1424,2016,서울,서대문구,1141000000,초등학교,2016-04-01,여자,1103,1070,1023,-47,80,33,-0.043925234,0.078201369,0.030841121
1425,2016,서울,서대문구,1141000000,초등학교,2016-04-01,남자,1110,1103,1052,-51,58,7,-0.046237534,0.05513308,0.006346328
1426,2016,서울,마포구,1144000000,초등학교,2016-04-01,전체,2638,2994,3040,46,-402,-356,0.015364061,-0.132236842,-0.118904476
1427,2016,서울,마포구,1144000000,초등학교,2016-04-01,여자,1275,1417,1432,15,-157,-142,0.010585745,-0.109636872,-0.100211715
1428,2016,서울,마포구,1144000000,초등학교,2016-04-01,남자,1363,1577,1608,31,-245,-214,0.019657578,-0.152363184,-0.135700698
1429,2016,서울,양천구,1147000000,초등학교,2016-04-01,전체,3616,3693,3741,48,-125,-77,0.012997563,-0.033413526,-0.020850257
1430,2016,서울,양천구,1147000000,초등학교,2016-04-01,여자,1762,1790,1836,46,-74,-28,0.025698324,-0.040305011,-0.015642458
1431,2016,서울,양천구,1147000000,초등학교,2016-04-01,남자,1854,1903,1905,2,-51,-49,0.001050972,-0.026771654,-0.025748818
1432,2016,서울,강서구,1150000000,초등학교,2016-04-01,전체,4413,4430,4562,132,-149,-17,0.02979684,-0.032661114,-0.003837472
1433,2016,서울,강서구,1150000000,초등학교,2016-04-01,여자,2124,2135,2204,69,-80,-11,0.032318501,-0.036297641,-0.005152225
1434,2016,서울,강서구,1150000000,초등학교,2016-04-01,남자,2289,2295,2358,63,-69,-6,0.02745098,-0.029262087,-0.002614379
1435,2016,서울,구로구,1153000000,초등학교,2016-04-01,전체,3329,3900,3720,-180,-391,-571,-0.046153846,-0.105107527,-0.146410256
1436,2016,서울,구로구,1153000000,초등학교,2016-04-01,여자,1640,1882,1792,-90,-152,-242,-0.047821467,-0.084821429,-0.12858661
1437,2016,서울,구로구,1153000000,초등학교,2016-04-01,남자,1689,2018,1928,-90,-239,-329,-0.044598612,-0.123962656,-0.163032706
1438,2016,서울,금천구,1154500000,초등학교,2016-04-01,전체,1510,1600,1534,-66,-24,-90,-0.04125,-0.015645372,-0.05625
1439,2016,서울,금천구,1154500000,초등학교,2016-04-01,여자,734,758,715,-43,19,-24,-0.056728232,0.026573427,-0.031662269
1440,2016,서울,금천구,1154500000,초등학교,2016-04-01,남자,776,842,819,-23,-43,-66,-0.027315914,-0.052503053,-0.078384798
1441,2016,서울,영등포구,1156000000,초등학교,2016-04-01,전체,2377,3069,2903,-166,-526,-692,-0.05408928,-0.18119187,-0.225480613
1442,2016,서울,영등포구,1156000000,초등학교,2016-04-01,여자,1166,1467,1416,-51,-250,-301,-0.034764826,-0.176553672,-0.205180641
1443,2016,서울,영등포구,1156000000,초등학교,2016-04-01,남자,1211,1602,1487,-115,-276,-391,-0.071785268,-0.185608608,-0.244069913
1444,2016,서울,동작구,1159000000,초등학교,2016-04-01,전체,2807,3154,3063,-91,-256,-347,-0.028852251,-0.083578191,-0.110019023
1445,2016,서울,동작구,1159000000,초등학교,2016-04-01,여자,1395,1546,1501,-45,-106,-151,-0.029107374,-0.070619587,-0.09767141
1446,2016,서울,동작구,1159000000,초등학교,2016-04-01,남자,1412,1608,1562,-46,-150,-196,-0.028606965,-0.09603073,-0.121890547
1447,2016,서울,관악구,1162000000,초등학교,2016-04-01,전체,2732,3422,3225,-197,-493,-690,-0.057568673,-0.152868217,-0.20163647
1448,2016,서울,관악구,1162000000,초등학교,2016-04-01,여자,1310,1657,1578,-79,-268,-347,-0.047676524,-0.169835234,-0.209414605
1449,2016,서울,관악구,1162000000,초등학교,2016-04-01,남자,1422,1765,1647,-118,-225,-343,-0.066855524,-0.136612022,-0.194334278
1450,2016,서울,서초구,1165000000,초등학교,2016-04-01,전체,3662,3972,4189,217,-527,-310,0.054632427,-0.125805682,-0.078046324
1451,2016,서울,서초구,1165000000,초등학교,2016-04-01,여자,1797,1980,2081,101,-284,-183,0.051010101,-0.13647285,-0.092424242
1452,2016,서울,서초구,1165000000,초등학교,2016-04-01,남자,1865,1992,2108,116,-243,-127,0.058232932,-0.115275142,-0.06375502
1453,2016,서울,강남구,1168000000,초등학교,2016-04-01,전체,3703,3931,4148,217,-445,-228,0.055202239,-0.107280617,-0.058000509
1454,2016,서울,강남구,1168000000,초등학교,2016-04-01,여자,1807,1918,2023,105,-216,-111,0.054744526,-0.106772121,-0.057872784
1455,2016,서울,강남구,1168000000,초등학교,2016-04-01,남자,1896,2013,2125,112,-229,-117,0.055638351,-0.107764706,-0.058122206
1456,2016,서울,송파구,1171000000,초등학교,2016-04-01,전체,5075,5627,5544,-83,-469,-552,-0.014750311,-0.08459596,-0.098098454
1457,2016,서울,송파구,1171000000,초등학교,2016-04-01,여자,2476,2738,2721,-17,-245,-262,-0.006208912,-0.090040426,-0.095690285
1458,2016,서울,송파구,1171000000,초등학교,2016-04-01,남자,2599,2889,2823,-66,-224,-290,-0.022845275,-0.079348211,-0.100380755
1459,2016,서울,강동구,1174000000,초등학교,2016-04-01,전체,3229,3863,3736,-127,-507,-634,-0.032876003,-0.135706638,-0.164121149
1460,2016,서울,강동구,1174000000,초등학교,2016-04-01,여자,1583,1859,1805,-54,-222,-276,-0.029047875,-0.12299169,-0.148466918
1461,2016,서울,강동구,1174000000,초등학교,2016-04-01,남자,1646,2004,1931,-73,-285,-358,-0.036427146,-0.147591921,-0.178642715
1462,2016,부산,중구,2611000000,초등학교,2016-04-01,전체,245,223,228,5,17,22,0.022421525,0.074561404,0.098654709
1463,2016,부산,중구,2611000000,초등학교,2016-04-01,여자,110,111,109,-2,1,-1,-0.018018018,0.009174312,-0.009009009
1464,2016,부산,중구,2611000000,초등학교,2016-04-01,남자,135,112,119,7,16,23,0.0625,0.134453782,0.205357143
1465,2016,부산,서구,2614000000,초등학교,2016-04-01,전체,572,598,600,2,-28,-26,0.003344482,-0.046666667,-0.043478261
1466,2016,부산,서구,2614000000,초등학교,2016-04-01,여자,268,281,284,3,-16,-13,0.010676157,-0.056338028,-0.046263345
1467,2016,부산,서구,2614000000,초등학교,2016-04-01,남자,304,317,316,-1,-12,-13,-0.003154574,-0.037974684,-0.041009464
1468,2016,부산,동구,2617000000,초등학교,2016-04-01,전체,388,536,492,-44,-104,-148,-0.082089552,-0.211382114,-0.276119403
1469,2016,부산,동구,2617000000,초등학교,2016-04-01,여자,196,269,256,-13,-60,-73,-0.048327138,-0.234375,-0.271375465
1470,2016,부산,동구,2617000000,초등학교,2016-04-01,남자,192,267,236,-31,-44,-75,-0.116104869,-0.186440678,-0.280898876
1471,2016,부산,영도구,2620000000,초등학교,2016-04-01,전체,617,724,700,-24,-83,-107,-0.033149171,-0.118571429,-0.147790055
1472,2016,부산,영도구,2620000000,초등학교,2016-04-01,여자,301,360,344,-16,-43,-59,-0.044444444,-0.125,-0.163888889
1473,2016,부산,영도구,2620000000,초등학교,2016-04-01,남자,316,364,356,-8,-40,-48,-0.021978022,-0.112359551,-0.131868132
1474,2016,부산,부산진구,2623000000,초등학교,2016-04-01,전체,2550,2703,2649,-54,-99,-153,-0.019977802,-0.037372593,-0.056603774
1475,2016,부산,부산진구,2623000000,초등학교,2016-04-01,여자,1262,1320,1282,-38,-20,-58,-0.028787879,-0.015600624,-0.043939394
1476,2016,부산,부산진구,2623000000,초등학교,2016-04-01,남자,1288,1383,1367,-16,-79,-95,-0.011569053,-0.057790783,-0.068691251
1477,2016,부산,동래구,2626000000,초등학교,2016-04-01,전체,1856,1829,1847,18,9,27,0.009841443,0.004872767,0.014762165
1478,2016,부산,동래구,2626000000,초등학교,2016-04-01,여자,886,906,907,1,-21,-20,0.001103753,-0.023153252,-0.022075055
1479,2016,부산,동래구,2626000000,초등학교,2016-04-01,남자,970,923,940,17,30,47,0.018418202,0.031914894,0.05092091
1480,2016,부산,남구,2629000000,초등학교,2016-04-01,전체,1932,2188,2159,-29,-227,-256,-0.013254113,-0.105141269,-0.117001828
1481,2016,부산,남구,2629000000,초등학교,2016-04-01,여자,961,1074,1067,-7,-106,-113,-0.006517691,-0.099343955,-0.105214153
1482,2016,부산,남구,2629000000,초등학교,2016-04-01,남자,971,1114,1092,-22,-121,-143,-0.019748654,-0.110805861,-0.128366248
1483,2016,부산,북구,2632000000,초등학교,2016-04-01,전체,2203,2217,2197,-20,6,-14,-0.0090212,0.002730997,-0.00631484
1484,2016,부산,북구,2632000000,초등학교,2016-04-01,여자,1107,1077,1072,-5,35,30,-0.004642526,0.032649254,0.027855153
1485,2016,부산,북구,2632000000,초등학교,2016-04-01,남자,1096,1140,1125,-15,-29,-44,-0.013157895,-0.025777778,-0.038596491
1486,2016,부산,해운대구,2635000000,초등학교,2016-04-01,전체,3149,3323,3389,66,-240,-174,0.019861571,-0.07081735,-0.052362323
1487,2016,부산,해운대구,2635000000,초등학교,2016-04-01,여자,1534,1620,1648,28,-114,-86,0.017283951,-0.069174757,-0.05308642
1488,2016,부산,해운대구,2635000000,초등학교,2016-04-01,남자,1615,1703,1741,38,-126,-88,0.022313564,-0.0723722,-0.051673517
1489,2016,부산,사하구,2638000000,초등학교,2016-04-01,전체,2413,2638,2557,-81,-144,-225,-0.03070508,-0.056315995,-0.085291888
1490,2016,부산,사하구,2638000000,초등학교,2016-04-01,여자,1160,1270,1230,-40,-70,-110,-0.031496063,-0.056910569,-0.086614173
1491,2016,부산,사하구,2638000000,초등학교,2016-04-01,남자,1253,1368,1327,-41,-74,-115,-0.02997076,-0.055764883,-0.084064327
1492,2016,부산,금정구,2641000000,초등학교,2016-04-01,전체,1534,1606,1589,-17,-55,-72,-0.010585305,-0.034612964,-0.04483188
1493,2016,부산,금정구,2641000000,초등학교,2016-04-01,여자,728,753,744,-9,-16,-25,-0.011952191,-0.021505376,-0.033200531
1494,2016,부산,금정구,2641000000,초등학교,2016-04-01,남자,806,853,845,-8,-39,-47,-0.009378664,-0.046153846,-0.055099648
1495,2016,부산,강서구,2644000000,초등학교,2016-04-01,전체,1191,807,1025,218,166,384,0.270136307,0.16195122,0.475836431
1496,2016,부산,강서구,2644000000,초등학교,2016-04-01,여자,568,384,500,116,68,184,0.302083333,0.136,0.479166667
1497,2016,부산,강서구,2644000000,초등학교,2016-04-01,남자,623,423,525,102,98,200,0.241134752,0.186666667,0.472813239
1498,2016,부산,연제구,2647000000,초등학교,2016-04-01,전체,1472,1469,1475,6,-3,3,0.004084411,-0.002033898,0.002042206
1499,2016,부산,연제구,2647000000,초등학교,2016-04-01,여자,689,690,702,12,-13,-1,0.017391304,-0.018518519,-0.001449275
1500,2016,부산,연제구,2647000000,초등학교,2016-04-01,남자,783,779,773,-6,10,4,-0.007702182,0.012936611,0.005134788
1501,2016,부산,수영구,2650000000,초등학교,2016-04-01,전체,1017,1082,1092,10,-75,-65,0.009242144,-0.068681319,-0.060073937
1502,2016,부산,수영구,2650000000,초등학교,2016-04-01,여자,485,508,506,-2,-21,-23,-0.003937008,-0.041501976,-0.045275591
1503,2016,부산,수영구,2650000000,초등학교,2016-04-01,남자,532,574,586,12,-54,-42,0.020905923,-0.092150171,-0.073170732
1504,2016,부산,사상구,2653000000,초등학교,2016-04-01,전체,1394,1646,1594,-52,-200,-252,-0.031591738,-0.125470514,-0.15309842
1505,2016,부산,사상구,2653000000,초등학교,2016-04-01,여자,668,776,757,-19,-89,-108,-0.024484536,-0.117569353,-0.139175258
1506,2016,부산,사상구,2653000000,초등학교,2016-04-01,남자,726,870,837,-33,-111,-144,-0.037931034,-0.132616487,-0.165517241
1507,2016,부산,기장군,2671000000,초등학교,2016-04-01,전체,1799,1683,1813,130,-14,116,0.077243018,-0.007722008,0.06892454
1508,2016,부산,기장군,2671000000,초등학교,2016-04-01,여자,880,828,888,60,-8,52,0.072463768,-0.009009009,0.062801932
1509,2016,부산,기장군,2671000000,초등학교,2016-04-01,남자,919,855,925,70,-6,64,0.081871345,-0.006486486,0.074853801
1510,2016,대구,중구,2711000000,초등학교,2016-04-01,전체,686,460,496,36,190,226,0.07826087,0.383064516,0.491304348
1511,2016,대구,중구,2711000000,초등학교,2016-04-01,여자,316,193,216,23,100,123,0.119170984,0.462962963,0.637305699
1512,2016,대구,중구,2711000000,초등학교,2016-04-01,남자,370,267,280,13,90,103,0.048689139,0.321428571,0.38576779
1513,2016,대구,동구,2714000000,초등학교,2016-04-01,전체,2890,3074,3053,-21,-163,-184,-0.00683149,-0.053390108,-0.059856864
1514,2016,대구,동구,2714000000,초등학교,2016-04-01,여자,1372,1451,1459,8,-87,-79,0.005513439,-0.059629883,-0.05444521
1515,2016,대구,동구,2714000000,초등학교,2016-04-01,남자,1518,1623,1594,-29,-76,-105,-0.017868145,-0.047678795,-0.064695009
1516,2016,대구,서구,2717000000,초등학교,2016-04-01,전체,1028,1116,1045,-71,-17,-88,-0.063620072,-0.016267943,-0.078853047
1517,2016,대구,서구,2717000000,초등학교,2016-04-01,여자,530,550,514,-36,16,-20,-0.065454545,0.031128405,-0.036363636
1518,2016,대구,서구,2717000000,초등학교,2016-04-01,남자,498,566,531,-35,-33,-68,-0.061837456,-0.062146893,-0.120141343
1519,2016,대구,남구,2720000000,초등학교,2016-04-01,전체,779,868,846,-22,-67,-89,-0.025345622,-0.079196217,-0.102534562
1520,2016,대구,남구,2720000000,초등학교,2016-04-01,여자,397,432,414,-18,-17,-35,-0.041666667,-0.041062802,-0.081018519
1521,2016,대구,남구,2720000000,초등학교,2016-04-01,남자,382,436,432,-4,-50,-54,-0.009174312,-0.115740741,-0.123853211
1522,2016,대구,북구,2723000000,초등학교,2016-04-01,전체,3662,3908,3874,-34,-212,-246,-0.008700102,-0.0547238,-0.062947799
1523,2016,대구,북구,2723000000,초등학교,2016-04-01,여자,1800,1864,1861,-3,-61,-64,-0.001609442,-0.032778076,-0.034334764
1524,2016,대구,북구,2723000000,초등학교,2016-04-01,남자,1862,2044,2013,-31,-151,-182,-0.015166341,-0.075012419,-0.089041096
1525,2016,대구,수성구,2726000000,초등학교,2016-04-01,전체,3558,3346,3467,121,91,212,0.036162582,0.026247476,0.063359235
1526,2016,대구,수성구,2726000000,초등학교,2016-04-01,여자,1684,1605,1660,55,24,79,0.034267913,0.014457831,0.049221184
1527,2016,대구,수성구,2726000000,초등학교,2016-04-01,남자,1874,1741,1807,66,67,133,0.037909248,0.03707803,0.076392878
1528,2016,대구,달서구,2729000000,초등학교,2016-04-01,전체,5193,5221,5265,44,-72,-28,0.008427504,-0.013675214,-0.005362957
1529,2016,대구,달서구,2729000000,초등학교,2016-04-01,여자,2451,2519,2541,22,-90,-68,0.008733624,-0.035419126,-0.026994839
1530,2016,대구,달서구,2729000000,초등학교,2016-04-01,남자,2742,2702,2724,22,18,40,0.008142117,0.00660793,0.014803849
1531,2016,대구,달성군,2771000000,초등학교,2016-04-01,전체,1916,1922,1915,-7,1,-6,-0.00364204,0.000522193,-0.003121748
1532,2016,대구,달성군,2771000000,초등학교,2016-04-01,여자,961,950,940,-10,21,11,-0.010526316,0.022340426,0.011578947
1533,2016,대구,달성군,2771000000,초등학교,2016-04-01,남자,955,972,975,3,-20,-17,0.00308642,-0.020512821,-0.017489712
1534,2016,인천,중구,2811000000,초등학교,2016-04-01,전체,1201,1070,1115,45,86,131,0.042056075,0.077130045,0.122429907
1535,2016,인천,중구,2811000000,초등학교,2016-04-01,여자,589,546,559,13,30,43,0.023809524,0.053667263,0.078754579
1536,2016,인천,중구,2811000000,초등학교,2016-04-01,남자,612,524,556,32,56,88,0.061068702,0.100719424,0.167938931
1537,2016,인천,동구,2814000000,초등학교,2016-04-01,전체,704,638,631,-7,73,66,-0.010971787,0.115689382,0.103448276
1538,2016,인천,동구,2814000000,초등학교,2016-04-01,여자,372,311,312,1,60,61,0.003215434,0.192307692,0.196141479
1539,2016,인천,동구,2814000000,초등학교,2016-04-01,남자,332,327,319,-8,13,5,-0.024464832,0.040752351,0.01529052
1540,2016,인천,미추홀구,2817700000,초등학교,2016-04-01,전체,2826,3252,3170,-82,-344,-426,-0.025215252,-0.10851735,-0.13099631
1541,2016,인천,미추홀구,2817700000,초등학교,2016-04-01,여자,1403,1636,1602,-34,-199,-233,-0.020782396,-0.124219725,-0.142420538
1542,2016,인천,미추홀구,2817700000,초등학교,2016-04-01,남자,1423,1616,1568,-48,-145,-193,-0.02970297,-0.09247449,-0.119430693
1543,2016,인천,연수구,2818500000,초등학교,2016-04-01,전체,3226,2813,2965,152,261,413,0.054034838,0.088026981,0.146818343
1544,2016,인천,연수구,2818500000,초등학교,2016-04-01,여자,1540,1368,1432,64,108,172,0.046783626,0.075418994,0.125730994
1545,2016,인천,연수구,2818500000,초등학교,2016-04-01,남자,1686,1445,1533,88,153,241,0.060899654,0.099804305,0.166782007
1546,2016,인천,남동구,2820000000,초등학교,2016-04-01,전체,5079,5100,5109,9,-30,-21,0.001764706,-0.005871991,-0.004117647
1547,2016,인천,남동구,2820000000,초등학교,2016-04-01,여자,2480,2462,2486,24,-6,18,0.009748172,-0.002413516,0.007311129
1548,2016,인천,남동구,2820000000,초등학교,2016-04-01,남자,2599,2638,2623,-15,-24,-39,-0.005686126,-0.009149828,-0.014783927
1549,2016,인천,부평구,2823700000,초등학교,2016-04-01,전체,4474,4622,4558,-64,-84,-148,-0.01384682,-0.018429136,-0.03202077
1550,2016,인천,부평구,2823700000,초등학교,2016-04-01,여자,2169,2267,2224,-43,-55,-98,-0.018967799,-0.024730216,-0.043228937
1551,2016,인천,부평구,2823700000,초등학교,2016-04-01,남자,2305,2355,2334,-21,-29,-50,-0.008917197,-0.012425021,-0.021231423
1552,2016,인천,계양구,2824500000,초등학교,2016-04-01,전체,2720,3021,2923,-98,-203,-301,-0.03243959,-0.069449196,-0.099635882
1553,2016,인천,계양구,2824500000,초등학교,2016-04-01,여자,1294,1465,1420,-45,-126,-171,-0.030716724,-0.088732394,-0.116723549
1554,2016,인천,계양구,2824500000,초등학교,2016-04-01,남자,1426,1556,1503,-53,-77,-130,-0.034061697,-0.051230872,-0.083547558
1555,2016,인천,서구,2826000000,초등학교,2016-04-01,전체,5111,5461,5455,-6,-344,-350,-0.0010987,-0.063061412,-0.064090826
1556,2016,인천,서구,2826000000,초등학교,2016-04-01,여자,2454,2640,2637,-3,-183,-186,-0.001136364,-0.069397042,-0.070454545
1557,2016,인천,서구,2826000000,초등학교,2016-04-01,남자,2657,2821,2818,-3,-161,-164,-0.001063453,-0.057132718,-0.058135413
1558,2016,인천,강화군,2871000000,초등학교,2016-04-01,전체,394,389,399,10,-5,5,0.025706941,-0.012531328,0.01285347
1559,2016,인천,강화군,2871000000,초등학교,2016-04-01,여자,184,201,201,0,-17,-17,0,-0.084577114,-0.084577114
1560,2016,인천,강화군,2871000000,초등학교,2016-04-01,남자,210,188,198,10,12,22,0.053191489,0.060606061,0.117021277
1561,2016,인천,옹진군,2872000000,초등학교,2016-04-01,전체,114,126,120,-6,-6,-12,-0.047619048,-0.05,-0.095238095
1562,2016,인천,옹진군,2872000000,초등학교,2016-04-01,여자,52,67,56,-11,-4,-15,-0.164179104,-0.071428571,-0.223880597
1563,2016,인천,옹진군,2872000000,초등학교,2016-04-01,남자,62,59,64,5,-2,3,0.084745763,-0.03125,0.050847458
1564,2016,광주,동구,2911000000,초등학교,2016-04-01,전체,496,594,577,-17,-81,-98,-0.028619529,-0.140381282,-0.164983165
1565,2016,광주,동구,2911000000,초등학교,2016-04-01,여자,233,297,291,-6,-58,-64,-0.02020202,-0.199312715,-0.215488215
1566,2016,광주,동구,2911000000,초등학교,2016-04-01,남자,263,297,286,-11,-23,-34,-0.037037037,-0.08041958,-0.114478114
1567,2016,광주,서구,2914000000,초등학교,2016-04-01,전체,2724,2810,2747,-63,-23,-86,-0.022419929,-0.00837277,-0.030604982
1568,2016,광주,서구,2914000000,초등학교,2016-04-01,여자,1337,1322,1287,-35,50,15,-0.026475038,0.038850039,0.011346445
1569,2016,광주,서구,2914000000,초등학교,2016-04-01,남자,1387,1488,1460,-28,-73,-101,-0.018817204,-0.05,-0.067876344
1570,2016,광주,남구,2915500000,초등학교,2016-04-01,전체,1985,1720,1858,138,127,265,0.080232558,0.068353068,0.154069767
1571,2016,광주,남구,2915500000,초등학교,2016-04-01,여자,955,842,894,52,61,113,0.06175772,0.068232662,0.134204276
1572,2016,광주,남구,2915500000,초등학교,2016-04-01,남자,1030,878,964,86,66,152,0.097949886,0.06846473,0.173120729
1573,2016,광주,북구,2917000000,초등학교,2016-04-01,전체,3883,3873,3927,54,-44,10,0.01394268,-0.011204482,0.002581978
1574,2016,광주,북구,2917000000,초등학교,2016-04-01,여자,1807,1810,1832,22,-25,-3,0.012154696,-0.013646288,-0.001657459
1575,2016,광주,북구,2917000000,초등학교,2016-04-01,남자,2076,2063,2095,32,-19,13,0.015511391,-0.009069212,0.006301503
1576,2016,광주,광산구,2920000000,초등학교,2016-04-01,전체,5163,5194,5212,18,-49,-31,0.003465537,-0.009401381,-0.005968425
1577,2016,광주,광산구,2920000000,초등학교,2016-04-01,여자,2557,2526,2545,19,12,31,0.007521774,0.004715128,0.012272367
1578,2016,광주,광산구,2920000000,초등학교,2016-04-01,남자,2606,2668,2667,-1,-61,-62,-0.000374813,-0.022872141,-0.023238381
1579,2016,대전,동구,3011000000,초등학교,2016-04-01,전체,1971,2296,2132,-164,-161,-325,-0.071428571,-0.075515947,-0.141550523
1580,2016,대전,동구,3011000000,초등학교,2016-04-01,여자,936,1110,1030,-80,-94,-174,-0.072072072,-0.091262136,-0.156756757
1581,2016,대전,동구,3011000000,초등학교,2016-04-01,남자,1035,1186,1102,-84,-67,-151,-0.070826307,-0.060798548,-0.127318718
1582,2016,대전,중구,3014000000,초등학교,2016-04-01,전체,2067,2286,2156,-130,-89,-219,-0.056867892,-0.041280148,-0.095800525
1583,2016,대전,중구,3014000000,초등학교,2016-04-01,여자,1014,1124,1060,-64,-46,-110,-0.056939502,-0.043396226,-0.097864769
1584,2016,대전,중구,3014000000,초등학교,2016-04-01,남자,1053,1162,1096,-66,-43,-109,-0.056798623,-0.039233577,-0.093803787
1585,2016,대전,서구,3017000000,초등학교,2016-04-01,전체,4253,4399,4426,27,-173,-146,0.006137759,-0.039087212,-0.033189361
1586,2016,대전,서구,3017000000,초등학교,2016-04-01,여자,2043,2209,2210,1,-167,-166,0.000452694,-0.075565611,-0.075147125
1587,2016,대전,서구,3017000000,초등학교,2016-04-01,남자,2210,2190,2216,26,-6,20,0.011872146,-0.002707581,0.00913242
1588,2016,대전,유성구,3020000000,초등학교,2016-04-01,전체,3830,3898,3957,59,-127,-68,0.015135967,-0.032095021,-0.017444844
1589,2016,대전,유성구,3020000000,초등학교,2016-04-01,여자,1900,1872,1940,68,-40,28,0.036324786,-0.020618557,0.014957265
1590,2016,대전,유성구,3020000000,초등학교,2016-04-01,남자,1930,2026,2017,-9,-87,-96,-0.004442251,-0.043133366,-0.047384008
1591,2016,대전,대덕구,3023000000,초등학교,2016-04-01,전체,1575,1741,1692,-49,-117,-166,-0.028144744,-0.069148936,-0.095347501
1592,2016,대전,대덕구,3023000000,초등학교,2016-04-01,여자,741,826,803,-23,-62,-85,-0.027845036,-0.077210461,-0.102905569
1593,2016,대전,대덕구,3023000000,초등학교,2016-04-01,남자,834,915,889,-26,-55,-81,-0.028415301,-0.061867267,-0.08852459
1594,2016,울산,중구,3111000000,초등학교,2016-04-01,전체,2079,1942,2079,137,0,137,0.070545829,0,0.070545829
1595,2016,울산,중구,3111000000,초등학교,2016-04-01,여자,966,910,960,50,6,56,0.054945055,0.00625,0.061538462
1596,2016,울산,중구,3111000000,초등학교,2016-04-01,남자,1113,1032,1119,87,-6,81,0.084302326,-0.00536193,0.078488372
1597,2016,울산,남구,3114000000,초등학교,2016-04-01,전체,2702,2864,2820,-44,-118,-162,-0.015363128,-0.041843972,-0.056564246
1598,2016,울산,남구,3114000000,초등학교,2016-04-01,여자,1291,1367,1347,-20,-56,-76,-0.014630578,-0.041573868,-0.055596196
1599,2016,울산,남구,3114000000,초등학교,2016-04-01,남자,1411,1497,1473,-24,-62,-86,-0.016032064,-0.042090971,-0.05744823
1600,2016,울산,동구,3117000000,초등학교,2016-04-01,전체,1772,1957,1880,-77,-108,-185,-0.039345938,-0.057446809,-0.094532448
1601,2016,울산,동구,3117000000,초등학교,2016-04-01,여자,872,948,904,-44,-32,-76,-0.046413502,-0.03539823,-0.080168776
1602,2016,울산,동구,3117000000,초등학교,2016-04-01,남자,900,1009,976,-33,-76,-109,-0.032705649,-0.077868852,-0.10802775
1603,2016,울산,북구,3120000000,초등학교,2016-04-01,전체,2278,2313,2301,-12,-23,-35,-0.005188067,-0.009995654,-0.015131863
1604,2016,울산,북구,3120000000,초등학교,2016-04-01,여자,1055,1078,1081,3,-26,-23,0.002782931,-0.024051804,-0.021335807
1605,2016,울산,북구,3120000000,초등학교,2016-04-01,남자,1223,1235,1220,-15,3,-12,-0.012145749,0.002459016,-0.009716599
1606,2016,울산,울주군,3171000000,초등학교,2016-04-01,전체,2179,2156,2156,0,23,23,0,0.010667904,0.010667904
1607,2016,울산,울주군,3171000000,초등학교,2016-04-01,여자,1086,1044,1048,4,38,42,0.003831418,0.036259542,0.040229885
1608,2016,울산,울주군,3171000000,초등학교,2016-04-01,남자,1093,1112,1108,-4,-15,-19,-0.003597122,-0.013537906,-0.017086331
1609,2016,세종,세종시,3611000000,초등학교,2016-04-01,전체,3248,1444,2434,990,814,1804,0.685595568,0.334428924,1.249307479
1610,2016,세종,세종시,3611000000,초등학교,2016-04-01,전체,3248,1444,2434,990,814,1804,0.685595568,0.334428924,1.249307479
1611,2016,세종,세종시,3611000000,초등학교,2016-04-01,전체,3248,1444,2434,990,814,1804,0.685595568,0.334428924,1.249307479
1612,2016,세종,세종시,3611000000,초등학교,2016-04-01,전체,3248,1444,2434,990,814,1804,0.685595568,0.334428924,1.249307479
1613,2016,세종,세종시,3611000000,초등학교,2016-04-01,여자,1599,746,1211,465,388,853,0.623324397,0.320396367,1.143431635
1614,2016,세종,세종시,3611000000,초등학교,2016-04-01,여자,1599,746,1211,465,388,853,0.623324397,0.320396367,1.143431635
1615,2016,세종,세종시,3611000000,초등학교,2016-04-01,여자,1599,746,1211,465,388,853,0.623324397,0.320396367,1.143431635
1616,2016,세종,세종시,3611000000,초등학교,2016-04-01,여자,1599,746,1211,465,388,853,0.623324397,0.320396367,1.143431635
1617,2016,세종,세종시,3611000000,초등학교,2016-04-01,남자,1649,698,1223,525,426,951,0.752148997,0.348323794,1.362464183
1618,2016,세종,세종시,3611000000,초등학교,2016-04-01,남자,1649,698,1223,525,426,951,0.752148997,0.348323794,1.362464183
1619,2016,세종,세종시,3611000000,초등학교,2016-04-01,남자,1649,698,1223,525,426,951,0.752148997,0.348323794,1.362464183
1620,2016,세종,세종시,3611000000,초등학교,2016-04-01,남자,1649,698,1223,525,426,951,0.752148997,0.348323794,1.362464183
1621,2016,경기,수원시,4111000000,초등학교,2016-04-01,전체,11258,11340,11447,107,-189,-82,0.009435626,-0.016510876,-0.007231041
1622,2016,경기,수원시,4111000000,초등학교,2016-04-01,여자,5511,5566,5603,37,-92,-55,0.006647503,-0.016419775,-0.009881423
1623,2016,경기,수원시,4111000000,초등학교,2016-04-01,남자,5747,5774,5844,70,-97,-27,0.012123311,-0.01659822,-0.004676134
1624,2016,경기,성남시,4113000000,초등학교,2016-04-01,전체,7483,8036,7881,-155,-398,-553,-0.019288203,-0.050501205,-0.068815331
1625,2016,경기,성남시,4113000000,초등학교,2016-04-01,여자,3658,3971,3881,-90,-223,-313,-0.022664316,-0.057459418,-0.078821456
1626,2016,경기,성남시,4113000000,초등학교,2016-04-01,남자,3825,4065,4000,-65,-175,-240,-0.01599016,-0.04375,-0.05904059
1627,2016,경기,부천시,4119000000,초등학교,2016-04-01,전체,6657,7301,7106,-195,-449,-644,-0.02670867,-0.06318604,-0.088207095
1628,2016,경기,부천시,4119000000,초등학교,2016-04-01,여자,3254,3588,3496,-92,-242,-334,-0.025641026,-0.069221968,-0.093088071
1629,2016,경기,부천시,4119000000,초등학교,2016-04-01,남자,3403,3713,3610,-103,-207,-310,-0.027740372,-0.05734072,-0.083490439
1630,2016,경기,안양시,4117000000,초등학교,2016-04-01,전체,4642,4927,4837,-90,-195,-285,-0.018266694,-0.040314244,-0.05784453
1631,2016,경기,안양시,4117000000,초등학교,2016-04-01,여자,2253,2387,2357,-30,-104,-134,-0.012568077,-0.044123886,-0.056137411
1632,2016,경기,안양시,4117000000,초등학교,2016-04-01,남자,2389,2540,2480,-60,-91,-151,-0.023622047,-0.036693548,-0.059448819
1633,2016,경기,과천시,4129000000,초등학교,2016-04-01,전체,496,589,568,-21,-72,-93,-0.03565365,-0.126760563,-0.157894737
1634,2016,경기,과천시,4129000000,초등학교,2016-04-01,여자,238,279,274,-5,-36,-41,-0.017921147,-0.131386861,-0.146953405
1635,2016,경기,과천시,4129000000,초등학교,2016-04-01,남자,258,310,294,-16,-36,-52,-0.051612903,-0.12244898,-0.167741935
1636,2016,경기,안산시,4127000000,초등학교,2016-04-01,전체,5900,6315,6102,-213,-202,-415,-0.033729216,-0.0331039,-0.065716548
1637,2016,경기,안산시,4127000000,초등학교,2016-04-01,여자,2863,3017,2924,-93,-61,-154,-0.030825323,-0.020861833,-0.051044084
1638,2016,경기,안산시,4127000000,초등학교,2016-04-01,남자,3037,3298,3178,-120,-141,-261,-0.036385688,-0.044367527,-0.079138872
1639,2016,경기,용인시,4146000000,초등학교,2016-04-01,전체,10993,11340,11493,153,-500,-347,0.013492063,-0.043504742,-0.030599647
1640,2016,경기,용인시,4146000000,초등학교,2016-04-01,여자,5300,5517,5572,55,-272,-217,0.009969186,-0.048815506,-0.039332971
1641,2016,경기,용인시,4146000000,초등학교,2016-04-01,남자,5693,5823,5921,98,-228,-130,0.016829813,-0.038507009,-0.022325262
1642,2016,경기,군포시,4141000000,초등학교,2016-04-01,전체,2679,2866,2840,-26,-161,-187,-0.009071877,-0.056690141,-0.065247732
1643,2016,경기,군포시,4141000000,초등학교,2016-04-01,여자,1318,1379,1362,-17,-44,-61,-0.012327774,-0.032305433,-0.044234953
1644,2016,경기,군포시,4141000000,초등학교,2016-04-01,남자,1361,1487,1478,-9,-117,-126,-0.006052455,-0.079161028,-0.084734364
1645,2016,경기,의왕시,4143000000,초등학교,2016-04-01,전체,1368,1617,1530,-87,-162,-249,-0.05380334,-0.105882353,-0.153988868
1646,2016,경기,의왕시,4143000000,초등학교,2016-04-01,여자,667,816,755,-61,-88,-149,-0.074754902,-0.116556291,-0.182598039
1647,2016,경기,의왕시,4143000000,초등학교,2016-04-01,남자,701,801,775,-26,-74,-100,-0.032459426,-0.095483871,-0.124843945
1648,2016,경기,시흥시,4139000000,초등학교,2016-04-01,전체,4069,4064,3996,-68,73,5,-0.016732283,0.018268268,0.001230315
1649,2016,경기,시흥시,4139000000,초등학교,2016-04-01,여자,1963,1988,1962,-26,1,-25,-0.013078471,0.000509684,-0.012575453
1650,2016,경기,시흥시,4139000000,초등학교,2016-04-01,남자,2106,2076,2034,-42,72,30,-0.020231214,0.03539823,0.014450867
1651,2016,경기,평택시,4122000000,초등학교,2016-04-01,전체,4704,4589,4649,60,55,115,0.013074744,0.011830501,0.025059926
1652,2016,경기,평택시,4122000000,초등학교,2016-04-01,여자,2303,2214,2243,29,60,89,0.013098464,0.026749889,0.040198735
1653,2016,경기,평택시,4122000000,초등학교,2016-04-01,남자,2401,2375,2406,31,-5,26,0.013052632,-0.002078138,0.010947368
1654,2016,경기,화성시,4159000000,초등학교,2016-04-01,전체,8751,7917,8230,313,521,834,0.039535177,0.063304982,0.105342933
1655,2016,경기,화성시,4159000000,초등학교,2016-04-01,여자,4268,3852,4003,151,265,416,0.039200415,0.06620035,0.107995846
1656,2016,경기,화성시,4159000000,초등학교,2016-04-01,남자,4483,4065,4227,162,256,418,0.039852399,0.060563047,0.102829028
1657,2016,경기,오산시,4137000000,초등학교,2016-04-01,전체,2728,3012,2918,-94,-190,-284,-0.031208499,-0.065113091,-0.094289509
1658,2016,경기,오산시,4137000000,초등학교,2016-04-01,여자,1301,1467,1427,-40,-126,-166,-0.02726653,-0.088297127,-0.113156101
1659,2016,경기,오산시,4137000000,초등학교,2016-04-01,남자,1427,1545,1491,-54,-64,-118,-0.034951456,-0.042924212,-0.076375405
1660,2016,경기,광명시,4121000000,초등학교,2016-04-01,전체,3274,3497,3407,-90,-133,-223,-0.025736345,-0.039037276,-0.063768945
1661,2016,경기,광명시,4121000000,초등학교,2016-04-01,여자,1539,1665,1612,-53,-73,-126,-0.031831832,-0.04528536,-0.075675676
1662,2016,경기,광명시,4121000000,초등학교,2016-04-01,남자,1735,1832,1795,-37,-60,-97,-0.020196507,-0.033426184,-0.052947598
1663,2016,경기,광주시,4161000000,초등학교,2016-04-01,전체,2816,3050,3015,-35,-199,-234,-0.01147541,-0.066003317,-0.076721311
1664,2016,경기,광주시,4161000000,초등학교,2016-04-01,여자,1392,1461,1455,-6,-63,-69,-0.004106776,-0.043298969,-0.047227926
1665,2016,경기,광주시,4161000000,초등학교,2016-04-01,남자,1424,1589,1560,-29,-136,-165,-0.018250472,-0.087179487,-0.103838892
1666,2016,경기,하남시,4145000000,초등학교,2016-04-01,전체,1652,1320,1507,187,145,332,0.141666667,0.096217651,0.251515152
1667,2016,경기,하남시,4145000000,초등학교,2016-04-01,여자,816,635,735,100,81,181,0.157480315,0.110204082,0.28503937
1668,2016,경기,하남시,4145000000,초등학교,2016-04-01,남자,836,685,772,87,64,151,0.127007299,0.082901554,0.220437956
1669,2016,경기,김포시,4157000000,초등학교,2016-04-01,전체,4133,3903,4238,335,-105,230,0.085831412,-0.024775838,0.058929029
1670,2016,경기,김포시,4157000000,초등학교,2016-04-01,여자,1996,1872,2055,183,-59,124,0.09775641,-0.028710462,0.066239316
1671,2016,경기,김포시,4157000000,초등학교,2016-04-01,남자,2137,2031,2183,152,-46,106,0.07483998,-0.021071919,0.052191039
1672,2016,경기,이천시,4150000000,초등학교,2016-04-01,전체,2032,2190,2133,-57,-101,-158,-0.026027397,-0.047351149,-0.072146119
1673,2016,경기,이천시,4150000000,초등학교,2016-04-01,여자,968,1029,1006,-23,-38,-61,-0.022351798,-0.03777336,-0.059280855
1674,2016,경기,이천시,4150000000,초등학교,2016-04-01,남자,1064,1161,1127,-34,-63,-97,-0.029285099,-0.055900621,-0.083548665
1675,2016,경기,안성시,4155000000,초등학교,2016-04-01,전체,1802,1929,1891,-38,-89,-127,-0.019699326,-0.047065045,-0.065837221
1676,2016,경기,안성시,4155000000,초등학교,2016-04-01,여자,883,926,905,-21,-22,-43,-0.022678186,-0.024309392,-0.046436285
1677,2016,경기,안성시,4155000000,초등학교,2016-04-01,남자,919,1003,986,-17,-67,-84,-0.016949153,-0.067951318,-0.083748754
1678,2016,경기,여주시,4167000000,초등학교,2016-04-01,전체,908,865,882,17,26,43,0.019653179,0.029478458,0.049710983
1679,2016,경기,여주시,4167000000,초등학교,2016-04-01,여자,427,401,409,8,18,26,0.019950125,0.04400978,0.064837905
1680,2016,경기,여주시,4167000000,초등학교,2016-04-01,남자,481,464,473,9,8,17,0.019396552,0.016913319,0.036637931
1681,2016,경기,양평군,4183000000,초등학교,2016-04-01,전체,822,761,805,44,17,61,0.05781866,0.021118012,0.080157687
1682,2016,경기,양평군,4183000000,초등학교,2016-04-01,여자,391,383,401,18,-10,8,0.046997389,-0.024937656,0.020887728
1683,2016,경기,양평군,4183000000,초등학교,2016-04-01,남자,431,378,404,26,27,53,0.068783069,0.066831683,0.14021164
1684,2016,경기,고양시,4128000000,초등학교,2016-04-01,전체,8646,8858,9097,239,-451,-212,0.02698126,-0.049576784,-0.023933168
1685,2016,경기,고양시,4128000000,초등학교,2016-04-01,여자,4156,4245,4348,103,-192,-89,0.02426384,-0.044158234,-0.020965842
1686,2016,경기,고양시,4128000000,초등학교,2016-04-01,남자,4490,4613,4749,136,-259,-123,0.029481899,-0.054537797,-0.026663776
1687,2016,경기,남양주시,4136000000,초등학교,2016-04-01,전체,7049,7196,7308,112,-259,-147,0.015564202,-0.035440613,-0.020428016
1688,2016,경기,남양주시,4136000000,초등학교,2016-04-01,여자,3421,3500,3544,44,-123,-79,0.012571429,-0.034706546,-0.022571429
1689,2016,경기,남양주시,4136000000,초등학교,2016-04-01,남자,3628,3696,3764,68,-136,-68,0.018398268,-0.036131775,-0.018398268
1690,2016,경기,구리시,4131000000,초등학교,2016-04-01,전체,1524,1702,1650,-52,-126,-178,-0.030552291,-0.076363636,-0.104582844
1691,2016,경기,구리시,4131000000,초등학교,2016-04-01,여자,720,794,769,-25,-49,-74,-0.031486146,-0.063719116,-0.093198992
1692,2016,경기,구리시,4131000000,초등학교,2016-04-01,남자,804,908,881,-27,-77,-104,-0.029735683,-0.087400681,-0.114537445
1693,2016,경기,의정부시,4115000000,초등학교,2016-04-01,전체,3466,3767,3681,-86,-215,-301,-0.022829838,-0.058408041,-0.079904433
1694,2016,경기,의정부시,4115000000,초등학교,2016-04-01,여자,1735,1859,1814,-45,-79,-124,-0.024206563,-0.043550165,-0.066702528
1695,2016,경기,의정부시,4115000000,초등학교,2016-04-01,남자,1731,1908,1867,-41,-136,-177,-0.02148847,-0.072844135,-0.092767296
1696,2016,경기,파주시,4148000000,초등학교,2016-04-01,전체,4591,4599,4721,122,-130,-8,0.026527506,-0.027536539,-0.001739509
1697,2016,경기,파주시,4148000000,초등학교,2016-04-01,여자,2195,2224,2289,65,-94,-29,0.029226619,-0.041065968,-0.013039568
1698,2016,경기,파주시,4148000000,초등학교,2016-04-01,남자,2396,2375,2432,57,-36,21,0.024,-0.014802632,0.008842105
1699,2016,경기,동두천시,4125000000,초등학교,2016-04-01,전체,863,926,919,-7,-56,-63,-0.007559395,-0.0609358,-0.068034557
1700,2016,경기,동두천시,4125000000,초등학교,2016-04-01,여자,432,463,459,-4,-27,-31,-0.008639309,-0.058823529,-0.066954644
1701,2016,경기,동두천시,4125000000,초등학교,2016-04-01,남자,431,463,460,-3,-29,-32,-0.006479482,-0.063043478,-0.069114471
1702,2016,경기,양주시,4163000000,초등학교,2016-04-01,전체,2141,2091,2142,51,-1,50,0.024390244,-0.000466853,0.023912004
1703,2016,경기,양주시,4163000000,초등학교,2016-04-01,여자,1052,1029,1057,28,-5,23,0.027210884,-0.004730369,0.022351798
1704,2016,경기,양주시,4163000000,초등학교,2016-04-01,남자,1089,1062,1085,23,4,27,0.02165725,0.003686636,0.025423729
1705,2016,경기,포천시,4165000000,초등학교,2016-04-01,전체,1192,1295,1290,-5,-98,-103,-0.003861004,-0.075968992,-0.07953668
1706,2016,경기,포천시,4165000000,초등학교,2016-04-01,여자,589,615,617,2,-28,-26,0.003252033,-0.045380875,-0.042276423
1707,2016,경기,포천시,4165000000,초등학교,2016-04-01,남자,603,680,673,-7,-70,-77,-0.010294118,-0.104011887,-0.113235294
1708,2016,경기,가평군,4182000000,초등학교,2016-04-01,전체,418,426,413,-13,5,-8,-0.030516432,0.012106538,-0.018779343
1709,2016,경기,가평군,4182000000,초등학교,2016-04-01,여자,201,207,198,-9,3,-6,-0.043478261,0.015151515,-0.028985507
1710,2016,경기,가평군,4182000000,초등학교,2016-04-01,남자,217,219,215,-4,2,-2,-0.01826484,0.009302326,-0.00913242
1711,2016,경기,연천군,4180000000,초등학교,2016-04-01,전체,271,320,299,-21,-28,-49,-0.065625,-0.093645485,-0.153125
1712,2016,경기,연천군,4180000000,초등학교,2016-04-01,여자,124,145,134,-11,-10,-21,-0.075862069,-0.074626866,-0.144827586
1713,2016,경기,연천군,4180000000,초등학교,2016-04-01,남자,147,175,165,-10,-18,-28,-0.057142857,-0.109090909,-0.16
1714,2016,강원,춘천시,4211000000,초등학교,2016-04-01,전체,2297,2324,2372,48,-75,-27,0.020654045,-0.031618887,-0.0116179
1715,2016,강원,춘천시,4211000000,초등학교,2016-04-01,여자,1107,1119,1139,20,-32,-12,0.017873101,-0.02809482,-0.010723861
1716,2016,강원,춘천시,4211000000,초등학교,2016-04-01,남자,1190,1205,1233,28,-43,-15,0.023236515,-0.03487429,-0.012448133
1717,2016,강원,원주시,4213000000,초등학교,2016-04-01,전체,3173,3000,3025,25,148,173,0.008333333,0.04892562,0.057666667
1718,2016,강원,원주시,4213000000,초등학교,2016-04-01,여자,1518,1467,1484,17,34,51,0.011588275,0.022911051,0.034764826
1719,2016,강원,원주시,4213000000,초등학교,2016-04-01,남자,1655,1533,1541,8,114,122,0.005218526,0.073977936,0.079582518
1720,2016,강원,강릉시,4215000000,초등학교,2016-04-01,전체,1659,1647,1666,19,-7,12,0.011536126,-0.004201681,0.007285974
1721,2016,강원,강릉시,4215000000,초등학교,2016-04-01,여자,839,812,826,14,13,27,0.017241379,0.015738499,0.033251232
1722,2016,강원,강릉시,4215000000,초등학교,2016-04-01,남자,820,835,840,5,-20,-15,0.005988024,-0.023809524,-0.017964072
1723,2016,강원,동해시,4217000000,초등학교,2016-04-01,전체,869,847,865,18,4,22,0.021251476,0.004624277,0.025974026
1724,2016,강원,동해시,4217000000,초등학교,2016-04-01,여자,440,399,412,13,28,41,0.032581454,0.067961165,0.102756892
1725,2016,강원,동해시,4217000000,초등학교,2016-04-01,남자,429,448,453,5,-24,-19,0.011160714,-0.052980132,-0.042410714
1726,2016,강원,태백시,4219000000,초등학교,2016-04-01,전체,399,416,401,-15,-2,-17,-0.036057692,-0.004987531,-0.040865385
1727,2016,강원,태백시,4219000000,초등학교,2016-04-01,여자,210,216,208,-8,2,-6,-0.037037037,0.009615385,-0.027777778
1728,2016,강원,태백시,4219000000,초등학교,2016-04-01,남자,189,200,193,-7,-4,-11,-0.035,-0.020725389,-0.055
1729,2016,강원,속초시,4221000000,초등학교,2016-04-01,전체,597,634,628,-6,-31,-37,-0.009463722,-0.049363057,-0.058359621
1730,2016,강원,속초시,4221000000,초등학교,2016-04-01,여자,283,302,300,-2,-17,-19,-0.006622517,-0.056666667,-0.062913907
1731,2016,강원,속초시,4221000000,초등학교,2016-04-01,남자,314,332,328,-4,-14,-18,-0.012048193,-0.042682927,-0.054216867
1732,2016,강원,삼척시,4223000000,초등학교,2016-04-01,전체,461,463,469,6,-8,-2,0.012958963,-0.017057569,-0.004319654
1733,2016,강원,삼척시,4223000000,초등학교,2016-04-01,여자,212,222,222,0,-10,-10,0,-0.045045045,-0.045045045
1734,2016,강원,삼척시,4223000000,초등학교,2016-04-01,남자,249,241,247,6,2,8,0.024896266,0.008097166,0.033195021
1735,2016,강원,홍천군,4272000000,초등학교,2016-04-01,전체,504,496,497,1,7,8,0.002016129,0.014084507,0.016129032
1736,2016,강원,홍천군,4272000000,초등학교,2016-04-01,여자,230,231,236,5,-6,-1,0.021645022,-0.025423729,-0.004329004
1737,2016,강원,홍천군,4272000000,초등학교,2016-04-01,남자,274,265,261,-4,13,9,-0.01509434,0.049808429,0.033962264
1738,2016,강원,횡성군,4273000000,초등학교,2016-04-01,전체,260,275,278,3,-18,-15,0.010909091,-0.064748201,-0.054545455
1739,2016,강원,횡성군,4273000000,초등학교,2016-04-01,여자,125,144,144,0,-19,-19,0,-0.131944444,-0.131944444
1740,2016,강원,횡성군,4273000000,초등학교,2016-04-01,남자,135,131,134,3,1,4,0.022900763,0.007462687,0.030534351
1741,2016,강원,영월군,4275000000,초등학교,2016-04-01,전체,205,213,200,-13,5,-8,-0.061032864,0.025,-0.037558685
1742,2016,강원,영월군,4275000000,초등학교,2016-04-01,여자,92,103,98,-5,-6,-11,-0.048543689,-0.06122449,-0.106796117
1743,2016,강원,영월군,4275000000,초등학교,2016-04-01,남자,113,110,102,-8,11,3,-0.072727273,0.107843137,0.027272727
1744,2016,강원,평창군,4276000000,초등학교,2016-04-01,전체,258,262,252,-10,6,-4,-0.038167939,0.023809524,-0.015267176
1745,2016,강원,평창군,4276000000,초등학교,2016-04-01,여자,130,129,126,-3,4,1,-0.023255814,0.031746032,0.007751938
1746,2016,강원,평창군,4276000000,초등학교,2016-04-01,남자,128,133,126,-7,2,-5,-0.052631579,0.015873016,-0.037593985
1747,2016,강원,정선군,4277000000,초등학교,2016-04-01,전체,267,268,263,-5,4,-1,-0.018656716,0.015209125,-0.003731343
1748,2016,강원,정선군,4277000000,초등학교,2016-04-01,여자,124,131,127,-4,-3,-7,-0.030534351,-0.023622047,-0.053435115
1749,2016,강원,정선군,4277000000,초등학교,2016-04-01,남자,143,137,136,-1,7,6,-0.00729927,0.051470588,0.04379562
1750,2016,강원,철원군,4278000000,초등학교,2016-04-01,전체,361,383,363,-20,-2,-22,-0.052219321,-0.005509642,-0.057441253
1751,2016,강원,철원군,4278000000,초등학교,2016-04-01,여자,177,184,169,-15,8,-7,-0.081521739,0.047337278,-0.038043478
1752,2016,강원,철원군,4278000000,초등학교,2016-04-01,남자,184,199,194,-5,-10,-15,-0.025125628,-0.051546392,-0.075376884
1753,2016,강원,화천군,4279000000,초등학교,2016-04-01,전체,208,227,209,-18,-1,-19,-0.079295154,-0.004784689,-0.083700441
1754,2016,강원,화천군,4279000000,초등학교,2016-04-01,여자,111,122,114,-8,-3,-11,-0.06557377,-0.026315789,-0.090163934
1755,2016,강원,화천군,4279000000,초등학교,2016-04-01,남자,97,105,95,-10,2,-8,-0.095238095,0.021052632,-0.076190476
1756,2016,강원,양구군,4280000000,초등학교,2016-04-01,전체,166,198,204,6,-38,-32,0.03030303,-0.18627451,-0.161616162
1757,2016,강원,양구군,4280000000,초등학교,2016-04-01,여자,81,99,100,1,-19,-18,0.01010101,-0.19,-0.181818182
1758,2016,강원,양구군,4280000000,초등학교,2016-04-01,남자,85,99,104,5,-19,-14,0.050505051,-0.182692308,-0.141414141
1759,2016,강원,인제군,4281000000,초등학교,2016-04-01,전체,264,285,271,-14,-7,-21,-0.049122807,-0.025830258,-0.073684211
1760,2016,강원,인제군,4281000000,초등학교,2016-04-01,여자,127,131,126,-5,1,-4,-0.038167939,0.007936508,-0.030534351
1761,2016,강원,인제군,4281000000,초등학교,2016-04-01,남자,137,154,145,-9,-8,-17,-0.058441558,-0.055172414,-0.11038961
1762,2016,강원,고성군,4282000000,초등학교,2016-04-01,전체,144,143,144,1,0,1,0.006993007,0,0.006993007
1763,2016,강원,고성군,4282000000,초등학교,2016-04-01,여자,75,75,73,-2,2,0,-0.026666667,0.02739726,0
1764,2016,강원,고성군,4282000000,초등학교,2016-04-01,남자,69,68,71,3,-2,1,0.044117647,-0.028169014,0.014705882
1765,2016,강원,양양군,4283000000,초등학교,2016-04-01,전체,151,148,156,8,-5,3,0.054054054,-0.032051282,0.02027027
1766,2016,강원,양양군,4283000000,초등학교,2016-04-01,여자,81,76,83,7,-2,5,0.092105263,-0.024096386,0.065789474
1767,2016,강원,양양군,4283000000,초등학교,2016-04-01,남자,70,72,73,1,-3,-2,0.013888889,-0.04109589,-0.027777778
1768,2016,충북,청주시,4311000000,초등학교,2016-04-01,전체,8134,6672,8317,1645,-183,1462,0.246552758,-0.022003126,0.2191247
1769,2016,충북,청주시,4311000000,초등학교,2016-04-01,여자,3871,3158,3956,798,-85,713,0.252691577,-0.02148635,0.225775807
1770,2016,충북,청주시,4311000000,초등학교,2016-04-01,남자,4263,3514,4361,847,-98,749,0.241035857,-0.02247191,0.21314741
1771,2016,충북,충주시,4313000000,초등학교,2016-04-01,전체,1594,1629,1643,14,-49,-35,0.00859423,-0.029823494,-0.021485574
1772,2016,충북,충주시,4313000000,초등학교,2016-04-01,여자,805,840,855,15,-50,-35,0.017857143,-0.058479532,-0.041666667
1773,2016,충북,충주시,4313000000,초등학교,2016-04-01,남자,789,789,788,-1,1,0,-0.001267427,0.001269036,0
1774,2016,충북,제천시,4315000000,초등학교,2016-04-01,전체,993,1042,1031,-11,-38,-49,-0.010556622,-0.03685742,-0.047024952
1775,2016,충북,제천시,4315000000,초등학교,2016-04-01,여자,497,531,530,-1,-33,-34,-0.001883239,-0.062264151,-0.064030132
1776,2016,충북,제천시,4315000000,초등학교,2016-04-01,남자,496,511,501,-10,-5,-15,-0.019569472,-0.00998004,-0.029354207
1777,2016,충북,보은군,4372000000,초등학교,2016-04-01,전체,196,193,184,-9,12,3,-0.046632124,0.065217391,0.015544041
1778,2016,충북,보은군,4372000000,초등학교,2016-04-01,여자,95,92,85,-7,10,3,-0.076086957,0.117647059,0.032608696
1779,2016,충북,보은군,4372000000,초등학교,2016-04-01,남자,101,101,99,-2,2,0,-0.01980198,0.02020202,0
1780,2016,충북,옥천군,4373000000,초등학교,2016-04-01,전체,350,354,355,1,-5,-4,0.002824859,-0.014084507,-0.011299435
1781,2016,충북,옥천군,4373000000,초등학교,2016-04-01,여자,171,168,171,3,0,3,0.017857143,0,0.017857143
1782,2016,충북,옥천군,4373000000,초등학교,2016-04-01,남자,179,186,184,-2,-5,-7,-0.010752688,-0.027173913,-0.037634409
1783,2016,충북,영동군,4374000000,초등학교,2016-04-01,전체,272,320,321,1,-49,-48,0.003125,-0.152647975,-0.15
1784,2016,충북,영동군,4374000000,초등학교,2016-04-01,여자,129,152,156,4,-27,-23,0.026315789,-0.173076923,-0.151315789
1785,2016,충북,영동군,4374000000,초등학교,2016-04-01,남자,143,168,165,-3,-22,-25,-0.017857143,-0.133333333,-0.148809524
1786,2016,충북,진천군,4375000000,초등학교,2016-04-01,전체,681,574,597,23,84,107,0.040069686,0.140703518,0.18641115
1787,2016,충북,진천군,4375000000,초등학교,2016-04-01,여자,356,299,314,15,42,57,0.050167224,0.133757962,0.190635452
1788,2016,충북,진천군,4375000000,초등학교,2016-04-01,남자,325,275,283,8,42,50,0.029090909,0.148409894,0.181818182
1789,2016,충북,괴산군,4376000000,초등학교,2016-04-01,전체,182,182,194,12,-12,0,0.065934066,-0.06185567,0
1790,2016,충북,괴산군,4376000000,초등학교,2016-04-01,여자,105,83,97,14,8,22,0.168674699,0.082474227,0.265060241
1791,2016,충북,괴산군,4376000000,초등학교,2016-04-01,남자,77,99,97,-2,-20,-22,-0.02020202,-0.206185567,-0.222222222
1792,2016,충북,음성군,4377000000,초등학교,2016-04-01,전체,785,765,801,36,-16,20,0.047058824,-0.019975031,0.026143791
1793,2016,충북,음성군,4377000000,초등학교,2016-04-01,여자,358,350,360,10,-2,8,0.028571429,-0.005555556,0.022857143
1794,2016,충북,음성군,4377000000,초등학교,2016-04-01,남자,427,415,441,26,-14,12,0.062650602,-0.031746032,0.028915663
1795,2016,충북,단양군,4380000000,초등학교,2016-04-01,전체,175,158,165,7,10,17,0.044303797,0.060606061,0.107594937
1796,2016,충북,단양군,4380000000,초등학교,2016-04-01,여자,75,70,73,3,2,5,0.042857143,0.02739726,0.071428571
1797,2016,충북,단양군,4380000000,초등학교,2016-04-01,남자,100,88,92,4,8,12,0.045454545,0.086956522,0.136363636
1798,2016,충북,증평군,4374500000,초등학교,2016-04-01,전체,341,392,384,-8,-43,-51,-0.020408163,-0.111979167,-0.130102041
1799,2016,충북,증평군,4374500000,초등학교,2016-04-01,여자,148,193,183,-10,-35,-45,-0.051813472,-0.191256831,-0.233160622
1800,2016,충북,증평군,4374500000,초등학교,2016-04-01,남자,193,199,201,2,-8,-6,0.010050251,-0.039800995,-0.030150754
1801,2016,충남,천안시,4413000000,초등학교,2016-04-01,전체,6326,6332,6330,-2,-4,-6,-0.000315856,-0.000631912,-0.000947568
1802,2016,충남,천안시,4413000000,초등학교,2016-04-01,여자,3053,3030,3033,3,20,23,0.000990099,0.006594131,0.007590759
1803,2016,충남,천안시,4413000000,초등학교,2016-04-01,남자,3273,3302,3297,-5,-24,-29,-0.001514234,-0.007279345,-0.008782556
1804,2016,충남,공주시,4415000000,초등학교,2016-04-01,전체,731,796,753,-43,-22,-65,-0.054020101,-0.029216467,-0.081658291
1805,2016,충남,공주시,4415000000,초등학교,2016-04-01,여자,351,401,373,-28,-22,-50,-0.069825436,-0.058981233,-0.124688279
1806,2016,충남,공주시,4415000000,초등학교,2016-04-01,남자,380,395,380,-15,0,-15,-0.037974684,0,-0.037974684
1807,2016,충남,보령시,4418000000,초등학교,2016-04-01,전체,768,786,787,1,-19,-18,0.001272265,-0.024142313,-0.022900763
1808,2016,충남,보령시,4418000000,초등학교,2016-04-01,여자,380,401,405,4,-25,-21,0.009975062,-0.061728395,-0.052369077
1809,2016,충남,보령시,4418000000,초등학교,2016-04-01,남자,388,385,382,-3,6,3,-0.007792208,0.015706806,0.007792208
1810,2016,충남,아산시,4420000000,초등학교,2016-04-01,전체,3564,3816,3796,-20,-232,-252,-0.00524109,-0.061116965,-0.066037736
1811,2016,충남,아산시,4420000000,초등학교,2016-04-01,여자,1747,1899,1888,-11,-141,-152,-0.005792522,-0.074682203,-0.080042127
1812,2016,충남,아산시,4420000000,초등학교,2016-04-01,남자,1817,1917,1908,-9,-91,-100,-0.004694836,-0.04769392,-0.052164841
1813,2016,충남,서산시,4421000000,초등학교,2016-04-01,전체,1641,1700,1705,5,-64,-59,0.002941176,-0.037536657,-0.034705882
1814,2016,충남,서산시,4421000000,초등학교,2016-04-01,여자,757,800,809,9,-52,-43,0.01125,-0.064276885,-0.05375
1815,2016,충남,서산시,4421000000,초등학교,2016-04-01,남자,884,900,896,-4,-12,-16,-0.004444444,-0.013392857,-0.017777778
1816,2016,충남,논산시,4423000000,초등학교,2016-04-01,전체,919,901,906,5,13,18,0.00554939,0.014348786,0.019977802
1817,2016,충남,논산시,4423000000,초등학교,2016-04-01,여자,452,448,445,-3,7,4,-0.006696429,0.015730337,0.008928571
1818,2016,충남,논산시,4423000000,초등학교,2016-04-01,남자,467,453,461,8,6,14,0.017660044,0.013015184,0.030905077
1819,2016,충남,계룡시,4425000000,초등학교,2016-04-01,전체,455,481,453,-28,2,-26,-0.058212058,0.004415011,-0.054054054
1820,2016,충남,계룡시,4425000000,초등학교,2016-04-01,여자,195,218,202,-16,-7,-23,-0.073394495,-0.034653465,-0.105504587
1821,2016,충남,계룡시,4425000000,초등학교,2016-04-01,남자,260,263,251,-12,9,-3,-0.045627376,0.035856574,-0.011406844
1822,2016,충남,금산군,4471000000,초등학교,2016-04-01,전체,377,410,406,-4,-29,-33,-0.009756098,-0.071428571,-0.080487805
1823,2016,충남,금산군,4471000000,초등학교,2016-04-01,여자,187,210,205,-5,-18,-23,-0.023809524,-0.087804878,-0.10952381
1824,2016,충남,금산군,4471000000,초등학교,2016-04-01,남자,190,200,201,1,-11,-10,0.005,-0.054726368,-0.05
1825,2016,충남,부여군,4476000000,초등학교,2016-04-01,전체,377,393,406,13,-29,-16,0.03307888,-0.071428571,-0.040712468
1826,2016,충남,부여군,4476000000,초등학교,2016-04-01,여자,177,198,202,4,-25,-21,0.02020202,-0.123762376,-0.106060606
1827,2016,충남,부여군,4476000000,초등학교,2016-04-01,남자,200,195,204,9,-4,5,0.046153846,-0.019607843,0.025641026
1828,2016,충남,서천군,4477000000,초등학교,2016-04-01,전체,293,309,312,3,-19,-16,0.009708738,-0.060897436,-0.051779935
1829,2016,충남,서천군,4477000000,초등학교,2016-04-01,여자,144,153,157,4,-13,-9,0.026143791,-0.082802548,-0.058823529
1830,2016,충남,서천군,4477000000,초등학교,2016-04-01,남자,149,156,155,-1,-6,-7,-0.006410256,-0.038709677,-0.044871795
1831,2016,충남,청양군,4479000000,초등학교,2016-04-01,전체,144,167,168,1,-24,-23,0.005988024,-0.142857143,-0.137724551
1832,2016,충남,청양군,4479000000,초등학교,2016-04-01,여자,81,93,92,-1,-11,-12,-0.010752688,-0.119565217,-0.129032258
1833,2016,충남,청양군,4479000000,초등학교,2016-04-01,남자,63,74,76,2,-13,-11,0.027027027,-0.171052632,-0.148648649
1834,2016,충남,홍성군,4480000000,초등학교,2016-04-01,전체,849,655,713,58,136,194,0.088549618,0.190743338,0.296183206
1835,2016,충남,홍성군,4480000000,초등학교,2016-04-01,여자,420,337,351,14,69,83,0.041543027,0.196581197,0.246290801
1836,2016,충남,홍성군,4480000000,초등학교,2016-04-01,남자,429,318,362,44,67,111,0.13836478,0.185082873,0.349056604
1837,2016,충남,예산군,4481000000,초등학교,2016-04-01,전체,484,518,510,-8,-26,-34,-0.015444015,-0.050980392,-0.065637066
1838,2016,충남,예산군,4481000000,초등학교,2016-04-01,여자,220,262,256,-6,-36,-42,-0.022900763,-0.140625,-0.160305344
1839,2016,충남,예산군,4481000000,초등학교,2016-04-01,남자,264,256,254,-2,10,8,-0.0078125,0.039370079,0.03125
1840,2016,충남,태안군,4482500000,초등학교,2016-04-01,전체,429,377,390,13,39,52,0.034482759,0.1,0.137931034
1841,2016,충남,태안군,4482500000,초등학교,2016-04-01,여자,205,169,176,7,29,36,0.041420118,0.164772727,0.213017751
1842,2016,충남,태안군,4482500000,초등학교,2016-04-01,남자,224,208,214,6,10,16,0.028846154,0.046728972,0.076923077
1843,2016,충남,당진시,4427000000,초등학교,2016-04-01,전체,1691,1778,1756,-22,-65,-87,-0.012373453,-0.037015945,-0.048931384
1844,2016,충남,당진시,4427000000,초등학교,2016-04-01,여자,846,876,856,-20,-10,-30,-0.02283105,-0.011682243,-0.034246575
1845,2016,충남,당진시,4427000000,초등학교,2016-04-01,남자,845,902,900,-2,-55,-57,-0.002217295,-0.061111111,-0.063192905
1846,2016,전북,전주시,4511000000,초등학교,2016-04-01,전체,6041,6057,6135,78,-94,-16,0.012877662,-0.015321923,-0.002641572
1847,2016,전북,전주시,4511000000,초등학교,2016-04-01,여자,2941,2888,2942,54,-1,53,0.018698061,-0.000339905,0.018351801
1848,2016,전북,전주시,4511000000,초등학교,2016-04-01,남자,3100,3169,3193,24,-93,-69,0.007573367,-0.029126214,-0.02177343
1849,2016,전북,군산시,4513000000,초등학교,2016-04-01,전체,2597,2703,2687,-16,-90,-106,-0.005919349,-0.033494604,-0.039215686
1850,2016,전북,군산시,4513000000,초등학교,2016-04-01,여자,1270,1337,1335,-2,-65,-67,-0.001495886,-0.048689139,-0.050112191
1851,2016,전북,군산시,4513000000,초등학교,2016-04-01,남자,1327,1366,1352,-14,-25,-39,-0.010248902,-0.018491124,-0.028550512
1852,2016,전북,익산시,4514000000,초등학교,2016-04-01,전체,2534,2537,2548,11,-14,-3,0.00433583,-0.005494505,-0.001182499
1853,2016,전북,익산시,4514000000,초등학교,2016-04-01,여자,1252,1274,1265,-9,-13,-22,-0.007064364,-0.01027668,-0.017268446
1854,2016,전북,익산시,4514000000,초등학교,2016-04-01,남자,1282,1263,1283,20,-1,19,0.015835313,-0.000779423,0.015043547
1855,2016,전북,정읍시,4518000000,초등학교,2016-04-01,전체,812,795,798,3,14,17,0.003773585,0.01754386,0.021383648
1856,2016,전북,정읍시,4518000000,초등학교,2016-04-01,여자,354,372,372,0,-18,-18,0,-0.048387097,-0.048387097
1857,2016,전북,정읍시,4518000000,초등학교,2016-04-01,남자,458,423,426,3,32,35,0.007092199,0.075117371,0.082742317
1858,2016,전북,남원시,4519000000,초등학교,2016-04-01,전체,616,621,629,8,-13,-5,0.012882448,-0.020667727,-0.00805153
1859,2016,전북,남원시,4519000000,초등학교,2016-04-01,여자,284,290,290,0,-6,-6,0,-0.020689655,-0.020689655
1860,2016,전북,남원시,4519000000,초등학교,2016-04-01,남자,332,331,339,8,-7,1,0.024169184,-0.020648968,0.003021148
1861,2016,전북,김제시,4521000000,초등학교,2016-04-01,전체,591,605,614,9,-23,-14,0.014876033,-0.037459283,-0.023140496
1862,2016,전북,김제시,4521000000,초등학교,2016-04-01,여자,292,297,300,3,-8,-5,0.01010101,-0.026666667,-0.016835017
1863,2016,전북,김제시,4521000000,초등학교,2016-04-01,남자,299,308,314,6,-15,-9,0.019480519,-0.047770701,-0.029220779
1864,2016,전북,완주군,4571000000,초등학교,2016-04-01,전체,848,904,938,34,-90,-56,0.037610619,-0.095948827,-0.061946903
1865,2016,전북,완주군,4571000000,초등학교,2016-04-01,여자,405,440,448,8,-43,-35,0.018181818,-0.095982143,-0.079545455
1866,2016,전북,완주군,4571000000,초등학교,2016-04-01,남자,443,464,490,26,-47,-21,0.056034483,-0.095918367,-0.045258621
1867,2016,전북,진안군,4572000000,초등학교,2016-04-01,전체,152,187,174,-13,-22,-35,-0.069518717,-0.126436782,-0.187165775
1868,2016,전북,진안군,4572000000,초등학교,2016-04-01,여자,72,94,87,-7,-15,-22,-0.074468085,-0.172413793,-0.234042553
1869,2016,전북,진안군,4572000000,초등학교,2016-04-01,남자,80,93,87,-6,-7,-13,-0.064516129,-0.08045977,-0.139784946
1870,2016,전북,무주군,4573000000,초등학교,2016-04-01,전체,178,157,158,1,20,21,0.006369427,0.126582278,0.133757962
1871,2016,전북,무주군,4573000000,초등학교,2016-04-01,여자,103,87,90,3,13,16,0.034482759,0.144444444,0.183908046
1872,2016,전북,무주군,4573000000,초등학교,2016-04-01,남자,75,70,68,-2,7,5,-0.028571429,0.102941176,0.071428571
1873,2016,전북,장수군,4574000000,초등학교,2016-04-01,전체,146,155,167,12,-21,-9,0.077419355,-0.125748503,-0.058064516
1874,2016,전북,장수군,4574000000,초등학교,2016-04-01,여자,68,78,84,6,-16,-10,0.076923077,-0.19047619,-0.128205128
1875,2016,전북,장수군,4574000000,초등학교,2016-04-01,남자,78,77,83,6,-5,1,0.077922078,-0.060240964,0.012987013
1876,2016,전북,임실군,4575000000,초등학교,2016-04-01,전체,163,181,182,1,-19,-18,0.005524862,-0.104395604,-0.099447514
1877,2016,전북,임실군,4575000000,초등학교,2016-04-01,여자,79,87,89,2,-10,-8,0.022988506,-0.112359551,-0.091954023
1878,2016,전북,임실군,4575000000,초등학교,2016-04-01,남자,84,94,93,-1,-9,-10,-0.010638298,-0.096774194,-0.106382979
1879,2016,전북,순창군,4577000000,초등학교,2016-04-01,전체,181,211,209,-2,-28,-30,-0.009478673,-0.133971292,-0.142180095
1880,2016,전북,순창군,4577000000,초등학교,2016-04-01,여자,87,84,84,0,3,3,0,0.035714286,0.035714286
1881,2016,전북,순창군,4577000000,초등학교,2016-04-01,남자,94,127,125,-2,-31,-33,-0.015748031,-0.248,-0.25984252
1882,2016,전북,고창군,4579000000,초등학교,2016-04-01,전체,346,341,343,2,3,5,0.005865103,0.008746356,0.014662757
1883,2016,전북,고창군,4579000000,초등학교,2016-04-01,여자,175,168,168,0,7,7,0,0.041666667,0.041666667
1884,2016,전북,고창군,4579000000,초등학교,2016-04-01,남자,171,173,175,2,-4,-2,0.011560694,-0.022857143,-0.011560694
1885,2016,전북,부안군,4580000000,초등학교,2016-04-01,전체,317,355,351,-4,-34,-38,-0.011267606,-0.096866097,-0.107042254
1886,2016,전북,부안군,4580000000,초등학교,2016-04-01,여자,161,178,175,-3,-14,-17,-0.016853933,-0.08,-0.095505618
1887,2016,전북,부안군,4580000000,초등학교,2016-04-01,남자,156,177,176,-1,-20,-21,-0.005649718,-0.113636364,-0.118644068
1888,2016,전남,목포시,4611000000,초등학교,2016-04-01,전체,2538,2458,2472,14,66,80,0.005695688,0.026699029,0.032546786
1889,2016,전남,목포시,4611000000,초등학교,2016-04-01,여자,1246,1189,1202,13,44,57,0.010933558,0.036605657,0.047939445
1890,2016,전남,목포시,4611000000,초등학교,2016-04-01,남자,1292,1269,1270,1,22,23,0.000788022,0.017322835,0.018124507
1891,2016,전남,여수시,4613000000,초등학교,2016-04-01,전체,2367,2456,2457,1,-90,-89,0.000407166,-0.036630037,-0.036237785
1892,2016,전남,여수시,4613000000,초등학교,2016-04-01,여자,1185,1204,1194,-10,-9,-19,-0.008305648,-0.007537688,-0.015780731
1893,2016,전남,여수시,4613000000,초등학교,2016-04-01,남자,1182,1252,1263,11,-81,-70,0.008785942,-0.064133017,-0.055910543
1894,2016,전남,순천시,4615000000,초등학교,2016-04-01,전체,2712,2522,2587,65,125,190,0.025773196,0.048318516,0.075337034
1895,2016,전남,순천시,4615000000,초등학교,2016-04-01,여자,1315,1198,1226,28,89,117,0.023372287,0.072593801,0.097662771
1896,2016,전남,순천시,4615000000,초등학교,2016-04-01,남자,1397,1324,1361,37,36,73,0.027945619,0.026451139,0.055135952
1897,2016,전남,나주시,4617000000,초등학교,2016-04-01,전체,728,565,648,83,80,163,0.146902655,0.12345679,0.288495575
1898,2016,전남,나주시,4617000000,초등학교,2016-04-01,여자,359,251,293,42,66,108,0.167330677,0.225255973,0.430278884
1899,2016,전남,나주시,4617000000,초등학교,2016-04-01,남자,369,314,355,41,14,55,0.130573248,0.03943662,0.175159236
1900,2016,전남,광양시,4623000000,초등학교,2016-04-01,전체,1459,1582,1566,-16,-107,-123,-0.01011378,-0.068326948,-0.077749684
1901,2016,전남,광양시,4623000000,초등학교,2016-04-01,여자,712,750,744,-6,-32,-38,-0.008,-0.043010753,-0.050666667
1902,2016,전남,광양시,4623000000,초등학교,2016-04-01,남자,747,832,822,-10,-75,-85,-0.012019231,-0.091240876,-0.102163462
1903,2016,전남,담양군,4671000000,초등학교,2016-04-01,전체,246,271,258,-13,-12,-25,-0.04797048,-0.046511628,-0.092250923
1904,2016,전남,담양군,4671000000,초등학교,2016-04-01,여자,114,147,140,-7,-26,-33,-0.047619048,-0.185714286,-0.224489796
1905,2016,전남,담양군,4671000000,초등학교,2016-04-01,남자,132,124,118,-6,14,8,-0.048387097,0.118644068,0.064516129
1906,2016,전남,곡성군,4672000000,초등학교,2016-04-01,전체,152,173,164,-9,-12,-21,-0.052023121,-0.073170732,-0.121387283
1907,2016,전남,곡성군,4672000000,초등학교,2016-04-01,여자,68,83,76,-7,-8,-15,-0.084337349,-0.105263158,-0.180722892
1908,2016,전남,곡성군,4672000000,초등학교,2016-04-01,남자,84,90,88,-2,-4,-6,-0.022222222,-0.045454545,-0.066666667
1909,2016,전남,구례군,4673000000,초등학교,2016-04-01,전체,170,164,165,1,5,6,0.006097561,0.03030303,0.036585366
1910,2016,전남,구례군,4673000000,초등학교,2016-04-01,여자,83,72,76,4,7,11,0.055555556,0.092105263,0.152777778
1911,2016,전남,구례군,4673000000,초등학교,2016-04-01,남자,87,92,89,-3,-2,-5,-0.032608696,-0.02247191,-0.054347826
1912,2016,전남,고흥군,4677000000,초등학교,2016-04-01,전체,319,363,374,11,-55,-44,0.03030303,-0.147058824,-0.121212121
1913,2016,전남,고흥군,4677000000,초등학교,2016-04-01,여자,155,168,169,1,-14,-13,0.005952381,-0.082840237,-0.077380952
1914,2016,전남,고흥군,4677000000,초등학교,2016-04-01,남자,164,195,205,10,-41,-31,0.051282051,-0.2,-0.158974359
1915,2016,전남,보성군,4678000000,초등학교,2016-04-01,전체,214,278,249,-29,-35,-64,-0.104316547,-0.140562249,-0.230215827
1916,2016,전남,보성군,4678000000,초등학교,2016-04-01,여자,113,137,127,-10,-14,-24,-0.072992701,-0.11023622,-0.175182482
1917,2016,전남,보성군,4678000000,초등학교,2016-04-01,남자,101,141,122,-19,-21,-40,-0.134751773,-0.172131148,-0.283687943
1918,2016,전남,화순군,4679000000,초등학교,2016-04-01,전체,491,551,538,-13,-47,-60,-0.023593466,-0.087360595,-0.108892922
1919,2016,전남,화순군,4679000000,초등학교,2016-04-01,여자,229,264,254,-10,-25,-35,-0.037878788,-0.098425197,-0.132575758
1920,2016,전남,화순군,4679000000,초등학교,2016-04-01,남자,262,287,284,-3,-22,-25,-0.010452962,-0.077464789,-0.087108014
1921,2016,전남,장흥군,4680000000,초등학교,2016-04-01,전체,243,231,243,12,0,12,0.051948052,0,0.051948052
1922,2016,전남,장흥군,4680000000,초등학교,2016-04-01,여자,114,115,122,7,-8,-1,0.060869565,-0.06557377,-0.008695652
1923,2016,전남,장흥군,4680000000,초등학교,2016-04-01,남자,129,116,121,5,8,13,0.043103448,0.066115702,0.112068966
1924,2016,전남,강진군,4681000000,초등학교,2016-04-01,전체,194,253,239,-14,-45,-59,-0.055335968,-0.188284519,-0.233201581
1925,2016,전남,강진군,4681000000,초등학교,2016-04-01,여자,98,129,123,-6,-25,-31,-0.046511628,-0.203252033,-0.240310078
1926,2016,전남,강진군,4681000000,초등학교,2016-04-01,남자,96,124,116,-8,-20,-28,-0.064516129,-0.172413793,-0.225806452
1927,2016,전남,해남군,4682000000,초등학교,2016-04-01,전체,441,492,468,-24,-27,-51,-0.048780488,-0.057692308,-0.103658537
1928,2016,전남,해남군,4682000000,초등학교,2016-04-01,여자,220,239,233,-6,-13,-19,-0.025104603,-0.055793991,-0.079497908
1929,2016,전남,해남군,4682000000,초등학교,2016-04-01,남자,221,253,235,-18,-14,-32,-0.071146245,-0.059574468,-0.126482213
1930,2016,전남,영암군,4683000000,초등학교,2016-04-01,전체,453,531,513,-18,-60,-78,-0.033898305,-0.116959064,-0.146892655
1931,2016,전남,영암군,4683000000,초등학교,2016-04-01,여자,218,256,243,-13,-25,-38,-0.05078125,-0.102880658,-0.1484375
1932,2016,전남,영암군,4683000000,초등학교,2016-04-01,남자,235,275,270,-5,-35,-40,-0.018181818,-0.12962963,-0.145454545
1933,2016,전남,무안군,4684000000,초등학교,2016-04-01,전체,790,850,886,36,-96,-60,0.042352941,-0.108352144,-0.070588235
1934,2016,전남,무안군,4684000000,초등학교,2016-04-01,여자,377,419,432,13,-55,-42,0.031026253,-0.127314815,-0.100238663
1935,2016,전남,무안군,4684000000,초등학교,2016-04-01,남자,413,431,454,23,-41,-18,0.053364269,-0.09030837,-0.041763341
1936,2016,전남,함평군,4686000000,초등학교,2016-04-01,전체,166,201,205,4,-39,-35,0.019900498,-0.190243902,-0.174129353
1937,2016,전남,함평군,4686000000,초등학교,2016-04-01,여자,72,78,81,3,-9,-6,0.038461538,-0.111111111,-0.076923077
1938,2016,전남,함평군,4686000000,초등학교,2016-04-01,남자,94,123,124,1,-30,-29,0.008130081,-0.241935484,-0.235772358
1939,2016,전남,영광군,4687000000,초등학교,2016-04-01,전체,373,397,387,-10,-14,-24,-0.025188917,-0.036175711,-0.060453401
1940,2016,전남,영광군,4687000000,초등학교,2016-04-01,여자,189,190,184,-6,5,-1,-0.031578947,0.027173913,-0.005263158
1941,2016,전남,영광군,4687000000,초등학교,2016-04-01,남자,184,207,203,-4,-19,-23,-0.019323671,-0.093596059,-0.111111111
1942,2016,전남,장성군,4688000000,초등학교,2016-04-01,전체,309,333,333,0,-24,-24,0,-0.072072072,-0.072072072
1943,2016,전남,장성군,4688000000,초등학교,2016-04-01,여자,155,159,156,-3,-1,-4,-0.018867925,-0.006410256,-0.025157233
1944,2016,전남,장성군,4688000000,초등학교,2016-04-01,남자,154,174,177,3,-23,-20,0.017241379,-0.129943503,-0.114942529
1945,2016,전남,완도군,4689000000,초등학교,2016-04-01,전체,323,379,388,9,-65,-56,0.023746702,-0.167525773,-0.147757256
1946,2016,전남,완도군,4689000000,초등학교,2016-04-01,여자,173,193,200,7,-27,-20,0.03626943,-0.135,-0.103626943
1947,2016,전남,완도군,4689000000,초등학교,2016-04-01,남자,150,186,188,2,-38,-36,0.010752688,-0.20212766,-0.193548387
1948,2016,전남,진도군,4690000000,초등학교,2016-04-01,전체,208,205,202,-3,6,3,-0.014634146,0.02970297,0.014634146
1949,2016,전남,진도군,4690000000,초등학교,2016-04-01,여자,100,101,101,0,-1,-1,0,-0.00990099,-0.00990099
1950,2016,전남,진도군,4690000000,초등학교,2016-04-01,남자,108,104,101,-3,7,4,-0.028846154,0.069306931,0.038461538
1951,2016,전남,신안군,4691000000,초등학교,2016-04-01,전체,156,201,195,-6,-39,-45,-0.029850746,-0.2,-0.223880597
1952,2016,전남,신안군,4691000000,초등학교,2016-04-01,여자,81,98,99,1,-18,-17,0.010204082,-0.181818182,-0.173469388
1953,2016,전남,신안군,4691000000,초등학교,2016-04-01,남자,75,103,96,-7,-21,-28,-0.067961165,-0.21875,-0.27184466
1954,2016,경북,포항시,4711000000,초등학교,2016-04-01,전체,4355,4436,4478,42,-123,-81,0.009467989,-0.027467619,-0.018259693
1955,2016,경북,포항시,4711000000,초등학교,2016-04-01,여자,2080,2078,2100,22,-20,2,0.010587103,-0.00952381,0.000962464
1956,2016,경북,포항시,4711000000,초등학교,2016-04-01,남자,2275,2358,2378,20,-103,-83,0.008481764,-0.043313709,-0.035199321
1957,2016,경북,경주시,4713000000,초등학교,2016-04-01,전체,1909,1953,1938,-15,-29,-44,-0.007680492,-0.01496388,-0.022529442
1958,2016,경북,경주시,4713000000,초등학교,2016-04-01,여자,919,934,927,-7,-8,-15,-0.007494647,-0.008629989,-0.016059957
1959,2016,경북,경주시,4713000000,초등학교,2016-04-01,남자,990,1019,1011,-8,-21,-29,-0.007850834,-0.020771513,-0.028459274
1960,2016,경북,김천시,4715000000,초등학교,2016-04-01,전체,1021,1043,1049,6,-28,-22,0.005752637,-0.026692088,-0.021093001
1961,2016,경북,김천시,4715000000,초등학교,2016-04-01,여자,493,505,504,-1,-11,-12,-0.001980198,-0.021825397,-0.023762376
1962,2016,경북,김천시,4715000000,초등학교,2016-04-01,남자,528,538,545,7,-17,-10,0.013011152,-0.031192661,-0.018587361
1963,2016,경북,안동시,4717000000,초등학교,2016-04-01,전체,1302,1309,1302,-7,0,-7,-0.005347594,0,-0.005347594
1964,2016,경북,안동시,4717000000,초등학교,2016-04-01,여자,637,626,615,-11,22,11,-0.017571885,0.035772358,0.017571885
1965,2016,경북,안동시,4717000000,초등학교,2016-04-01,남자,665,683,687,4,-22,-18,0.005856515,-0.03202329,-0.026354319
1966,2016,경북,구미시,4719000000,초등학교,2016-04-01,전체,4405,4472,4408,-64,-3,-67,-0.01431127,-0.000680581,-0.014982111
1967,2016,경북,구미시,4719000000,초등학교,2016-04-01,여자,2094,2220,2187,-33,-93,-126,-0.014864865,-0.042524005,-0.056756757
1968,2016,경북,구미시,4719000000,초등학교,2016-04-01,남자,2311,2252,2221,-31,90,59,-0.013765542,0.040522287,0.026198934
1969,2016,경북,영주시,4721000000,초등학교,2016-04-01,전체,787,756,764,8,23,31,0.010582011,0.030104712,0.041005291
1970,2016,경북,영주시,4721000000,초등학교,2016-04-01,여자,391,379,383,4,8,12,0.01055409,0.020887728,0.031662269
1971,2016,경북,영주시,4721000000,초등학교,2016-04-01,남자,396,377,381,4,15,19,0.01061008,0.039370079,0.050397878
1972,2016,경북,영천시,4723000000,초등학교,2016-04-01,전체,577,606,613,7,-36,-29,0.011551155,-0.058727569,-0.047854785
1973,2016,경북,영천시,4723000000,초등학교,2016-04-01,여자,252,287,291,4,-39,-35,0.013937282,-0.134020619,-0.12195122
1974,2016,경북,영천시,4723000000,초등학교,2016-04-01,남자,325,319,322,3,3,6,0.009404389,0.00931677,0.018808777
1975,2016,경북,상주시,4725000000,초등학교,2016-04-01,전체,658,664,658,-6,0,-6,-0.009036145,0,-0.009036145
1976,2016,경북,상주시,4725000000,초등학교,2016-04-01,여자,319,320,314,-6,5,-1,-0.01875,0.015923567,-0.003125
1977,2016,경북,상주시,4725000000,초등학교,2016-04-01,남자,339,344,344,0,-5,-5,0,-0.014534884,-0.014534884
1978,2016,경북,문경시,4728000000,초등학교,2016-04-01,전체,456,458,459,1,-3,-2,0.002183406,-0.006535948,-0.004366812
1979,2016,경북,문경시,4728000000,초등학교,2016-04-01,여자,207,215,217,2,-10,-8,0.009302326,-0.046082949,-0.037209302
1980,2016,경북,문경시,4728000000,초등학교,2016-04-01,남자,249,243,242,-1,7,6,-0.004115226,0.02892562,0.024691358
1981,2016,경북,경산시,4729000000,초등학교,2016-04-01,전체,2155,2284,2256,-28,-101,-129,-0.012259194,-0.044769504,-0.05647986
1982,2016,경북,경산시,4729000000,초등학교,2016-04-01,여자,1046,1104,1094,-10,-48,-58,-0.009057971,-0.043875686,-0.052536232
1983,2016,경북,경산시,4729000000,초등학교,2016-04-01,남자,1109,1180,1162,-18,-53,-71,-0.015254237,-0.045611015,-0.060169492
1984,2016,경북,군위군,4772000000,초등학교,2016-04-01,전체,70,72,66,-6,4,-2,-0.083333333,0.060606061,-0.027777778
1985,2016,경북,군위군,4772000000,초등학교,2016-04-01,여자,31,33,31,-2,0,-2,-0.060606061,0,-0.060606061
1986,2016,경북,군위군,4772000000,초등학교,2016-04-01,남자,39,39,35,-4,4,0,-0.102564103,0.114285714,0
1987,2016,경북,의성군,4773000000,초등학교,2016-04-01,전체,193,209,206,-3,-13,-16,-0.014354067,-0.063106796,-0.076555024
1988,2016,경북,의성군,4773000000,초등학교,2016-04-01,여자,98,110,108,-2,-10,-12,-0.018181818,-0.092592593,-0.109090909
1989,2016,경북,의성군,4773000000,초등학교,2016-04-01,남자,95,99,98,-1,-3,-4,-0.01010101,-0.030612245,-0.04040404
1990,2016,경북,청송군,4775000000,초등학교,2016-04-01,전체,106,101,105,4,1,5,0.03960396,0.00952381,0.04950495
1991,2016,경북,청송군,4775000000,초등학교,2016-04-01,여자,57,54,56,2,1,3,0.037037037,0.017857143,0.055555556
1992,2016,경북,청송군,4775000000,초등학교,2016-04-01,남자,49,47,49,2,0,2,0.042553191,0,0.042553191
1993,2016,경북,영양군,4776000000,초등학교,2016-04-01,전체,81,89,94,5,-13,-8,0.056179775,-0.138297872,-0.08988764
1994,2016,경북,영양군,4776000000,초등학교,2016-04-01,여자,36,42,44,2,-8,-6,0.047619048,-0.181818182,-0.142857143
1995,2016,경북,영양군,4776000000,초등학교,2016-04-01,남자,45,47,50,3,-5,-2,0.063829787,-0.1,-0.042553191
1996,2016,경북,영덕군,4777000000,초등학교,2016-04-01,전체,191,197,195,-2,-4,-6,-0.010152284,-0.020512821,-0.030456853
1997,2016,경북,영덕군,4777000000,초등학교,2016-04-01,여자,93,102,100,-2,-7,-9,-0.019607843,-0.07,-0.088235294
1998,2016,경북,영덕군,4777000000,초등학교,2016-04-01,남자,98,95,95,0,3,3,0,0.031578947,0.031578947
1999,2016,경북,청도군,4782000000,초등학교,2016-04-01,전체,175,196,193,-3,-18,-21,-0.015306122,-0.093264249,-0.107142857
2000,2016,경북,청도군,4782000000,초등학교,2016-04-01,여자,93,88,90,2,3,5,0.022727273,0.033333333,0.056818182
2001,2016,경북,청도군,4782000000,초등학교,2016-04-01,남자,82,108,103,-5,-21,-26,-0.046296296,-0.203883495,-0.240740741
2002,2016,경북,고령군,4783000000,초등학교,2016-04-01,전체,213,256,247,-9,-34,-43,-0.03515625,-0.137651822,-0.16796875
2003,2016,경북,고령군,4783000000,초등학교,2016-04-01,여자,99,130,122,-8,-23,-31,-0.061538462,-0.18852459,-0.238461538
2004,2016,경북,고령군,4783000000,초등학교,2016-04-01,남자,114,126,125,-1,-11,-12,-0.007936508,-0.088,-0.095238095
2005,2016,경북,성주군,4784000000,초등학교,2016-04-01,전체,218,235,226,-9,-8,-17,-0.038297872,-0.03539823,-0.072340426
2006,2016,경북,성주군,4784000000,초등학교,2016-04-01,여자,92,107,106,-1,-14,-15,-0.009345794,-0.132075472,-0.140186916
2007,2016,경북,성주군,4784000000,초등학교,2016-04-01,남자,126,128,120,-8,6,-2,-0.0625,0.05,-0.015625
2008,2016,경북,칠곡군,4785000000,초등학교,2016-04-01,전체,1212,1269,1261,-8,-49,-57,-0.006304177,-0.038858049,-0.044917258
2009,2016,경북,칠곡군,4785000000,초등학교,2016-04-01,여자,589,596,601,5,-12,-7,0.008389262,-0.019966722,-0.011744966
2010,2016,경북,칠곡군,4785000000,초등학교,2016-04-01,남자,623,673,660,-13,-37,-50,-0.019316493,-0.056060606,-0.074294205
2011,2016,경북,예천군,4790000000,초등학교,2016-04-01,전체,243,266,263,-3,-20,-23,-0.011278195,-0.076045627,-0.086466165
2012,2016,경북,예천군,4790000000,초등학교,2016-04-01,여자,105,117,116,-1,-11,-12,-0.008547009,-0.094827586,-0.102564103
2013,2016,경북,예천군,4790000000,초등학교,2016-04-01,남자,138,149,147,-2,-9,-11,-0.013422819,-0.06122449,-0.073825503
2014,2016,경북,봉화군,4792000000,초등학교,2016-04-01,전체,157,196,184,-12,-27,-39,-0.06122449,-0.14673913,-0.198979592
2015,2016,경북,봉화군,4792000000,초등학교,2016-04-01,여자,66,78,71,-7,-5,-12,-0.08974359,-0.070422535,-0.153846154
2016,2016,경북,봉화군,4792000000,초등학교,2016-04-01,남자,91,118,113,-5,-22,-27,-0.042372881,-0.194690265,-0.228813559
2017,2016,경북,울진군,4793000000,초등학교,2016-04-01,전체,332,386,374,-12,-42,-54,-0.031088083,-0.112299465,-0.139896373
2018,2016,경북,울진군,4793000000,초등학교,2016-04-01,여자,163,186,174,-12,-11,-23,-0.064516129,-0.063218391,-0.123655914
2019,2016,경북,울진군,4793000000,초등학교,2016-04-01,남자,169,200,200,0,-31,-31,0,-0.155,-0.155
2020,2016,경북,울릉군,4794000000,초등학교,2016-04-01,전체,41,45,45,0,-4,-4,0,-0.088888889,-0.088888889
2021,2016,경북,울릉군,4794000000,초등학교,2016-04-01,여자,20,19,19,0,1,1,0,0.052631579,0.052631579
2022,2016,경북,울릉군,4794000000,초등학교,2016-04-01,남자,21,26,26,0,-5,-5,0,-0.192307692,-0.192307692
2023,2016,경남,진주시,4817000000,초등학교,2016-04-01,전체,3086,2899,3059,160,27,187,0.055191445,0.008826414,0.064505002
2024,2016,경남,진주시,4817000000,초등학교,2016-04-01,여자,1436,1364,1430,66,6,72,0.048387097,0.004195804,0.052785924
2025,2016,경남,진주시,4817000000,초등학교,2016-04-01,남자,1650,1535,1629,94,21,115,0.061237785,0.012891344,0.074918567
2026,2016,경남,통영시,4822000000,초등학교,2016-04-01,전체,1411,1476,1467,-9,-56,-65,-0.006097561,-0.038173142,-0.04403794
2027,2016,경남,통영시,4822000000,초등학교,2016-04-01,여자,655,698,700,2,-45,-43,0.00286533,-0.064285714,-0.061604585
2028,2016,경남,통영시,4822000000,초등학교,2016-04-01,남자,756,778,767,-11,-11,-22,-0.014138817,-0.014341591,-0.028277635
2029,2016,경남,사천시,4824000000,초등학교,2016-04-01,전체,1121,1232,1192,-40,-71,-111,-0.032467532,-0.059563758,-0.090097403
2030,2016,경남,사천시,4824000000,초등학교,2016-04-01,여자,575,629,608,-21,-33,-54,-0.033386328,-0.054276316,-0.085850556
2031,2016,경남,사천시,4824000000,초등학교,2016-04-01,남자,546,603,584,-19,-38,-57,-0.031509121,-0.065068493,-0.094527363
2032,2016,경남,김해시,4825000000,초등학교,2016-04-01,전체,5671,5774,5754,-20,-83,-103,-0.003463803,-0.014424748,-0.017838587
2033,2016,경남,김해시,4825000000,초등학교,2016-04-01,여자,2741,2781,2762,-19,-21,-40,-0.006832075,-0.007603186,-0.014383315
2034,2016,경남,김해시,4825000000,초등학교,2016-04-01,남자,2930,2993,2992,-1,-62,-63,-0.000334113,-0.020721925,-0.021049115
2035,2016,경남,밀양시,4827000000,초등학교,2016-04-01,전체,635,614,629,15,6,21,0.024429967,0.009538951,0.034201954
2036,2016,경남,밀양시,4827000000,초등학교,2016-04-01,여자,305,286,298,12,7,19,0.041958042,0.023489933,0.066433566
2037,2016,경남,밀양시,4827000000,초등학교,2016-04-01,남자,330,328,331,3,-1,2,0.009146341,-0.003021148,0.006097561
2038,2016,경남,거제시,4831000000,초등학교,2016-04-01,전체,3054,3135,3163,28,-109,-81,0.008931419,-0.034460955,-0.025837321
2039,2016,경남,거제시,4831000000,초등학교,2016-04-01,여자,1459,1498,1531,33,-72,-39,0.022029372,-0.047028086,-0.026034713
2040,2016,경남,거제시,4831000000,초등학교,2016-04-01,남자,1595,1637,1632,-5,-37,-42,-0.003054368,-0.022671569,-0.025656689
2041,2016,경남,양산시,4833000000,초등학교,2016-04-01,전체,3092,2986,3133,147,-41,106,0.049229739,-0.013086499,0.035498995
2042,2016,경남,양산시,4833000000,초등학교,2016-04-01,여자,1508,1464,1521,57,-13,44,0.038934426,-0.008547009,0.030054645
2043,2016,경남,양산시,4833000000,초등학교,2016-04-01,남자,1584,1522,1612,90,-28,62,0.05913272,-0.017369727,0.040735874
2044,2016,경남,의령군,4872000000,초등학교,2016-04-01,전체,143,184,172,-12,-29,-41,-0.065217391,-0.168604651,-0.222826087
2045,2016,경남,의령군,4872000000,초등학교,2016-04-01,여자,63,92,84,-8,-21,-29,-0.086956522,-0.25,-0.315217391
2046,2016,경남,의령군,4872000000,초등학교,2016-04-01,남자,80,92,88,-4,-8,-12,-0.043478261,-0.090909091,-0.130434783
2047,2016,경남,함안군,4873000000,초등학교,2016-04-01,전체,646,605,635,30,11,41,0.049586777,0.017322835,0.067768595
2048,2016,경남,함안군,4873000000,초등학교,2016-04-01,여자,317,284,306,22,11,33,0.077464789,0.035947712,0.116197183
2049,2016,경남,함안군,4873000000,초등학교,2016-04-01,남자,329,321,329,8,0,8,0.024922118,0,0.024922118
2050,2016,경남,창녕군,4874000000,초등학교,2016-04-01,전체,355,353,360,7,-5,2,0.019830028,-0.013888889,0.005665722
2051,2016,경남,창녕군,4874000000,초등학교,2016-04-01,여자,163,175,176,1,-13,-12,0.005714286,-0.073863636,-0.068571429
2052,2016,경남,창녕군,4874000000,초등학교,2016-04-01,남자,192,178,184,6,8,14,0.033707865,0.043478261,0.078651685
2053,2016,경남,고성군,4882000000,초등학교,2016-04-01,전체,364,387,394,7,-30,-23,0.018087855,-0.076142132,-0.059431525
2054,2016,경남,고성군,4882000000,초등학교,2016-04-01,여자,177,173,180,7,-3,4,0.040462428,-0.016666667,0.023121387
2055,2016,경남,고성군,4882000000,초등학교,2016-04-01,남자,187,214,214,0,-27,-27,0,-0.126168224,-0.126168224
2056,2016,경남,남해군,4884000000,초등학교,2016-04-01,전체,226,221,222,1,4,5,0.004524887,0.018018018,0.022624434
2057,2016,경남,남해군,4884000000,초등학교,2016-04-01,여자,94,106,107,1,-13,-12,0.009433962,-0.121495327,-0.113207547
2058,2016,경남,남해군,4884000000,초등학교,2016-04-01,남자,132,115,115,0,17,17,0,0.147826087,0.147826087
2059,2016,경남,하동군,4885000000,초등학교,2016-04-01,전체,217,277,269,-8,-52,-60,-0.028880866,-0.19330855,-0.216606498
2060,2016,경남,하동군,4885000000,초등학교,2016-04-01,여자,126,152,141,-11,-15,-26,-0.072368421,-0.106382979,-0.171052632
2061,2016,경남,하동군,4885000000,초등학교,2016-04-01,남자,91,125,128,3,-37,-34,0.024,-0.2890625,-0.272
2062,2016,경남,산청군,4886000000,초등학교,2016-04-01,전체,159,193,181,-12,-22,-34,-0.062176166,-0.121546961,-0.176165803
2063,2016,경남,산청군,4886000000,초등학교,2016-04-01,여자,82,88,80,-8,2,-6,-0.090909091,0.025,-0.068181818
2064,2016,경남,산청군,4886000000,초등학교,2016-04-01,남자,77,105,101,-4,-24,-28,-0.038095238,-0.237623762,-0.266666667
2065,2016,경남,함양군,4887000000,초등학교,2016-04-01,전체,241,262,257,-5,-16,-21,-0.019083969,-0.062256809,-0.080152672
2066,2016,경남,함양군,4887000000,초등학교,2016-04-01,여자,126,129,126,-3,0,-3,-0.023255814,0,-0.023255814
2067,2016,경남,함양군,4887000000,초등학교,2016-04-01,남자,115,133,131,-2,-16,-18,-0.015037594,-0.122137405,-0.135338346
2068,2016,경남,거창군,4888000000,초등학교,2016-04-01,전체,490,446,458,12,32,44,0.02690583,0.069868996,0.098654709
2069,2016,경남,거창군,4888000000,초등학교,2016-04-01,여자,230,210,216,6,14,20,0.028571429,0.064814815,0.095238095
2070,2016,경남,거창군,4888000000,초등학교,2016-04-01,남자,260,236,242,6,18,24,0.025423729,0.074380165,0.101694915
2071,2016,경남,합천군,4889000000,초등학교,2016-04-01,전체,210,229,231,2,-21,-19,0.008733624,-0.090909091,-0.082969432
2072,2016,경남,합천군,4889000000,초등학교,2016-04-01,여자,109,115,109,-6,0,-6,-0.052173913,0,-0.052173913
2073,2016,경남,합천군,4889000000,초등학교,2016-04-01,남자,101,114,122,8,-21,-13,0.070175439,-0.172131148,-0.114035088
2074,2016,제주,제주시,5011000000,초등학교,2016-04-01,전체,4774,4577,4734,157,40,197,0.034301945,0.008449514,0.043041293
2075,2016,제주,제주시,5011000000,초등학교,2016-04-01,여자,2272,2178,2249,71,23,94,0.032598714,0.010226767,0.043158861
2076,2016,제주,제주시,5011000000,초등학교,2016-04-01,남자,2502,2399,2485,86,17,103,0.03584827,0.006841046,0.042934556
2077,2016,제주,서귀포시,5013000000,초등학교,2016-04-01,전체,1412,1340,1373,33,39,72,0.024626866,0.028404953,0.053731343
2078,2016,제주,서귀포시,5013000000,초등학교,2016-04-01,여자,704,676,684,8,20,28,0.01183432,0.029239766,0.041420118
2079,2016,제주,서귀포시,5013000000,초등학교,2016-04-01,남자,708,664,689,25,19,44,0.037650602,0.027576197,0.06626506
2080,2017,서울,종로구,1111000000,초등학교,2017-04-01,전체,926,939,947,8,-21,-13,0.008519702,-0.02217529,-0.013844515
2081,2017,서울,종로구,1111000000,초등학교,2017-04-01,여자,467,449,443,-6,24,18,-0.013363029,0.054176072,0.040089087
2082,2017,서울,종로구,1111000000,초등학교,2017-04-01,남자,459,490,504,14,-45,-31,0.028571429,-0.089285714,-0.063265306
2083,2017,서울,중구,1114000000,초등학교,2017-04-01,전체,868,870,830,-40,38,-2,-0.045977011,0.045783133,-0.002298851
2084,2017,서울,중구,1114000000,초등학교,2017-04-01,여자,412,426,409,-17,3,-14,-0.039906103,0.007334963,-0.03286385
2085,2017,서울,중구,1114000000,초등학교,2017-04-01,남자,456,444,421,-23,35,12,-0.051801802,0.083135392,0.027027027
2086,2017,서울,용산구,1117000000,초등학교,2017-04-01,전체,1253,1768,1705,-63,-452,-515,-0.035633484,-0.265102639,-0.291289593
2087,2017,서울,용산구,1117000000,초등학교,2017-04-01,여자,621,858,816,-42,-195,-237,-0.048951049,-0.238970588,-0.276223776
2088,2017,서울,용산구,1117000000,초등학교,2017-04-01,남자,632,910,889,-21,-257,-278,-0.023076923,-0.289088864,-0.305494505
2089,2017,서울,성동구,1120000000,초등학교,2017-04-01,전체,2111,2397,2329,-68,-218,-286,-0.028368794,-0.093602404,-0.119315811
2090,2017,서울,성동구,1120000000,초등학교,2017-04-01,여자,1019,1183,1150,-33,-131,-164,-0.027895182,-0.113913043,-0.1386306
2091,2017,서울,성동구,1120000000,초등학교,2017-04-01,남자,1092,1214,1179,-35,-87,-122,-0.028830313,-0.073791349,-0.100494234
2092,2017,서울,광진구,1121500000,초등학교,2017-04-01,전체,2550,2688,2597,-91,-47,-138,-0.033854167,-0.018097805,-0.051339286
2093,2017,서울,광진구,1121500000,초등학교,2017-04-01,여자,1184,1348,1301,-47,-117,-164,-0.034866469,-0.089930822,-0.121661721
2094,2017,서울,광진구,1121500000,초등학교,2017-04-01,남자,1366,1340,1296,-44,70,26,-0.032835821,0.054012346,0.019402985
2095,2017,서울,동대문구,1123000000,초등학교,2017-04-01,전체,2396,2788,2665,-123,-269,-392,-0.044117647,-0.100938086,-0.140602582
2096,2017,서울,동대문구,1123000000,초등학교,2017-04-01,여자,1179,1392,1329,-63,-150,-213,-0.045258621,-0.112866817,-0.153017241
2097,2017,서울,동대문구,1123000000,초등학교,2017-04-01,남자,1217,1396,1336,-60,-119,-179,-0.042979943,-0.089071856,-0.128223496
2098,2017,서울,중랑구,1126000000,초등학교,2017-04-01,전체,2652,3102,2966,-136,-314,-450,-0.043842682,-0.105866487,-0.145067698
2099,2017,서울,중랑구,1126000000,초등학교,2017-04-01,여자,1294,1529,1472,-57,-178,-235,-0.037279267,-0.120923913,-0.153695226
2100,2017,서울,중랑구,1126000000,초등학교,2017-04-01,남자,1358,1573,1494,-79,-136,-215,-0.050222505,-0.09103079,-0.1366815
2101,2017,서울,성북구,1129000000,초등학교,2017-04-01,전체,3718,3917,3885,-32,-167,-199,-0.008169517,-0.042985843,-0.050804187
2102,2017,서울,성북구,1129000000,초등학교,2017-04-01,여자,1840,1904,1898,-6,-58,-64,-0.003151261,-0.030558483,-0.033613445
2103,2017,서울,성북구,1129000000,초등학교,2017-04-01,남자,1878,2013,1987,-26,-109,-135,-0.012916046,-0.054856568,-0.067064083
2104,2017,서울,강북구,1130500000,초등학교,2017-04-01,전체,1791,2589,2461,-128,-670,-798,-0.049439938,-0.272247054,-0.308227115
2105,2017,서울,강북구,1130500000,초등학교,2017-04-01,여자,880,1286,1207,-79,-327,-406,-0.061430793,-0.270919635,-0.315707621
2106,2017,서울,강북구,1130500000,초등학교,2017-04-01,남자,911,1303,1254,-49,-343,-392,-0.037605526,-0.273524721,-0.300844206
2107,2017,서울,도봉구,1132000000,초등학교,2017-04-01,전체,2737,2727,2699,-28,38,10,-0.010267693,0.014079289,0.003667033
2108,2017,서울,도봉구,1132000000,초등학교,2017-04-01,여자,1326,1302,1291,-11,35,24,-0.008448541,0.027110767,0.01843318
2109,2017,서울,도봉구,1132000000,초등학교,2017-04-01,남자,1411,1425,1408,-17,3,-14,-0.011929825,0.002130682,-0.009824561
2110,2017,서울,노원구,1135000000,초등학교,2017-04-01,전체,4470,4625,4555,-70,-85,-155,-0.015135135,-0.018660812,-0.033513514
2111,2017,서울,노원구,1135000000,초등학교,2017-04-01,여자,2199,2233,2194,-39,5,-34,-0.017465293,0.002278943,-0.015226153
2112,2017,서울,노원구,1135000000,초등학교,2017-04-01,남자,2271,2392,2361,-31,-90,-121,-0.012959866,-0.038119441,-0.050585284
2113,2017,서울,은평구,1138000000,초등학교,2017-04-01,전체,3803,4103,3974,-129,-171,-300,-0.031440409,-0.043029693,-0.073117231
2114,2017,서울,은평구,1138000000,초등학교,2017-04-01,여자,1862,1993,1940,-53,-78,-131,-0.026593076,-0.040206186,-0.065730055
2115,2017,서울,은평구,1138000000,초등학교,2017-04-01,남자,1941,2110,2034,-76,-93,-169,-0.036018957,-0.045722714,-0.080094787
2116,2017,서울,서대문구,1141000000,초등학교,2017-04-01,전체,2288,2213,2295,82,-7,75,0.037053773,-0.003050109,0.033890646
2117,2017,서울,서대문구,1141000000,초등학교,2017-04-01,여자,1068,1065,1094,29,-26,3,0.027230047,-0.023765996,0.002816901
2118,2017,서울,서대문구,1141000000,초등학교,2017-04-01,남자,1220,1148,1201,53,19,72,0.046167247,0.01582015,0.06271777
2119,2017,서울,마포구,1144000000,초등학교,2017-04-01,전체,2676,3282,3199,-83,-523,-606,-0.025289458,-0.16348859,-0.18464351
2120,2017,서울,마포구,1144000000,초등학교,2017-04-01,여자,1310,1616,1579,-37,-269,-306,-0.02289604,-0.170360988,-0.189356436
2121,2017,서울,마포구,1144000000,초등학교,2017-04-01,남자,1366,1666,1620,-46,-254,-300,-0.027611044,-0.156790123,-0.180072029
2122,2017,서울,양천구,1147000000,초등학교,2017-04-01,전체,3815,3854,3963,109,-148,-39,0.028282304,-0.037345445,-0.010119357
2123,2017,서울,양천구,1147000000,초등학교,2017-04-01,여자,1879,1876,1921,45,-42,3,0.023987207,-0.021863613,0.001599147
2124,2017,서울,양천구,1147000000,초등학교,2017-04-01,남자,1936,1978,2042,64,-106,-42,0.032355915,-0.051909892,-0.021233569
2125,2017,서울,강서구,1150000000,초등학교,2017-04-01,전체,4529,5111,4968,-143,-439,-582,-0.027978869,-0.088365539,-0.113872041
2126,2017,서울,강서구,1150000000,초등학교,2017-04-01,여자,2176,2493,2455,-38,-279,-317,-0.01524268,-0.113645621,-0.127156037
2127,2017,서울,강서구,1150000000,초등학교,2017-04-01,남자,2353,2618,2513,-105,-160,-265,-0.040106952,-0.063668922,-0.101222307
2128,2017,서울,구로구,1153000000,초등학교,2017-04-01,전체,3464,4154,4016,-138,-552,-690,-0.033220992,-0.137450199,-0.166104959
2129,2017,서울,구로구,1153000000,초등학교,2017-04-01,여자,1703,2050,1979,-71,-276,-347,-0.034634146,-0.139464376,-0.169268293
2130,2017,서울,구로구,1153000000,초등학교,2017-04-01,남자,1761,2104,2037,-67,-276,-343,-0.031844106,-0.135493373,-0.163022814
2131,2017,서울,금천구,1154500000,초등학교,2017-04-01,전체,1610,1718,1635,-83,-25,-108,-0.048311991,-0.01529052,-0.062863795
2132,2017,서울,금천구,1154500000,초등학교,2017-04-01,여자,782,823,792,-31,-10,-41,-0.037667072,-0.012626263,-0.04981774
2133,2017,서울,금천구,1154500000,초등학교,2017-04-01,남자,828,895,843,-52,-15,-67,-0.058100559,-0.017793594,-0.074860335
2134,2017,서울,영등포구,1156000000,초등학교,2017-04-01,전체,2377,3176,3028,-148,-651,-799,-0.046599496,-0.214993395,-0.251574307
2135,2017,서울,영등포구,1156000000,초등학교,2017-04-01,여자,1188,1569,1521,-48,-333,-381,-0.030592734,-0.218934911,-0.242829828
2136,2017,서울,영등포구,1156000000,초등학교,2017-04-01,남자,1189,1607,1507,-100,-318,-418,-0.062227754,-0.211015262,-0.26011201
2137,2017,서울,동작구,1159000000,초등학교,2017-04-01,전체,2950,3229,3117,-112,-167,-279,-0.034685661,-0.053577158,-0.08640446
2138,2017,서울,동작구,1159000000,초등학교,2017-04-01,여자,1389,1529,1481,-48,-92,-140,-0.031393067,-0.062120189,-0.091563113
2139,2017,서울,동작구,1159000000,초등학교,2017-04-01,남자,1561,1700,1636,-64,-75,-139,-0.037647059,-0.045843521,-0.081764706
2140,2017,서울,관악구,1162000000,초등학교,2017-04-01,전체,2769,3448,3276,-172,-507,-679,-0.049883991,-0.154761905,-0.196925754
2141,2017,서울,관악구,1162000000,초등학교,2017-04-01,여자,1358,1700,1599,-101,-241,-342,-0.059411765,-0.150719199,-0.201176471
2142,2017,서울,관악구,1162000000,초등학교,2017-04-01,남자,1411,1748,1677,-71,-266,-337,-0.040617849,-0.158616577,-0.192791762
2143,2017,서울,서초구,1165000000,초등학교,2017-04-01,전체,4031,4499,4467,-32,-436,-468,-0.007112692,-0.097604656,-0.104023116
2144,2017,서울,서초구,1165000000,초등학교,2017-04-01,여자,1967,2207,2171,-36,-204,-240,-0.016311735,-0.093965914,-0.108744903
2145,2017,서울,서초구,1165000000,초등학교,2017-04-01,남자,2064,2292,2296,4,-232,-228,0.001745201,-0.101045296,-0.09947644
2146,2017,서울,강남구,1168000000,초등학교,2017-04-01,전체,3957,4571,4685,114,-728,-614,0.024939838,-0.155389541,-0.134325093
2147,2017,서울,강남구,1168000000,초등학교,2017-04-01,여자,1897,2231,2279,48,-382,-334,0.021515016,-0.167617376,-0.149708651
2148,2017,서울,강남구,1168000000,초등학교,2017-04-01,남자,2060,2340,2406,66,-346,-280,0.028205128,-0.143807149,-0.11965812
2149,2017,서울,송파구,1171000000,초등학교,2017-04-01,전체,5300,5921,5774,-147,-474,-621,-0.024826887,-0.082092137,-0.104880932
2150,2017,서울,송파구,1171000000,초등학교,2017-04-01,여자,2595,2818,2769,-49,-174,-223,-0.017388219,-0.06283857,-0.079134138
2151,2017,서울,송파구,1171000000,초등학교,2017-04-01,남자,2705,3103,3005,-98,-300,-398,-0.03158234,-0.099833611,-0.128262971
2152,2017,서울,강동구,1174000000,초등학교,2017-04-01,전체,3470,4039,3823,-216,-353,-569,-0.053478584,-0.092335862,-0.140876455
2153,2017,서울,강동구,1174000000,초등학교,2017-04-01,여자,1664,1923,1809,-114,-145,-259,-0.059282371,-0.080154782,-0.134685387
2154,2017,서울,강동구,1174000000,초등학교,2017-04-01,남자,1806,2116,2014,-102,-208,-310,-0.048204159,-0.103277061,-0.146502836
2155,2017,부산,중구,2611000000,초등학교,2017-04-01,전체,270,247,234,-13,36,23,-0.052631579,0.153846154,0.093117409
2156,2017,부산,중구,2611000000,초등학교,2017-04-01,여자,141,116,110,-6,31,25,-0.051724138,0.281818182,0.215517241
2157,2017,부산,중구,2611000000,초등학교,2017-04-01,남자,129,131,124,-7,5,-2,-0.053435115,0.040322581,-0.015267176
2158,2017,부산,서구,2614000000,초등학교,2017-04-01,전체,644,694,674,-20,-30,-50,-0.028818444,-0.044510386,-0.07204611
2159,2017,부산,서구,2614000000,초등학교,2017-04-01,여자,327,354,334,-20,-7,-27,-0.056497175,-0.020958084,-0.076271186
2160,2017,부산,서구,2614000000,초등학교,2017-04-01,남자,317,340,340,0,-23,-23,0,-0.067647059,-0.067647059
2161,2017,부산,동구,2617000000,초등학교,2017-04-01,전체,403,477,453,-24,-50,-74,-0.050314465,-0.110375276,-0.155136268
2162,2017,부산,동구,2617000000,초등학교,2017-04-01,여자,200,227,218,-9,-18,-27,-0.039647577,-0.082568807,-0.118942731
2163,2017,부산,동구,2617000000,초등학교,2017-04-01,남자,203,250,235,-15,-32,-47,-0.06,-0.136170213,-0.188
2164,2017,부산,영도구,2620000000,초등학교,2017-04-01,전체,708,847,842,-5,-134,-139,-0.005903188,-0.159144893,-0.164108619
2165,2017,부산,영도구,2620000000,초등학교,2017-04-01,여자,349,415,405,-10,-56,-66,-0.024096386,-0.138271605,-0.159036145
2166,2017,부산,영도구,2620000000,초등학교,2017-04-01,남자,359,432,437,5,-78,-73,0.011574074,-0.178489703,-0.168981481
2167,2017,부산,부산진구,2623000000,초등학교,2017-04-01,전체,2673,2881,2788,-93,-115,-208,-0.032280458,-0.041248207,-0.072197154
2168,2017,부산,부산진구,2623000000,초등학교,2017-04-01,여자,1278,1427,1385,-42,-107,-149,-0.029432376,-0.077256318,-0.104414856
2169,2017,부산,부산진구,2623000000,초등학교,2017-04-01,남자,1395,1454,1403,-51,-8,-59,-0.035075653,-0.005702067,-0.040577717
2170,2017,부산,동래구,2626000000,초등학교,2017-04-01,전체,2214,2108,2175,67,39,106,0.031783681,0.017931034,0.05028463
2171,2017,부산,동래구,2626000000,초등학교,2017-04-01,여자,1047,1028,1063,35,-16,19,0.034046693,-0.01505174,0.01848249
2172,2017,부산,동래구,2626000000,초등학교,2017-04-01,남자,1167,1080,1112,32,55,87,0.02962963,0.049460432,0.080555556
2173,2017,부산,남구,2629000000,초등학교,2017-04-01,전체,2120,2335,2291,-44,-171,-215,-0.018843683,-0.074639895,-0.092077088
2174,2017,부산,남구,2629000000,초등학교,2017-04-01,여자,1051,1144,1138,-6,-87,-93,-0.005244755,-0.076449912,-0.081293706
2175,2017,부산,남구,2629000000,초등학교,2017-04-01,남자,1069,1191,1153,-38,-84,-122,-0.031905961,-0.072853426,-0.102434929
2176,2017,부산,북구,2632000000,초등학교,2017-04-01,전체,2235,2338,2414,76,-179,-103,0.032506416,-0.074150787,-0.044054748
2177,2017,부산,북구,2632000000,초등학교,2017-04-01,여자,1049,1139,1184,45,-135,-90,0.039508341,-0.11402027,-0.079016681
2178,2017,부산,북구,2632000000,초등학교,2017-04-01,남자,1186,1199,1230,31,-44,-13,0.025854879,-0.035772358,-0.010842369
2179,2017,부산,해운대구,2635000000,초등학교,2017-04-01,전체,3285,3644,3649,5,-364,-359,0.001372119,-0.099753357,-0.098518112
2180,2017,부산,해운대구,2635000000,초등학교,2017-04-01,여자,1574,1744,1734,-10,-160,-170,-0.005733945,-0.092272203,-0.097477064
2181,2017,부산,해운대구,2635000000,초등학교,2017-04-01,남자,1711,1900,1915,15,-204,-189,0.007894737,-0.106527415,-0.099473684
2182,2017,부산,사하구,2638000000,초등학교,2017-04-01,전체,2498,2961,2809,-152,-311,-463,-0.051334009,-0.110715557,-0.156366093
2183,2017,부산,사하구,2638000000,초등학교,2017-04-01,여자,1248,1454,1394,-60,-146,-206,-0.041265475,-0.104734577,-0.141678129
2184,2017,부산,사하구,2638000000,초등학교,2017-04-01,남자,1250,1507,1415,-92,-165,-257,-0.061048441,-0.116607774,-0.170537492
2185,2017,부산,금정구,2641000000,초등학교,2017-04-01,전체,1656,1663,1640,-23,16,-7,-0.013830427,0.009756098,-0.00420926
2186,2017,부산,금정구,2641000000,초등학교,2017-04-01,여자,782,810,788,-22,-6,-28,-0.027160494,-0.007614213,-0.034567901
2187,2017,부산,금정구,2641000000,초등학교,2017-04-01,남자,874,853,852,-1,22,21,-0.001172333,0.025821596,0.024618992
2188,2017,부산,강서구,2644000000,초등학교,2017-04-01,전체,1561,1141,1454,313,107,420,0.274320771,0.073590096,0.36809816
2189,2017,부산,강서구,2644000000,초등학교,2017-04-01,여자,772,549,702,153,70,223,0.278688525,0.0997151,0.406193078
2190,2017,부산,강서구,2644000000,초등학교,2017-04-01,남자,789,592,752,160,37,197,0.27027027,0.049202128,0.33277027
2191,2017,부산,연제구,2647000000,초등학교,2017-04-01,전체,1650,1628,1675,47,-25,22,0.028869779,-0.014925373,0.013513514
2192,2017,부산,연제구,2647000000,초등학교,2017-04-01,여자,826,797,818,21,8,29,0.026348808,0.009779951,0.036386449
2193,2017,부산,연제구,2647000000,초등학교,2017-04-01,남자,824,831,857,26,-33,-7,0.031287605,-0.038506418,-0.008423586
2194,2017,부산,수영구,2650000000,초등학교,2017-04-01,전체,992,1188,1160,-28,-168,-196,-0.023569024,-0.144827586,-0.164983165
2195,2017,부산,수영구,2650000000,초등학교,2017-04-01,여자,464,596,578,-18,-114,-132,-0.030201342,-0.197231834,-0.22147651
2196,2017,부산,수영구,2650000000,초등학교,2017-04-01,남자,528,592,582,-10,-54,-64,-0.016891892,-0.092783505,-0.108108108
2197,2017,부산,사상구,2653000000,초등학교,2017-04-01,전체,1462,1866,1768,-98,-306,-404,-0.052518757,-0.173076923,-0.216505895
2198,2017,부산,사상구,2653000000,초등학교,2017-04-01,여자,716,903,862,-41,-146,-187,-0.045404208,-0.16937355,-0.207087486
2199,2017,부산,사상구,2653000000,초등학교,2017-04-01,남자,746,963,906,-57,-160,-217,-0.059190031,-0.176600442,-0.225337487
2200,2017,부산,기장군,2671000000,초등학교,2017-04-01,전체,1987,2144,2223,79,-236,-157,0.036847015,-0.106162843,-0.073227612
2201,2017,부산,기장군,2671000000,초등학교,2017-04-01,여자,997,1066,1109,43,-112,-69,0.040337711,-0.100991885,-0.064727955
2202,2017,부산,기장군,2671000000,초등학교,2017-04-01,남자,990,1078,1114,36,-124,-88,0.033395176,-0.111310592,-0.081632653
2203,2017,대구,중구,2711000000,초등학교,2017-04-01,전체,735,613,613,0,122,122,0,0.199021207,0.199021207
2204,2017,대구,중구,2711000000,초등학교,2017-04-01,여자,350,311,310,-1,40,39,-0.003215434,0.129032258,0.125401929
2205,2017,대구,중구,2711000000,초등학교,2017-04-01,남자,385,302,303,1,82,83,0.003311258,0.270627063,0.274834437
2206,2017,대구,동구,2714000000,초등학교,2017-04-01,전체,3072,3251,3215,-36,-143,-179,-0.011073516,-0.044479005,-0.055059982
2207,2017,대구,동구,2714000000,초등학교,2017-04-01,여자,1494,1557,1550,-7,-56,-63,-0.004495825,-0.036129032,-0.040462428
2208,2017,대구,동구,2714000000,초등학교,2017-04-01,남자,1578,1694,1665,-29,-87,-116,-0.017119244,-0.052252252,-0.068476978
2209,2017,대구,서구,2717000000,초등학교,2017-04-01,전체,991,1359,1269,-90,-278,-368,-0.066225166,-0.219070134,-0.270787344
2210,2017,대구,서구,2717000000,초등학교,2017-04-01,여자,482,660,621,-39,-139,-178,-0.059090909,-0.223832528,-0.26969697
2211,2017,대구,서구,2717000000,초등학교,2017-04-01,남자,509,699,648,-51,-139,-190,-0.072961373,-0.214506173,-0.271816881
2212,2017,대구,남구,2720000000,초등학교,2017-04-01,전체,731,965,941,-24,-210,-234,-0.024870466,-0.223166844,-0.242487047
2213,2017,대구,남구,2720000000,초등학교,2017-04-01,여자,345,463,446,-17,-101,-118,-0.036717063,-0.226457399,-0.254859611
2214,2017,대구,남구,2720000000,초등학교,2017-04-01,남자,386,502,495,-7,-109,-116,-0.013944223,-0.22020202,-0.231075697
2215,2017,대구,북구,2723000000,초등학교,2017-04-01,전체,3816,4307,4248,-59,-432,-491,-0.01369863,-0.101694915,-0.114000464
2216,2017,대구,북구,2723000000,초등학교,2017-04-01,여자,1828,2071,2051,-20,-223,-243,-0.00965717,-0.10872745,-0.117334621
2217,2017,대구,북구,2723000000,초등학교,2017-04-01,남자,1988,2236,2197,-39,-209,-248,-0.01744186,-0.095129722,-0.110912343
2218,2017,대구,수성구,2726000000,초등학교,2017-04-01,전체,3571,3539,3750,211,-179,32,0.059621362,-0.047733333,0.009042102
2219,2017,대구,수성구,2726000000,초등학교,2017-04-01,여자,1719,1727,1835,108,-116,-8,0.06253619,-0.063215259,-0.00463231
2220,2017,대구,수성구,2726000000,초등학교,2017-04-01,남자,1852,1812,1915,103,-63,40,0.056843267,-0.032898172,0.022075055
2221,2017,대구,달서구,2729000000,초등학교,2017-04-01,전체,5415,5634,5501,-133,-86,-219,-0.023606674,-0.015633521,-0.03887114
2222,2017,대구,달서구,2729000000,초등학교,2017-04-01,여자,2619,2723,2659,-64,-40,-104,-0.023503489,-0.015043249,-0.038193169
2223,2017,대구,달서구,2729000000,초등학교,2017-04-01,남자,2796,2911,2842,-69,-46,-115,-0.023703195,-0.016185785,-0.039505325
2224,2017,대구,달성군,2771000000,초등학교,2017-04-01,전체,2687,2162,2420,258,267,525,0.11933395,0.110330579,0.242830712
2225,2017,대구,달성군,2771000000,초등학교,2017-04-01,여자,1310,1054,1182,128,128,256,0.121442125,0.108291032,0.24288425
2226,2017,대구,달성군,2771000000,초등학교,2017-04-01,남자,1377,1108,1238,130,139,269,0.11732852,0.112277868,0.242779783
2227,2017,인천,중구,2811000000,초등학교,2017-04-01,전체,1244,1207,1210,3,34,37,0.002485501,0.028099174,0.030654515
2228,2017,인천,중구,2811000000,초등학교,2017-04-01,여자,601,575,571,-4,30,26,-0.006956522,0.052539405,0.045217391
2229,2017,인천,중구,2811000000,초등학교,2017-04-01,남자,643,632,639,7,4,11,0.011075949,0.006259781,0.017405063
2230,2017,인천,동구,2814000000,초등학교,2017-04-01,전체,714,696,654,-42,60,18,-0.060344828,0.091743119,0.025862069
2231,2017,인천,동구,2814000000,초등학교,2017-04-01,여자,353,329,314,-15,39,24,-0.045592705,0.124203822,0.072948328
2232,2017,인천,동구,2814000000,초등학교,2017-04-01,남자,361,367,340,-27,21,-6,-0.073569482,0.061764706,-0.016348774
2233,2017,인천,미추홀구,2817700000,초등학교,2017-04-01,전체,3076,3516,3409,-107,-333,-440,-0.030432309,-0.097682605,-0.125142207
2234,2017,인천,미추홀구,2817700000,초등학교,2017-04-01,여자,1515,1677,1641,-36,-126,-162,-0.021466905,-0.07678245,-0.096601073
2235,2017,인천,미추홀구,2817700000,초등학교,2017-04-01,남자,1561,1839,1768,-71,-207,-278,-0.038607939,-0.117081448,-0.151169114
2236,2017,인천,연수구,2818500000,초등학교,2017-04-01,전체,3514,3205,3485,280,29,309,0.087363495,0.008321377,0.096411856
2237,2017,인천,연수구,2818500000,초등학교,2017-04-01,여자,1687,1548,1649,101,38,139,0.065245478,0.023044269,0.089793282
2238,2017,인천,연수구,2818500000,초등학교,2017-04-01,남자,1827,1657,1836,179,-9,170,0.108026554,-0.004901961,0.102595051
2239,2017,인천,남동구,2820000000,초등학교,2017-04-01,전체,5243,5478,5642,164,-399,-235,0.029937934,-0.070719603,-0.042898868
2240,2017,인천,남동구,2820000000,초등학교,2017-04-01,여자,2547,2636,2712,76,-165,-89,0.028831563,-0.060840708,-0.033763278
2241,2017,인천,남동구,2820000000,초등학교,2017-04-01,남자,2696,2842,2930,88,-234,-146,0.03096411,-0.079863481,-0.051372273
2242,2017,인천,부평구,2823700000,초등학교,2017-04-01,전체,4338,4962,4785,-177,-447,-624,-0.0356711,-0.093416928,-0.125755744
2243,2017,인천,부평구,2823700000,초등학교,2017-04-01,여자,2101,2445,2349,-96,-248,-344,-0.039263804,-0.105576841,-0.140695297
2244,2017,인천,부평구,2823700000,초등학교,2017-04-01,남자,2237,2517,2436,-81,-199,-280,-0.032181168,-0.081691297,-0.111243544
2245,2017,인천,계양구,2824500000,초등학교,2017-04-01,전체,2836,3146,3039,-107,-203,-310,-0.034011443,-0.066798289,-0.098537826
2246,2017,인천,계양구,2824500000,초등학교,2017-04-01,여자,1406,1555,1507,-48,-101,-149,-0.030868167,-0.067020571,-0.095819936
2247,2017,인천,계양구,2824500000,초등학교,2017-04-01,남자,1430,1591,1532,-59,-102,-161,-0.037083595,-0.066579634,-0.101194217
2248,2017,인천,서구,2826000000,초등학교,2017-04-01,전체,5554,5964,5966,2,-412,-410,0.000335345,-0.069057995,-0.068745808
2249,2017,인천,서구,2826000000,초등학교,2017-04-01,여자,2692,2921,2925,4,-233,-229,0.001369394,-0.07965812,-0.078397809
2250,2017,인천,서구,2826000000,초등학교,2017-04-01,남자,2862,3043,3041,-2,-179,-181,-0.000657246,-0.058862216,-0.059480776
2251,2017,인천,강화군,2871000000,초등학교,2017-04-01,전체,402,347,376,29,26,55,0.083573487,0.069148936,0.158501441
2252,2017,인천,강화군,2871000000,초등학교,2017-04-01,여자,189,165,180,15,9,24,0.090909091,0.05,0.145454545
2253,2017,인천,강화군,2871000000,초등학교,2017-04-01,남자,213,182,196,14,17,31,0.076923077,0.086734694,0.17032967
2254,2017,인천,옹진군,2872000000,초등학교,2017-04-01,전체,111,140,143,3,-32,-29,0.021428571,-0.223776224,-0.207142857
2255,2017,인천,옹진군,2872000000,초등학교,2017-04-01,여자,54,66,68,2,-14,-12,0.03030303,-0.205882353,-0.181818182
2256,2017,인천,옹진군,2872000000,초등학교,2017-04-01,남자,57,74,75,1,-18,-17,0.013513514,-0.24,-0.22972973
2257,2017,광주,동구,2911000000,초등학교,2017-04-01,전체,560,710,691,-19,-131,-150,-0.026760563,-0.189580318,-0.211267606
2258,2017,광주,동구,2911000000,초등학교,2017-04-01,여자,260,351,347,-4,-87,-91,-0.011396011,-0.250720461,-0.259259259
2259,2017,광주,동구,2911000000,초등학교,2017-04-01,남자,300,359,344,-15,-44,-59,-0.04178273,-0.127906977,-0.164345404
2260,2017,광주,서구,2914000000,초등학교,2017-04-01,전체,2820,2868,2852,-16,-32,-48,-0.005578801,-0.011220196,-0.016736402
2261,2017,광주,서구,2914000000,초등학교,2017-04-01,여자,1348,1411,1394,-17,-46,-63,-0.012048193,-0.032998565,-0.044649185
2262,2017,광주,서구,2914000000,초등학교,2017-04-01,남자,1472,1457,1458,1,14,15,0.000686342,0.009602195,0.010295127
2263,2017,광주,남구,2915500000,초등학교,2017-04-01,전체,2240,2002,2047,45,193,238,0.022477522,0.094284319,0.118881119
2264,2017,광주,남구,2915500000,초등학교,2017-04-01,여자,1097,977,997,20,100,120,0.020470829,0.100300903,0.122824974
2265,2017,광주,남구,2915500000,초등학교,2017-04-01,남자,1143,1025,1050,25,93,118,0.024390244,0.088571429,0.115121951
2266,2017,광주,북구,2917000000,초등학교,2017-04-01,전체,3957,4117,4079,-38,-122,-160,-0.009230022,-0.029909291,-0.03886325
2267,2017,광주,북구,2917000000,초등학교,2017-04-01,여자,1939,2040,2017,-23,-78,-101,-0.01127451,-0.038671294,-0.049509804
2268,2017,광주,북구,2917000000,초등학교,2017-04-01,남자,2018,2077,2062,-15,-44,-59,-0.007221955,-0.021338506,-0.028406355
2269,2017,광주,광산구,2920000000,초등학교,2017-04-01,전체,5323,5543,5515,-28,-192,-220,-0.005051416,-0.034814143,-0.039689699
2270,2017,광주,광산구,2920000000,초등학교,2017-04-01,여자,2586,2697,2675,-22,-89,-111,-0.008157212,-0.033271028,-0.041156841
2271,2017,광주,광산구,2920000000,초등학교,2017-04-01,남자,2737,2846,2840,-6,-103,-109,-0.002108222,-0.036267606,-0.038299368
2272,2017,대전,동구,3011000000,초등학교,2017-04-01,전체,1953,2297,2195,-102,-242,-344,-0.044405747,-0.110250569,-0.149760557
2273,2017,대전,동구,3011000000,초등학교,2017-04-01,여자,954,1120,1089,-31,-135,-166,-0.027678571,-0.123966942,-0.148214286
2274,2017,대전,동구,3011000000,초등학교,2017-04-01,남자,999,1177,1106,-71,-107,-178,-0.060322855,-0.096745027,-0.151231946
2275,2017,대전,중구,3014000000,초등학교,2017-04-01,전체,2166,2231,2183,-48,-17,-65,-0.021515016,-0.007787448,-0.029134917
2276,2017,대전,중구,3014000000,초등학교,2017-04-01,여자,1080,1126,1076,-50,4,-46,-0.044404973,0.003717472,-0.040852575
2277,2017,대전,중구,3014000000,초등학교,2017-04-01,남자,1086,1105,1107,2,-21,-19,0.001809955,-0.01897019,-0.01719457
2278,2017,대전,서구,3017000000,초등학교,2017-04-01,전체,4454,4762,4714,-48,-260,-308,-0.010079798,-0.055154858,-0.064678706
2279,2017,대전,서구,3017000000,초등학교,2017-04-01,여자,2155,2272,2253,-19,-98,-117,-0.008362676,-0.043497559,-0.051496479
2280,2017,대전,서구,3017000000,초등학교,2017-04-01,남자,2299,2490,2461,-29,-162,-191,-0.011646586,-0.0658269,-0.076706827
2281,2017,대전,유성구,3020000000,초등학교,2017-04-01,전체,4067,4187,4189,2,-122,-120,0.000477669,-0.029123896,-0.028660139
2282,2017,대전,유성구,3020000000,초등학교,2017-04-01,여자,1959,2050,2061,11,-102,-91,0.005365854,-0.049490539,-0.044390244
2283,2017,대전,유성구,3020000000,초등학교,2017-04-01,남자,2108,2137,2128,-9,-20,-29,-0.004211511,-0.009398496,-0.013570426
2284,2017,대전,대덕구,3023000000,초등학교,2017-04-01,전체,1553,1762,1652,-110,-99,-209,-0.062429058,-0.059927361,-0.11861521
2285,2017,대전,대덕구,3023000000,초등학교,2017-04-01,여자,722,835,778,-57,-56,-113,-0.068263473,-0.071979434,-0.135329341
2286,2017,대전,대덕구,3023000000,초등학교,2017-04-01,남자,831,927,874,-53,-43,-96,-0.057173679,-0.049199085,-0.103559871
2287,2017,울산,중구,3111000000,초등학교,2017-04-01,전체,2179,2255,2328,73,-149,-76,0.032372506,-0.064003436,-0.033702882
2288,2017,울산,중구,3111000000,초등학교,2017-04-01,여자,1033,1083,1115,32,-82,-50,0.029547553,-0.073542601,-0.046168052
2289,2017,울산,중구,3111000000,초등학교,2017-04-01,남자,1146,1172,1213,41,-67,-26,0.034982935,-0.055234955,-0.0221843
2290,2017,울산,남구,3114000000,초등학교,2017-04-01,전체,2649,2972,2898,-74,-249,-323,-0.024899058,-0.085921325,-0.108681023
2291,2017,울산,남구,3114000000,초등학교,2017-04-01,여자,1239,1432,1379,-53,-140,-193,-0.037011173,-0.101522843,-0.134776536
2292,2017,울산,남구,3114000000,초등학교,2017-04-01,남자,1410,1540,1519,-21,-109,-130,-0.013636364,-0.071757735,-0.084415584
2293,2017,울산,동구,3117000000,초등학교,2017-04-01,전체,1890,2082,2040,-42,-150,-192,-0.020172911,-0.073529412,-0.09221902
2294,2017,울산,동구,3117000000,초등학교,2017-04-01,여자,893,980,956,-24,-63,-87,-0.024489796,-0.065899582,-0.08877551
2295,2017,울산,동구,3117000000,초등학교,2017-04-01,남자,997,1102,1084,-18,-87,-105,-0.016333938,-0.080258303,-0.095281307
2296,2017,울산,북구,3120000000,초등학교,2017-04-01,전체,2446,2535,2524,-11,-78,-89,-0.00433925,-0.030903328,-0.035108481
2297,2017,울산,북구,3120000000,초등학교,2017-04-01,여자,1221,1238,1230,-8,-9,-17,-0.006462036,-0.007317073,-0.013731826
2298,2017,울산,북구,3120000000,초등학교,2017-04-01,남자,1225,1297,1294,-3,-69,-72,-0.00231303,-0.053323029,-0.055512722
2299,2017,울산,울주군,3171000000,초등학교,2017-04-01,전체,2320,2316,2323,7,-3,4,0.003022453,-0.001291433,0.001727116
2300,2017,울산,울주군,3171000000,초등학교,2017-04-01,여자,1137,1157,1172,15,-35,-20,0.012964564,-0.029863481,-0.017286085
2301,2017,울산,울주군,3171000000,초등학교,2017-04-01,남자,1183,1159,1151,-8,32,24,-0.006902502,0.027801911,0.020707506
2302,2017,세종,세종시,3611000000,초등학교,2017-04-01,전체,3839,2680,3550,870,289,1159,0.324626866,0.081408451,0.432462687
2303,2017,세종,세종시,3611000000,초등학교,2017-04-01,전체,3839,2680,3550,870,289,1159,0.324626866,0.081408451,0.432462687
2304,2017,세종,세종시,3611000000,초등학교,2017-04-01,전체,3839,2680,3550,870,289,1159,0.324626866,0.081408451,0.432462687
2305,2017,세종,세종시,3611000000,초등학교,2017-04-01,전체,3839,2680,3550,870,289,1159,0.324626866,0.081408451,0.432462687
2306,2017,세종,세종시,3611000000,초등학교,2017-04-01,여자,1871,1332,1735,403,136,539,0.302552553,0.078386167,0.404654655
2307,2017,세종,세종시,3611000000,초등학교,2017-04-01,여자,1871,1332,1735,403,136,539,0.302552553,0.078386167,0.404654655
2308,2017,세종,세종시,3611000000,초등학교,2017-04-01,여자,1871,1332,1735,403,136,539,0.302552553,0.078386167,0.404654655
2309,2017,세종,세종시,3611000000,초등학교,2017-04-01,여자,1871,1332,1735,403,136,539,0.302552553,0.078386167,0.404654655
2310,2017,세종,세종시,3611000000,초등학교,2017-04-01,남자,1968,1348,1815,467,153,620,0.346439169,0.084297521,0.459940653
2311,2017,세종,세종시,3611000000,초등학교,2017-04-01,남자,1968,1348,1815,467,153,620,0.346439169,0.084297521,0.459940653
2312,2017,세종,세종시,3611000000,초등학교,2017-04-01,남자,1968,1348,1815,467,153,620,0.346439169,0.084297521,0.459940653
2313,2017,세종,세종시,3611000000,초등학교,2017-04-01,남자,1968,1348,1815,467,153,620,0.346439169,0.084297521,0.459940653
2314,2017,경기,수원시,4111000000,초등학교,2017-04-01,전체,11580,12475,12332,-143,-752,-895,-0.011462926,-0.060979565,-0.071743487
2315,2017,경기,수원시,4111000000,초등학교,2017-04-01,여자,5596,6014,5960,-54,-364,-418,-0.008979049,-0.061073826,-0.06950449
2316,2017,경기,수원시,4111000000,초등학교,2017-04-01,남자,5984,6461,6372,-89,-388,-477,-0.013774957,-0.0608914,-0.073827581
2317,2017,경기,성남시,4113000000,초등학교,2017-04-01,전체,8106,8780,8662,-118,-556,-674,-0.013439636,-0.064188409,-0.076765376
2318,2017,경기,성남시,4113000000,초등학교,2017-04-01,여자,3949,4206,4159,-47,-210,-257,-0.011174513,-0.050492907,-0.061103186
2319,2017,경기,성남시,4113000000,초등학교,2017-04-01,남자,4157,4574,4503,-71,-346,-417,-0.015522519,-0.076837664,-0.091167468
2320,2017,경기,부천시,4119000000,초등학교,2017-04-01,전체,6934,7467,7310,-157,-376,-533,-0.021025847,-0.051436389,-0.071380742
2321,2017,경기,부천시,4119000000,초등학교,2017-04-01,여자,3406,3648,3582,-66,-176,-242,-0.018092105,-0.049134562,-0.066337719
2322,2017,경기,부천시,4119000000,초등학교,2017-04-01,남자,3528,3819,3728,-91,-200,-291,-0.023828227,-0.053648069,-0.076197958
2323,2017,경기,안양시,4117000000,초등학교,2017-04-01,전체,4978,5356,5257,-99,-279,-378,-0.018483943,-0.053072094,-0.070575056
2324,2017,경기,안양시,4117000000,초등학교,2017-04-01,여자,2395,2575,2538,-37,-143,-180,-0.014368932,-0.056343578,-0.069902913
2325,2017,경기,안양시,4117000000,초등학교,2017-04-01,남자,2583,2781,2719,-62,-136,-198,-0.022294139,-0.050018389,-0.071197411
2326,2017,경기,과천시,4129000000,초등학교,2017-04-01,전체,440,582,568,-14,-128,-142,-0.024054983,-0.225352113,-0.243986254
2327,2017,경기,과천시,4129000000,초등학교,2017-04-01,여자,211,265,266,1,-55,-54,0.003773585,-0.206766917,-0.203773585
2328,2017,경기,과천시,4129000000,초등학교,2017-04-01,남자,229,317,302,-15,-73,-88,-0.047318612,-0.241721854,-0.277602524
2329,2017,경기,안산시,4127000000,초등학교,2017-04-01,전체,6090,6595,6394,-201,-304,-505,-0.030477635,-0.047544573,-0.076573161
2330,2017,경기,안산시,4127000000,초등학교,2017-04-01,여자,2944,3222,3130,-92,-186,-278,-0.028553693,-0.05942492,-0.086281813
2331,2017,경기,안산시,4127000000,초등학교,2017-04-01,남자,3146,3373,3264,-109,-118,-227,-0.032315446,-0.036151961,-0.06729914
2332,2017,경기,용인시,4146000000,초등학교,2017-04-01,전체,11437,12248,12297,49,-860,-811,0.004000653,-0.069935757,-0.066214892
2333,2017,경기,용인시,4146000000,초등학교,2017-04-01,여자,5555,6038,6053,15,-498,-483,0.002484266,-0.082273253,-0.079993375
2334,2017,경기,용인시,4146000000,초등학교,2017-04-01,남자,5882,6210,6244,34,-362,-328,0.00547504,-0.057975657,-0.052818035
2335,2017,경기,군포시,4141000000,초등학교,2017-04-01,전체,2682,3073,2974,-99,-292,-391,-0.032216075,-0.098184264,-0.127237227
2336,2017,경기,군포시,4141000000,초등학교,2017-04-01,여자,1267,1475,1431,-44,-164,-208,-0.029830508,-0.114605171,-0.141016949
2337,2017,경기,군포시,4141000000,초등학교,2017-04-01,남자,1415,1598,1543,-55,-128,-183,-0.034418023,-0.082955282,-0.114518148
2338,2017,경기,의왕시,4143000000,초등학교,2017-04-01,전체,1326,1654,1578,-76,-252,-328,-0.045949214,-0.159695817,-0.198307134
2339,2017,경기,의왕시,4143000000,초등학교,2017-04-01,여자,618,791,761,-30,-143,-173,-0.037926675,-0.187910644,-0.218710493
2340,2017,경기,의왕시,4143000000,초등학교,2017-04-01,남자,708,863,817,-46,-109,-155,-0.053302433,-0.133414933,-0.179606025
2341,2017,경기,시흥시,4139000000,초등학교,2017-04-01,전체,4248,4172,4201,29,47,76,0.006951103,0.011187812,0.018216683
2342,2017,경기,시흥시,4139000000,초등학교,2017-04-01,여자,2083,2080,2071,-9,12,3,-0.004326923,0.005794302,0.001442308
2343,2017,경기,시흥시,4139000000,초등학교,2017-04-01,남자,2165,2092,2130,38,35,73,0.018164436,0.016431925,0.034894837
2344,2017,경기,평택시,4122000000,초등학교,2017-04-01,전체,4918,4936,5046,110,-128,-18,0.022285251,-0.025366627,-0.003646677
2345,2017,경기,평택시,4122000000,초등학교,2017-04-01,여자,2346,2385,2433,48,-87,-39,0.020125786,-0.035758323,-0.016352201
2346,2017,경기,평택시,4122000000,초등학교,2017-04-01,남자,2572,2551,2613,62,-41,21,0.024304194,-0.015690777,0.008232066
2347,2017,경기,화성시,4159000000,초등학교,2017-04-01,전체,9716,8730,9574,844,142,986,0.096678121,0.014831836,0.112943872
2348,2017,경기,화성시,4159000000,초등학교,2017-04-01,여자,4732,4256,4651,395,81,476,0.09281015,0.01741561,0.111842105
2349,2017,경기,화성시,4159000000,초등학교,2017-04-01,남자,4984,4474,4923,449,61,510,0.100357622,0.012390819,0.113991954
2350,2017,경기,오산시,4137000000,초등학교,2017-04-01,전체,2839,3081,2975,-106,-136,-242,-0.034404414,-0.045714286,-0.078545927
2351,2017,경기,오산시,4137000000,초등학교,2017-04-01,여자,1400,1514,1472,-42,-72,-114,-0.027741083,-0.048913043,-0.075297226
2352,2017,경기,오산시,4137000000,초등학교,2017-04-01,남자,1439,1567,1503,-64,-64,-128,-0.040842374,-0.042581504,-0.081684748
2353,2017,경기,광명시,4121000000,초등학교,2017-04-01,전체,3272,3732,3615,-117,-343,-460,-0.031350482,-0.094882434,-0.123258307
2354,2017,경기,광명시,4121000000,초등학교,2017-04-01,여자,1621,1825,1767,-58,-146,-204,-0.031780822,-0.08262592,-0.111780822
2355,2017,경기,광명시,4121000000,초등학교,2017-04-01,남자,1651,1907,1848,-59,-197,-256,-0.030938647,-0.106601732,-0.134242265
2356,2017,경기,광주시,4161000000,초등학교,2017-04-01,전체,3151,3559,3579,20,-428,-408,0.005619556,-0.119586477,-0.114638944
2357,2017,경기,광주시,4161000000,초등학교,2017-04-01,여자,1523,1691,1720,29,-197,-168,0.017149616,-0.114534884,-0.099349497
2358,2017,경기,광주시,4161000000,초등학교,2017-04-01,남자,1628,1868,1859,-9,-231,-240,-0.004817987,-0.124260355,-0.128479657
2359,2017,경기,하남시,4145000000,초등학교,2017-04-01,전체,2477,1610,2032,422,445,867,0.262111801,0.218996063,0.538509317
2360,2017,경기,하남시,4145000000,초등학교,2017-04-01,여자,1208,806,985,179,223,402,0.222084367,0.226395939,0.498759305
2361,2017,경기,하남시,4145000000,초등학교,2017-04-01,남자,1269,804,1047,243,222,465,0.302238806,0.212034384,0.578358209
2362,2017,경기,김포시,4157000000,초등학교,2017-04-01,전체,4856,4626,4712,86,144,230,0.018590575,0.030560272,0.04971898
2363,2017,경기,김포시,4157000000,초등학교,2017-04-01,여자,2265,2195,2232,37,33,70,0.016856492,0.014784946,0.031890661
2364,2017,경기,김포시,4157000000,초등학교,2017-04-01,남자,2591,2431,2480,49,111,160,0.020156314,0.044758065,0.065816536
2365,2017,경기,이천시,4150000000,초등학교,2017-04-01,전체,2274,2285,2303,18,-29,-11,0.007877462,-0.012592271,-0.004814004
2366,2017,경기,이천시,4150000000,초등학교,2017-04-01,여자,1071,1088,1097,9,-26,-17,0.008272059,-0.023701003,-0.015625
2367,2017,경기,이천시,4150000000,초등학교,2017-04-01,남자,1203,1197,1206,9,-3,6,0.007518797,-0.002487562,0.005012531
2368,2017,경기,안성시,4155000000,초등학교,2017-04-01,전체,1809,1959,1898,-61,-89,-150,-0.031138336,-0.046891465,-0.076569678
2369,2017,경기,안성시,4155000000,초등학교,2017-04-01,여자,871,984,938,-46,-67,-113,-0.046747967,-0.071428571,-0.114837398
2370,2017,경기,안성시,4155000000,초등학교,2017-04-01,남자,938,975,960,-15,-22,-37,-0.015384615,-0.022916667,-0.037948718
2371,2017,경기,여주시,4167000000,초등학교,2017-04-01,전체,939,992,984,-8,-45,-53,-0.008064516,-0.045731707,-0.053427419
2372,2017,경기,여주시,4167000000,초등학교,2017-04-01,여자,476,509,510,1,-34,-33,0.001964637,-0.066666667,-0.064833006
2373,2017,경기,여주시,4167000000,초등학교,2017-04-01,남자,463,483,474,-9,-11,-20,-0.01863354,-0.023206751,-0.041407867
2374,2017,경기,양평군,4183000000,초등학교,2017-04-01,전체,831,825,866,41,-35,6,0.04969697,-0.040415704,0.007272727
2375,2017,경기,양평군,4183000000,초등학교,2017-04-01,여자,410,400,415,15,-5,10,0.0375,-0.012048193,0.025
2376,2017,경기,양평군,4183000000,초등학교,2017-04-01,남자,421,425,451,26,-30,-4,0.061176471,-0.066518847,-0.009411765
2377,2017,경기,고양시,4128000000,초등학교,2017-04-01,전체,9165,9638,9865,227,-700,-473,0.023552604,-0.070957932,-0.049076572
2378,2017,경기,고양시,4128000000,초등학교,2017-04-01,여자,4444,4685,4830,145,-386,-241,0.03094984,-0.079917184,-0.051440768
2379,2017,경기,고양시,4128000000,초등학교,2017-04-01,남자,4721,4953,5035,82,-314,-232,0.016555623,-0.062363456,-0.046840299
2380,2017,경기,남양주시,4136000000,초등학교,2017-04-01,전체,7192,7605,7756,151,-564,-413,0.019855358,-0.072717896,-0.054306377
2381,2017,경기,남양주시,4136000000,초등학교,2017-04-01,여자,3492,3716,3782,66,-290,-224,0.017761033,-0.076679006,-0.060279871
2382,2017,경기,남양주시,4136000000,초등학교,2017-04-01,남자,3700,3889,3974,85,-274,-189,0.021856518,-0.068948163,-0.048598611
2383,2017,경기,구리시,4131000000,초등학교,2017-04-01,전체,1598,1742,1706,-36,-108,-144,-0.020665901,-0.063305979,-0.082663605
2384,2017,경기,구리시,4131000000,초등학교,2017-04-01,여자,759,855,845,-10,-86,-96,-0.011695906,-0.101775148,-0.112280702
2385,2017,경기,구리시,4131000000,초등학교,2017-04-01,남자,839,887,861,-26,-22,-48,-0.029312289,-0.025551684,-0.054114994
2386,2017,경기,의정부시,4115000000,초등학교,2017-04-01,전체,3749,3916,3915,-1,-166,-167,-0.000255363,-0.042401022,-0.042645557
2387,2017,경기,의정부시,4115000000,초등학교,2017-04-01,여자,1852,1884,1892,8,-40,-32,0.004246285,-0.021141649,-0.016985138
2388,2017,경기,의정부시,4115000000,초등학교,2017-04-01,남자,1897,2032,2023,-9,-126,-135,-0.004429134,-0.062283737,-0.066437008
2389,2017,경기,파주시,4148000000,초등학교,2017-04-01,전체,4992,5159,5236,77,-244,-167,0.014925373,-0.046600458,-0.032370614
2390,2017,경기,파주시,4148000000,초등학교,2017-04-01,여자,2500,2603,2644,41,-144,-103,0.015751056,-0.054462935,-0.039569727
2391,2017,경기,파주시,4148000000,초등학교,2017-04-01,남자,2492,2556,2592,36,-100,-64,0.014084507,-0.038580247,-0.025039124
2392,2017,경기,동두천시,4125000000,초등학교,2017-04-01,전체,923,982,976,-6,-53,-59,-0.00610998,-0.054303279,-0.060081466
2393,2017,경기,동두천시,4125000000,초등학교,2017-04-01,여자,441,460,460,0,-19,-19,0,-0.041304348,-0.041304348
2394,2017,경기,동두천시,4125000000,초등학교,2017-04-01,남자,482,522,516,-6,-34,-40,-0.011494253,-0.065891473,-0.076628352
2395,2017,경기,양주시,4163000000,초등학교,2017-04-01,전체,2136,2303,2292,-11,-156,-167,-0.004776379,-0.068062827,-0.072514112
2396,2017,경기,양주시,4163000000,초등학교,2017-04-01,여자,1062,1153,1140,-13,-78,-91,-0.011274935,-0.068421053,-0.078924545
2397,2017,경기,양주시,4163000000,초등학교,2017-04-01,남자,1074,1150,1152,2,-78,-76,0.00173913,-0.067708333,-0.066086957
2398,2017,경기,포천시,4165000000,초등학교,2017-04-01,전체,1171,1255,1235,-20,-64,-84,-0.015936255,-0.051821862,-0.066932271
2399,2017,경기,포천시,4165000000,초등학교,2017-04-01,여자,566,600,598,-2,-32,-34,-0.003333333,-0.053511706,-0.056666667
2400,2017,경기,포천시,4165000000,초등학교,2017-04-01,남자,605,655,637,-18,-32,-50,-0.027480916,-0.050235479,-0.076335878
2401,2017,경기,가평군,4182000000,초등학교,2017-04-01,전체,459,457,471,14,-12,2,0.030634573,-0.025477707,0.004376368
2402,2017,경기,가평군,4182000000,초등학교,2017-04-01,여자,221,238,241,3,-20,-17,0.012605042,-0.082987552,-0.071428571
2403,2017,경기,가평군,4182000000,초등학교,2017-04-01,남자,238,219,230,11,8,19,0.050228311,0.034782609,0.086757991
2404,2017,경기,연천군,4180000000,초등학교,2017-04-01,전체,334,377,366,-11,-32,-43,-0.029177719,-0.087431694,-0.114058355
2405,2017,경기,연천군,4180000000,초등학교,2017-04-01,여자,169,188,184,-4,-15,-19,-0.021276596,-0.081521739,-0.10106383
2406,2017,경기,연천군,4180000000,초등학교,2017-04-01,남자,165,189,182,-7,-17,-24,-0.037037037,-0.093406593,-0.126984127
2407,2017,강원,춘천시,4211000000,초등학교,2017-04-01,전체,2485,2527,2558,31,-73,-42,0.012267511,-0.02853792,-0.016620499
2408,2017,강원,춘천시,4211000000,초등학교,2017-04-01,여자,1196,1228,1231,3,-35,-32,0.002442997,-0.028432169,-0.026058632
2409,2017,강원,춘천시,4211000000,초등학교,2017-04-01,남자,1289,1299,1327,28,-38,-10,0.021555042,-0.028636021,-0.007698229
2410,2017,강원,원주시,4213000000,초등학교,2017-04-01,전체,3285,3256,3391,135,-106,29,0.041461916,-0.031259216,0.008906634
2411,2017,강원,원주시,4213000000,초등학교,2017-04-01,여자,1636,1609,1675,66,-39,27,0.041019267,-0.023283582,0.016780609
2412,2017,강원,원주시,4213000000,초등학교,2017-04-01,남자,1649,1647,1716,69,-67,2,0.041894353,-0.039044289,0.001214329
2413,2017,강원,강릉시,4215000000,초등학교,2017-04-01,전체,1625,1651,1685,34,-60,-26,0.02059358,-0.035608309,-0.015748031
2414,2017,강원,강릉시,4215000000,초등학교,2017-04-01,여자,756,804,815,11,-59,-48,0.013681592,-0.072392638,-0.059701493
2415,2017,강원,강릉시,4215000000,초등학교,2017-04-01,남자,869,847,870,23,-1,22,0.027154664,-0.001149425,0.025974026
2416,2017,강원,동해시,4217000000,초등학교,2017-04-01,전체,810,826,819,-7,-9,-16,-0.008474576,-0.010989011,-0.01937046
2417,2017,강원,동해시,4217000000,초등학교,2017-04-01,여자,384,399,401,2,-17,-15,0.005012531,-0.042394015,-0.037593985
2418,2017,강원,동해시,4217000000,초등학교,2017-04-01,남자,426,427,418,-9,8,-1,-0.021077283,0.019138756,-0.00234192
2419,2017,강원,태백시,4219000000,초등학교,2017-04-01,전체,397,415,418,3,-21,-18,0.007228916,-0.050239234,-0.043373494
2420,2017,강원,태백시,4219000000,초등학교,2017-04-01,여자,204,210,217,7,-13,-6,0.033333333,-0.059907834,-0.028571429
2421,2017,강원,태백시,4219000000,초등학교,2017-04-01,남자,193,205,201,-4,-8,-12,-0.019512195,-0.039800995,-0.058536585
2422,2017,강원,속초시,4221000000,초등학교,2017-04-01,전체,666,694,692,-2,-26,-28,-0.002881844,-0.037572254,-0.040345821
2423,2017,강원,속초시,4221000000,초등학교,2017-04-01,여자,350,343,344,1,6,7,0.002915452,0.01744186,0.020408163
2424,2017,강원,속초시,4221000000,초등학교,2017-04-01,남자,316,351,348,-3,-32,-35,-0.008547009,-0.091954023,-0.0997151
2425,2017,강원,삼척시,4223000000,초등학교,2017-04-01,전체,464,506,507,1,-43,-42,0.001976285,-0.084812623,-0.083003953
2426,2017,강원,삼척시,4223000000,초등학교,2017-04-01,여자,228,248,250,2,-22,-20,0.008064516,-0.088,-0.080645161
2427,2017,강원,삼척시,4223000000,초등학교,2017-04-01,남자,236,258,257,-1,-21,-22,-0.003875969,-0.081712062,-0.085271318
2428,2017,강원,홍천군,4272000000,초등학교,2017-04-01,전체,495,506,497,-9,-2,-11,-0.017786561,-0.004024145,-0.02173913
2429,2017,강원,홍천군,4272000000,초등학교,2017-04-01,여자,255,248,250,2,5,7,0.008064516,0.02,0.028225806
2430,2017,강원,홍천군,4272000000,초등학교,2017-04-01,남자,240,258,247,-11,-7,-18,-0.042635659,-0.028340081,-0.069767442
2431,2017,강원,횡성군,4273000000,초등학교,2017-04-01,전체,255,269,266,-3,-11,-14,-0.011152416,-0.041353383,-0.05204461
2432,2017,강원,횡성군,4273000000,초등학교,2017-04-01,여자,129,134,129,-5,0,-5,-0.037313433,0,-0.037313433
2433,2017,강원,횡성군,4273000000,초등학교,2017-04-01,남자,126,135,137,2,-11,-9,0.014814815,-0.080291971,-0.066666667
2434,2017,강원,영월군,4275000000,초등학교,2017-04-01,전체,221,230,239,9,-18,-9,0.039130435,-0.075313808,-0.039130435
2435,2017,강원,영월군,4275000000,초등학교,2017-04-01,여자,100,103,104,1,-4,-3,0.009708738,-0.038461538,-0.029126214
2436,2017,강원,영월군,4275000000,초등학교,2017-04-01,남자,121,127,135,8,-14,-6,0.062992126,-0.103703704,-0.047244094
2437,2017,강원,평창군,4276000000,초등학교,2017-04-01,전체,278,283,271,-12,7,-5,-0.042402827,0.025830258,-0.017667845
2438,2017,강원,평창군,4276000000,초등학교,2017-04-01,여자,121,132,126,-6,-5,-11,-0.045454545,-0.03968254,-0.083333333
2439,2017,강원,평창군,4276000000,초등학교,2017-04-01,남자,157,151,145,-6,12,6,-0.039735099,0.082758621,0.039735099
2440,2017,강원,정선군,4277000000,초등학교,2017-04-01,전체,262,260,247,-13,15,2,-0.05,0.060728745,0.007692308
2441,2017,강원,정선군,4277000000,초등학교,2017-04-01,여자,128,123,122,-1,6,5,-0.008130081,0.049180328,0.040650407
2442,2017,강원,정선군,4277000000,초등학교,2017-04-01,남자,134,137,125,-12,9,-3,-0.087591241,0.072,-0.02189781
2443,2017,강원,철원군,4278000000,초등학교,2017-04-01,전체,371,408,399,-9,-28,-37,-0.022058824,-0.070175439,-0.090686275
2444,2017,강원,철원군,4278000000,초등학교,2017-04-01,여자,171,186,172,-14,-1,-15,-0.075268817,-0.005813953,-0.080645161
2445,2017,강원,철원군,4278000000,초등학교,2017-04-01,남자,200,222,227,5,-27,-22,0.022522523,-0.118942731,-0.099099099
2446,2017,강원,화천군,4279000000,초등학교,2017-04-01,전체,197,256,234,-22,-37,-59,-0.0859375,-0.158119658,-0.23046875
2447,2017,강원,화천군,4279000000,초등학교,2017-04-01,여자,96,133,121,-12,-25,-37,-0.090225564,-0.20661157,-0.278195489
2448,2017,강원,화천군,4279000000,초등학교,2017-04-01,남자,101,123,113,-10,-12,-22,-0.081300813,-0.10619469,-0.178861789
2449,2017,강원,양구군,4280000000,초등학교,2017-04-01,전체,197,227,220,-7,-23,-30,-0.030837004,-0.104545455,-0.13215859
2450,2017,강원,양구군,4280000000,초등학교,2017-04-01,여자,104,114,109,-5,-5,-10,-0.043859649,-0.04587156,-0.087719298
2451,2017,강원,양구군,4280000000,초등학교,2017-04-01,남자,93,113,111,-2,-18,-20,-0.017699115,-0.162162162,-0.17699115
2452,2017,강원,인제군,4281000000,초등학교,2017-04-01,전체,300,333,322,-11,-22,-33,-0.033033033,-0.068322981,-0.099099099
2453,2017,강원,인제군,4281000000,초등학교,2017-04-01,여자,137,153,152,-1,-15,-16,-0.006535948,-0.098684211,-0.104575163
2454,2017,강원,인제군,4281000000,초등학교,2017-04-01,남자,163,180,170,-10,-7,-17,-0.055555556,-0.041176471,-0.094444444
2455,2017,강원,고성군,4282000000,초등학교,2017-04-01,전체,154,161,165,4,-11,-7,0.02484472,-0.066666667,-0.043478261
2456,2017,강원,고성군,4282000000,초등학교,2017-04-01,여자,72,66,66,0,6,6,0,0.090909091,0.090909091
2457,2017,강원,고성군,4282000000,초등학교,2017-04-01,남자,82,95,99,4,-17,-13,0.042105263,-0.171717172,-0.136842105
2458,2017,강원,양양군,4283000000,초등학교,2017-04-01,전체,158,180,168,-12,-10,-22,-0.066666667,-0.05952381,-0.122222222
2459,2017,강원,양양군,4283000000,초등학교,2017-04-01,여자,73,85,76,-9,-3,-12,-0.105882353,-0.039473684,-0.141176471
2460,2017,강원,양양군,4283000000,초등학교,2017-04-01,남자,85,95,92,-3,-7,-10,-0.031578947,-0.076086957,-0.105263158
2461,2017,충북,청주시,4311000000,초등학교,2017-04-01,전체,8554,8935,8868,-67,-314,-381,-0.007498601,-0.035408209,-0.042641298
2462,2017,충북,청주시,4311000000,초등학교,2017-04-01,여자,4147,4390,4361,-29,-214,-243,-0.006605923,-0.049071314,-0.055353075
2463,2017,충북,청주시,4311000000,초등학교,2017-04-01,남자,4407,4545,4507,-38,-100,-138,-0.008360836,-0.022187708,-0.030363036
2464,2017,충북,충주시,4313000000,초등학교,2017-04-01,전체,1738,1759,1781,22,-43,-21,0.012507106,-0.024143739,-0.011938601
2465,2017,충북,충주시,4313000000,초등학교,2017-04-01,여자,864,840,850,10,14,24,0.011904762,0.016470588,0.028571429
2466,2017,충북,충주시,4313000000,초등학교,2017-04-01,남자,874,919,931,12,-57,-45,0.013057671,-0.06122449,-0.048966268
2467,2017,충북,제천시,4315000000,초등학교,2017-04-01,전체,1061,1098,1071,-27,-10,-37,-0.024590164,-0.009337068,-0.033697632
2468,2017,충북,제천시,4315000000,초등학교,2017-04-01,여자,550,547,540,-7,10,3,-0.012797075,0.018518519,0.005484461
2469,2017,충북,제천시,4315000000,초등학교,2017-04-01,남자,511,551,531,-20,-20,-40,-0.036297641,-0.037664783,-0.072595281
2470,2017,충북,보은군,4372000000,초등학교,2017-04-01,전체,185,185,201,16,-16,0,0.086486486,-0.07960199,0
2471,2017,충북,보은군,4372000000,초등학교,2017-04-01,여자,75,81,87,6,-12,-6,0.074074074,-0.137931034,-0.074074074
2472,2017,충북,보은군,4372000000,초등학교,2017-04-01,남자,110,104,114,10,-4,6,0.096153846,-0.035087719,0.057692308
2473,2017,충북,옥천군,4373000000,초등학교,2017-04-01,전체,362,392,395,3,-33,-30,0.007653061,-0.083544304,-0.076530612
2474,2017,충북,옥천군,4373000000,초등학교,2017-04-01,여자,167,181,181,0,-14,-14,0,-0.077348066,-0.077348066
2475,2017,충북,옥천군,4373000000,초등학교,2017-04-01,남자,195,211,214,3,-19,-16,0.014218009,-0.088785047,-0.075829384
2476,2017,충북,영동군,4374000000,초등학교,2017-04-01,전체,298,322,317,-5,-19,-24,-0.01552795,-0.059936909,-0.074534161
2477,2017,충북,영동군,4374000000,초등학교,2017-04-01,여자,117,131,125,-6,-8,-14,-0.045801527,-0.064,-0.106870229
2478,2017,충북,영동군,4374000000,초등학교,2017-04-01,남자,181,191,192,1,-11,-10,0.005235602,-0.057291667,-0.052356021
2479,2017,충북,진천군,4375000000,초등학교,2017-04-01,전체,767,661,697,36,70,106,0.054462935,0.100430416,0.160363086
2480,2017,충북,진천군,4375000000,초등학교,2017-04-01,여자,375,322,341,19,34,53,0.059006211,0.099706745,0.164596273
2481,2017,충북,진천군,4375000000,초등학교,2017-04-01,남자,392,339,356,17,36,53,0.050147493,0.101123596,0.156342183
2482,2017,충북,괴산군,4376000000,초등학교,2017-04-01,전체,190,171,165,-6,25,19,-0.035087719,0.151515152,0.111111111
2483,2017,충북,괴산군,4376000000,초등학교,2017-04-01,여자,86,77,73,-4,13,9,-0.051948052,0.178082192,0.116883117
2484,2017,충북,괴산군,4376000000,초등학교,2017-04-01,남자,104,94,92,-2,12,10,-0.021276596,0.130434783,0.106382979
2485,2017,충북,음성군,4377000000,초등학교,2017-04-01,전체,823,859,871,12,-48,-36,0.013969732,-0.05510907,-0.041909197
2486,2017,충북,음성군,4377000000,초등학교,2017-04-01,여자,369,412,412,0,-43,-43,0,-0.104368932,-0.104368932
2487,2017,충북,음성군,4377000000,초등학교,2017-04-01,남자,454,447,459,12,-5,7,0.026845638,-0.010893246,0.015659955
2488,2017,충북,단양군,4380000000,초등학교,2017-04-01,전체,152,185,184,-1,-32,-33,-0.005405405,-0.173913043,-0.178378378
2489,2017,충북,단양군,4380000000,초등학교,2017-04-01,여자,64,79,78,-1,-14,-15,-0.012658228,-0.179487179,-0.189873418
2490,2017,충북,단양군,4380000000,초등학교,2017-04-01,남자,88,106,106,0,-18,-18,0,-0.169811321,-0.169811321
2491,2017,충북,증평군,4374500000,초등학교,2017-04-01,전체,397,413,424,11,-27,-16,0.026634383,-0.063679245,-0.03874092
2492,2017,충북,증평군,4374500000,초등학교,2017-04-01,여자,183,204,210,6,-27,-21,0.029411765,-0.128571429,-0.102941176
2493,2017,충북,증평군,4374500000,초등학교,2017-04-01,남자,214,209,214,5,0,5,0.023923445,0,0.023923445
2494,2017,충남,천안시,4413000000,초등학교,2017-04-01,전체,6857,6681,6635,-46,222,176,-0.006885197,0.03345893,0.026343362
2495,2017,충남,천안시,4413000000,초등학교,2017-04-01,여자,3340,3268,3245,-23,95,72,-0.007037944,0.029275809,0.022031824
2496,2017,충남,천안시,4413000000,초등학교,2017-04-01,남자,3517,3413,3390,-23,127,104,-0.006738939,0.037463127,0.030471726
2497,2017,충남,공주시,4415000000,초등학교,2017-04-01,전체,749,807,789,-18,-40,-58,-0.022304833,-0.050697085,-0.071871128
2498,2017,충남,공주시,4415000000,초등학교,2017-04-01,여자,359,366,359,-7,0,-7,-0.019125683,0,-0.019125683
2499,2017,충남,공주시,4415000000,초등학교,2017-04-01,남자,390,441,430,-11,-40,-51,-0.024943311,-0.093023256,-0.115646259
2500,2017,충남,보령시,4418000000,초등학교,2017-04-01,전체,797,842,860,18,-63,-45,0.021377672,-0.073255814,-0.053444181
2501,2017,충남,보령시,4418000000,초등학교,2017-04-01,여자,385,407,410,3,-25,-22,0.007371007,-0.06097561,-0.054054054
2502,2017,충남,보령시,4418000000,초등학교,2017-04-01,남자,412,435,450,15,-38,-23,0.034482759,-0.084444444,-0.052873563
2503,2017,충남,아산시,4420000000,초등학교,2017-04-01,전체,3824,4168,4195,27,-371,-344,0.006477927,-0.088438617,-0.082533589
2504,2017,충남,아산시,4420000000,초등학교,2017-04-01,여자,1834,1953,1972,19,-138,-119,0.009728623,-0.069979716,-0.0609319
2505,2017,충남,아산시,4420000000,초등학교,2017-04-01,남자,1990,2215,2223,8,-233,-225,0.003611738,-0.104813315,-0.101580135
2506,2017,충남,서산시,4421000000,초등학교,2017-04-01,전체,1716,1849,1840,-9,-124,-133,-0.004867496,-0.067391304,-0.071930773
2507,2017,충남,서산시,4421000000,초등학교,2017-04-01,여자,827,891,892,1,-65,-64,0.001122334,-0.072869955,-0.071829405
2508,2017,충남,서산시,4421000000,초등학교,2017-04-01,남자,889,958,948,-10,-59,-69,-0.010438413,-0.062236287,-0.072025052
2509,2017,충남,논산시,4423000000,초등학교,2017-04-01,전체,918,911,909,-2,9,7,-0.00219539,0.00990099,0.007683864
2510,2017,충남,논산시,4423000000,초등학교,2017-04-01,여자,423,444,439,-5,-16,-21,-0.011261261,-0.036446469,-0.047297297
2511,2017,충남,논산시,4423000000,초등학교,2017-04-01,남자,495,467,470,3,25,28,0.006423983,0.053191489,0.059957173
2512,2017,충남,계룡시,4425000000,초등학교,2017-04-01,전체,480,459,501,42,-21,21,0.091503268,-0.041916168,0.045751634
2513,2017,충남,계룡시,4425000000,초등학교,2017-04-01,여자,231,225,241,16,-10,6,0.071111111,-0.041493776,0.026666667
2514,2017,충남,계룡시,4425000000,초등학교,2017-04-01,남자,249,234,260,26,-11,15,0.111111111,-0.042307692,0.064102564
2515,2017,충남,금산군,4471000000,초등학교,2017-04-01,전체,400,432,424,-8,-24,-32,-0.018518519,-0.056603774,-0.074074074
2516,2017,충남,금산군,4471000000,초등학교,2017-04-01,여자,182,193,189,-4,-7,-11,-0.020725389,-0.037037037,-0.056994819
2517,2017,충남,금산군,4471000000,초등학교,2017-04-01,남자,218,239,235,-4,-17,-21,-0.016736402,-0.072340426,-0.087866109
2518,2017,충남,부여군,4476000000,초등학교,2017-04-01,전체,380,396,396,0,-16,-16,0,-0.04040404,-0.04040404
2519,2017,충남,부여군,4476000000,초등학교,2017-04-01,여자,168,174,174,0,-6,-6,0,-0.034482759,-0.034482759
2520,2017,충남,부여군,4476000000,초등학교,2017-04-01,남자,212,222,222,0,-10,-10,0,-0.045045045,-0.045045045
2521,2017,충남,서천군,4477000000,초등학교,2017-04-01,전체,316,345,347,2,-31,-29,0.005797101,-0.089337176,-0.084057971
2522,2017,충남,서천군,4477000000,초등학교,2017-04-01,여자,162,168,176,8,-14,-6,0.047619048,-0.079545455,-0.035714286
2523,2017,충남,서천군,4477000000,초등학교,2017-04-01,남자,154,177,171,-6,-17,-23,-0.033898305,-0.099415205,-0.129943503
2524,2017,충남,청양군,4479000000,초등학교,2017-04-01,전체,165,207,208,1,-43,-42,0.004830918,-0.206730769,-0.202898551
2525,2017,충남,청양군,4479000000,초등학교,2017-04-01,여자,77,101,102,1,-25,-24,0.00990099,-0.245098039,-0.237623762
2526,2017,충남,청양군,4479000000,초등학교,2017-04-01,남자,88,106,106,0,-18,-18,0,-0.169811321,-0.169811321
2527,2017,충남,홍성군,4480000000,초등학교,2017-04-01,전체,950,795,876,81,74,155,0.101886792,0.084474886,0.194968553
2528,2017,충남,홍성군,4480000000,초등학교,2017-04-01,여자,472,387,421,34,51,85,0.087855297,0.121140143,0.219638243
2529,2017,충남,홍성군,4480000000,초등학교,2017-04-01,남자,478,408,455,47,23,70,0.115196078,0.050549451,0.171568627
2530,2017,충남,예산군,4481000000,초등학교,2017-04-01,전체,496,526,509,-17,-13,-30,-0.032319392,-0.025540275,-0.057034221
2531,2017,충남,예산군,4481000000,초등학교,2017-04-01,여자,237,238,238,0,-1,-1,0,-0.004201681,-0.004201681
2532,2017,충남,예산군,4481000000,초등학교,2017-04-01,남자,259,288,271,-17,-12,-29,-0.059027778,-0.044280443,-0.100694444
2533,2017,충남,태안군,4482500000,초등학교,2017-04-01,전체,349,379,400,21,-51,-30,0.055408971,-0.1275,-0.079155673
2534,2017,충남,태안군,4482500000,초등학교,2017-04-01,여자,160,181,194,13,-34,-21,0.071823204,-0.175257732,-0.116022099
2535,2017,충남,태안군,4482500000,초등학교,2017-04-01,남자,189,198,206,8,-17,-9,0.04040404,-0.082524272,-0.045454545
2536,2017,충남,당진시,4427000000,초등학교,2017-04-01,전체,1862,1954,1944,-10,-82,-92,-0.005117707,-0.04218107,-0.047082907
2537,2017,충남,당진시,4427000000,초등학교,2017-04-01,여자,873,935,937,2,-64,-62,0.002139037,-0.068303095,-0.06631016
2538,2017,충남,당진시,4427000000,초등학교,2017-04-01,남자,989,1019,1007,-12,-18,-30,-0.011776251,-0.017874876,-0.029440628
2539,2017,전북,전주시,4511000000,초등학교,2017-04-01,전체,6505,6428,6474,46,31,77,0.007156192,0.004788384,0.011978843
2540,2017,전북,전주시,4511000000,초등학교,2017-04-01,여자,3159,3106,3140,34,19,53,0.010946555,0.006050955,0.017063748
2541,2017,전북,전주시,4511000000,초등학교,2017-04-01,남자,3346,3322,3334,12,12,24,0.003612282,0.00359928,0.007224564
2542,2017,전북,군산시,4513000000,초등학교,2017-04-01,전체,2708,2857,2847,-10,-139,-149,-0.003500175,-0.048823323,-0.052152608
2543,2017,전북,군산시,4513000000,초등학교,2017-04-01,여자,1342,1399,1396,-3,-54,-57,-0.002144389,-0.038681948,-0.040743388
2544,2017,전북,군산시,4513000000,초등학교,2017-04-01,남자,1366,1458,1451,-7,-85,-92,-0.004801097,-0.058580289,-0.063100137
2545,2017,전북,익산시,4514000000,초등학교,2017-04-01,전체,2651,2733,2748,15,-97,-82,0.005488474,-0.035298399,-0.030003659
2546,2017,전북,익산시,4514000000,초등학교,2017-04-01,여자,1307,1385,1402,17,-95,-78,0.012274368,-0.067760342,-0.05631769
2547,2017,전북,익산시,4514000000,초등학교,2017-04-01,남자,1344,1348,1346,-2,-2,-4,-0.00148368,-0.001485884,-0.002967359
2548,2017,전북,정읍시,4518000000,초등학교,2017-04-01,전체,829,917,904,-13,-75,-88,-0.014176663,-0.082964602,-0.095965104
2549,2017,전북,정읍시,4518000000,초등학교,2017-04-01,여자,395,461,449,-12,-54,-66,-0.026030369,-0.120267261,-0.143167028
2550,2017,전북,정읍시,4518000000,초등학교,2017-04-01,남자,434,456,455,-1,-21,-22,-0.002192982,-0.046153846,-0.048245614
2551,2017,전북,남원시,4519000000,초등학교,2017-04-01,전체,686,681,702,21,-16,5,0.030837004,-0.022792023,0.007342144
2552,2017,전북,남원시,4519000000,초등학교,2017-04-01,여자,338,345,359,14,-21,-7,0.04057971,-0.058495822,-0.020289855
2553,2017,전북,남원시,4519000000,초등학교,2017-04-01,남자,348,336,343,7,5,12,0.020833333,0.014577259,0.035714286
2554,2017,전북,김제시,4521000000,초등학교,2017-04-01,전체,602,618,622,4,-20,-16,0.006472492,-0.032154341,-0.025889968
2555,2017,전북,김제시,4521000000,초등학교,2017-04-01,여자,303,321,327,6,-24,-18,0.018691589,-0.073394495,-0.056074766
2556,2017,전북,김제시,4521000000,초등학교,2017-04-01,남자,299,297,295,-2,4,2,-0.006734007,0.013559322,0.006734007
2557,2017,전북,완주군,4571000000,초등학교,2017-04-01,전체,898,1015,1043,28,-145,-117,0.027586207,-0.139022052,-0.115270936
2558,2017,전북,완주군,4571000000,초등학교,2017-04-01,여자,394,476,473,-3,-79,-82,-0.006302521,-0.167019027,-0.172268908
2559,2017,전북,완주군,4571000000,초등학교,2017-04-01,남자,504,539,570,31,-66,-35,0.057513915,-0.115789474,-0.064935065
2560,2017,전북,진안군,4572000000,초등학교,2017-04-01,전체,166,191,181,-10,-15,-25,-0.052356021,-0.082872928,-0.130890052
2561,2017,전북,진안군,4572000000,초등학교,2017-04-01,여자,81,90,85,-5,-4,-9,-0.055555556,-0.047058824,-0.1
2562,2017,전북,진안군,4572000000,초등학교,2017-04-01,남자,85,101,96,-5,-11,-16,-0.04950495,-0.114583333,-0.158415842
2563,2017,전북,무주군,4573000000,초등학교,2017-04-01,전체,164,205,204,-1,-40,-41,-0.004878049,-0.196078431,-0.2
2564,2017,전북,무주군,4573000000,초등학교,2017-04-01,여자,74,85,93,8,-19,-11,0.094117647,-0.204301075,-0.129411765
2565,2017,전북,무주군,4573000000,초등학교,2017-04-01,남자,90,120,111,-9,-21,-30,-0.075,-0.189189189,-0.25
2566,2017,전북,장수군,4574000000,초등학교,2017-04-01,전체,165,206,205,-1,-40,-41,-0.004854369,-0.195121951,-0.199029126
2567,2017,전북,장수군,4574000000,초등학교,2017-04-01,여자,75,93,93,0,-18,-18,0,-0.193548387,-0.193548387
2568,2017,전북,장수군,4574000000,초등학교,2017-04-01,남자,90,113,112,-1,-22,-23,-0.008849558,-0.196428571,-0.203539823
2569,2017,전북,임실군,4575000000,초등학교,2017-04-01,전체,164,175,170,-5,-6,-11,-0.028571429,-0.035294118,-0.062857143
2570,2017,전북,임실군,4575000000,초등학교,2017-04-01,여자,86,99,97,-2,-11,-13,-0.02020202,-0.113402062,-0.131313131
2571,2017,전북,임실군,4575000000,초등학교,2017-04-01,남자,78,76,73,-3,5,2,-0.039473684,0.068493151,0.026315789
2572,2017,전북,순창군,4577000000,초등학교,2017-04-01,전체,192,187,199,12,-7,5,0.064171123,-0.035175879,0.026737968
2573,2017,전북,순창군,4577000000,초등학교,2017-04-01,여자,88,95,103,8,-15,-7,0.084210526,-0.145631068,-0.073684211
2574,2017,전북,순창군,4577000000,초등학교,2017-04-01,남자,104,92,96,4,8,12,0.043478261,0.083333333,0.130434783
2575,2017,전북,고창군,4579000000,초등학교,2017-04-01,전체,348,393,392,-1,-44,-45,-0.002544529,-0.112244898,-0.114503817
2576,2017,전북,고창군,4579000000,초등학교,2017-04-01,여자,154,173,171,-2,-17,-19,-0.011560694,-0.099415205,-0.10982659
2577,2017,전북,고창군,4579000000,초등학교,2017-04-01,남자,194,220,221,1,-27,-26,0.004545455,-0.122171946,-0.118181818
2578,2017,전북,부안군,4580000000,초등학교,2017-04-01,전체,341,377,378,1,-37,-36,0.00265252,-0.097883598,-0.095490716
2579,2017,전북,부안군,4580000000,초등학교,2017-04-01,여자,159,177,179,2,-20,-18,0.011299435,-0.111731844,-0.101694915
2580,2017,전북,부안군,4580000000,초등학교,2017-04-01,남자,182,200,199,-1,-17,-18,-0.005,-0.085427136,-0.09
2581,2017,전남,목포시,4611000000,초등학교,2017-04-01,전체,2756,2548,2632,84,124,208,0.032967033,0.047112462,0.081632653
2582,2017,전남,목포시,4611000000,초등학교,2017-04-01,여자,1326,1244,1304,60,22,82,0.048231511,0.016871166,0.065916399
2583,2017,전남,목포시,4611000000,초등학교,2017-04-01,남자,1430,1304,1328,24,102,126,0.018404908,0.076807229,0.096625767
2584,2017,전남,여수시,4613000000,초등학교,2017-04-01,전체,2477,2724,2689,-35,-212,-247,-0.012848752,-0.078839717,-0.090675477
2585,2017,전남,여수시,4613000000,초등학교,2017-04-01,여자,1190,1305,1289,-16,-99,-115,-0.012260536,-0.076803724,-0.088122605
2586,2017,전남,여수시,4613000000,초등학교,2017-04-01,남자,1287,1419,1400,-19,-113,-132,-0.013389711,-0.080714286,-0.093023256
2587,2017,전남,순천시,4615000000,초등학교,2017-04-01,전체,2761,2679,2795,116,-34,82,0.043299739,-0.01216458,0.030608436
2588,2017,전남,순천시,4615000000,초등학교,2017-04-01,여자,1287,1294,1360,66,-73,-7,0.051004637,-0.053676471,-0.005409583
2589,2017,전남,순천시,4615000000,초등학교,2017-04-01,남자,1474,1385,1435,50,39,89,0.036101083,0.0271777,0.064259928
2590,2017,전남,나주시,4617000000,초등학교,2017-04-01,전체,914,670,797,127,117,244,0.189552239,0.146800502,0.364179104
2591,2017,전남,나주시,4617000000,초등학교,2017-04-01,여자,435,325,394,69,41,110,0.212307692,0.104060914,0.338461538
2592,2017,전남,나주시,4617000000,초등학교,2017-04-01,남자,479,345,403,58,76,134,0.168115942,0.188585608,0.388405797
2593,2017,전남,광양시,4623000000,초등학교,2017-04-01,전체,1652,1738,1706,-32,-54,-86,-0.018411968,-0.031652989,-0.049482163
2594,2017,전남,광양시,4623000000,초등학교,2017-04-01,여자,786,863,842,-21,-56,-77,-0.02433372,-0.066508314,-0.089223638
2595,2017,전남,광양시,4623000000,초등학교,2017-04-01,남자,866,875,864,-11,2,-9,-0.012571429,0.002314815,-0.010285714
2596,2017,전남,담양군,4671000000,초등학교,2017-04-01,전체,269,286,280,-6,-11,-17,-0.020979021,-0.039285714,-0.059440559
2597,2017,전남,담양군,4671000000,초등학교,2017-04-01,여자,139,146,138,-8,1,-7,-0.054794521,0.007246377,-0.047945205
2598,2017,전남,담양군,4671000000,초등학교,2017-04-01,남자,130,140,142,2,-12,-10,0.014285714,-0.084507042,-0.071428571
2599,2017,전남,곡성군,4672000000,초등학교,2017-04-01,전체,155,170,173,3,-18,-15,0.017647059,-0.104046243,-0.088235294
2600,2017,전남,곡성군,4672000000,초등학교,2017-04-01,여자,82,88,89,1,-7,-6,0.011363636,-0.078651685,-0.068181818
2601,2017,전남,곡성군,4672000000,초등학교,2017-04-01,남자,73,82,84,2,-11,-9,0.024390244,-0.130952381,-0.109756098
2602,2017,전남,구례군,4673000000,초등학교,2017-04-01,전체,155,152,162,10,-7,3,0.065789474,-0.043209877,0.019736842
2603,2017,전남,구례군,4673000000,초등학교,2017-04-01,여자,75,79,82,3,-7,-4,0.037974684,-0.085365854,-0.050632911
2604,2017,전남,구례군,4673000000,초등학교,2017-04-01,남자,80,73,80,7,0,7,0.095890411,0,0.095890411
2605,2017,전남,고흥군,4677000000,초등학교,2017-04-01,전체,326,317,319,2,7,9,0.006309148,0.021943574,0.028391167
2606,2017,전남,고흥군,4677000000,초등학교,2017-04-01,여자,158,150,151,1,7,8,0.006666667,0.046357616,0.053333333
2607,2017,전남,고흥군,4677000000,초등학교,2017-04-01,남자,168,167,168,1,0,1,0.005988024,0,0.005988024
2608,2017,전남,보성군,4678000000,초등학교,2017-04-01,전체,224,321,294,-27,-70,-97,-0.08411215,-0.238095238,-0.302180685
2609,2017,전남,보성군,4678000000,초등학교,2017-04-01,여자,116,166,154,-12,-38,-50,-0.072289157,-0.246753247,-0.301204819
2610,2017,전남,보성군,4678000000,초등학교,2017-04-01,남자,108,155,140,-15,-32,-47,-0.096774194,-0.228571429,-0.303225806
2611,2017,전남,화순군,4679000000,초등학교,2017-04-01,전체,450,491,473,-18,-23,-41,-0.036659878,-0.048625793,-0.083503055
2612,2017,전남,화순군,4679000000,초등학교,2017-04-01,여자,213,231,225,-6,-12,-18,-0.025974026,-0.053333333,-0.077922078
2613,2017,전남,화순군,4679000000,초등학교,2017-04-01,남자,237,260,248,-12,-11,-23,-0.046153846,-0.044354839,-0.088461538
2614,2017,전남,장흥군,4680000000,초등학교,2017-04-01,전체,230,240,240,0,-10,-10,0,-0.041666667,-0.041666667
2615,2017,전남,장흥군,4680000000,초등학교,2017-04-01,여자,120,107,107,0,13,13,0,0.121495327,0.121495327
2616,2017,전남,장흥군,4680000000,초등학교,2017-04-01,남자,110,133,133,0,-23,-23,0,-0.172932331,-0.172932331
2617,2017,전남,강진군,4681000000,초등학교,2017-04-01,전체,219,301,273,-28,-54,-82,-0.093023256,-0.197802198,-0.272425249
2618,2017,전남,강진군,4681000000,초등학교,2017-04-01,여자,102,144,132,-12,-30,-42,-0.083333333,-0.227272727,-0.291666667
2619,2017,전남,강진군,4681000000,초등학교,2017-04-01,남자,117,157,141,-16,-24,-40,-0.101910828,-0.170212766,-0.25477707
2620,2017,전남,해남군,4682000000,초등학교,2017-04-01,전체,479,534,542,8,-63,-55,0.014981273,-0.116236162,-0.102996255
2621,2017,전남,해남군,4682000000,초등학교,2017-04-01,여자,215,272,266,-6,-51,-57,-0.022058824,-0.191729323,-0.209558824
2622,2017,전남,해남군,4682000000,초등학교,2017-04-01,남자,264,262,276,14,-12,2,0.053435115,-0.043478261,0.007633588
2623,2017,전남,영암군,4683000000,초등학교,2017-04-01,전체,448,577,544,-33,-96,-129,-0.057192374,-0.176470588,-0.223570191
2624,2017,전남,영암군,4683000000,초등학교,2017-04-01,여자,204,272,267,-5,-63,-68,-0.018382353,-0.235955056,-0.25
2625,2017,전남,영암군,4683000000,초등학교,2017-04-01,남자,244,305,277,-28,-33,-61,-0.091803279,-0.119133574,-0.2
2626,2017,전남,무안군,4684000000,초등학교,2017-04-01,전체,819,926,954,28,-135,-107,0.030237581,-0.141509434,-0.115550756
2627,2017,전남,무안군,4684000000,초등학교,2017-04-01,여자,412,477,485,8,-73,-65,0.016771488,-0.150515464,-0.136268344
2628,2017,전남,무안군,4684000000,초등학교,2017-04-01,남자,407,449,469,20,-62,-42,0.04454343,-0.132196162,-0.093541203
2629,2017,전남,함평군,4686000000,초등학교,2017-04-01,전체,167,240,232,-8,-65,-73,-0.033333333,-0.280172414,-0.304166667
2630,2017,전남,함평군,4686000000,초등학교,2017-04-01,여자,80,113,110,-3,-30,-33,-0.026548673,-0.272727273,-0.292035398
2631,2017,전남,함평군,4686000000,초등학교,2017-04-01,남자,87,127,122,-5,-35,-40,-0.039370079,-0.286885246,-0.31496063
2632,2017,전남,영광군,4687000000,초등학교,2017-04-01,전체,387,448,439,-9,-52,-61,-0.020089286,-0.118451025,-0.136160714
2633,2017,전남,영광군,4687000000,초등학교,2017-04-01,여자,187,238,228,-10,-41,-51,-0.042016807,-0.179824561,-0.214285714
2634,2017,전남,영광군,4687000000,초등학교,2017-04-01,남자,200,210,211,1,-11,-10,0.004761905,-0.052132701,-0.047619048
2635,2017,전남,장성군,4688000000,초등학교,2017-04-01,전체,339,347,351,4,-12,-8,0.011527378,-0.034188034,-0.023054755
2636,2017,전남,장성군,4688000000,초등학교,2017-04-01,여자,152,161,169,8,-17,-9,0.049689441,-0.100591716,-0.055900621
2637,2017,전남,장성군,4688000000,초등학교,2017-04-01,남자,187,186,182,-4,5,1,-0.021505376,0.027472527,0.005376344
2638,2017,전남,완도군,4689000000,초등학교,2017-04-01,전체,390,388,397,9,-7,2,0.023195876,-0.017632242,0.005154639
2639,2017,전남,완도군,4689000000,초등학교,2017-04-01,여자,192,180,182,2,10,12,0.011111111,0.054945055,0.066666667
2640,2017,전남,완도군,4689000000,초등학교,2017-04-01,남자,198,208,215,7,-17,-10,0.033653846,-0.079069767,-0.048076923
2641,2017,전남,진도군,4690000000,초등학교,2017-04-01,전체,185,237,240,3,-55,-52,0.012658228,-0.229166667,-0.219409283
2642,2017,전남,진도군,4690000000,초등학교,2017-04-01,여자,83,120,121,1,-38,-37,0.008333333,-0.314049587,-0.308333333
2643,2017,전남,진도군,4690000000,초등학교,2017-04-01,남자,102,117,119,2,-17,-15,0.017094017,-0.142857143,-0.128205128
2644,2017,전남,신안군,4691000000,초등학교,2017-04-01,전체,160,259,245,-14,-85,-99,-0.054054054,-0.346938776,-0.382239382
2645,2017,전남,신안군,4691000000,초등학교,2017-04-01,여자,71,116,106,-10,-35,-45,-0.086206897,-0.330188679,-0.387931034
2646,2017,전남,신안군,4691000000,초등학교,2017-04-01,남자,89,143,139,-4,-50,-54,-0.027972028,-0.35971223,-0.377622378
2647,2017,경북,포항시,4711000000,초등학교,2017-04-01,전체,4712,4939,4937,-2,-225,-227,-0.00040494,-0.045574235,-0.045960721
2648,2017,경북,포항시,4711000000,초등학교,2017-04-01,여자,2280,2375,2368,-7,-88,-95,-0.002947368,-0.037162162,-0.04
2649,2017,경북,포항시,4711000000,초등학교,2017-04-01,남자,2432,2564,2569,5,-137,-132,0.001950078,-0.053328143,-0.051482059
2650,2017,경북,경주시,4713000000,초등학교,2017-04-01,전체,1946,2001,2021,20,-75,-55,0.009995002,-0.037110341,-0.027486257
2651,2017,경북,경주시,4713000000,초등학교,2017-04-01,여자,954,982,992,10,-38,-28,0.010183299,-0.038306452,-0.028513238
2652,2017,경북,경주시,4713000000,초등학교,2017-04-01,남자,992,1019,1029,10,-37,-27,0.009813543,-0.03595724,-0.026496565
2653,2017,경북,김천시,4715000000,초등학교,2017-04-01,전체,1130,1134,1194,60,-64,-4,0.052910053,-0.05360134,-0.003527337
2654,2017,경북,김천시,4715000000,초등학교,2017-04-01,여자,562,549,574,25,-12,13,0.045537341,-0.020905923,0.023679417
2655,2017,경북,김천시,4715000000,초등학교,2017-04-01,남자,568,585,620,35,-52,-17,0.05982906,-0.083870968,-0.029059829
2656,2017,경북,안동시,4717000000,초등학교,2017-04-01,전체,1407,1401,1419,18,-12,6,0.012847966,-0.00845666,0.004282655
2657,2017,경북,안동시,4717000000,초등학교,2017-04-01,여자,664,679,688,9,-24,-15,0.013254786,-0.034883721,-0.022091311
2658,2017,경북,안동시,4717000000,초등학교,2017-04-01,남자,743,722,731,9,12,21,0.012465374,0.016415869,0.029085873
2659,2017,경북,구미시,4719000000,초등학교,2017-04-01,전체,4667,4988,4951,-37,-284,-321,-0.007417803,-0.057362149,-0.064354451
2660,2017,경북,구미시,4719000000,초등학교,2017-04-01,여자,2256,2346,2318,-28,-62,-90,-0.011935209,-0.026747196,-0.038363171
2661,2017,경북,구미시,4719000000,초등학교,2017-04-01,남자,2411,2642,2633,-9,-222,-231,-0.00340651,-0.08431447,-0.087433762
2662,2017,경북,영주시,4721000000,초등학교,2017-04-01,전체,830,827,822,-5,8,3,-0.006045949,0.00973236,0.00362757
2663,2017,경북,영주시,4721000000,초등학교,2017-04-01,여자,403,394,390,-4,13,9,-0.010152284,0.033333333,0.02284264
2664,2017,경북,영주시,4721000000,초등학교,2017-04-01,남자,427,433,432,-1,-5,-6,-0.002309469,-0.011574074,-0.013856813
2665,2017,경북,영천시,4723000000,초등학교,2017-04-01,전체,615,674,666,-8,-51,-59,-0.011869436,-0.076576577,-0.087537092
2666,2017,경북,영천시,4723000000,초등학교,2017-04-01,여자,291,322,318,-4,-27,-31,-0.01242236,-0.08490566,-0.096273292
2667,2017,경북,영천시,4723000000,초등학교,2017-04-01,남자,324,352,348,-4,-24,-28,-0.011363636,-0.068965517,-0.079545455
2668,2017,경북,상주시,4725000000,초등학교,2017-04-01,전체,637,680,674,-6,-37,-43,-0.008823529,-0.054896142,-0.063235294
2669,2017,경북,상주시,4725000000,초등학교,2017-04-01,여자,289,310,302,-8,-13,-21,-0.025806452,-0.043046358,-0.067741935
2670,2017,경북,상주시,4725000000,초등학교,2017-04-01,남자,348,370,372,2,-24,-22,0.005405405,-0.064516129,-0.059459459
2671,2017,경북,문경시,4728000000,초등학교,2017-04-01,전체,464,540,541,1,-77,-76,0.001851852,-0.14232902,-0.140740741
2672,2017,경북,문경시,4728000000,초등학교,2017-04-01,여자,226,266,265,-1,-39,-40,-0.003759398,-0.147169811,-0.15037594
2673,2017,경북,문경시,4728000000,초등학교,2017-04-01,남자,238,274,276,2,-38,-36,0.00729927,-0.137681159,-0.131386861
2674,2017,경북,경산시,4729000000,초등학교,2017-04-01,전체,2164,2435,2407,-28,-243,-271,-0.011498973,-0.100955546,-0.111293634
2675,2017,경북,경산시,4729000000,초등학교,2017-04-01,여자,1062,1229,1205,-24,-143,-167,-0.019528072,-0.118672199,-0.135882832
2676,2017,경북,경산시,4729000000,초등학교,2017-04-01,남자,1102,1206,1202,-4,-100,-104,-0.00331675,-0.083194676,-0.086235489
2677,2017,경북,군위군,4772000000,초등학교,2017-04-01,전체,78,85,85,0,-7,-7,0,-0.082352941,-0.082352941
2678,2017,경북,군위군,4772000000,초등학교,2017-04-01,여자,40,42,41,-1,-1,-2,-0.023809524,-0.024390244,-0.047619048
2679,2017,경북,군위군,4772000000,초등학교,2017-04-01,남자,38,43,44,1,-6,-5,0.023255814,-0.136363636,-0.11627907
2680,2017,경북,의성군,4773000000,초등학교,2017-04-01,전체,192,222,218,-4,-26,-30,-0.018018018,-0.119266055,-0.135135135
2681,2017,경북,의성군,4773000000,초등학교,2017-04-01,여자,88,112,108,-4,-20,-24,-0.035714286,-0.185185185,-0.214285714
2682,2017,경북,의성군,4773000000,초등학교,2017-04-01,남자,104,110,110,0,-6,-6,0,-0.054545455,-0.054545455
2683,2017,경북,청송군,4775000000,초등학교,2017-04-01,전체,98,110,117,7,-19,-12,0.063636364,-0.162393162,-0.109090909
2684,2017,경북,청송군,4775000000,초등학교,2017-04-01,여자,48,50,57,7,-9,-2,0.14,-0.157894737,-0.04
2685,2017,경북,청송군,4775000000,초등학교,2017-04-01,남자,50,60,60,0,-10,-10,0,-0.166666667,-0.166666667
2686,2017,경북,영양군,4776000000,초등학교,2017-04-01,전체,93,95,94,-1,-1,-2,-0.010526316,-0.010638298,-0.021052632
2687,2017,경북,영양군,4776000000,초등학교,2017-04-01,여자,47,38,41,3,6,9,0.078947368,0.146341463,0.236842105
2688,2017,경북,영양군,4776000000,초등학교,2017-04-01,남자,46,57,53,-4,-7,-11,-0.070175439,-0.132075472,-0.192982456
2689,2017,경북,영덕군,4777000000,초등학교,2017-04-01,전체,203,199,195,-4,8,4,-0.020100503,0.041025641,0.020100503
2690,2017,경북,영덕군,4777000000,초등학교,2017-04-01,여자,97,104,103,-1,-6,-7,-0.009615385,-0.058252427,-0.067307692
2691,2017,경북,영덕군,4777000000,초등학교,2017-04-01,남자,106,95,92,-3,14,11,-0.031578947,0.152173913,0.115789474
2692,2017,경북,청도군,4782000000,초등학교,2017-04-01,전체,182,218,216,-2,-34,-36,-0.009174312,-0.157407407,-0.165137615
2693,2017,경북,청도군,4782000000,초등학교,2017-04-01,여자,85,122,120,-2,-35,-37,-0.016393443,-0.291666667,-0.303278689
2694,2017,경북,청도군,4782000000,초등학교,2017-04-01,남자,97,96,96,0,1,1,0,0.010416667,0.010416667
2695,2017,경북,고령군,4783000000,초등학교,2017-04-01,전체,191,208,200,-8,-9,-17,-0.038461538,-0.045,-0.081730769
2696,2017,경북,고령군,4783000000,초등학교,2017-04-01,여자,92,109,102,-7,-10,-17,-0.064220183,-0.098039216,-0.155963303
2697,2017,경북,고령군,4783000000,초등학교,2017-04-01,남자,99,99,98,-1,1,0,-0.01010101,0.010204082,0
2698,2017,경북,성주군,4784000000,초등학교,2017-04-01,전체,178,232,239,7,-61,-54,0.030172414,-0.255230126,-0.232758621
2699,2017,경북,성주군,4784000000,초등학교,2017-04-01,여자,94,112,118,6,-24,-18,0.053571429,-0.203389831,-0.160714286
2700,2017,경북,성주군,4784000000,초등학교,2017-04-01,남자,84,120,121,1,-37,-36,0.008333333,-0.305785124,-0.3
2701,2017,경북,칠곡군,4785000000,초등학교,2017-04-01,전체,1223,1352,1315,-37,-92,-129,-0.027366864,-0.069961977,-0.095414201
2702,2017,경북,칠곡군,4785000000,초등학교,2017-04-01,여자,572,673,656,-17,-84,-101,-0.02526003,-0.12804878,-0.150074294
2703,2017,경북,칠곡군,4785000000,초등학교,2017-04-01,남자,651,679,659,-20,-8,-28,-0.029455081,-0.012139605,-0.041237113
2704,2017,경북,예천군,4790000000,초등학교,2017-04-01,전체,208,276,277,1,-69,-68,0.003623188,-0.249097473,-0.246376812
2705,2017,경북,예천군,4790000000,초등학교,2017-04-01,여자,100,133,139,6,-39,-33,0.045112782,-0.28057554,-0.248120301
2706,2017,경북,예천군,4790000000,초등학교,2017-04-01,남자,108,143,138,-5,-30,-35,-0.034965035,-0.217391304,-0.244755245
2707,2017,경북,봉화군,4792000000,초등학교,2017-04-01,전체,177,235,228,-7,-51,-58,-0.029787234,-0.223684211,-0.246808511
2708,2017,경북,봉화군,4792000000,초등학교,2017-04-01,여자,88,121,115,-6,-27,-33,-0.049586777,-0.234782609,-0.272727273
2709,2017,경북,봉화군,4792000000,초등학교,2017-04-01,남자,89,114,113,-1,-24,-25,-0.00877193,-0.212389381,-0.219298246
2710,2017,경북,울진군,4793000000,초등학교,2017-04-01,전체,335,375,362,-13,-27,-40,-0.034666667,-0.074585635,-0.106666667
2711,2017,경북,울진군,4793000000,초등학교,2017-04-01,여자,154,195,182,-13,-28,-41,-0.066666667,-0.153846154,-0.21025641
2712,2017,경북,울진군,4793000000,초등학교,2017-04-01,남자,181,180,180,0,1,1,0,0.005555556,0.005555556
2713,2017,경북,울릉군,4794000000,초등학교,2017-04-01,전체,40,55,55,0,-15,-15,0,-0.272727273,-0.272727273
2714,2017,경북,울릉군,4794000000,초등학교,2017-04-01,여자,18,24,25,1,-7,-6,0.041666667,-0.28,-0.25
2715,2017,경북,울릉군,4794000000,초등학교,2017-04-01,남자,22,31,30,-1,-8,-9,-0.032258065,-0.266666667,-0.290322581
2716,2017,경남,진주시,4817000000,초등학교,2017-04-01,전체,3352,3285,3397,112,-45,67,0.034094368,-0.013246983,0.020395738
2717,2017,경남,진주시,4817000000,초등학교,2017-04-01,여자,1576,1518,1580,62,-4,58,0.040843215,-0.002531646,0.038208169
2718,2017,경남,진주시,4817000000,초등학교,2017-04-01,남자,1776,1767,1817,50,-41,9,0.028296548,-0.022564667,0.005093379
2719,2017,경남,통영시,4822000000,초등학교,2017-04-01,전체,1522,1556,1566,10,-44,-34,0.006426735,-0.028097063,-0.0218509
2720,2017,경남,통영시,4822000000,초등학교,2017-04-01,여자,733,748,754,6,-21,-15,0.00802139,-0.027851459,-0.020053476
2721,2017,경남,통영시,4822000000,초등학교,2017-04-01,남자,789,808,812,4,-23,-19,0.004950495,-0.028325123,-0.023514851
2722,2017,경남,사천시,4824000000,초등학교,2017-04-01,전체,1167,1238,1189,-49,-22,-71,-0.039579968,-0.018502944,-0.057350565
2723,2017,경남,사천시,4824000000,초등학교,2017-04-01,여자,548,573,546,-27,2,-25,-0.047120419,0.003663004,-0.043630017
2724,2017,경남,사천시,4824000000,초등학교,2017-04-01,남자,619,665,643,-22,-24,-46,-0.033082707,-0.037325039,-0.069172932
2725,2017,경남,김해시,4825000000,초등학교,2017-04-01,전체,5886,6219,6199,-20,-313,-333,-0.003215951,-0.050492015,-0.053545586
2726,2017,경남,김해시,4825000000,초등학교,2017-04-01,여자,2848,2990,3000,10,-152,-142,0.003344482,-0.050666667,-0.047491639
2727,2017,경남,김해시,4825000000,초등학교,2017-04-01,남자,3038,3229,3199,-30,-161,-191,-0.009290802,-0.050328228,-0.05915144
2728,2017,경남,밀양시,4827000000,초등학교,2017-04-01,전체,692,716,736,20,-44,-24,0.027932961,-0.059782609,-0.033519553
2729,2017,경남,밀양시,4827000000,초등학교,2017-04-01,여자,333,349,360,11,-27,-16,0.031518625,-0.075,-0.045845272
2730,2017,경남,밀양시,4827000000,초등학교,2017-04-01,남자,359,367,376,9,-17,-8,0.024523161,-0.045212766,-0.021798365
2731,2017,경남,거제시,4831000000,초등학교,2017-04-01,전체,3305,3442,3469,27,-164,-137,0.007844277,-0.047275872,-0.03980244
2732,2017,경남,거제시,4831000000,초등학교,2017-04-01,여자,1631,1691,1690,-1,-59,-60,-0.000591366,-0.034911243,-0.035481963
2733,2017,경남,거제시,4831000000,초등학교,2017-04-01,남자,1674,1751,1779,28,-105,-77,0.015990862,-0.059021922,-0.043974872
2734,2017,경남,양산시,4833000000,초등학교,2017-04-01,전체,3559,3485,3566,81,-7,74,0.023242468,-0.001962984,0.021233859
2735,2017,경남,양산시,4833000000,초등학교,2017-04-01,여자,1759,1660,1716,56,43,99,0.03373494,0.025058275,0.059638554
2736,2017,경남,양산시,4833000000,초등학교,2017-04-01,남자,1800,1825,1850,25,-50,-25,0.01369863,-0.027027027,-0.01369863
2737,2017,경남,의령군,4872000000,초등학교,2017-04-01,전체,127,173,163,-10,-36,-46,-0.057803468,-0.220858896,-0.265895954
2738,2017,경남,의령군,4872000000,초등학교,2017-04-01,여자,61,85,78,-7,-17,-24,-0.082352941,-0.217948718,-0.282352941
2739,2017,경남,의령군,4872000000,초등학교,2017-04-01,남자,66,88,85,-3,-19,-22,-0.034090909,-0.223529412,-0.25
2740,2017,경남,함안군,4873000000,초등학교,2017-04-01,전체,628,656,659,3,-31,-28,0.004573171,-0.047040971,-0.042682927
2741,2017,경남,함안군,4873000000,초등학교,2017-04-01,여자,291,321,315,-6,-24,-30,-0.018691589,-0.076190476,-0.093457944
2742,2017,경남,함안군,4873000000,초등학교,2017-04-01,남자,337,335,344,9,-7,2,0.026865672,-0.020348837,0.005970149
2743,2017,경남,창녕군,4874000000,초등학교,2017-04-01,전체,382,403,397,-6,-15,-21,-0.014888337,-0.037783375,-0.052109181
2744,2017,경남,창녕군,4874000000,초등학교,2017-04-01,여자,179,193,185,-8,-6,-14,-0.041450777,-0.032432432,-0.07253886
2745,2017,경남,창녕군,4874000000,초등학교,2017-04-01,남자,203,210,212,2,-9,-7,0.00952381,-0.04245283,-0.033333333
2746,2017,경남,고성군,4882000000,초등학교,2017-04-01,전체,397,432,425,-7,-28,-35,-0.016203704,-0.065882353,-0.081018519
2747,2017,경남,고성군,4882000000,초등학교,2017-04-01,여자,183,203,192,-11,-9,-20,-0.054187192,-0.046875,-0.098522167
2748,2017,경남,고성군,4882000000,초등학교,2017-04-01,남자,214,229,233,4,-19,-15,0.017467249,-0.081545064,-0.065502183
2749,2017,경남,남해군,4884000000,초등학교,2017-04-01,전체,221,240,235,-5,-14,-19,-0.020833333,-0.059574468,-0.079166667
2750,2017,경남,남해군,4884000000,초등학교,2017-04-01,여자,107,103,97,-6,10,4,-0.058252427,0.103092784,0.038834951
2751,2017,경남,남해군,4884000000,초등학교,2017-04-01,남자,114,137,138,1,-24,-23,0.00729927,-0.173913043,-0.167883212
2752,2017,경남,하동군,4885000000,초등학교,2017-04-01,전체,266,310,305,-5,-39,-44,-0.016129032,-0.127868852,-0.141935484
2753,2017,경남,하동군,4885000000,초등학교,2017-04-01,여자,116,139,137,-2,-21,-23,-0.014388489,-0.153284672,-0.165467626
2754,2017,경남,하동군,4885000000,초등학교,2017-04-01,남자,150,171,168,-3,-18,-21,-0.01754386,-0.107142857,-0.122807018
2755,2017,경남,산청군,4886000000,초등학교,2017-04-01,전체,194,209,199,-10,-5,-15,-0.04784689,-0.025125628,-0.071770335
2756,2017,경남,산청군,4886000000,초등학교,2017-04-01,여자,86,96,82,-14,4,-10,-0.145833333,0.048780488,-0.104166667
2757,2017,경남,산청군,4886000000,초등학교,2017-04-01,남자,108,113,117,4,-9,-5,0.03539823,-0.076923077,-0.044247788
2758,2017,경남,함양군,4887000000,초등학교,2017-04-01,전체,253,278,282,4,-29,-25,0.014388489,-0.102836879,-0.089928058
2759,2017,경남,함양군,4887000000,초등학교,2017-04-01,여자,111,132,131,-1,-20,-21,-0.007575758,-0.152671756,-0.159090909
2760,2017,경남,함양군,4887000000,초등학교,2017-04-01,남자,142,146,151,5,-9,-4,0.034246575,-0.059602649,-0.02739726
2761,2017,경남,거창군,4888000000,초등학교,2017-04-01,전체,454,443,462,19,-8,11,0.042889391,-0.017316017,0.0248307
2762,2017,경남,거창군,4888000000,초등학교,2017-04-01,여자,214,202,210,8,4,12,0.03960396,0.019047619,0.059405941
2763,2017,경남,거창군,4888000000,초등학교,2017-04-01,남자,240,241,252,11,-12,-1,0.045643154,-0.047619048,-0.004149378
2764,2017,경남,합천군,4889000000,초등학교,2017-04-01,전체,165,244,241,-3,-76,-79,-0.012295082,-0.315352697,-0.323770492
2765,2017,경남,합천군,4889000000,초등학교,2017-04-01,여자,80,125,124,-1,-44,-45,-0.008,-0.35483871,-0.36
2766,2017,경남,합천군,4889000000,초등학교,2017-04-01,남자,85,119,117,-2,-32,-34,-0.016806723,-0.273504274,-0.285714286
2767,2017,제주,제주시,5011000000,초등학교,2017-04-01,전체,5048,5002,5128,126,-80,46,0.025189924,-0.015600624,0.009196321
2768,2017,제주,제주시,5011000000,초등학교,2017-04-01,여자,2419,2457,2522,65,-103,-38,0.026455026,-0.040840603,-0.015466015
2769,2017,제주,제주시,5011000000,초등학교,2017-04-01,남자,2629,2545,2606,61,23,84,0.023968566,0.008825787,0.033005894
2770,2017,제주,서귀포시,5013000000,초등학교,2017-04-01,전체,1515,1467,1604,137,-89,48,0.093387866,-0.055486284,0.032719836
2771,2017,제주,서귀포시,5013000000,초등학교,2017-04-01,여자,746,706,765,59,-19,40,0.083569405,-0.024836601,0.056657224
2772,2017,제주,서귀포시,5013000000,초등학교,2017-04-01,남자,769,761,839,78,-70,8,0.102496715,-0.083432658,0.010512484
2773,2018,서울,종로구,1111000000,초등학교,2018-04-01,전체,862,885,919,34,-57,-23,0.038418079,-0.062023939,-0.025988701
2774,2018,서울,종로구,1111000000,초등학교,2018-04-01,여자,419,446,449,3,-30,-27,0.006726457,-0.066815145,-0.060538117
2775,2018,서울,종로구,1111000000,초등학교,2018-04-01,남자,443,439,470,31,-27,4,0.070615034,-0.057446809,0.009111617
2776,2018,서울,중구,1114000000,초등학교,2018-04-01,전체,898,893,828,-65,70,5,-0.072788354,0.084541063,0.005599104
2777,2018,서울,중구,1114000000,초등학교,2018-04-01,여자,459,436,400,-36,59,23,-0.082568807,0.1475,0.052752294
2778,2018,서울,중구,1114000000,초등학교,2018-04-01,남자,439,457,428,-29,11,-18,-0.06345733,0.025700935,-0.039387309
2779,2018,서울,용산구,1117000000,초등학교,2018-04-01,전체,1248,1731,1656,-75,-408,-483,-0.043327556,-0.246376812,-0.279029463
2780,2018,서울,용산구,1117000000,초등학교,2018-04-01,여자,588,855,805,-50,-217,-267,-0.058479532,-0.269565217,-0.312280702
2781,2018,서울,용산구,1117000000,초등학교,2018-04-01,남자,660,876,851,-25,-191,-216,-0.028538813,-0.224441833,-0.246575342
2782,2018,서울,성동구,1120000000,초등학교,2018-04-01,전체,2100,2368,2359,-9,-259,-268,-0.003800676,-0.109792285,-0.113175676
2783,2018,서울,성동구,1120000000,초등학교,2018-04-01,여자,1031,1165,1155,-10,-124,-134,-0.008583691,-0.107359307,-0.115021459
2784,2018,서울,성동구,1120000000,초등학교,2018-04-01,남자,1069,1203,1204,1,-135,-134,0.000831255,-0.112126246,-0.111388196
2785,2018,서울,광진구,1121500000,초등학교,2018-04-01,전체,2480,2522,2438,-84,42,-42,-0.033306899,0.017227235,-0.01665345
2786,2018,서울,광진구,1121500000,초등학교,2018-04-01,여자,1232,1242,1209,-33,23,-10,-0.026570048,0.019023987,-0.00805153
2787,2018,서울,광진구,1121500000,초등학교,2018-04-01,남자,1248,1280,1229,-51,19,-32,-0.03984375,0.015459723,-0.025
2788,2018,서울,동대문구,1123000000,초등학교,2018-04-01,전체,2284,2645,2505,-140,-221,-361,-0.052930057,-0.088223553,-0.136483932
2789,2018,서울,동대문구,1123000000,초등학교,2018-04-01,여자,1116,1280,1225,-55,-109,-164,-0.04296875,-0.088979592,-0.128125
2790,2018,서울,동대문구,1123000000,초등학교,2018-04-01,남자,1168,1365,1280,-85,-112,-197,-0.062271062,-0.0875,-0.144322344
2791,2018,서울,중랑구,1126000000,초등학교,2018-04-01,전체,2647,3106,2999,-107,-352,-459,-0.034449453,-0.117372457,-0.147778493
2792,2018,서울,중랑구,1126000000,초등학교,2018-04-01,여자,1279,1486,1427,-59,-148,-207,-0.039703903,-0.103714085,-0.139300135
2793,2018,서울,중랑구,1126000000,초등학교,2018-04-01,남자,1368,1620,1572,-48,-204,-252,-0.02962963,-0.129770992,-0.155555556
2794,2018,서울,성북구,1129000000,초등학교,2018-04-01,전체,3604,3712,3633,-79,-29,-108,-0.021282328,-0.007982384,-0.029094828
2795,2018,서울,성북구,1129000000,초등학교,2018-04-01,여자,1745,1775,1738,-37,7,-30,-0.02084507,0.004027618,-0.016901408
2796,2018,서울,성북구,1129000000,초등학교,2018-04-01,남자,1859,1937,1895,-42,-36,-78,-0.021683015,-0.018997361,-0.040268456
2797,2018,서울,강북구,1130500000,초등학교,2018-04-01,전체,1753,2333,2244,-89,-491,-580,-0.038148307,-0.218805704,-0.248606944
2798,2018,서울,강북구,1130500000,초등학교,2018-04-01,여자,856,1142,1098,-44,-242,-286,-0.038528897,-0.220400729,-0.250437828
2799,2018,서울,강북구,1130500000,초등학교,2018-04-01,남자,897,1191,1146,-45,-249,-294,-0.037783375,-0.217277487,-0.246851385
2800,2018,서울,도봉구,1132000000,초등학교,2018-04-01,전체,2572,2659,2563,-96,9,-87,-0.036103798,0.00351151,-0.032719067
2801,2018,서울,도봉구,1132000000,초등학교,2018-04-01,여자,1259,1286,1247,-39,12,-27,-0.030326594,0.009623095,-0.020995334
2802,2018,서울,도봉구,1132000000,초등학교,2018-04-01,남자,1313,1373,1316,-57,-3,-60,-0.041514931,-0.002279635,-0.043699927
2803,2018,서울,노원구,1135000000,초등학교,2018-04-01,전체,4236,4382,4265,-117,-29,-146,-0.026700137,-0.006799531,-0.03331812
2804,2018,서울,노원구,1135000000,초등학교,2018-04-01,여자,2090,2166,2104,-62,-14,-76,-0.028624192,-0.006653992,-0.035087719
2805,2018,서울,노원구,1135000000,초등학교,2018-04-01,남자,2146,2216,2161,-55,-15,-70,-0.024819495,-0.006941231,-0.031588448
2806,2018,서울,은평구,1138000000,초등학교,2018-04-01,전체,3569,3985,3853,-132,-284,-416,-0.033124216,-0.073708798,-0.104391468
2807,2018,서울,은평구,1138000000,초등학교,2018-04-01,여자,1732,1921,1853,-68,-121,-189,-0.03539823,-0.065299514,-0.098386257
2808,2018,서울,은평구,1138000000,초등학교,2018-04-01,남자,1837,2064,2000,-64,-163,-227,-0.031007752,-0.0815,-0.10998062
2809,2018,서울,서대문구,1141000000,초등학교,2018-04-01,전체,2140,2292,2239,-53,-99,-152,-0.023123909,-0.044216168,-0.066317627
2810,2018,서울,서대문구,1141000000,초등학교,2018-04-01,여자,1086,1132,1117,-15,-31,-46,-0.013250883,-0.02775291,-0.040636042
2811,2018,서울,서대문구,1141000000,초등학교,2018-04-01,남자,1054,1160,1122,-38,-68,-106,-0.032758621,-0.060606061,-0.09137931
2812,2018,서울,마포구,1144000000,초등학교,2018-04-01,전체,2458,2999,2867,-132,-409,-541,-0.044014672,-0.14265783,-0.180393464
2813,2018,서울,마포구,1144000000,초등학교,2018-04-01,여자,1235,1473,1404,-69,-169,-238,-0.046843177,-0.12037037,-0.161575017
2814,2018,서울,마포구,1144000000,초등학교,2018-04-01,남자,1223,1526,1463,-63,-240,-303,-0.041284404,-0.16404648,-0.198558322
2815,2018,서울,양천구,1147000000,초등학교,2018-04-01,전체,3736,3710,3772,62,-36,26,0.01671159,-0.009544008,0.007008086
2816,2018,서울,양천구,1147000000,초등학교,2018-04-01,여자,1771,1749,1777,28,-6,22,0.016009148,-0.003376477,0.012578616
2817,2018,서울,양천구,1147000000,초등학교,2018-04-01,남자,1965,1961,1995,34,-30,4,0.017338093,-0.015037594,0.002039776
2818,2018,서울,강서구,1150000000,초등학교,2018-04-01,전체,4816,5319,5161,-158,-345,-503,-0.029704832,-0.06684751,-0.094566648
2819,2018,서울,강서구,1150000000,초등학교,2018-04-01,여자,2356,2551,2465,-86,-109,-195,-0.03371227,-0.044219067,-0.076440612
2820,2018,서울,강서구,1150000000,초등학교,2018-04-01,남자,2460,2768,2696,-72,-236,-308,-0.026011561,-0.087537092,-0.111271676
2821,2018,서울,구로구,1153000000,초등학교,2018-04-01,전체,3320,3929,3724,-205,-404,-609,-0.052176126,-0.108485499,-0.155001273
2822,2018,서울,구로구,1153000000,초등학교,2018-04-01,여자,1636,1916,1826,-90,-190,-280,-0.04697286,-0.104052574,-0.146137787
2823,2018,서울,구로구,1153000000,초등학교,2018-04-01,남자,1684,2013,1898,-115,-214,-329,-0.057128664,-0.112750263,-0.163437655
2824,2018,서울,금천구,1154500000,초등학교,2018-04-01,전체,1561,1617,1606,-11,-45,-56,-0.006802721,-0.028019925,-0.034632035
2825,2018,서울,금천구,1154500000,초등학교,2018-04-01,여자,775,777,785,8,-10,-2,0.01029601,-0.012738854,-0.002574003
2826,2018,서울,금천구,1154500000,초등학교,2018-04-01,남자,786,840,821,-19,-35,-54,-0.022619048,-0.042630938,-0.064285714
2827,2018,서울,영등포구,1156000000,초등학교,2018-04-01,전체,2457,3003,2784,-219,-327,-546,-0.072927073,-0.117456897,-0.181818182
2828,2018,서울,영등포구,1156000000,초등학교,2018-04-01,여자,1270,1532,1420,-112,-150,-262,-0.07310705,-0.105633803,-0.171018277
2829,2018,서울,영등포구,1156000000,초등학교,2018-04-01,남자,1187,1471,1364,-107,-177,-284,-0.072739633,-0.129765396,-0.193065942
2830,2018,서울,동작구,1159000000,초등학교,2018-04-01,전체,2801,3244,3159,-85,-358,-443,-0.026202219,-0.113327002,-0.136559803
2831,2018,서울,동작구,1159000000,초등학교,2018-04-01,여자,1382,1570,1527,-43,-145,-188,-0.027388535,-0.094957433,-0.119745223
2832,2018,서울,동작구,1159000000,초등학교,2018-04-01,남자,1419,1674,1632,-42,-213,-255,-0.025089606,-0.130514706,-0.152329749
2833,2018,서울,관악구,1162000000,초등학교,2018-04-01,전체,2687,3439,3228,-211,-541,-752,-0.061355045,-0.167596035,-0.218668218
2834,2018,서울,관악구,1162000000,초등학교,2018-04-01,여자,1294,1691,1595,-96,-301,-397,-0.056771141,-0.188714734,-0.234772324
2835,2018,서울,관악구,1162000000,초등학교,2018-04-01,남자,1393,1748,1633,-115,-240,-355,-0.065789474,-0.146968769,-0.203089245
2836,2018,서울,서초구,1165000000,초등학교,2018-04-01,전체,3861,4223,4301,78,-440,-362,0.018470282,-0.10230179,-0.085721051
2837,2018,서울,서초구,1165000000,초등학교,2018-04-01,여자,1843,2003,2045,42,-202,-160,0.020968547,-0.098777506,-0.07988018
2838,2018,서울,서초구,1165000000,초등학교,2018-04-01,남자,2018,2220,2256,36,-238,-202,0.016216216,-0.105496454,-0.090990991
2839,2018,서울,강남구,1168000000,초등학교,2018-04-01,전체,3938,4414,4425,11,-487,-476,0.002492071,-0.110056497,-0.107838695
2840,2018,서울,강남구,1168000000,초등학교,2018-04-01,여자,1882,2142,2154,12,-272,-260,0.005602241,-0.126276695,-0.121381886
2841,2018,서울,강남구,1168000000,초등학교,2018-04-01,남자,2056,2272,2271,-1,-215,-216,-0.000440141,-0.094671951,-0.095070423
2842,2018,서울,송파구,1171000000,초등학교,2018-04-01,전체,5216,5696,5761,65,-545,-480,0.011411517,-0.094601632,-0.084269663
2843,2018,서울,송파구,1171000000,초등학교,2018-04-01,여자,2499,2745,2783,38,-284,-246,0.013843352,-0.102048149,-0.089617486
2844,2018,서울,송파구,1171000000,초등학교,2018-04-01,남자,2717,2951,2978,27,-261,-234,0.009149441,-0.087642713,-0.079295154
2845,2018,서울,강동구,1174000000,초등학교,2018-04-01,전체,3210,3644,3615,-29,-405,-434,-0.007958288,-0.112033195,-0.11909989
2846,2018,서울,강동구,1174000000,초등학교,2018-04-01,여자,1513,1777,1763,-14,-250,-264,-0.007878447,-0.141803744,-0.148564997
2847,2018,서울,강동구,1174000000,초등학교,2018-04-01,남자,1697,1867,1852,-15,-155,-170,-0.00803428,-0.083693305,-0.091055169
2848,2018,부산,중구,2611000000,초등학교,2018-04-01,전체,229,234,221,-13,8,-5,-0.055555556,0.036199095,-0.021367521
2849,2018,부산,중구,2611000000,초등학교,2018-04-01,여자,114,106,106,0,8,8,0,0.075471698,0.075471698
2850,2018,부산,중구,2611000000,초등학교,2018-04-01,남자,115,128,115,-13,0,-13,-0.1015625,0,-0.1015625
2851,2018,부산,서구,2614000000,초등학교,2018-04-01,전체,615,655,648,-7,-33,-40,-0.010687023,-0.050925926,-0.061068702
2852,2018,부산,서구,2614000000,초등학교,2018-04-01,여자,292,322,316,-6,-24,-30,-0.01863354,-0.075949367,-0.093167702
2853,2018,부산,서구,2614000000,초등학교,2018-04-01,남자,323,333,332,-1,-9,-10,-0.003003003,-0.027108434,-0.03003003
2854,2018,부산,동구,2617000000,초등학교,2018-04-01,전체,435,518,506,-12,-71,-83,-0.023166023,-0.140316206,-0.16023166
2855,2018,부산,동구,2617000000,초등학교,2018-04-01,여자,212,259,245,-14,-33,-47,-0.054054054,-0.134693878,-0.181467181
2856,2018,부산,동구,2617000000,초등학교,2018-04-01,남자,223,259,261,2,-38,-36,0.007722008,-0.14559387,-0.138996139
2857,2018,부산,영도구,2620000000,초등학교,2018-04-01,전체,686,723,712,-11,-26,-37,-0.015214385,-0.036516854,-0.051175657
2858,2018,부산,영도구,2620000000,초등학교,2018-04-01,여자,365,357,360,3,5,8,0.008403361,0.013888889,0.022408964
2859,2018,부산,영도구,2620000000,초등학교,2018-04-01,남자,321,366,352,-14,-31,-45,-0.038251366,-0.088068182,-0.12295082
2860,2018,부산,부산진구,2623000000,초등학교,2018-04-01,전체,2659,2798,2705,-93,-46,-139,-0.033238027,-0.017005545,-0.049678342
2861,2018,부산,부산진구,2623000000,초등학교,2018-04-01,여자,1367,1408,1355,-53,12,-41,-0.037642045,0.008856089,-0.029119318
2862,2018,부산,부산진구,2623000000,초등학교,2018-04-01,남자,1292,1390,1350,-40,-58,-98,-0.028776978,-0.042962963,-0.070503597
2863,2018,부산,동래구,2626000000,초등학교,2018-04-01,전체,2004,2036,2155,119,-151,-32,0.058447937,-0.070069606,-0.015717092
2864,2018,부산,동래구,2626000000,초등학교,2018-04-01,여자,972,997,1055,58,-83,-25,0.058174524,-0.078672986,-0.025075226
2865,2018,부산,동래구,2626000000,초등학교,2018-04-01,남자,1032,1039,1100,61,-68,-7,0.058710298,-0.061818182,-0.006737247
2866,2018,부산,남구,2629000000,초등학교,2018-04-01,전체,2139,2233,2198,-35,-59,-94,-0.015673981,-0.026842584,-0.042095835
2867,2018,부산,남구,2629000000,초등학교,2018-04-01,여자,1046,1129,1106,-23,-60,-83,-0.020372011,-0.054249548,-0.073516386
2868,2018,부산,남구,2629000000,초등학교,2018-04-01,남자,1093,1104,1092,-12,1,-11,-0.010869565,0.000915751,-0.009963768
2869,2018,부산,북구,2632000000,초등학교,2018-04-01,전체,2224,2507,2435,-72,-211,-283,-0.028719585,-0.086652977,-0.112883925
2870,2018,부산,북구,2632000000,초등학교,2018-04-01,여자,1083,1216,1193,-23,-110,-133,-0.018914474,-0.092204526,-0.109375
2871,2018,부산,북구,2632000000,초등학교,2018-04-01,남자,1141,1291,1242,-49,-101,-150,-0.037955074,-0.081320451,-0.116189001
2872,2018,부산,해운대구,2635000000,초등학교,2018-04-01,전체,3294,3610,3578,-32,-284,-316,-0.008864266,-0.079373952,-0.087534626
2873,2018,부산,해운대구,2635000000,초등학교,2018-04-01,여자,1584,1735,1718,-17,-134,-151,-0.009798271,-0.077997672,-0.0870317
2874,2018,부산,해운대구,2635000000,초등학교,2018-04-01,남자,1710,1875,1860,-15,-150,-165,-0.008,-0.080645161,-0.088
2875,2018,부산,사하구,2638000000,초등학교,2018-04-01,전체,2577,2800,2742,-58,-165,-223,-0.020714286,-0.060175055,-0.079642857
2876,2018,부산,사하구,2638000000,초등학교,2018-04-01,여자,1267,1358,1331,-27,-64,-91,-0.01988218,-0.048084147,-0.067010309
2877,2018,부산,사하구,2638000000,초등학교,2018-04-01,남자,1310,1442,1411,-31,-101,-132,-0.02149792,-0.071580439,-0.091539528
2878,2018,부산,금정구,2641000000,초등학교,2018-04-01,전체,1709,1642,1644,2,65,67,0.001218027,0.039537713,0.040803898
2879,2018,부산,금정구,2641000000,초등학교,2018-04-01,여자,850,777,786,9,64,73,0.011583012,0.081424936,0.093951094
2880,2018,부산,금정구,2641000000,초등학교,2018-04-01,남자,859,865,858,-7,1,-6,-0.008092486,0.001165501,-0.006936416
2881,2018,부산,강서구,2644000000,초등학교,2018-04-01,전체,1750,1487,1695,208,55,263,0.139878951,0.032448378,0.176866174
2882,2018,부산,강서구,2644000000,초등학교,2018-04-01,여자,863,736,831,95,32,127,0.129076087,0.038507822,0.172554348
2883,2018,부산,강서구,2644000000,초등학교,2018-04-01,남자,887,751,864,113,23,136,0.150466045,0.02662037,0.181091877
2884,2018,부산,연제구,2647000000,초등학교,2018-04-01,전체,1675,1687,1678,-9,-3,-12,-0.005334914,-0.001787843,-0.007113219
2885,2018,부산,연제구,2647000000,초등학교,2018-04-01,여자,790,834,827,-7,-37,-44,-0.008393285,-0.044740024,-0.052757794
2886,2018,부산,연제구,2647000000,초등학교,2018-04-01,남자,885,853,851,-2,34,32,-0.002344666,0.039952996,0.037514654
2887,2018,부산,수영구,2650000000,초등학교,2018-04-01,전체,1089,1176,1165,-11,-76,-87,-0.009353741,-0.065236052,-0.073979592
2888,2018,부산,수영구,2650000000,초등학교,2018-04-01,여자,534,569,561,-8,-27,-35,-0.014059754,-0.048128342,-0.061511424
2889,2018,부산,수영구,2650000000,초등학교,2018-04-01,남자,555,607,604,-3,-49,-52,-0.004942339,-0.081125828,-0.085667216
2890,2018,부산,사상구,2653000000,초등학교,2018-04-01,전체,1434,1821,1738,-83,-304,-387,-0.045579352,-0.174913694,-0.212520593
2891,2018,부산,사상구,2653000000,초등학교,2018-04-01,여자,686,871,837,-34,-151,-185,-0.039035591,-0.180406213,-0.212399541
2892,2018,부산,사상구,2653000000,초등학교,2018-04-01,남자,748,950,901,-49,-153,-202,-0.051578947,-0.169811321,-0.212631579
2893,2018,부산,기장군,2671000000,초등학교,2018-04-01,전체,2106,2160,2156,-4,-50,-54,-0.001851852,-0.023191095,-0.025
2894,2018,부산,기장군,2671000000,초등학교,2018-04-01,여자,1032,1043,1030,-13,2,-11,-0.012464046,0.001941748,-0.0105465
2895,2018,부산,기장군,2671000000,초등학교,2018-04-01,남자,1074,1117,1126,9,-52,-43,0.008057296,-0.046181172,-0.038495971
2896,2018,대구,중구,2711000000,초등학교,2018-04-01,전체,797,581,563,-18,234,216,-0.030981067,0.415630551,0.371772806
2897,2018,대구,중구,2711000000,초등학교,2018-04-01,여자,381,271,254,-17,127,110,-0.062730627,0.5,0.405904059
2898,2018,대구,중구,2711000000,초등학교,2018-04-01,남자,416,310,309,-1,107,106,-0.003225806,0.346278317,0.341935484
2899,2018,대구,동구,2714000000,초등학교,2018-04-01,전체,3015,3311,3246,-65,-231,-296,-0.019631531,-0.07116451,-0.089398973
2900,2018,대구,동구,2714000000,초등학교,2018-04-01,여자,1436,1594,1553,-41,-117,-158,-0.025721455,-0.075338055,-0.099121706
2901,2018,대구,동구,2714000000,초등학교,2018-04-01,남자,1579,1717,1693,-24,-114,-138,-0.013977868,-0.06733609,-0.080372743
2902,2018,대구,서구,2717000000,초등학교,2018-04-01,전체,1018,1209,1110,-99,-92,-191,-0.081885856,-0.082882883,-0.157981803
2903,2018,대구,서구,2717000000,초등학교,2018-04-01,여자,487,589,536,-53,-49,-102,-0.089983022,-0.09141791,-0.173174873
2904,2018,대구,서구,2717000000,초등학교,2018-04-01,남자,531,620,574,-46,-43,-89,-0.074193548,-0.074912892,-0.143548387
2905,2018,대구,남구,2720000000,초등학교,2018-04-01,전체,732,954,885,-69,-153,-222,-0.072327044,-0.172881356,-0.232704403
2906,2018,대구,남구,2720000000,초등학교,2018-04-01,여자,343,466,419,-47,-76,-123,-0.100858369,-0.181384248,-0.263948498
2907,2018,대구,남구,2720000000,초등학교,2018-04-01,남자,389,488,466,-22,-77,-99,-0.045081967,-0.165236052,-0.202868852
2908,2018,대구,북구,2723000000,초등학교,2018-04-01,전체,3807,4099,4050,-49,-243,-292,-0.011954135,-0.06,-0.071236887
2909,2018,대구,북구,2723000000,초등학교,2018-04-01,여자,1864,1954,1946,-8,-82,-90,-0.004094166,-0.042137718,-0.046059365
2910,2018,대구,북구,2723000000,초등학교,2018-04-01,남자,1943,2145,2104,-41,-161,-202,-0.019114219,-0.076520913,-0.094172494
2911,2018,대구,수성구,2726000000,초등학교,2018-04-01,전체,3553,3462,3616,154,-63,91,0.044482958,-0.017422566,0.026285384
2912,2018,대구,수성구,2726000000,초등학교,2018-04-01,여자,1775,1730,1806,76,-31,45,0.043930636,-0.017165006,0.026011561
2913,2018,대구,수성구,2726000000,초등학교,2018-04-01,남자,1778,1732,1810,78,-32,46,0.045034642,-0.017679558,0.026558891
2914,2018,대구,달서구,2729000000,초등학교,2018-04-01,전체,5249,5315,5267,-48,-18,-66,-0.009031044,-0.003417505,-0.012417686
2915,2018,대구,달서구,2729000000,초등학교,2018-04-01,여자,2613,2618,2627,9,-14,-5,0.003437739,-0.005329273,-0.001909855
2916,2018,대구,달서구,2729000000,초등학교,2018-04-01,남자,2636,2697,2640,-57,-4,-61,-0.021134594,-0.001515152,-0.022617723
2917,2018,대구,달성군,2771000000,초등학교,2018-04-01,전체,2910,2470,2870,400,40,440,0.16194332,0.013937282,0.178137652
2918,2018,대구,달성군,2771000000,초등학교,2018-04-01,여자,1400,1214,1408,194,-8,186,0.159802306,-0.005681818,0.153212521
2919,2018,대구,달성군,2771000000,초등학교,2018-04-01,남자,1510,1256,1462,206,48,254,0.164012739,0.032831737,0.202229299
2920,2018,인천,중구,2811000000,초등학교,2018-04-01,전체,1345,1262,1221,-41,124,83,-0.032488114,0.101556102,0.065768621
2921,2018,인천,중구,2811000000,초등학교,2018-04-01,여자,655,623,602,-21,53,32,-0.033707865,0.088039867,0.051364366
2922,2018,인천,중구,2811000000,초등학교,2018-04-01,남자,690,639,619,-20,71,51,-0.031298905,0.114701131,0.079812207
2923,2018,인천,동구,2814000000,초등학교,2018-04-01,전체,663,641,624,-17,39,22,-0.026521061,0.0625,0.034321373
2924,2018,인천,동구,2814000000,초등학교,2018-04-01,여자,318,318,310,-8,8,0,-0.025157233,0.025806452,0
2925,2018,인천,동구,2814000000,초등학교,2018-04-01,남자,345,323,314,-9,31,22,-0.027863777,0.098726115,0.068111455
2926,2018,인천,미추홀구,2817700000,초등학교,2018-04-01,전체,3200,3384,3525,141,-325,-184,0.041666667,-0.092198582,-0.054373522
2927,2018,인천,미추홀구,2817700000,초등학교,2018-04-01,여자,1526,1589,1657,68,-131,-63,0.04279421,-0.07905854,-0.039647577
2928,2018,인천,미추홀구,2817700000,초등학교,2018-04-01,남자,1674,1795,1868,73,-194,-121,0.040668524,-0.10385439,-0.067409471
2929,2018,인천,연수구,2818500000,초등학교,2018-04-01,전체,3667,3326,3540,214,127,341,0.064341551,0.035875706,0.102525556
2930,2018,인천,연수구,2818500000,초등학교,2018-04-01,여자,1794,1622,1730,108,64,172,0.066584464,0.03699422,0.106041924
2931,2018,인천,연수구,2818500000,초등학교,2018-04-01,남자,1873,1704,1810,106,63,169,0.062206573,0.03480663,0.099178404
2932,2018,인천,남동구,2820000000,초등학교,2018-04-01,전체,5242,5536,5459,-77,-217,-294,-0.01390896,-0.03975087,-0.053106936
2933,2018,인천,남동구,2820000000,초등학교,2018-04-01,여자,2546,2705,2662,-43,-116,-159,-0.015896488,-0.043576258,-0.058780037
2934,2018,인천,남동구,2820000000,초등학교,2018-04-01,남자,2696,2831,2797,-34,-101,-135,-0.01200989,-0.036110118,-0.04768633
2935,2018,인천,부평구,2823700000,초등학교,2018-04-01,전체,4209,4833,4644,-189,-435,-624,-0.039106145,-0.093669251,-0.129112353
2936,2018,인천,부평구,2823700000,초등학교,2018-04-01,여자,2038,2393,2303,-90,-265,-355,-0.037609695,-0.115067304,-0.148349352
2937,2018,인천,부평구,2823700000,초등학교,2018-04-01,남자,2171,2440,2341,-99,-170,-269,-0.04057377,-0.072618539,-0.110245902
2938,2018,인천,계양구,2824500000,초등학교,2018-04-01,전체,2606,2946,2804,-142,-198,-340,-0.04820095,-0.070613409,-0.115410726
2939,2018,인천,계양구,2824500000,초등학교,2018-04-01,여자,1287,1441,1384,-57,-97,-154,-0.039555864,-0.070086705,-0.106870229
2940,2018,인천,계양구,2824500000,초등학교,2018-04-01,남자,1319,1505,1420,-85,-101,-186,-0.056478405,-0.071126761,-0.12358804
2941,2018,인천,서구,2826000000,초등학교,2018-04-01,전체,5863,5879,5782,-97,81,-16,-0.016499405,0.014008993,-0.002721551
2942,2018,인천,서구,2826000000,초등학교,2018-04-01,여자,2828,2803,2757,-46,71,25,-0.016410988,0.02575263,0.008919015
2943,2018,인천,서구,2826000000,초등학교,2018-04-01,남자,3035,3076,3025,-51,10,-41,-0.016579974,0.003305785,-0.013328999
2944,2018,인천,강화군,2871000000,초등학교,2018-04-01,전체,386,360,389,29,-3,26,0.080555556,-0.007712082,0.072222222
2945,2018,인천,강화군,2871000000,초등학교,2018-04-01,여자,182,167,185,18,-3,15,0.107784431,-0.016216216,0.089820359
2946,2018,인천,강화군,2871000000,초등학교,2018-04-01,남자,204,193,204,11,0,11,0.056994819,0,0.056994819
2947,2018,인천,옹진군,2872000000,초등학교,2018-04-01,전체,108,135,132,-3,-24,-27,-0.022222222,-0.181818182,-0.2
2948,2018,인천,옹진군,2872000000,초등학교,2018-04-01,여자,45,57,54,-3,-9,-12,-0.052631579,-0.166666667,-0.210526316
2949,2018,인천,옹진군,2872000000,초등학교,2018-04-01,남자,63,78,78,0,-15,-15,0,-0.192307692,-0.192307692
2950,2018,광주,동구,2911000000,초등학교,2018-04-01,전체,578,672,659,-13,-81,-94,-0.019345238,-0.122913505,-0.139880952
2951,2018,광주,동구,2911000000,초등학교,2018-04-01,여자,302,330,322,-8,-20,-28,-0.024242424,-0.062111801,-0.084848485
2952,2018,광주,동구,2911000000,초등학교,2018-04-01,남자,276,342,337,-5,-61,-66,-0.014619883,-0.181008902,-0.192982456
2953,2018,광주,서구,2914000000,초등학교,2018-04-01,전체,2794,2791,2894,103,-100,3,0.036904335,-0.03455425,0.001074884
2954,2018,광주,서구,2914000000,초등학교,2018-04-01,여자,1349,1383,1432,49,-83,-34,0.035430224,-0.057960894,-0.024584237
2955,2018,광주,서구,2914000000,초등학교,2018-04-01,남자,1445,1408,1462,54,-17,37,0.038352273,-0.011627907,0.026278409
2956,2018,광주,남구,2915500000,초등학교,2018-04-01,전체,2195,2028,2041,13,154,167,0.006410256,0.075453209,0.08234714
2957,2018,광주,남구,2915500000,초등학교,2018-04-01,여자,1072,999,1000,1,72,73,0.001001001,0.072,0.073073073
2958,2018,광주,남구,2915500000,초등학교,2018-04-01,남자,1123,1029,1041,12,82,94,0.011661808,0.078770413,0.091350826
2959,2018,광주,북구,2917000000,초등학교,2018-04-01,전체,3978,4057,4018,-39,-40,-79,-0.009613015,-0.009955202,-0.019472517
2960,2018,광주,북구,2917000000,초등학교,2018-04-01,여자,1920,1914,1888,-26,32,6,-0.013584117,0.016949153,0.003134796
2961,2018,광주,북구,2917000000,초등학교,2018-04-01,남자,2058,2143,2130,-13,-72,-85,-0.006066262,-0.033802817,-0.039664022
2962,2018,광주,광산구,2920000000,초등학교,2018-04-01,전체,5100,5179,5173,-6,-73,-79,-0.001158525,-0.014111734,-0.01525391
2963,2018,광주,광산구,2920000000,초등학교,2018-04-01,여자,2436,2451,2450,-1,-14,-15,-0.000407997,-0.005714286,-0.006119951
2964,2018,광주,광산구,2920000000,초등학교,2018-04-01,남자,2664,2728,2723,-5,-59,-64,-0.001832845,-0.021667279,-0.023460411
2965,2018,대전,동구,3011000000,초등학교,2018-04-01,전체,1931,2152,2064,-88,-133,-221,-0.040892193,-0.064437984,-0.102695167
2966,2018,대전,동구,3011000000,초등학교,2018-04-01,여자,971,1074,1023,-51,-52,-103,-0.047486034,-0.05083089,-0.095903166
2967,2018,대전,동구,3011000000,초등학교,2018-04-01,남자,960,1078,1041,-37,-81,-118,-0.03432282,-0.077809798,-0.109461967
2968,2018,대전,중구,3014000000,초등학교,2018-04-01,전체,2057,2213,2159,-54,-102,-156,-0.024401265,-0.047244094,-0.070492544
2969,2018,대전,중구,3014000000,초등학교,2018-04-01,여자,990,1058,1020,-38,-30,-68,-0.035916824,-0.029411765,-0.064272212
2970,2018,대전,중구,3014000000,초등학교,2018-04-01,남자,1067,1155,1139,-16,-72,-88,-0.013852814,-0.063213345,-0.076190476
2971,2018,대전,서구,3017000000,초등학교,2018-04-01,전체,4459,4577,4583,6,-124,-118,0.001310902,-0.027056513,-0.025781079
2972,2018,대전,서구,3017000000,초등학교,2018-04-01,여자,2165,2205,2196,-9,-31,-40,-0.004081633,-0.014116576,-0.01814059
2973,2018,대전,서구,3017000000,초등학교,2018-04-01,남자,2294,2372,2387,15,-93,-78,0.006323777,-0.038961039,-0.032883642
2974,2018,대전,유성구,3020000000,초등학교,2018-04-01,전체,4099,4227,4273,46,-174,-128,0.010882423,-0.040720805,-0.030281524
2975,2018,대전,유성구,3020000000,초등학교,2018-04-01,여자,1958,2027,2037,10,-79,-69,0.004933399,-0.038782523,-0.034040454
2976,2018,대전,유성구,3020000000,초등학교,2018-04-01,남자,2141,2200,2236,36,-95,-59,0.016363636,-0.042486583,-0.026818182
2977,2018,대전,대덕구,3023000000,초등학교,2018-04-01,전체,1510,1679,1624,-55,-114,-169,-0.032757594,-0.070197044,-0.100655152
2978,2018,대전,대덕구,3023000000,초등학교,2018-04-01,여자,718,800,771,-29,-53,-82,-0.03625,-0.068741894,-0.1025
2979,2018,대전,대덕구,3023000000,초등학교,2018-04-01,남자,792,879,853,-26,-61,-87,-0.029579067,-0.071512309,-0.098976109
2980,2018,울산,중구,3111000000,초등학교,2018-04-01,전체,2181,2355,2352,-3,-171,-174,-0.001273885,-0.072704082,-0.07388535
2981,2018,울산,중구,3111000000,초등학교,2018-04-01,여자,1047,1072,1076,4,-29,-25,0.003731343,-0.026951673,-0.023320896
2982,2018,울산,중구,3111000000,초등학교,2018-04-01,남자,1134,1283,1276,-7,-142,-149,-0.005455963,-0.111285266,-0.116134061
2983,2018,울산,남구,3114000000,초등학교,2018-04-01,전체,2678,2926,2864,-62,-186,-248,-0.021189337,-0.064944134,-0.084757348
2984,2018,울산,남구,3114000000,초등학교,2018-04-01,여자,1264,1415,1403,-12,-139,-151,-0.008480565,-0.099073414,-0.106713781
2985,2018,울산,남구,3114000000,초등학교,2018-04-01,남자,1414,1511,1461,-50,-47,-97,-0.033090668,-0.032169747,-0.064195897
2986,2018,울산,동구,3117000000,초등학교,2018-04-01,전체,1869,2091,2029,-62,-160,-222,-0.029650885,-0.07885658,-0.106169297
2987,2018,울산,동구,3117000000,초등학교,2018-04-01,여자,894,1003,974,-29,-80,-109,-0.02891326,-0.082135524,-0.108673978
2988,2018,울산,동구,3117000000,초등학교,2018-04-01,남자,975,1088,1055,-33,-80,-113,-0.030330882,-0.075829384,-0.103860294
2989,2018,울산,북구,3120000000,초등학교,2018-04-01,전체,2599,2441,2542,101,57,158,0.041376485,0.022423289,0.064727571
2990,2018,울산,북구,3120000000,초등학교,2018-04-01,여자,1271,1207,1255,48,16,64,0.03976802,0.012749004,0.053024027
2991,2018,울산,북구,3120000000,초등학교,2018-04-01,남자,1328,1234,1287,53,41,94,0.042949757,0.031857032,0.076175041
2992,2018,울산,울주군,3171000000,초등학교,2018-04-01,전체,2262,2237,2182,-55,80,25,-0.0245865,0.036663611,0.011175682
2993,2018,울산,울주군,3171000000,초등학교,2018-04-01,여자,1063,1092,1066,-26,-3,-29,-0.023809524,-0.002814259,-0.026556777
2994,2018,울산,울주군,3171000000,초등학교,2018-04-01,남자,1199,1145,1116,-29,83,54,-0.025327511,0.07437276,0.047161572
2995,2018,세종,세종시,3611000000,초등학교,2018-04-01,전체,4442,3310,3782,472,660,1132,0.142598187,0.174510841,0.341993958
2996,2018,세종,세종시,3611000000,초등학교,2018-04-01,전체,4442,3310,3782,472,660,1132,0.142598187,0.174510841,0.341993958
2997,2018,세종,세종시,3611000000,초등학교,2018-04-01,전체,4442,3310,3782,472,660,1132,0.142598187,0.174510841,0.341993958
2998,2018,세종,세종시,3611000000,초등학교,2018-04-01,전체,4442,3310,3782,472,660,1132,0.142598187,0.174510841,0.341993958
2999,2018,세종,세종시,3611000000,초등학교,2018-04-01,여자,2132,1642,1873,231,259,490,0.140682095,0.138280833,0.298416565
3000,2018,세종,세종시,3611000000,초등학교,2018-04-01,여자,2132,1642,1873,231,259,490,0.140682095,0.138280833,0.298416565
3001,2018,세종,세종시,3611000000,초등학교,2018-04-01,여자,2132,1642,1873,231,259,490,0.140682095,0.138280833,0.298416565
3002,2018,세종,세종시,3611000000,초등학교,2018-04-01,여자,2132,1642,1873,231,259,490,0.140682095,0.138280833,0.298416565
3003,2018,세종,세종시,3611000000,초등학교,2018-04-01,남자,2310,1668,1909,241,401,642,0.144484412,0.210057622,0.384892086
3004,2018,세종,세종시,3611000000,초등학교,2018-04-01,남자,2310,1668,1909,241,401,642,0.144484412,0.210057622,0.384892086
3005,2018,세종,세종시,3611000000,초등학교,2018-04-01,남자,2310,1668,1909,241,401,642,0.144484412,0.210057622,0.384892086
3006,2018,세종,세종시,3611000000,초등학교,2018-04-01,남자,2310,1668,1909,241,401,642,0.144484412,0.210057622,0.384892086
3007,2018,경기,수원시,4111000000,초등학교,2018-04-01,전체,11749,12047,11919,-128,-170,-298,-0.010625052,-0.014262942,-0.024736449
3008,2018,경기,수원시,4111000000,초등학교,2018-04-01,여자,5677,5879,5789,-90,-112,-202,-0.015308726,-0.019347037,-0.034359585
3009,2018,경기,수원시,4111000000,초등학교,2018-04-01,남자,6072,6168,6130,-38,-58,-96,-0.00616083,-0.009461664,-0.015564202
3010,2018,경기,성남시,4113000000,초등학교,2018-04-01,전체,7902,8294,8359,65,-457,-392,0.007836991,-0.054671611,-0.047263082
3011,2018,경기,성남시,4113000000,초등학교,2018-04-01,여자,3831,3960,4026,66,-195,-129,0.016666667,-0.048435171,-0.032575758
3012,2018,경기,성남시,4113000000,초등학교,2018-04-01,남자,4071,4334,4333,-1,-262,-263,-0.000230734,-0.06046619,-0.060682972
3013,2018,경기,부천시,4119000000,초등학교,2018-04-01,전체,7070,7322,7313,-9,-243,-252,-0.001229172,-0.033228497,-0.034416826
3014,2018,경기,부천시,4119000000,초등학교,2018-04-01,여자,3495,3602,3593,-9,-98,-107,-0.002498612,-0.027275257,-0.029705719
3015,2018,경기,부천시,4119000000,초등학교,2018-04-01,남자,3575,3720,3720,0,-145,-145,0,-0.038978495,-0.038978495
3016,2018,경기,안양시,4117000000,초등학교,2018-04-01,전체,4837,5207,5229,22,-392,-370,0.004225082,-0.074966533,-0.071058191
3017,2018,경기,안양시,4117000000,초등학교,2018-04-01,여자,2394,2525,2543,18,-149,-131,0.007128713,-0.058592214,-0.051881188
3018,2018,경기,안양시,4117000000,초등학교,2018-04-01,남자,2443,2682,2686,4,-243,-239,0.001491424,-0.090469099,-0.089112603
3019,2018,경기,과천시,4129000000,초등학교,2018-04-01,전체,418,557,509,-48,-91,-139,-0.086175943,-0.178781925,-0.249551167
3020,2018,경기,과천시,4129000000,초등학교,2018-04-01,여자,213,286,263,-23,-50,-73,-0.08041958,-0.190114068,-0.255244755
3021,2018,경기,과천시,4129000000,초등학교,2018-04-01,남자,205,271,246,-25,-41,-66,-0.092250923,-0.166666667,-0.243542435
3022,2018,경기,안산시,4127000000,초등학교,2018-04-01,전체,5745,6196,5986,-210,-241,-451,-0.033892834,-0.040260608,-0.072788896
3023,2018,경기,안산시,4127000000,초등학교,2018-04-01,여자,2836,3109,3000,-109,-164,-273,-0.035059505,-0.054666667,-0.087809585
3024,2018,경기,안산시,4127000000,초등학교,2018-04-01,남자,2909,3087,2986,-101,-77,-178,-0.032717849,-0.025787006,-0.05766116
3025,2018,경기,용인시,4146000000,초등학교,2018-04-01,전체,11495,11751,11796,45,-301,-256,0.003829461,-0.025517124,-0.02178538
3026,2018,경기,용인시,4146000000,초등학교,2018-04-01,여자,5629,5717,5717,0,-88,-88,0,-0.015392688,-0.015392688
3027,2018,경기,용인시,4146000000,초등학교,2018-04-01,남자,5866,6034,6079,45,-213,-168,0.007457739,-0.035038658,-0.027842227
3028,2018,경기,군포시,4141000000,초등학교,2018-04-01,전체,2625,2904,2808,-96,-183,-279,-0.033057851,-0.06517094,-0.09607438
3029,2018,경기,군포시,4141000000,초등학교,2018-04-01,여자,1279,1425,1391,-34,-112,-146,-0.023859649,-0.080517613,-0.10245614
3030,2018,경기,군포시,4141000000,초등학교,2018-04-01,남자,1346,1479,1417,-62,-71,-133,-0.041920216,-0.050105857,-0.089925625
3031,2018,경기,의왕시,4143000000,초등학교,2018-04-01,전체,1237,1603,1540,-63,-303,-366,-0.03930131,-0.196753247,-0.228321896
3032,2018,경기,의왕시,4143000000,초등학교,2018-04-01,여자,590,767,737,-30,-147,-177,-0.039113429,-0.199457259,-0.230769231
3033,2018,경기,의왕시,4143000000,초등학교,2018-04-01,남자,647,836,803,-33,-156,-189,-0.039473684,-0.194271482,-0.226076555
3034,2018,경기,시흥시,4139000000,초등학교,2018-04-01,전체,4662,4003,4113,110,549,659,0.02747939,0.133479212,0.16462653
3035,2018,경기,시흥시,4139000000,초등학교,2018-04-01,여자,2240,1895,1946,51,294,345,0.026912929,0.151079137,0.182058047
3036,2018,경기,시흥시,4139000000,초등학교,2018-04-01,남자,2422,2108,2167,59,255,314,0.027988615,0.117674204,0.148956357
3037,2018,경기,평택시,4122000000,초등학교,2018-04-01,전체,5043,4862,4971,109,72,181,0.022418758,0.014484007,0.037227478
3038,2018,경기,평택시,4122000000,초등학교,2018-04-01,여자,2450,2355,2413,58,37,95,0.02462845,0.01533361,0.040339703
3039,2018,경기,평택시,4122000000,초등학교,2018-04-01,남자,2593,2507,2558,51,35,86,0.020343039,0.013682565,0.034303949
3040,2018,경기,화성시,4159000000,초등학교,2018-04-01,전체,10549,9308,9860,552,689,1241,0.059303825,0.069878296,0.133326171
3041,2018,경기,화성시,4159000000,초등학교,2018-04-01,여자,5171,4537,4815,278,356,634,0.06127397,0.073935618,0.139739916
3042,2018,경기,화성시,4159000000,초등학교,2018-04-01,남자,5378,4771,5045,274,333,607,0.057430308,0.066005946,0.127226996
3043,2018,경기,오산시,4137000000,초등학교,2018-04-01,전체,2943,2962,2938,-24,5,-19,-0.008102633,0.001701838,-0.006414585
3044,2018,경기,오산시,4137000000,초등학교,2018-04-01,여자,1441,1443,1429,-14,12,-2,-0.00970201,0.008397481,-0.001386001
3045,2018,경기,오산시,4137000000,초등학교,2018-04-01,남자,1502,1519,1509,-10,-7,-17,-0.006583278,-0.004638834,-0.011191573
3046,2018,경기,광명시,4121000000,초등학교,2018-04-01,전체,3176,3539,3316,-223,-140,-363,-0.06301215,-0.042219542,-0.102571348
3047,2018,경기,광명시,4121000000,초등학교,2018-04-01,여자,1522,1695,1572,-123,-50,-173,-0.072566372,-0.031806616,-0.102064897
3048,2018,경기,광명시,4121000000,초등학교,2018-04-01,남자,1654,1844,1744,-100,-90,-190,-0.054229935,-0.051605505,-0.103036876
3049,2018,경기,광주시,4161000000,초등학교,2018-04-01,전체,3451,3537,3577,40,-126,-86,0.011309019,-0.035225049,-0.024314391
3050,2018,경기,광주시,4161000000,초등학교,2018-04-01,여자,1670,1699,1707,8,-37,-29,0.004708652,-0.021675454,-0.017068864
3051,2018,경기,광주시,4161000000,초등학교,2018-04-01,남자,1781,1838,1870,32,-89,-57,0.017410229,-0.047593583,-0.03101197
3052,2018,경기,하남시,4145000000,초등학교,2018-04-01,전체,2735,1975,2653,678,82,760,0.343291139,0.030908406,0.384810127
3053,2018,경기,하남시,4145000000,초등학교,2018-04-01,여자,1402,974,1313,339,89,428,0.348049281,0.067783701,0.439425051
3054,2018,경기,하남시,4145000000,초등학교,2018-04-01,남자,1333,1001,1340,339,-7,332,0.338661339,-0.005223881,0.331668332
3055,2018,경기,김포시,4157000000,초등학교,2018-04-01,전체,5362,4751,5186,435,176,611,0.091559672,0.033937524,0.128604504
3056,2018,경기,김포시,4157000000,초등학교,2018-04-01,여자,2650,2381,2617,236,33,269,0.099118018,0.012609859,0.11297774
3057,2018,경기,김포시,4157000000,초등학교,2018-04-01,남자,2712,2370,2569,199,143,342,0.083966245,0.055663682,0.144303797
3058,2018,경기,이천시,4150000000,초등학교,2018-04-01,전체,2274,2258,2297,39,-23,16,0.017271922,-0.010013061,0.007085917
3059,2018,경기,이천시,4150000000,초등학교,2018-04-01,여자,1093,1105,1141,36,-48,-12,0.032579186,-0.042068361,-0.010859729
3060,2018,경기,이천시,4150000000,초등학교,2018-04-01,남자,1181,1153,1156,3,25,28,0.002601908,0.021626298,0.024284475
3061,2018,경기,안성시,4155000000,초등학교,2018-04-01,전체,1888,1902,1894,-8,-6,-14,-0.004206099,-0.003167899,-0.007360673
3062,2018,경기,안성시,4155000000,초등학교,2018-04-01,여자,904,949,948,-1,-44,-45,-0.001053741,-0.046413502,-0.047418335
3063,2018,경기,안성시,4155000000,초등학교,2018-04-01,남자,984,953,946,-7,38,31,-0.007345226,0.040169133,0.032528856
3064,2018,경기,여주시,4167000000,초등학교,2018-04-01,전체,955,961,952,-9,3,-6,-0.009365245,0.003151261,-0.006243496
3065,2018,경기,여주시,4167000000,초등학교,2018-04-01,여자,461,460,457,-3,4,1,-0.006521739,0.008752735,0.002173913
3066,2018,경기,여주시,4167000000,초등학교,2018-04-01,남자,494,501,495,-6,-1,-7,-0.011976048,-0.002020202,-0.013972056
3067,2018,경기,양평군,4183000000,초등학교,2018-04-01,전체,873,887,936,49,-63,-14,0.05524239,-0.067307692,-0.01578354
3068,2018,경기,양평군,4183000000,초등학교,2018-04-01,여자,429,430,454,24,-25,-1,0.055813953,-0.055066079,-0.002325581
3069,2018,경기,양평군,4183000000,초등학교,2018-04-01,남자,444,457,482,25,-38,-13,0.054704595,-0.078838174,-0.028446389
3070,2018,경기,고양시,4128000000,초등학교,2018-04-01,전체,9095,9559,9600,41,-505,-464,0.004289152,-0.052604167,-0.048540642
3071,2018,경기,고양시,4128000000,초등학교,2018-04-01,여자,4464,4645,4663,18,-199,-181,0.003875135,-0.042676389,-0.038966631
3072,2018,경기,고양시,4128000000,초등학교,2018-04-01,남자,4631,4914,4937,23,-306,-283,0.004680505,-0.06198096,-0.057590558
3073,2018,경기,남양주시,4136000000,초등학교,2018-04-01,전체,7351,7698,7659,-39,-308,-347,-0.005066251,-0.040214127,-0.045076643
3074,2018,경기,남양주시,4136000000,초등학교,2018-04-01,여자,3571,3760,3707,-53,-136,-189,-0.014095745,-0.036687348,-0.050265957
3075,2018,경기,남양주시,4136000000,초등학교,2018-04-01,남자,3780,3938,3952,14,-172,-158,0.003555104,-0.043522267,-0.040121889
3076,2018,경기,구리시,4131000000,초등학교,2018-04-01,전체,1693,1549,1704,155,-11,144,0.100064558,-0.006455399,0.092963202
3077,2018,경기,구리시,4131000000,초등학교,2018-04-01,여자,840,797,871,74,-31,43,0.092848181,-0.035591274,0.053952321
3078,2018,경기,구리시,4131000000,초등학교,2018-04-01,남자,853,752,833,81,20,101,0.107712766,0.024009604,0.134308511
3079,2018,경기,의정부시,4115000000,초등학교,2018-04-01,전체,3683,3910,3931,21,-248,-227,0.005370844,-0.063088273,-0.058056266
3080,2018,경기,의정부시,4115000000,초등학교,2018-04-01,여자,1799,1936,1933,-3,-134,-137,-0.001549587,-0.069322297,-0.070764463
3081,2018,경기,의정부시,4115000000,초등학교,2018-04-01,남자,1884,1974,1998,24,-114,-90,0.012158055,-0.057057057,-0.045592705
3082,2018,경기,파주시,4148000000,초등학교,2018-04-01,전체,4847,4986,5005,19,-158,-139,0.00381067,-0.031568432,-0.027878059
3083,2018,경기,파주시,4148000000,초등학교,2018-04-01,여자,2364,2401,2417,16,-53,-37,0.00666389,-0.02192801,-0.015410246
3084,2018,경기,파주시,4148000000,초등학교,2018-04-01,남자,2483,2585,2588,3,-105,-102,0.001160542,-0.04057187,-0.039458414
3085,2018,경기,동두천시,4125000000,초등학교,2018-04-01,전체,835,899,884,-15,-49,-64,-0.016685206,-0.055429864,-0.071190211
3086,2018,경기,동두천시,4125000000,초등학교,2018-04-01,여자,396,426,415,-11,-19,-30,-0.025821596,-0.045783133,-0.070422535
3087,2018,경기,동두천시,4125000000,초등학교,2018-04-01,남자,439,473,469,-4,-30,-34,-0.00845666,-0.063965885,-0.071881607
3088,2018,경기,양주시,4163000000,초등학교,2018-04-01,전체,2187,2174,2185,11,2,13,0.005059798,0.000915332,0.005979761
3089,2018,경기,양주시,4163000000,초등학교,2018-04-01,여자,1087,1040,1056,16,31,47,0.015384615,0.029356061,0.045192308
3090,2018,경기,양주시,4163000000,초등학교,2018-04-01,남자,1100,1134,1129,-5,-29,-34,-0.004409171,-0.025686448,-0.029982363
3091,2018,경기,포천시,4165000000,초등학교,2018-04-01,전체,1110,1176,1164,-12,-54,-66,-0.010204082,-0.046391753,-0.056122449
3092,2018,경기,포천시,4165000000,초등학교,2018-04-01,여자,504,530,531,1,-27,-26,0.001886792,-0.050847458,-0.049056604
3093,2018,경기,포천시,4165000000,초등학교,2018-04-01,남자,606,646,633,-13,-27,-40,-0.020123839,-0.042654028,-0.061919505
3094,2018,경기,가평군,4182000000,초등학교,2018-04-01,전체,422,460,474,14,-52,-38,0.030434783,-0.109704641,-0.082608696
3095,2018,경기,가평군,4182000000,초등학교,2018-04-01,여자,226,242,245,3,-19,-16,0.012396694,-0.07755102,-0.066115702
3096,2018,경기,가평군,4182000000,초등학교,2018-04-01,남자,196,218,229,11,-33,-22,0.050458716,-0.144104803,-0.100917431
3097,2018,경기,연천군,4180000000,초등학교,2018-04-01,전체,300,344,339,-5,-39,-44,-0.014534884,-0.115044248,-0.127906977
3098,2018,경기,연천군,4180000000,초등학교,2018-04-01,여자,134,168,160,-8,-26,-34,-0.047619048,-0.1625,-0.202380952
3099,2018,경기,연천군,4180000000,초등학교,2018-04-01,남자,166,176,179,3,-13,-10,0.017045455,-0.072625698,-0.056818182
3100,2018,강원,춘천시,4211000000,초등학교,2018-04-01,전체,2570,2565,2575,10,-5,5,0.003898635,-0.001941748,0.001949318
3101,2018,강원,춘천시,4211000000,초등학교,2018-04-01,여자,1233,1248,1261,13,-28,-15,0.010416667,-0.0222046,-0.012019231
3102,2018,강원,춘천시,4211000000,초등학교,2018-04-01,남자,1337,1317,1314,-3,23,20,-0.002277904,0.017503805,0.015186029
3103,2018,강원,원주시,4213000000,초등학교,2018-04-01,전체,3224,3186,3225,39,-1,38,0.012241055,-0.000310078,0.011927181
3104,2018,강원,원주시,4213000000,초등학교,2018-04-01,여자,1576,1545,1575,30,1,31,0.019417476,0.000634921,0.020064725
3105,2018,강원,원주시,4213000000,초등학교,2018-04-01,남자,1648,1641,1650,9,-2,7,0.005484461,-0.001212121,0.004265692
3106,2018,강원,강릉시,4215000000,초등학교,2018-04-01,전체,1662,1615,1625,10,37,47,0.00619195,0.022769231,0.029102167
3107,2018,강원,강릉시,4215000000,초등학교,2018-04-01,여자,787,749,753,4,34,38,0.005340454,0.045152722,0.050734312
3108,2018,강원,강릉시,4215000000,초등학교,2018-04-01,남자,875,866,872,6,3,9,0.006928406,0.003440367,0.01039261
3109,2018,강원,동해시,4217000000,초등학교,2018-04-01,전체,829,832,842,10,-13,-3,0.012019231,-0.01543943,-0.003605769
3110,2018,강원,동해시,4217000000,초등학교,2018-04-01,여자,393,399,403,4,-10,-6,0.010025063,-0.024813896,-0.015037594
3111,2018,강원,동해시,4217000000,초등학교,2018-04-01,남자,436,433,439,6,-3,3,0.013856813,-0.006833713,0.006928406
3112,2018,강원,태백시,4219000000,초등학교,2018-04-01,전체,373,396,389,-7,-16,-23,-0.017676768,-0.041131105,-0.058080808
3113,2018,강원,태백시,4219000000,초등학교,2018-04-01,여자,192,187,181,-6,11,5,-0.032085561,0.060773481,0.026737968
3114,2018,강원,태백시,4219000000,초등학교,2018-04-01,남자,181,209,208,-1,-27,-28,-0.004784689,-0.129807692,-0.133971292
3115,2018,강원,속초시,4221000000,초등학교,2018-04-01,전체,648,672,658,-14,-10,-24,-0.020833333,-0.015197568,-0.035714286
3116,2018,강원,속초시,4221000000,초등학교,2018-04-01,여자,306,336,322,-14,-16,-30,-0.041666667,-0.049689441,-0.089285714
3117,2018,강원,속초시,4221000000,초등학교,2018-04-01,남자,342,336,336,0,6,6,0,0.017857143,0.017857143
3118,2018,강원,삼척시,4223000000,초등학교,2018-04-01,전체,450,496,502,6,-52,-46,0.012096774,-0.103585657,-0.092741935
3119,2018,강원,삼척시,4223000000,초등학교,2018-04-01,여자,217,237,234,-3,-17,-20,-0.012658228,-0.072649573,-0.084388186
3120,2018,강원,삼척시,4223000000,초등학교,2018-04-01,남자,233,259,268,9,-35,-26,0.034749035,-0.130597015,-0.1003861
3121,2018,강원,홍천군,4272000000,초등학교,2018-04-01,전체,474,497,503,6,-29,-23,0.012072435,-0.057654076,-0.046277666
3122,2018,강원,홍천군,4272000000,초등학교,2018-04-01,여자,242,266,268,2,-26,-24,0.007518797,-0.097014925,-0.090225564
3123,2018,강원,홍천군,4272000000,초등학교,2018-04-01,남자,232,231,235,4,-3,1,0.017316017,-0.012765957,0.004329004
3124,2018,강원,횡성군,4273000000,초등학교,2018-04-01,전체,268,256,264,8,4,12,0.03125,0.015151515,0.046875
3125,2018,강원,횡성군,4273000000,초등학교,2018-04-01,여자,125,124,127,3,-2,1,0.024193548,-0.015748031,0.008064516
3126,2018,강원,횡성군,4273000000,초등학교,2018-04-01,남자,143,132,137,5,6,11,0.037878788,0.04379562,0.083333333
3127,2018,강원,영월군,4275000000,초등학교,2018-04-01,전체,238,231,240,9,-2,7,0.038961039,-0.008333333,0.03030303
3128,2018,강원,영월군,4275000000,초등학교,2018-04-01,여자,123,114,116,2,7,9,0.01754386,0.060344828,0.078947368
3129,2018,강원,영월군,4275000000,초등학교,2018-04-01,남자,115,117,124,7,-9,-2,0.05982906,-0.072580645,-0.017094017
3130,2018,강원,평창군,4276000000,초등학교,2018-04-01,전체,237,258,259,1,-22,-21,0.003875969,-0.084942085,-0.081395349
3131,2018,강원,평창군,4276000000,초등학교,2018-04-01,여자,121,123,128,5,-7,-2,0.040650407,-0.0546875,-0.016260163
3132,2018,강원,평창군,4276000000,초등학교,2018-04-01,남자,116,135,131,-4,-15,-19,-0.02962963,-0.114503817,-0.140740741
3133,2018,강원,정선군,4277000000,초등학교,2018-04-01,전체,218,235,238,3,-20,-17,0.012765957,-0.084033613,-0.072340426
3134,2018,강원,정선군,4277000000,초등학교,2018-04-01,여자,110,115,117,2,-7,-5,0.017391304,-0.05982906,-0.043478261
3135,2018,강원,정선군,4277000000,초등학교,2018-04-01,남자,108,120,121,1,-13,-12,0.008333333,-0.107438017,-0.1
3136,2018,강원,철원군,4278000000,초등학교,2018-04-01,전체,359,398,396,-2,-37,-39,-0.005025126,-0.093434343,-0.09798995
3137,2018,강원,철원군,4278000000,초등학교,2018-04-01,여자,159,190,192,2,-33,-31,0.010526316,-0.171875,-0.163157895
3138,2018,강원,철원군,4278000000,초등학교,2018-04-01,남자,200,208,204,-4,-4,-8,-0.019230769,-0.019607843,-0.038461538
3139,2018,강원,화천군,4279000000,초등학교,2018-04-01,전체,190,220,213,-7,-23,-30,-0.031818182,-0.107981221,-0.136363636
3140,2018,강원,화천군,4279000000,초등학교,2018-04-01,여자,90,107,105,-2,-15,-17,-0.018691589,-0.142857143,-0.158878505
3141,2018,강원,화천군,4279000000,초등학교,2018-04-01,남자,100,113,108,-5,-8,-13,-0.044247788,-0.074074074,-0.115044248
3142,2018,강원,양구군,4280000000,초등학교,2018-04-01,전체,199,214,210,-4,-11,-15,-0.018691589,-0.052380952,-0.070093458
3143,2018,강원,양구군,4280000000,초등학교,2018-04-01,여자,89,93,88,-5,1,-4,-0.053763441,0.011363636,-0.043010753
3144,2018,강원,양구군,4280000000,초등학교,2018-04-01,남자,110,121,122,1,-12,-11,0.008264463,-0.098360656,-0.090909091
3145,2018,강원,인제군,4281000000,초등학교,2018-04-01,전체,253,297,275,-22,-22,-44,-0.074074074,-0.08,-0.148148148
3146,2018,강원,인제군,4281000000,초등학교,2018-04-01,여자,101,135,128,-7,-27,-34,-0.051851852,-0.2109375,-0.251851852
3147,2018,강원,인제군,4281000000,초등학교,2018-04-01,남자,152,162,147,-15,5,-10,-0.092592593,0.034013605,-0.061728395
3148,2018,강원,고성군,4282000000,초등학교,2018-04-01,전체,163,153,151,-2,12,10,-0.013071895,0.079470199,0.065359477
3149,2018,강원,고성군,4282000000,초등학교,2018-04-01,여자,73,72,69,-3,4,1,-0.041666667,0.057971014,0.013888889
3150,2018,강원,고성군,4282000000,초등학교,2018-04-01,남자,90,81,82,1,8,9,0.012345679,0.097560976,0.111111111
3151,2018,강원,양양군,4283000000,초등학교,2018-04-01,전체,146,154,157,3,-11,-8,0.019480519,-0.070063694,-0.051948052
3152,2018,강원,양양군,4283000000,초등학교,2018-04-01,여자,72,83,83,0,-11,-11,0,-0.13253012,-0.13253012
3153,2018,강원,양양군,4283000000,초등학교,2018-04-01,남자,74,71,74,3,0,3,0.042253521,0,0.042253521
3154,2018,충북,청주시,4311000000,초등학교,2018-04-01,전체,8496,8844,8843,-1,-347,-348,-0.000113071,-0.039240077,-0.039348711
3155,2018,충북,청주시,4311000000,초등학교,2018-04-01,여자,4212,4342,4333,-9,-121,-130,-0.002072778,-0.027925225,-0.02994012
3156,2018,충북,청주시,4311000000,초등학교,2018-04-01,남자,4284,4502,4510,8,-226,-218,0.001776988,-0.050110865,-0.048422923
3157,2018,충북,충주시,4313000000,초등학교,2018-04-01,전체,1735,1626,1628,2,107,109,0.001230012,0.065724816,0.06703567
3158,2018,충북,충주시,4313000000,초등학교,2018-04-01,여자,821,796,801,5,20,25,0.006281407,0.024968789,0.031407035
3159,2018,충북,충주시,4313000000,초등학교,2018-04-01,남자,914,830,827,-3,87,84,-0.003614458,0.105199516,0.101204819
3160,2018,충북,제천시,4315000000,초등학교,2018-04-01,전체,1057,1125,1143,18,-86,-68,0.016,-0.075240595,-0.060444444
3161,2018,충북,제천시,4315000000,초등학교,2018-04-01,여자,533,561,579,18,-46,-28,0.032085561,-0.079447323,-0.049910873
3162,2018,충북,제천시,4315000000,초등학교,2018-04-01,남자,524,564,564,0,-40,-40,0,-0.070921986,-0.070921986
3163,2018,충북,보은군,4372000000,초등학교,2018-04-01,전체,202,175,178,3,24,27,0.017142857,0.134831461,0.154285714
3164,2018,충북,보은군,4372000000,초등학교,2018-04-01,여자,101,83,90,7,11,18,0.084337349,0.122222222,0.21686747
3165,2018,충북,보은군,4372000000,초등학교,2018-04-01,남자,101,92,88,-4,13,9,-0.043478261,0.147727273,0.097826087
3166,2018,충북,옥천군,4373000000,초등학교,2018-04-01,전체,379,355,364,9,15,24,0.025352113,0.041208791,0.067605634
3167,2018,충북,옥천군,4373000000,초등학교,2018-04-01,여자,169,161,176,15,-7,8,0.093167702,-0.039772727,0.049689441
3168,2018,충북,옥천군,4373000000,초등학교,2018-04-01,남자,210,194,188,-6,22,16,-0.030927835,0.117021277,0.082474227
3169,2018,충북,영동군,4374000000,초등학교,2018-04-01,전체,279,309,307,-2,-28,-30,-0.006472492,-0.091205212,-0.097087379
3170,2018,충북,영동군,4374000000,초등학교,2018-04-01,여자,138,155,150,-5,-12,-17,-0.032258065,-0.08,-0.109677419
3171,2018,충북,영동군,4374000000,초등학교,2018-04-01,남자,141,154,157,3,-16,-13,0.019480519,-0.101910828,-0.084415584
3172,2018,충북,진천군,4375000000,초등학교,2018-04-01,전체,852,715,747,32,105,137,0.044755245,0.140562249,0.191608392
3173,2018,충북,진천군,4375000000,초등학교,2018-04-01,여자,415,349,363,14,52,66,0.040114613,0.143250689,0.189111748
3174,2018,충북,진천군,4375000000,초등학교,2018-04-01,남자,437,366,384,18,53,71,0.049180328,0.138020833,0.193989071
3175,2018,충북,괴산군,4376000000,초등학교,2018-04-01,전체,142,165,175,10,-33,-23,0.060606061,-0.188571429,-0.139393939
3176,2018,충북,괴산군,4376000000,초등학교,2018-04-01,여자,81,92,93,1,-12,-11,0.010869565,-0.129032258,-0.119565217
3177,2018,충북,괴산군,4376000000,초등학교,2018-04-01,남자,61,73,82,9,-21,-12,0.123287671,-0.256097561,-0.164383562
3178,2018,충북,음성군,4377000000,초등학교,2018-04-01,전체,801,872,862,-10,-61,-71,-0.01146789,-0.070765661,-0.081422018
3179,2018,충북,음성군,4377000000,초등학교,2018-04-01,여자,373,384,394,10,-21,-11,0.026041667,-0.053299492,-0.028645833
3180,2018,충북,음성군,4377000000,초등학교,2018-04-01,남자,428,488,468,-20,-40,-60,-0.040983607,-0.085470085,-0.12295082
3181,2018,충북,단양군,4380000000,초등학교,2018-04-01,전체,164,165,167,2,-3,-1,0.012121212,-0.017964072,-0.006060606
3182,2018,충북,단양군,4380000000,초등학교,2018-04-01,여자,72,84,84,0,-12,-12,0,-0.142857143,-0.142857143
3183,2018,충북,단양군,4380000000,초등학교,2018-04-01,남자,92,81,83,2,9,11,0.024691358,0.108433735,0.135802469
3184,2018,충북,증평군,4374500000,초등학교,2018-04-01,전체,381,390,394,4,-13,-9,0.01025641,-0.032994924,-0.023076923
3185,2018,충북,증평군,4374500000,초등학교,2018-04-01,여자,189,186,191,5,-2,3,0.02688172,-0.010471204,0.016129032
3186,2018,충북,증평군,4374500000,초등학교,2018-04-01,남자,192,204,203,-1,-11,-12,-0.004901961,-0.054187192,-0.058823529
3187,2018,충남,천안시,4413000000,초등학교,2018-04-01,전체,7076,6789,7029,240,47,287,0.035351304,0.006686584,0.042274267
3188,2018,충남,천안시,4413000000,초등학교,2018-04-01,여자,3376,3262,3396,134,-20,114,0.041079093,-0.005889282,0.034947885
3189,2018,충남,천안시,4413000000,초등학교,2018-04-01,남자,3700,3527,3633,106,67,173,0.03005387,0.018442059,0.049050184
3190,2018,충남,공주시,4415000000,초등학교,2018-04-01,전체,735,757,738,-19,-3,-22,-0.025099075,-0.004065041,-0.029062087
3191,2018,충남,공주시,4415000000,초등학교,2018-04-01,여자,371,390,377,-13,-6,-19,-0.033333333,-0.015915119,-0.048717949
3192,2018,충남,공주시,4415000000,초등학교,2018-04-01,남자,364,367,361,-6,3,-3,-0.016348774,0.008310249,-0.008174387
3193,2018,충남,보령시,4418000000,초등학교,2018-04-01,전체,811,824,816,-8,-5,-13,-0.009708738,-0.006127451,-0.015776699
3194,2018,충남,보령시,4418000000,초등학교,2018-04-01,여자,410,404,400,-4,10,6,-0.00990099,0.025,0.014851485
3195,2018,충남,보령시,4418000000,초등학교,2018-04-01,남자,401,420,416,-4,-15,-19,-0.00952381,-0.036057692,-0.045238095
3196,2018,충남,아산시,4420000000,초등학교,2018-04-01,전체,3957,4190,4124,-66,-167,-233,-0.01575179,-0.040494665,-0.055608592
3197,2018,충남,아산시,4420000000,초등학교,2018-04-01,여자,1923,2098,2054,-44,-131,-175,-0.020972355,-0.063777994,-0.083412774
3198,2018,충남,아산시,4420000000,초등학교,2018-04-01,남자,2034,2092,2070,-22,-36,-58,-0.010516252,-0.017391304,-0.027724665
3199,2018,충남,서산시,4421000000,초등학교,2018-04-01,전체,1716,1719,1709,-10,7,-3,-0.005817336,0.004095963,-0.001745201
3200,2018,충남,서산시,4421000000,초등학교,2018-04-01,여자,812,812,807,-5,5,0,-0.006157635,0.006195787,0
3201,2018,충남,서산시,4421000000,초등학교,2018-04-01,남자,904,907,902,-5,2,-3,-0.005512679,0.002217295,-0.003307607
3202,2018,충남,논산시,4423000000,초등학교,2018-04-01,전체,909,918,910,-8,-1,-9,-0.008714597,-0.001098901,-0.009803922
3203,2018,충남,논산시,4423000000,초등학교,2018-04-01,여자,444,434,432,-2,12,10,-0.004608295,0.027777778,0.023041475
3204,2018,충남,논산시,4423000000,초등학교,2018-04-01,남자,465,484,478,-6,-13,-19,-0.012396694,-0.027196653,-0.039256198
3205,2018,충남,계룡시,4425000000,초등학교,2018-04-01,전체,508,485,530,45,-22,23,0.092783505,-0.041509434,0.04742268
3206,2018,충남,계룡시,4425000000,초등학교,2018-04-01,여자,235,231,254,23,-19,4,0.0995671,-0.07480315,0.017316017
3207,2018,충남,계룡시,4425000000,초등학교,2018-04-01,남자,273,254,276,22,-3,19,0.086614173,-0.010869565,0.07480315
3208,2018,충남,금산군,4471000000,초등학교,2018-04-01,전체,370,360,359,-1,11,10,-0.002777778,0.030640669,0.027777778
3209,2018,충남,금산군,4471000000,초등학교,2018-04-01,여자,183,186,187,1,-4,-3,0.005376344,-0.021390374,-0.016129032
3210,2018,충남,금산군,4471000000,초등학교,2018-04-01,남자,187,174,172,-2,15,13,-0.011494253,0.087209302,0.074712644
3211,2018,충남,부여군,4476000000,초등학교,2018-04-01,전체,359,412,407,-5,-48,-53,-0.012135922,-0.117936118,-0.128640777
3212,2018,충남,부여군,4476000000,초등학교,2018-04-01,여자,161,186,187,1,-26,-25,0.005376344,-0.139037433,-0.134408602
3213,2018,충남,부여군,4476000000,초등학교,2018-04-01,남자,198,226,220,-6,-22,-28,-0.026548673,-0.1,-0.123893805
3214,2018,충남,서천군,4477000000,초등학교,2018-04-01,전체,306,305,300,-5,6,1,-0.016393443,0.02,0.003278689
3215,2018,충남,서천군,4477000000,초등학교,2018-04-01,여자,150,148,151,3,-1,2,0.02027027,-0.006622517,0.013513514
3216,2018,충남,서천군,4477000000,초등학교,2018-04-01,남자,156,157,149,-8,7,-1,-0.050955414,0.046979866,-0.006369427
3217,2018,충남,청양군,4479000000,초등학교,2018-04-01,전체,169,173,164,-9,5,-4,-0.052023121,0.030487805,-0.023121387
3218,2018,충남,청양군,4479000000,초등학교,2018-04-01,여자,80,75,71,-4,9,5,-0.053333333,0.126760563,0.066666667
3219,2018,충남,청양군,4479000000,초등학교,2018-04-01,남자,89,98,93,-5,-4,-9,-0.051020408,-0.043010753,-0.091836735
3220,2018,충남,홍성군,4480000000,초등학교,2018-04-01,전체,942,825,912,87,30,117,0.105454545,0.032894737,0.141818182
3221,2018,충남,홍성군,4480000000,초등학교,2018-04-01,여자,452,379,421,42,31,73,0.110817942,0.073634204,0.192612137
3222,2018,충남,홍성군,4480000000,초등학교,2018-04-01,남자,490,446,491,45,-1,44,0.100896861,-0.00203666,0.098654709
3223,2018,충남,예산군,4481000000,초등학교,2018-04-01,전체,497,522,513,-9,-16,-25,-0.017241379,-0.031189084,-0.04789272
3224,2018,충남,예산군,4481000000,초등학교,2018-04-01,여자,235,251,240,-11,-5,-16,-0.043824701,-0.020833333,-0.06374502
3225,2018,충남,예산군,4481000000,초등학교,2018-04-01,남자,262,271,273,2,-11,-9,0.007380074,-0.04029304,-0.033210332
3226,2018,충남,태안군,4482500000,초등학교,2018-04-01,전체,422,443,439,-4,-17,-21,-0.009029345,-0.038724374,-0.047404063
3227,2018,충남,태안군,4482500000,초등학교,2018-04-01,여자,201,215,214,-1,-13,-14,-0.004651163,-0.060747664,-0.065116279
3228,2018,충남,태안군,4482500000,초등학교,2018-04-01,남자,221,228,225,-3,-4,-7,-0.013157895,-0.017777778,-0.030701754
3229,2018,충남,당진시,4427000000,초등학교,2018-04-01,전체,1865,1964,1951,-13,-86,-99,-0.006619145,-0.044079959,-0.050407332
3230,2018,충남,당진시,4427000000,초등학교,2018-04-01,여자,898,936,937,1,-39,-38,0.001068376,-0.041622199,-0.040598291
3231,2018,충남,당진시,4427000000,초등학교,2018-04-01,남자,967,1028,1014,-14,-47,-61,-0.013618677,-0.046351085,-0.059338521
3232,2018,전북,전주시,4511000000,초등학교,2018-04-01,전체,6532,6246,6345,99,187,286,0.015850144,0.029472025,0.045789305
3233,2018,전북,전주시,4511000000,초등학교,2018-04-01,여자,3266,3064,3138,74,128,202,0.024151436,0.040790312,0.065926893
3234,2018,전북,전주시,4511000000,초등학교,2018-04-01,남자,3266,3182,3207,25,59,84,0.007856694,0.018397256,0.026398492
3235,2018,전북,군산시,4513000000,초등학교,2018-04-01,전체,2721,2776,2754,-22,-33,-55,-0.007925072,-0.011982571,-0.01981268
3236,2018,전북,군산시,4513000000,초등학교,2018-04-01,여자,1319,1330,1323,-7,-4,-11,-0.005263158,-0.003023432,-0.008270677
3237,2018,전북,군산시,4513000000,초등학교,2018-04-01,남자,1402,1446,1431,-15,-29,-44,-0.010373444,-0.020265549,-0.030428769
3238,2018,전북,익산시,4514000000,초등학교,2018-04-01,전체,2610,2748,2731,-17,-121,-138,-0.006186317,-0.044306115,-0.050218341
3239,2018,전북,익산시,4514000000,초등학교,2018-04-01,여자,1301,1303,1304,1,-3,-2,0.00076746,-0.002300613,-0.001534919
3240,2018,전북,익산시,4514000000,초등학교,2018-04-01,남자,1309,1445,1427,-18,-118,-136,-0.012456747,-0.08269096,-0.094117647
3241,2018,전북,정읍시,4518000000,초등학교,2018-04-01,전체,873,859,861,2,12,14,0.002328289,0.013937282,0.016298021
3242,2018,전북,정읍시,4518000000,초등학교,2018-04-01,여자,418,413,417,4,1,5,0.00968523,0.002398082,0.012106538
3243,2018,전북,정읍시,4518000000,초등학교,2018-04-01,남자,455,446,444,-2,11,9,-0.004484305,0.024774775,0.020179372
3244,2018,전북,남원시,4519000000,초등학교,2018-04-01,전체,638,619,631,12,7,19,0.019386107,0.011093502,0.030694669
3245,2018,전북,남원시,4519000000,초등학교,2018-04-01,여자,311,292,292,0,19,19,0,0.065068493,0.065068493
3246,2018,전북,남원시,4519000000,초등학교,2018-04-01,남자,327,327,339,12,-12,0,0.036697248,-0.03539823,0
3247,2018,전북,김제시,4521000000,초등학교,2018-04-01,전체,658,621,640,19,18,37,0.030595813,0.028125,0.05958132
3248,2018,전북,김제시,4521000000,초등학교,2018-04-01,여자,340,321,330,9,10,19,0.028037383,0.03030303,0.059190031
3249,2018,전북,김제시,4521000000,초등학교,2018-04-01,남자,318,300,310,10,8,18,0.033333333,0.025806452,0.06
3250,2018,전북,완주군,4571000000,초등학교,2018-04-01,전체,829,1037,1010,-27,-181,-208,-0.026036644,-0.179207921,-0.200578592
3251,2018,전북,완주군,4571000000,초등학교,2018-04-01,여자,378,499,475,-24,-97,-121,-0.048096192,-0.204210526,-0.24248497
3252,2018,전북,완주군,4571000000,초등학교,2018-04-01,남자,451,538,535,-3,-84,-87,-0.005576208,-0.157009346,-0.161710037
3253,2018,전북,진안군,4572000000,초등학교,2018-04-01,전체,146,191,183,-8,-37,-45,-0.041884817,-0.202185792,-0.235602094
3254,2018,전북,진안군,4572000000,초등학교,2018-04-01,여자,61,86,84,-2,-23,-25,-0.023255814,-0.273809524,-0.290697674
3255,2018,전북,진안군,4572000000,초등학교,2018-04-01,남자,85,105,99,-6,-14,-20,-0.057142857,-0.141414141,-0.19047619
3256,2018,전북,무주군,4573000000,초등학교,2018-04-01,전체,165,161,163,2,2,4,0.01242236,0.012269939,0.02484472
3257,2018,전북,무주군,4573000000,초등학교,2018-04-01,여자,80,77,77,0,3,3,0,0.038961039,0.038961039
3258,2018,전북,무주군,4573000000,초등학교,2018-04-01,남자,85,84,86,2,-1,1,0.023809524,-0.011627907,0.011904762
3259,2018,전북,장수군,4574000000,초등학교,2018-04-01,전체,161,157,153,-4,8,4,-0.025477707,0.052287582,0.025477707
3260,2018,전북,장수군,4574000000,초등학교,2018-04-01,여자,83,77,73,-4,10,6,-0.051948052,0.136986301,0.077922078
3261,2018,전북,장수군,4574000000,초등학교,2018-04-01,남자,78,80,80,0,-2,-2,0,-0.025,-0.025
3262,2018,전북,임실군,4575000000,초등학교,2018-04-01,전체,158,172,190,18,-32,-14,0.104651163,-0.168421053,-0.081395349
3263,2018,전북,임실군,4575000000,초등학교,2018-04-01,여자,67,76,80,4,-13,-9,0.052631579,-0.1625,-0.118421053
3264,2018,전북,임실군,4575000000,초등학교,2018-04-01,남자,91,96,110,14,-19,-5,0.145833333,-0.172727273,-0.052083333
3265,2018,전북,순창군,4577000000,초등학교,2018-04-01,전체,160,175,171,-4,-11,-15,-0.022857143,-0.064327485,-0.085714286
3266,2018,전북,순창군,4577000000,초등학교,2018-04-01,여자,88,92,91,-1,-3,-4,-0.010869565,-0.032967033,-0.043478261
3267,2018,전북,순창군,4577000000,초등학교,2018-04-01,남자,72,83,80,-3,-8,-11,-0.036144578,-0.1,-0.13253012
3268,2018,전북,고창군,4579000000,초등학교,2018-04-01,전체,362,354,351,-3,11,8,-0.008474576,0.031339031,0.02259887
3269,2018,전북,고창군,4579000000,초등학교,2018-04-01,여자,166,167,164,-3,2,-1,-0.017964072,0.012195122,-0.005988024
3270,2018,전북,고창군,4579000000,초등학교,2018-04-01,남자,196,187,187,0,9,9,0,0.048128342,0.048128342
3271,2018,전북,부안군,4580000000,초등학교,2018-04-01,전체,328,345,352,7,-24,-17,0.020289855,-0.068181818,-0.049275362
3272,2018,전북,부안군,4580000000,초등학교,2018-04-01,여자,155,160,161,1,-6,-5,0.00625,-0.037267081,-0.03125
3273,2018,전북,부안군,4580000000,초등학교,2018-04-01,남자,173,185,191,6,-18,-12,0.032432432,-0.094240838,-0.064864865
3274,2018,전남,목포시,4611000000,초등학교,2018-04-01,전체,2756,2560,2577,17,179,196,0.006640625,0.069460613,0.0765625
3275,2018,전남,목포시,4611000000,초등학교,2018-04-01,여자,1396,1299,1301,2,95,97,0.001539646,0.073020753,0.074672825
3276,2018,전남,목포시,4611000000,초등학교,2018-04-01,남자,1360,1261,1276,15,84,99,0.011895321,0.065830721,0.07850912
3277,2018,전남,여수시,4613000000,초등학교,2018-04-01,전체,2614,2684,2659,-25,-45,-70,-0.009314456,-0.016923656,-0.026080477
3278,2018,전남,여수시,4613000000,초등학교,2018-04-01,여자,1303,1374,1362,-12,-59,-71,-0.008733624,-0.043318649,-0.051673945
3279,2018,전남,여수시,4613000000,초등학교,2018-04-01,남자,1311,1310,1297,-13,14,1,-0.009923664,0.01079414,0.000763359
3280,2018,전남,순천시,4615000000,초등학교,2018-04-01,전체,2747,2561,2635,74,112,186,0.028894963,0.042504744,0.07262788
3281,2018,전남,순천시,4615000000,초등학교,2018-04-01,여자,1339,1238,1271,33,68,101,0.026655897,0.05350118,0.081583199
3282,2018,전남,순천시,4615000000,초등학교,2018-04-01,남자,1408,1323,1364,41,44,85,0.030990174,0.032258065,0.064247921
3283,2018,전남,나주시,4617000000,초등학교,2018-04-01,전체,1006,902,1041,139,-35,104,0.154101996,-0.033621518,0.115299335
3284,2018,전남,나주시,4617000000,초등학교,2018-04-01,여자,531,450,524,74,7,81,0.164444444,0.013358779,0.18
3285,2018,전남,나주시,4617000000,초등학교,2018-04-01,남자,475,452,517,65,-42,23,0.14380531,-0.081237911,0.050884956
3286,2018,전남,광양시,4623000000,초등학교,2018-04-01,전체,1606,1676,1669,-7,-63,-70,-0.004176611,-0.037747154,-0.04176611
3287,2018,전남,광양시,4623000000,초등학교,2018-04-01,여자,804,821,819,-2,-15,-17,-0.002436054,-0.018315018,-0.020706456
3288,2018,전남,광양시,4623000000,초등학교,2018-04-01,남자,802,855,850,-5,-48,-53,-0.005847953,-0.056470588,-0.061988304
3289,2018,전남,담양군,4671000000,초등학교,2018-04-01,전체,221,260,262,2,-41,-39,0.007692308,-0.15648855,-0.15
3290,2018,전남,담양군,4671000000,초등학교,2018-04-01,여자,96,109,115,6,-19,-13,0.055045872,-0.165217391,-0.119266055
3291,2018,전남,담양군,4671000000,초등학교,2018-04-01,남자,125,151,147,-4,-22,-26,-0.026490066,-0.149659864,-0.17218543
3292,2018,전남,곡성군,4672000000,초등학교,2018-04-01,전체,169,173,169,-4,0,-4,-0.023121387,0,-0.023121387
3293,2018,전남,곡성군,4672000000,초등학교,2018-04-01,여자,86,91,92,1,-6,-5,0.010989011,-0.065217391,-0.054945055
3294,2018,전남,곡성군,4672000000,초등학교,2018-04-01,남자,83,82,77,-5,6,1,-0.06097561,0.077922078,0.012195122
3295,2018,전남,구례군,4673000000,초등학교,2018-04-01,전체,158,181,176,-5,-18,-23,-0.027624309,-0.102272727,-0.127071823
3296,2018,전남,구례군,4673000000,초등학교,2018-04-01,여자,83,87,84,-3,-1,-4,-0.034482759,-0.011904762,-0.045977011
3297,2018,전남,구례군,4673000000,초등학교,2018-04-01,남자,75,94,92,-2,-17,-19,-0.021276596,-0.184782609,-0.20212766
3298,2018,전남,고흥군,4677000000,초등학교,2018-04-01,전체,292,322,328,6,-36,-30,0.01863354,-0.109756098,-0.093167702
3299,2018,전남,고흥군,4677000000,초등학교,2018-04-01,여자,135,153,153,0,-18,-18,0,-0.117647059,-0.117647059
3300,2018,전남,고흥군,4677000000,초등학교,2018-04-01,남자,157,169,175,6,-18,-12,0.035502959,-0.102857143,-0.071005917
3301,2018,전남,보성군,4678000000,초등학교,2018-04-01,전체,238,298,274,-24,-36,-60,-0.080536913,-0.131386861,-0.201342282
3302,2018,전남,보성군,4678000000,초등학교,2018-04-01,여자,116,138,124,-14,-8,-22,-0.101449275,-0.064516129,-0.15942029
3303,2018,전남,보성군,4678000000,초등학교,2018-04-01,남자,122,160,150,-10,-28,-38,-0.0625,-0.186666667,-0.2375
3304,2018,전남,화순군,4679000000,초등학교,2018-04-01,전체,470,527,507,-20,-37,-57,-0.037950664,-0.072978304,-0.108159393
3305,2018,전남,화순군,4679000000,초등학교,2018-04-01,여자,232,253,248,-5,-16,-21,-0.019762846,-0.064516129,-0.083003953
3306,2018,전남,화순군,4679000000,초등학교,2018-04-01,남자,238,274,259,-15,-21,-36,-0.054744526,-0.081081081,-0.131386861
3307,2018,전남,장흥군,4680000000,초등학교,2018-04-01,전체,233,239,237,-2,-4,-6,-0.008368201,-0.016877637,-0.025104603
3308,2018,전남,장흥군,4680000000,초등학교,2018-04-01,여자,104,112,108,-4,-4,-8,-0.035714286,-0.037037037,-0.071428571
3309,2018,전남,장흥군,4680000000,초등학교,2018-04-01,남자,129,127,129,2,0,2,0.015748031,0,0.015748031
3310,2018,전남,강진군,4681000000,초등학교,2018-04-01,전체,223,270,254,-16,-31,-47,-0.059259259,-0.122047244,-0.174074074
3311,2018,전남,강진군,4681000000,초등학교,2018-04-01,여자,105,136,130,-6,-25,-31,-0.044117647,-0.192307692,-0.227941176
3312,2018,전남,강진군,4681000000,초등학교,2018-04-01,남자,118,134,124,-10,-6,-16,-0.074626866,-0.048387097,-0.119402985
3313,2018,전남,해남군,4682000000,초등학교,2018-04-01,전체,415,481,450,-31,-35,-66,-0.064449064,-0.077777778,-0.137214137
3314,2018,전남,해남군,4682000000,초등학교,2018-04-01,여자,210,260,242,-18,-32,-50,-0.069230769,-0.132231405,-0.192307692
3315,2018,전남,해남군,4682000000,초등학교,2018-04-01,남자,205,221,208,-13,-3,-16,-0.058823529,-0.014423077,-0.07239819
3316,2018,전남,영암군,4683000000,초등학교,2018-04-01,전체,413,531,474,-57,-61,-118,-0.107344633,-0.128691983,-0.222222222
3317,2018,전남,영암군,4683000000,초등학교,2018-04-01,여자,217,264,234,-30,-17,-47,-0.113636364,-0.072649573,-0.178030303
3318,2018,전남,영암군,4683000000,초등학교,2018-04-01,남자,196,267,240,-27,-44,-71,-0.101123596,-0.183333333,-0.265917603
3319,2018,전남,무안군,4684000000,초등학교,2018-04-01,전체,777,896,910,14,-133,-119,0.015625,-0.146153846,-0.1328125
3320,2018,전남,무안군,4684000000,초등학교,2018-04-01,여자,395,445,440,-5,-45,-50,-0.011235955,-0.102272727,-0.112359551
3321,2018,전남,무안군,4684000000,초등학교,2018-04-01,남자,382,451,470,19,-88,-69,0.042128603,-0.187234043,-0.152993348
3322,2018,전남,함평군,4686000000,초등학교,2018-04-01,전체,164,204,195,-9,-31,-40,-0.044117647,-0.158974359,-0.196078431
3323,2018,전남,함평군,4686000000,초등학교,2018-04-01,여자,75,89,89,0,-14,-14,0,-0.157303371,-0.157303371
3324,2018,전남,함평군,4686000000,초등학교,2018-04-01,남자,89,115,106,-9,-17,-26,-0.07826087,-0.160377358,-0.226086957
3325,2018,전남,영광군,4687000000,초등학교,2018-04-01,전체,372,423,396,-27,-24,-51,-0.063829787,-0.060606061,-0.120567376
3326,2018,전남,영광군,4687000000,초등학교,2018-04-01,여자,186,199,184,-15,2,-13,-0.075376884,0.010869565,-0.065326633
3327,2018,전남,영광군,4687000000,초등학교,2018-04-01,남자,186,224,212,-12,-26,-38,-0.053571429,-0.122641509,-0.169642857
3328,2018,전남,장성군,4688000000,초등학교,2018-04-01,전체,366,382,362,-20,4,-16,-0.052356021,0.011049724,-0.041884817
3329,2018,전남,장성군,4688000000,초등학교,2018-04-01,여자,175,192,183,-9,-8,-17,-0.046875,-0.043715847,-0.088541667
3330,2018,전남,장성군,4688000000,초등학교,2018-04-01,남자,191,190,179,-11,12,1,-0.057894737,0.067039106,0.005263158
3331,2018,전남,완도군,4689000000,초등학교,2018-04-01,전체,354,388,395,7,-41,-34,0.018041237,-0.103797468,-0.087628866
3332,2018,전남,완도군,4689000000,초등학교,2018-04-01,여자,168,201,200,-1,-32,-33,-0.004975124,-0.16,-0.164179104
3333,2018,전남,완도군,4689000000,초등학교,2018-04-01,남자,186,187,195,8,-9,-1,0.042780749,-0.046153846,-0.005347594
3334,2018,전남,진도군,4690000000,초등학교,2018-04-01,전체,202,223,223,0,-21,-21,0,-0.094170404,-0.094170404
3335,2018,전남,진도군,4690000000,초등학교,2018-04-01,여자,113,109,109,0,4,4,0,0.036697248,0.036697248
3336,2018,전남,진도군,4690000000,초등학교,2018-04-01,남자,89,114,114,0,-25,-25,0,-0.219298246,-0.219298246
3337,2018,전남,신안군,4691000000,초등학교,2018-04-01,전체,177,210,205,-5,-28,-33,-0.023809524,-0.136585366,-0.157142857
3338,2018,전남,신안군,4691000000,초등학교,2018-04-01,여자,97,118,116,-2,-19,-21,-0.016949153,-0.163793103,-0.177966102
3339,2018,전남,신안군,4691000000,초등학교,2018-04-01,남자,80,92,89,-3,-9,-12,-0.032608696,-0.101123596,-0.130434783
3340,2018,경북,포항시,4711000000,초등학교,2018-04-01,전체,4691,4832,4840,8,-149,-141,0.001655629,-0.030785124,-0.029180464
3341,2018,경북,포항시,4711000000,초등학교,2018-04-01,여자,2206,2322,2317,-5,-111,-116,-0.002153316,-0.047906776,-0.049956934
3342,2018,경북,포항시,4711000000,초등학교,2018-04-01,남자,2485,2510,2523,13,-38,-25,0.005179283,-0.015061435,-0.009960159
3343,2018,경북,경주시,4713000000,초등학교,2018-04-01,전체,1939,2031,2011,-20,-72,-92,-0.009847366,-0.035803083,-0.045297883
3344,2018,경북,경주시,4713000000,초등학교,2018-04-01,여자,946,1007,1004,-3,-58,-61,-0.002979146,-0.057768924,-0.060575968
3345,2018,경북,경주시,4713000000,초등학교,2018-04-01,남자,993,1024,1007,-17,-14,-31,-0.016601563,-0.013902681,-0.030273438
3346,2018,경북,김천시,4715000000,초등학교,2018-04-01,전체,1131,1187,1207,20,-76,-56,0.0168492,-0.062966031,-0.047177759
3347,2018,경북,김천시,4715000000,초등학교,2018-04-01,여자,526,581,593,12,-67,-55,0.020654045,-0.112984823,-0.094664372
3348,2018,경북,김천시,4715000000,초등학교,2018-04-01,남자,605,606,614,8,-9,-1,0.01320132,-0.01465798,-0.001650165
3349,2018,경북,안동시,4717000000,초등학교,2018-04-01,전체,1473,1442,1412,-30,61,31,-0.020804438,0.043201133,0.02149792
3350,2018,경북,안동시,4717000000,초등학교,2018-04-01,여자,697,666,648,-18,49,31,-0.027027027,0.075617284,0.046546547
3351,2018,경북,안동시,4717000000,초등학교,2018-04-01,남자,776,776,764,-12,12,0,-0.015463918,0.015706806,0
3352,2018,경북,구미시,4719000000,초등학교,2018-04-01,전체,4998,5075,5058,-17,-60,-77,-0.003349754,-0.011862396,-0.015172414
3353,2018,경북,구미시,4719000000,초등학교,2018-04-01,여자,2382,2461,2459,-2,-77,-79,-0.000812678,-0.031313542,-0.032100772
3354,2018,경북,구미시,4719000000,초등학교,2018-04-01,남자,2616,2614,2599,-15,17,2,-0.005738332,0.006540977,0.000765111
3355,2018,경북,영주시,4721000000,초등학교,2018-04-01,전체,809,770,820,50,-11,39,0.064935065,-0.013414634,0.050649351
3356,2018,경북,영주시,4721000000,초등학교,2018-04-01,여자,406,389,414,25,-8,17,0.064267352,-0.019323671,0.043701799
3357,2018,경북,영주시,4721000000,초등학교,2018-04-01,남자,403,381,406,25,-3,22,0.065616798,-0.007389163,0.057742782
3358,2018,경북,영천시,4723000000,초등학교,2018-04-01,전체,552,638,619,-19,-67,-86,-0.029780564,-0.108239095,-0.134796238
3359,2018,경북,영천시,4723000000,초등학교,2018-04-01,여자,278,307,299,-8,-21,-29,-0.026058632,-0.070234114,-0.094462541
3360,2018,경북,영천시,4723000000,초등학교,2018-04-01,남자,274,331,320,-11,-46,-57,-0.033232628,-0.14375,-0.172205438
3361,2018,경북,상주시,4725000000,초등학교,2018-04-01,전체,609,618,638,20,-29,-9,0.03236246,-0.045454545,-0.014563107
3362,2018,경북,상주시,4725000000,초등학교,2018-04-01,여자,304,304,315,11,-11,0,0.036184211,-0.034920635,0
3363,2018,경북,상주시,4725000000,초등학교,2018-04-01,남자,305,314,323,9,-18,-9,0.02866242,-0.055727554,-0.02866242
3364,2018,경북,문경시,4728000000,초등학교,2018-04-01,전체,513,523,498,-25,15,-10,-0.047801147,0.030120482,-0.019120459
3365,2018,경북,문경시,4728000000,초등학교,2018-04-01,여자,235,234,221,-13,14,1,-0.055555556,0.063348416,0.004273504
3366,2018,경북,문경시,4728000000,초등학교,2018-04-01,남자,278,289,277,-12,1,-11,-0.041522491,0.003610108,-0.038062284
3367,2018,경북,경산시,4729000000,초등학교,2018-04-01,전체,2342,2442,2403,-39,-61,-100,-0.015970516,-0.025384935,-0.040950041
3368,2018,경북,경산시,4729000000,초등학교,2018-04-01,여자,1122,1158,1141,-17,-19,-36,-0.014680484,-0.01665206,-0.031088083
3369,2018,경북,경산시,4729000000,초등학교,2018-04-01,남자,1220,1284,1262,-22,-42,-64,-0.017133956,-0.033280507,-0.049844237
3370,2018,경북,군위군,4772000000,초등학교,2018-04-01,전체,79,117,111,-6,-32,-38,-0.051282051,-0.288288288,-0.324786325
3371,2018,경북,군위군,4772000000,초등학교,2018-04-01,여자,36,60,55,-5,-19,-24,-0.083333333,-0.345454545,-0.4
3372,2018,경북,군위군,4772000000,초등학교,2018-04-01,남자,43,57,56,-1,-13,-14,-0.01754386,-0.232142857,-0.245614035
3373,2018,경북,의성군,4773000000,초등학교,2018-04-01,전체,183,224,217,-7,-34,-41,-0.03125,-0.156682028,-0.183035714
3374,2018,경북,의성군,4773000000,초등학교,2018-04-01,여자,95,101,98,-3,-3,-6,-0.02970297,-0.030612245,-0.059405941
3375,2018,경북,의성군,4773000000,초등학교,2018-04-01,남자,88,123,119,-4,-31,-35,-0.032520325,-0.260504202,-0.284552846
3376,2018,경북,청송군,4775000000,초등학교,2018-04-01,전체,116,122,122,0,-6,-6,0,-0.049180328,-0.049180328
3377,2018,경북,청송군,4775000000,초등학교,2018-04-01,여자,52,60,60,0,-8,-8,0,-0.133333333,-0.133333333
3378,2018,경북,청송군,4775000000,초등학교,2018-04-01,남자,64,62,62,0,2,2,0,0.032258065,0.032258065
3379,2018,경북,영양군,4776000000,초등학교,2018-04-01,전체,71,85,83,-2,-12,-14,-0.023529412,-0.144578313,-0.164705882
3380,2018,경북,영양군,4776000000,초등학교,2018-04-01,여자,26,34,38,4,-12,-8,0.117647059,-0.315789474,-0.235294118
3381,2018,경북,영양군,4776000000,초등학교,2018-04-01,남자,45,51,45,-6,0,-6,-0.117647059,0,-0.117647059
3382,2018,경북,영덕군,4777000000,초등학교,2018-04-01,전체,186,212,204,-8,-18,-26,-0.037735849,-0.088235294,-0.122641509
3383,2018,경북,영덕군,4777000000,초등학교,2018-04-01,여자,92,103,98,-5,-6,-11,-0.048543689,-0.06122449,-0.106796117
3384,2018,경북,영덕군,4777000000,초등학교,2018-04-01,남자,94,109,106,-3,-12,-15,-0.027522936,-0.113207547,-0.137614679
3385,2018,경북,청도군,4782000000,초등학교,2018-04-01,전체,174,185,172,-13,2,-11,-0.07027027,0.011627907,-0.059459459
3386,2018,경북,청도군,4782000000,초등학교,2018-04-01,여자,91,91,81,-10,10,0,-0.10989011,0.12345679,0
3387,2018,경북,청도군,4782000000,초등학교,2018-04-01,남자,83,94,91,-3,-8,-11,-0.031914894,-0.087912088,-0.117021277
3388,2018,경북,고령군,4783000000,초등학교,2018-04-01,전체,160,215,195,-20,-35,-55,-0.093023256,-0.179487179,-0.255813953
3389,2018,경북,고령군,4783000000,초등학교,2018-04-01,여자,84,105,92,-13,-8,-21,-0.123809524,-0.086956522,-0.2
3390,2018,경북,고령군,4783000000,초등학교,2018-04-01,남자,76,110,103,-7,-27,-34,-0.063636364,-0.262135922,-0.309090909
3391,2018,경북,성주군,4784000000,초등학교,2018-04-01,전체,192,251,233,-18,-41,-59,-0.071713147,-0.175965665,-0.235059761
3392,2018,경북,성주군,4784000000,초등학교,2018-04-01,여자,100,136,131,-5,-31,-36,-0.036764706,-0.236641221,-0.264705882
3393,2018,경북,성주군,4784000000,초등학교,2018-04-01,남자,92,115,102,-13,-10,-23,-0.113043478,-0.098039216,-0.2
3394,2018,경북,칠곡군,4785000000,초등학교,2018-04-01,전체,1206,1374,1334,-40,-128,-168,-0.029112082,-0.095952024,-0.122270742
3395,2018,경북,칠곡군,4785000000,초등학교,2018-04-01,여자,615,661,631,-30,-16,-46,-0.045385779,-0.025356577,-0.069591528
3396,2018,경북,칠곡군,4785000000,초등학교,2018-04-01,남자,591,713,703,-10,-112,-122,-0.014025245,-0.159317212,-0.171107994
3397,2018,경북,예천군,4790000000,초등학교,2018-04-01,전체,219,316,343,27,-124,-97,0.085443038,-0.361516035,-0.306962025
3398,2018,경북,예천군,4790000000,초등학교,2018-04-01,여자,111,158,171,13,-60,-47,0.082278481,-0.350877193,-0.297468354
3399,2018,경북,예천군,4790000000,초등학교,2018-04-01,남자,108,158,172,14,-64,-50,0.088607595,-0.372093023,-0.316455696
3400,2018,경북,봉화군,4792000000,초등학교,2018-04-01,전체,160,225,198,-27,-38,-65,-0.12,-0.191919192,-0.288888889
3401,2018,경북,봉화군,4792000000,초등학교,2018-04-01,여자,78,129,109,-20,-31,-51,-0.15503876,-0.28440367,-0.395348837
3402,2018,경북,봉화군,4792000000,초등학교,2018-04-01,남자,82,96,89,-7,-7,-14,-0.072916667,-0.078651685,-0.145833333
3403,2018,경북,울진군,4793000000,초등학교,2018-04-01,전체,343,408,389,-19,-46,-65,-0.046568627,-0.118251928,-0.159313725
3404,2018,경북,울진군,4793000000,초등학교,2018-04-01,여자,177,203,197,-6,-20,-26,-0.02955665,-0.101522843,-0.128078818
3405,2018,경북,울진군,4793000000,초등학교,2018-04-01,남자,166,205,192,-13,-26,-39,-0.063414634,-0.135416667,-0.190243902
3406,2018,경북,울릉군,4794000000,초등학교,2018-04-01,전체,50,49,49,0,1,1,0,0.020408163,0.020408163
3407,2018,경북,울릉군,4794000000,초등학교,2018-04-01,여자,21,19,17,-2,4,2,-0.105263158,0.235294118,0.105263158
3408,2018,경북,울릉군,4794000000,초등학교,2018-04-01,남자,29,30,32,2,-3,-1,0.066666667,-0.09375,-0.033333333
3409,2018,경남,진주시,4817000000,초등학교,2018-04-01,전체,3368,3285,3315,30,53,83,0.00913242,0.015987934,0.025266362
3410,2018,경남,진주시,4817000000,초등학교,2018-04-01,여자,1579,1564,1585,21,-6,15,0.01342711,-0.003785489,0.009590793
3411,2018,경남,진주시,4817000000,초등학교,2018-04-01,남자,1789,1721,1730,9,59,68,0.005229518,0.034104046,0.039511912
3412,2018,경남,통영시,4822000000,초등학교,2018-04-01,전체,1455,1517,1486,-31,-31,-62,-0.020435069,-0.020861373,-0.040870138
3413,2018,경남,통영시,4822000000,초등학교,2018-04-01,여자,723,757,749,-8,-26,-34,-0.010568032,-0.034712951,-0.044914135
3414,2018,경남,통영시,4822000000,초등학교,2018-04-01,남자,732,760,737,-23,-5,-28,-0.030263158,-0.006784261,-0.036842105
3415,2018,경남,사천시,4824000000,초등학교,2018-04-01,전체,1061,1117,1097,-20,-36,-56,-0.017905103,-0.032816773,-0.050134288
3416,2018,경남,사천시,4824000000,초등학교,2018-04-01,여자,507,537,521,-16,-14,-30,-0.029795158,-0.026871401,-0.055865922
3417,2018,경남,사천시,4824000000,초등학교,2018-04-01,남자,554,580,576,-4,-22,-26,-0.006896552,-0.038194444,-0.044827586
3418,2018,경남,김해시,4825000000,초등학교,2018-04-01,전체,5838,5979,5923,-56,-85,-141,-0.009366115,-0.014350836,-0.023582539
3419,2018,경남,김해시,4825000000,초등학교,2018-04-01,여자,2929,2982,2952,-30,-23,-53,-0.010060362,-0.007791328,-0.017773307
3420,2018,경남,김해시,4825000000,초등학교,2018-04-01,남자,2909,2997,2971,-26,-62,-88,-0.008675342,-0.020868394,-0.029362696
3421,2018,경남,밀양시,4827000000,초등학교,2018-04-01,전체,648,664,680,16,-32,-16,0.024096386,-0.047058824,-0.024096386
3422,2018,경남,밀양시,4827000000,초등학교,2018-04-01,여자,315,334,329,-5,-14,-19,-0.01497006,-0.042553191,-0.056886228
3423,2018,경남,밀양시,4827000000,초등학교,2018-04-01,남자,333,330,351,21,-18,3,0.063636364,-0.051282051,0.009090909
3424,2018,경남,거제시,4831000000,초등학교,2018-04-01,전체,3396,3626,3542,-84,-146,-230,-0.023166023,-0.04121965,-0.063430778
3425,2018,경남,거제시,4831000000,초등학교,2018-04-01,여자,1665,1749,1716,-33,-51,-84,-0.018867925,-0.02972028,-0.048027444
3426,2018,경남,거제시,4831000000,초등학교,2018-04-01,남자,1731,1877,1826,-51,-95,-146,-0.027171018,-0.052026287,-0.077783697
3427,2018,경남,양산시,4833000000,초등학교,2018-04-01,전체,3935,3567,3793,226,142,368,0.063358565,0.037437385,0.103167928
3428,2018,경남,양산시,4833000000,초등학교,2018-04-01,여자,1948,1760,1851,91,97,188,0.051704545,0.052404106,0.106818182
3429,2018,경남,양산시,4833000000,초등학교,2018-04-01,남자,1987,1807,1942,135,45,180,0.074709463,0.023171988,0.099612618
3430,2018,경남,의령군,4872000000,초등학교,2018-04-01,전체,120,150,137,-13,-17,-30,-0.086666667,-0.124087591,-0.2
3431,2018,경남,의령군,4872000000,초등학교,2018-04-01,여자,66,81,72,-9,-6,-15,-0.111111111,-0.083333333,-0.185185185
3432,2018,경남,의령군,4872000000,초등학교,2018-04-01,남자,54,69,65,-4,-11,-15,-0.057971014,-0.169230769,-0.217391304
3433,2018,경남,함안군,4873000000,초등학교,2018-04-01,전체,598,602,594,-8,4,-4,-0.013289037,0.006734007,-0.006644518
3434,2018,경남,함안군,4873000000,초등학교,2018-04-01,여자,308,319,319,0,-11,-11,0,-0.034482759,-0.034482759
3435,2018,경남,함안군,4873000000,초등학교,2018-04-01,남자,290,283,275,-8,15,7,-0.028268551,0.054545455,0.024734982
3436,2018,경남,창녕군,4874000000,초등학교,2018-04-01,전체,391,422,429,7,-38,-31,0.016587678,-0.088578089,-0.073459716
3437,2018,경남,창녕군,4874000000,초등학교,2018-04-01,여자,191,191,196,5,-5,0,0.02617801,-0.025510204,0
3438,2018,경남,창녕군,4874000000,초등학교,2018-04-01,남자,200,231,233,2,-33,-31,0.008658009,-0.141630901,-0.134199134
3439,2018,경남,고성군,4882000000,초등학교,2018-04-01,전체,368,372,364,-8,4,-4,-0.021505376,0.010989011,-0.010752688
3440,2018,경남,고성군,4882000000,초등학교,2018-04-01,여자,174,174,171,-3,3,0,-0.017241379,0.01754386,0
3441,2018,경남,고성군,4882000000,초등학교,2018-04-01,남자,194,198,193,-5,1,-4,-0.025252525,0.005181347,-0.02020202
3442,2018,경남,남해군,4884000000,초등학교,2018-04-01,전체,197,202,209,7,-12,-5,0.034653465,-0.057416268,-0.024752475
3443,2018,경남,남해군,4884000000,초등학교,2018-04-01,여자,78,91,97,6,-19,-13,0.065934066,-0.195876289,-0.142857143
3444,2018,경남,남해군,4884000000,초등학교,2018-04-01,남자,119,111,112,1,7,8,0.009009009,0.0625,0.072072072
3445,2018,경남,하동군,4885000000,초등학교,2018-04-01,전체,226,247,238,-9,-12,-21,-0.036437247,-0.050420168,-0.085020243
3446,2018,경남,하동군,4885000000,초등학교,2018-04-01,여자,95,121,114,-7,-19,-26,-0.05785124,-0.166666667,-0.214876033
3447,2018,경남,하동군,4885000000,초등학교,2018-04-01,남자,131,126,124,-2,7,5,-0.015873016,0.056451613,0.03968254
3448,2018,경남,산청군,4886000000,초등학교,2018-04-01,전체,149,163,154,-9,-5,-14,-0.055214724,-0.032467532,-0.085889571
3449,2018,경남,산청군,4886000000,초등학교,2018-04-01,여자,61,69,63,-6,-2,-8,-0.086956522,-0.031746032,-0.115942029
3450,2018,경남,산청군,4886000000,초등학교,2018-04-01,남자,88,94,91,-3,-3,-6,-0.031914894,-0.032967033,-0.063829787
3451,2018,경남,함양군,4887000000,초등학교,2018-04-01,전체,191,211,208,-3,-17,-20,-0.014218009,-0.081730769,-0.09478673
3452,2018,경남,함양군,4887000000,초등학교,2018-04-01,여자,98,109,107,-2,-9,-11,-0.018348624,-0.08411215,-0.100917431
3453,2018,경남,함양군,4887000000,초등학교,2018-04-01,남자,93,102,101,-1,-8,-9,-0.009803922,-0.079207921,-0.088235294
3454,2018,경남,거창군,4888000000,초등학교,2018-04-01,전체,519,502,517,15,2,17,0.029880478,0.003868472,0.033864542
3455,2018,경남,거창군,4888000000,초등학교,2018-04-01,여자,250,236,237,1,13,14,0.004237288,0.054852321,0.059322034
3456,2018,경남,거창군,4888000000,초등학교,2018-04-01,남자,269,266,280,14,-11,3,0.052631579,-0.039285714,0.011278195
3457,2018,경남,합천군,4889000000,초등학교,2018-04-01,전체,212,247,239,-8,-27,-35,-0.032388664,-0.112970711,-0.141700405
3458,2018,경남,합천군,4889000000,초등학교,2018-04-01,여자,103,130,123,-7,-20,-27,-0.053846154,-0.162601626,-0.207692308
3459,2018,경남,합천군,4889000000,초등학교,2018-04-01,남자,109,117,116,-1,-7,-8,-0.008547009,-0.060344828,-0.068376068
3460,2018,제주,제주시,5011000000,초등학교,2018-04-01,전체,5182,5085,5204,119,-22,97,0.023402163,-0.004227517,0.019075713
3461,2018,제주,제주시,5011000000,초등학교,2018-04-01,여자,2515,2449,2513,64,2,66,0.026133116,0.000795862,0.026949775
3462,2018,제주,제주시,5011000000,초등학교,2018-04-01,남자,2667,2636,2691,55,-24,31,0.020864947,-0.008918618,0.011760243
3463,2018,제주,서귀포시,5013000000,초등학교,2018-04-01,전체,1618,1510,1605,95,13,108,0.062913907,0.008099688,0.071523179
3464,2018,제주,서귀포시,5013000000,초등학교,2018-04-01,여자,736,712,750,38,-14,24,0.053370787,-0.018666667,0.033707865
3465,2018,제주,서귀포시,5013000000,초등학교,2018-04-01,남자,882,798,855,57,27,84,0.071428571,0.031578947,0.105263158
3466,2019,서울,종로구,1111000000,초등학교,2019-04-01,전체,946,1014,1019,5,-73,-68,0.004930966,-0.071638862,-0.067061144
3467,2019,서울,종로구,1111000000,초등학교,2019-04-01,여자,468,490,497,7,-29,-22,0.014285714,-0.058350101,-0.044897959
3468,2019,서울,종로구,1111000000,초등학교,2019-04-01,남자,478,524,522,-2,-44,-46,-0.003816794,-0.084291188,-0.08778626
3469,2019,서울,중구,1114000000,초등학교,2019-04-01,전체,919,795,795,0,124,124,0,0.155974843,0.155974843
3470,2019,서울,중구,1114000000,초등학교,2019-04-01,여자,460,397,399,2,61,63,0.005037783,0.152882206,0.158690176
3471,2019,서울,중구,1114000000,초등학교,2019-04-01,남자,459,398,396,-2,63,61,-0.005025126,0.159090909,0.153266332
3472,2019,서울,용산구,1117000000,초등학교,2019-04-01,전체,1245,1735,1695,-40,-450,-490,-0.023054755,-0.265486726,-0.282420749
3473,2019,서울,용산구,1117000000,초등학교,2019-04-01,여자,603,829,819,-10,-216,-226,-0.012062726,-0.263736264,-0.272617612
3474,2019,서울,용산구,1117000000,초등학교,2019-04-01,남자,642,906,876,-30,-234,-264,-0.033112583,-0.267123288,-0.291390728
3475,2019,서울,성동구,1120000000,초등학교,2019-04-01,전체,2102,2467,2419,-48,-317,-365,-0.01945683,-0.131045887,-0.147952979
3476,2019,서울,성동구,1120000000,초등학교,2019-04-01,여자,1060,1196,1171,-25,-111,-136,-0.02090301,-0.094790777,-0.113712375
3477,2019,서울,성동구,1120000000,초등학교,2019-04-01,남자,1042,1271,1248,-23,-206,-229,-0.018095987,-0.165064103,-0.180173092
3478,2019,서울,광진구,1121500000,초등학교,2019-04-01,전체,2599,2564,2511,-53,88,35,-0.020670827,0.035045798,0.013650546
3479,2019,서울,광진구,1121500000,초등학교,2019-04-01,여자,1249,1266,1258,-8,-9,-17,-0.006319115,-0.007154213,-0.01342812
3480,2019,서울,광진구,1121500000,초등학교,2019-04-01,남자,1350,1298,1253,-45,97,52,-0.034668721,0.077414206,0.040061633
3481,2019,서울,동대문구,1123000000,초등학교,2019-04-01,전체,2386,2610,2509,-101,-123,-224,-0.038697318,-0.049023515,-0.085823755
3482,2019,서울,동대문구,1123000000,초등학교,2019-04-01,여자,1159,1260,1203,-57,-44,-101,-0.045238095,-0.036575229,-0.08015873
3483,2019,서울,동대문구,1123000000,초등학교,2019-04-01,남자,1227,1350,1306,-44,-79,-123,-0.032592593,-0.060490046,-0.091111111
3484,2019,서울,중랑구,1126000000,초등학교,2019-04-01,전체,2717,3050,2917,-133,-200,-333,-0.043606557,-0.068563593,-0.109180328
3485,2019,서울,중랑구,1126000000,초등학교,2019-04-01,여자,1301,1509,1445,-64,-144,-208,-0.042412194,-0.099653979,-0.137839629
3486,2019,서울,중랑구,1126000000,초등학교,2019-04-01,남자,1416,1541,1472,-69,-56,-125,-0.044776119,-0.038043478,-0.081116158
3487,2019,서울,성북구,1129000000,초등학교,2019-04-01,전체,3539,3621,3563,-58,-24,-82,-0.016017675,-0.006735897,-0.022645678
3488,2019,서울,성북구,1129000000,초등학교,2019-04-01,여자,1712,1797,1772,-25,-60,-85,-0.013912076,-0.033860045,-0.047301057
3489,2019,서울,성북구,1129000000,초등학교,2019-04-01,남자,1827,1824,1791,-33,36,3,-0.018092105,0.020100503,0.001644737
3490,2019,서울,강북구,1130500000,초등학교,2019-04-01,전체,1706,2251,2151,-100,-445,-545,-0.0444247,-0.206880521,-0.242114616
3491,2019,서울,강북구,1130500000,초등학교,2019-04-01,여자,814,1076,1010,-66,-196,-262,-0.06133829,-0.194059406,-0.243494424
3492,2019,서울,강북구,1130500000,초등학교,2019-04-01,남자,892,1175,1141,-34,-249,-283,-0.02893617,-0.218229623,-0.240851064
3493,2019,서울,도봉구,1132000000,초등학교,2019-04-01,전체,2601,2545,2479,-66,122,56,-0.025933202,0.049213392,0.022003929
3494,2019,서울,도봉구,1132000000,초등학교,2019-04-01,여자,1253,1228,1182,-46,71,25,-0.037459283,0.060067682,0.020358306
3495,2019,서울,도봉구,1132000000,초등학교,2019-04-01,남자,1348,1317,1297,-20,51,31,-0.015186029,0.039321511,0.023538345
3496,2019,서울,노원구,1135000000,초등학교,2019-04-01,전체,4318,4368,4213,-155,105,-50,-0.035485348,0.024922858,-0.011446886
3497,2019,서울,노원구,1135000000,초등학교,2019-04-01,여자,2101,2100,2011,-89,90,1,-0.042380952,0.044753854,0.00047619
3498,2019,서울,노원구,1135000000,초등학교,2019-04-01,남자,2217,2268,2202,-66,15,-51,-0.029100529,0.006811989,-0.022486772
3499,2019,서울,은평구,1138000000,초등학교,2019-04-01,전체,3686,3863,3734,-129,-48,-177,-0.033393735,-0.012854847,-0.045819311
3500,2019,서울,은평구,1138000000,초등학교,2019-04-01,여자,1756,1874,1802,-72,-46,-118,-0.038420491,-0.025527192,-0.062966916
3501,2019,서울,은평구,1138000000,초등학교,2019-04-01,남자,1930,1989,1932,-57,-2,-59,-0.028657617,-0.001035197,-0.029663147
3502,2019,서울,서대문구,1141000000,초등학교,2019-04-01,전체,2243,2335,2233,-102,10,-92,-0.043683084,0.00447828,-0.039400428
3503,2019,서울,서대문구,1141000000,초등학교,2019-04-01,여자,1099,1144,1108,-36,-9,-45,-0.031468531,-0.008122744,-0.039335664
3504,2019,서울,서대문구,1141000000,초등학교,2019-04-01,남자,1144,1191,1125,-66,19,-47,-0.055415617,0.016888889,-0.039462636
3505,2019,서울,마포구,1144000000,초등학교,2019-04-01,전체,2572,3023,2944,-79,-372,-451,-0.02613298,-0.126358696,-0.149189547
3506,2019,서울,마포구,1144000000,초등학교,2019-04-01,여자,1260,1515,1469,-46,-209,-255,-0.030363036,-0.142273656,-0.168316832
3507,2019,서울,마포구,1144000000,초등학교,2019-04-01,남자,1312,1508,1475,-33,-163,-196,-0.021883289,-0.110508475,-0.129973475
3508,2019,서울,양천구,1147000000,초등학교,2019-04-01,전체,3731,3805,3876,71,-145,-74,0.018659658,-0.037409701,-0.019448095
3509,2019,서울,양천구,1147000000,초등학교,2019-04-01,여자,1832,1869,1924,55,-92,-37,0.029427501,-0.047817048,-0.019796683
3510,2019,서울,양천구,1147000000,초등학교,2019-04-01,남자,1899,1936,1952,16,-53,-37,0.008264463,-0.027151639,-0.01911157
3511,2019,서울,강서구,1150000000,초등학교,2019-04-01,전체,4946,5320,5205,-115,-259,-374,-0.021616541,-0.049759846,-0.070300752
3512,2019,서울,강서구,1150000000,초등학교,2019-04-01,여자,2390,2643,2576,-67,-186,-253,-0.025349981,-0.072204969,-0.095724555
3513,2019,서울,강서구,1150000000,초등학교,2019-04-01,남자,2556,2677,2629,-48,-73,-121,-0.017930519,-0.027767212,-0.045199851
3514,2019,서울,구로구,1153000000,초등학교,2019-04-01,전체,3305,3753,3493,-260,-188,-448,-0.069277911,-0.05382193,-0.11937117
3515,2019,서울,구로구,1153000000,초등학교,2019-04-01,여자,1690,1895,1767,-128,-77,-205,-0.067546174,-0.043576684,-0.10817942
3516,2019,서울,구로구,1153000000,초등학교,2019-04-01,남자,1615,1858,1726,-132,-111,-243,-0.071044133,-0.064310545,-0.130785791
3517,2019,서울,금천구,1154500000,초등학교,2019-04-01,전체,1656,1751,1633,-118,23,-95,-0.067390063,0.014084507,-0.054254712
3518,2019,서울,금천구,1154500000,초등학교,2019-04-01,여자,812,865,811,-54,1,-53,-0.062427746,0.001233046,-0.061271676
3519,2019,서울,금천구,1154500000,초등학교,2019-04-01,남자,844,886,822,-64,22,-42,-0.072234763,0.02676399,-0.047404063
3520,2019,서울,영등포구,1156000000,초등학교,2019-04-01,전체,2564,2889,2816,-73,-252,-325,-0.025268259,-0.089488636,-0.112495673
3521,2019,서울,영등포구,1156000000,초등학교,2019-04-01,여자,1279,1433,1397,-36,-118,-154,-0.025122121,-0.084466714,-0.107466853
3522,2019,서울,영등포구,1156000000,초등학교,2019-04-01,남자,1285,1456,1419,-37,-134,-171,-0.025412088,-0.094432699,-0.117445055
3523,2019,서울,동작구,1159000000,초등학교,2019-04-01,전체,2805,3123,3020,-103,-215,-318,-0.032981108,-0.071192053,-0.101825168
3524,2019,서울,동작구,1159000000,초등학교,2019-04-01,여자,1378,1503,1456,-47,-78,-125,-0.031270792,-0.053571429,-0.083166999
3525,2019,서울,동작구,1159000000,초등학교,2019-04-01,남자,1427,1620,1564,-56,-137,-193,-0.034567901,-0.087595908,-0.119135802
3526,2019,서울,관악구,1162000000,초등학교,2019-04-01,전체,2581,3181,2999,-182,-418,-600,-0.057214712,-0.139379793,-0.188619931
3527,2019,서울,관악구,1162000000,초등학교,2019-04-01,여자,1263,1567,1479,-88,-216,-304,-0.056158264,-0.146044625,-0.194001276
3528,2019,서울,관악구,1162000000,초등학교,2019-04-01,남자,1318,1614,1520,-94,-202,-296,-0.058240397,-0.132894737,-0.183395291
3529,2019,서울,서초구,1165000000,초등학교,2019-04-01,전체,3854,4349,4375,26,-521,-495,0.005978386,-0.119085714,-0.113819269
3530,2019,서울,서초구,1165000000,초등학교,2019-04-01,여자,1870,2121,2147,26,-277,-251,0.012258369,-0.129017233,-0.118340405
3531,2019,서울,서초구,1165000000,초등학교,2019-04-01,남자,1984,2228,2228,0,-244,-244,0,-0.10951526,-0.10951526
3532,2019,서울,강남구,1168000000,초등학교,2019-04-01,전체,4096,4468,4501,33,-405,-372,0.007385855,-0.089980004,-0.083258729
3533,2019,서울,강남구,1168000000,초등학교,2019-04-01,여자,1980,2185,2194,9,-214,-205,0.004118993,-0.097538742,-0.09382151
3534,2019,서울,강남구,1168000000,초등학교,2019-04-01,남자,2116,2283,2307,24,-191,-167,0.010512484,-0.082791504,-0.073149365
3535,2019,서울,송파구,1171000000,초등학교,2019-04-01,전체,5620,5748,5763,15,-143,-128,0.002609603,-0.024813465,-0.022268615
3536,2019,서울,송파구,1171000000,초등학교,2019-04-01,여자,2767,2819,2810,-9,-43,-52,-0.003192621,-0.015302491,-0.018446258
3537,2019,서울,송파구,1171000000,초등학교,2019-04-01,남자,2853,2929,2953,24,-100,-76,0.008193923,-0.033863867,-0.025947422
3538,2019,서울,강동구,1174000000,초등학교,2019-04-01,전체,3292,3616,3441,-175,-149,-324,-0.048396018,-0.043301366,-0.08960177
3539,2019,서울,강동구,1174000000,초등학교,2019-04-01,여자,1581,1736,1640,-96,-59,-155,-0.055299539,-0.03597561,-0.089285714
3540,2019,서울,강동구,1174000000,초등학교,2019-04-01,남자,1711,1880,1801,-79,-90,-169,-0.042021277,-0.049972238,-0.089893617
3541,2019,부산,중구,2611000000,초등학교,2019-04-01,전체,229,206,181,-25,48,23,-0.121359223,0.26519337,0.111650485
3542,2019,부산,중구,2611000000,초등학교,2019-04-01,여자,104,105,93,-12,11,-1,-0.114285714,0.11827957,-0.00952381
3543,2019,부산,중구,2611000000,초등학교,2019-04-01,남자,125,101,88,-13,37,24,-0.128712871,0.420454545,0.237623762
3544,2019,부산,서구,2614000000,초등학교,2019-04-01,전체,655,596,621,25,34,59,0.041946309,0.054750403,0.098993289
3545,2019,부산,서구,2614000000,초등학교,2019-04-01,여자,319,273,277,4,42,46,0.014652015,0.151624549,0.168498168
3546,2019,부산,서구,2614000000,초등학교,2019-04-01,남자,336,323,344,21,-8,13,0.06501548,-0.023255814,0.040247678
3547,2019,부산,동구,2617000000,초등학교,2019-04-01,전체,404,456,435,-21,-31,-52,-0.046052632,-0.071264368,-0.114035088
3548,2019,부산,동구,2617000000,초등학교,2019-04-01,여자,198,217,204,-13,-6,-19,-0.059907834,-0.029411765,-0.087557604
3549,2019,부산,동구,2617000000,초등학교,2019-04-01,남자,206,239,231,-8,-25,-33,-0.033472803,-0.108225108,-0.138075314
3550,2019,부산,영도구,2620000000,초등학교,2019-04-01,전체,645,702,691,-11,-46,-57,-0.015669516,-0.066570188,-0.081196581
3551,2019,부산,영도구,2620000000,초등학교,2019-04-01,여자,297,340,331,-9,-34,-43,-0.026470588,-0.102719033,-0.126470588
3552,2019,부산,영도구,2620000000,초등학교,2019-04-01,남자,348,362,360,-2,-12,-14,-0.005524862,-0.033333333,-0.038674033
3553,2019,부산,부산진구,2623000000,초등학교,2019-04-01,전체,2739,2716,2653,-63,86,23,-0.023195876,0.032416133,0.008468336
3554,2019,부산,부산진구,2623000000,초등학교,2019-04-01,여자,1353,1359,1333,-26,20,-6,-0.019131714,0.015003751,-0.004415011
3555,2019,부산,부산진구,2623000000,초등학교,2019-04-01,남자,1386,1357,1320,-37,66,29,-0.027266028,0.05,0.021370671
3556,2019,부산,동래구,2626000000,초등학교,2019-04-01,전체,2225,2194,2171,-23,54,31,-0.010483136,0.02487333,0.014129444
3557,2019,부산,동래구,2626000000,초등학교,2019-04-01,여자,1058,1056,1046,-10,12,2,-0.009469697,0.011472275,0.001893939
3558,2019,부산,동래구,2626000000,초등학교,2019-04-01,남자,1167,1138,1125,-13,42,29,-0.01142355,0.037333333,0.025483304
3559,2019,부산,남구,2629000000,초등학교,2019-04-01,전체,2214,2045,2101,56,113,169,0.027383863,0.053783912,0.082640587
3560,2019,부산,남구,2629000000,초등학교,2019-04-01,여자,1098,987,1023,36,75,111,0.036474164,0.073313783,0.112462006
3561,2019,부산,남구,2629000000,초등학교,2019-04-01,남자,1116,1058,1078,20,38,58,0.018903592,0.035250464,0.054820416
3562,2019,부산,북구,2632000000,초등학교,2019-04-01,전체,2275,2468,2370,-98,-95,-193,-0.039708266,-0.040084388,-0.078200972
3563,2019,부산,북구,2632000000,초등학교,2019-04-01,여자,1080,1189,1139,-50,-59,-109,-0.042052145,-0.051799824,-0.091673675
3564,2019,부산,북구,2632000000,초등학교,2019-04-01,남자,1195,1279,1231,-48,-36,-84,-0.03752932,-0.029244517,-0.06567631
3565,2019,부산,해운대구,2635000000,초등학교,2019-04-01,전체,3398,3574,3550,-24,-152,-176,-0.006715165,-0.042816901,-0.049244544
3566,2019,부산,해운대구,2635000000,초등학교,2019-04-01,여자,1605,1664,1647,-17,-42,-59,-0.010216346,-0.025500911,-0.035456731
3567,2019,부산,해운대구,2635000000,초등학교,2019-04-01,남자,1793,1910,1903,-7,-110,-117,-0.003664921,-0.057803468,-0.061256545
3568,2019,부산,사하구,2638000000,초등학교,2019-04-01,전체,2572,2740,2681,-59,-109,-168,-0.021532847,-0.040656471,-0.061313869
3569,2019,부산,사하구,2638000000,초등학교,2019-04-01,여자,1282,1360,1341,-19,-59,-78,-0.013970588,-0.043997017,-0.057352941
3570,2019,부산,사하구,2638000000,초등학교,2019-04-01,남자,1290,1380,1340,-40,-50,-90,-0.028985507,-0.037313433,-0.065217391
3571,2019,부산,금정구,2641000000,초등학교,2019-04-01,전체,1702,1594,1680,86,22,108,0.053952321,0.013095238,0.067754078
3572,2019,부산,금정구,2641000000,초등학교,2019-04-01,여자,812,776,815,39,-3,36,0.050257732,-0.003680982,0.046391753
3573,2019,부산,금정구,2641000000,초등학교,2019-04-01,남자,890,818,865,47,25,72,0.057457213,0.028901734,0.08801956
3574,2019,부산,강서구,2644000000,초등학교,2019-04-01,전체,1958,1833,1908,75,50,125,0.04091653,0.026205451,0.068194217
3575,2019,부산,강서구,2644000000,초등학교,2019-04-01,여자,925,874,904,30,21,51,0.034324943,0.023230088,0.058352403
3576,2019,부산,강서구,2644000000,초등학교,2019-04-01,남자,1033,959,1004,45,29,74,0.046923879,0.028884462,0.077163712
3577,2019,부산,연제구,2647000000,초등학교,2019-04-01,전체,1654,1619,1606,-13,48,35,-0.008029648,0.02988792,0.021618283
3578,2019,부산,연제구,2647000000,초등학교,2019-04-01,여자,825,813,810,-3,15,12,-0.003690037,0.018518519,0.014760148
3579,2019,부산,연제구,2647000000,초등학교,2019-04-01,남자,829,806,796,-10,33,23,-0.012406948,0.041457286,0.02853598
3580,2019,부산,수영구,2650000000,초등학교,2019-04-01,전체,1042,1247,1251,4,-209,-205,0.003207698,-0.167066347,-0.164394547
3581,2019,부산,수영구,2650000000,초등학교,2019-04-01,여자,507,602,599,-3,-92,-95,-0.004983389,-0.153589316,-0.157807309
3582,2019,부산,수영구,2650000000,초등학교,2019-04-01,남자,535,645,652,7,-117,-110,0.010852713,-0.179447853,-0.170542636
3583,2019,부산,사상구,2653000000,초등학교,2019-04-01,전체,1489,1759,1683,-76,-194,-270,-0.043206367,-0.115270351,-0.153496305
3584,2019,부산,사상구,2653000000,초등학교,2019-04-01,여자,739,899,857,-42,-118,-160,-0.046718576,-0.137689615,-0.177975528
3585,2019,부산,사상구,2653000000,초등학교,2019-04-01,남자,750,860,826,-34,-76,-110,-0.039534884,-0.092009685,-0.127906977
3586,2019,부산,기장군,2671000000,초등학교,2019-04-01,전체,2166,2302,2271,-31,-105,-136,-0.013466551,-0.046235139,-0.059079062
3587,2019,부산,기장군,2671000000,초등학교,2019-04-01,여자,1066,1132,1107,-25,-41,-66,-0.022084806,-0.037037037,-0.058303887
3588,2019,부산,기장군,2671000000,초등학교,2019-04-01,남자,1100,1170,1164,-6,-64,-70,-0.005128205,-0.054982818,-0.05982906
3589,2019,대구,중구,2711000000,초등학교,2019-04-01,전체,787,596,614,18,173,191,0.030201342,0.281758958,0.320469799
3590,2019,대구,중구,2711000000,초등학교,2019-04-01,여자,351,270,273,3,78,81,0.011111111,0.285714286,0.3
3591,2019,대구,중구,2711000000,초등학교,2019-04-01,남자,436,326,341,15,95,110,0.04601227,0.278592375,0.337423313
3592,2019,대구,동구,2714000000,초등학교,2019-04-01,전체,3154,3271,3165,-106,-11,-117,-0.032405992,-0.003475513,-0.035768878
3593,2019,대구,동구,2714000000,초등학교,2019-04-01,여자,1510,1591,1530,-61,-20,-81,-0.038340666,-0.013071895,-0.050911376
3594,2019,대구,동구,2714000000,초등학교,2019-04-01,남자,1644,1680,1635,-45,9,-36,-0.026785714,0.005504587,-0.021428571
3595,2019,대구,서구,2717000000,초등학교,2019-04-01,전체,1024,1169,1092,-77,-68,-145,-0.065868263,-0.062271062,-0.124037639
3596,2019,대구,서구,2717000000,초등학교,2019-04-01,여자,515,597,568,-29,-53,-82,-0.048576214,-0.093309859,-0.137353434
3597,2019,대구,서구,2717000000,초등학교,2019-04-01,남자,509,572,524,-48,-15,-63,-0.083916084,-0.028625954,-0.11013986
3598,2019,대구,남구,2720000000,초등학교,2019-04-01,전체,737,909,857,-52,-120,-172,-0.057205721,-0.140023337,-0.189218922
3599,2019,대구,남구,2720000000,초등학교,2019-04-01,여자,366,466,428,-38,-62,-100,-0.081545064,-0.144859813,-0.214592275
3600,2019,대구,남구,2720000000,초등학교,2019-04-01,남자,371,443,429,-14,-58,-72,-0.031602709,-0.135198135,-0.162528217
3601,2019,대구,북구,2723000000,초등학교,2019-04-01,전체,3864,4112,4115,3,-251,-248,0.000729572,-0.060996355,-0.060311284
3602,2019,대구,북구,2723000000,초등학교,2019-04-01,여자,1897,1976,2008,32,-111,-79,0.016194332,-0.055278884,-0.039979757
3603,2019,대구,북구,2723000000,초등학교,2019-04-01,남자,1967,2136,2107,-29,-140,-169,-0.013576779,-0.066445183,-0.07911985
3604,2019,대구,수성구,2726000000,초등학교,2019-04-01,전체,3675,3452,3587,135,88,223,0.039107764,0.024533036,0.064600232
3605,2019,대구,수성구,2726000000,초등학교,2019-04-01,여자,1756,1687,1743,56,13,69,0.033195021,0.007458405,0.040901008
3606,2019,대구,수성구,2726000000,초등학교,2019-04-01,남자,1919,1765,1844,79,75,154,0.044759207,0.040672451,0.087252125
3607,2019,대구,달서구,2729000000,초등학교,2019-04-01,전체,5343,5186,5050,-136,293,157,-0.02622445,0.058019802,0.030273814
3608,2019,대구,달서구,2729000000,초등학교,2019-04-01,여자,2666,2550,2495,-55,171,116,-0.021568627,0.068537074,0.045490196
3609,2019,대구,달서구,2729000000,초등학교,2019-04-01,남자,2677,2636,2555,-81,122,41,-0.030728376,0.047749511,0.015553869
3610,2019,대구,달성군,2771000000,초등학교,2019-04-01,전체,3044,2942,3203,261,-159,102,0.08871516,-0.049640962,0.034670292
3611,2019,대구,달성군,2771000000,초등학교,2019-04-01,여자,1475,1414,1513,99,-38,61,0.070014144,-0.025115664,0.043140028
3612,2019,대구,달성군,2771000000,초등학교,2019-04-01,남자,1569,1528,1690,162,-121,41,0.106020942,-0.071597633,0.026832461
3613,2019,인천,중구,2811000000,초등학교,2019-04-01,전체,1442,1199,1203,4,239,243,0.003336113,0.198669992,0.202668891
3614,2019,인천,중구,2811000000,초등학교,2019-04-01,여자,696,598,598,0,98,98,0,0.163879599,0.163879599
3615,2019,인천,중구,2811000000,초등학교,2019-04-01,남자,746,601,605,4,141,145,0.006655574,0.233057851,0.241264559
3616,2019,인천,동구,2814000000,초등학교,2019-04-01,전체,658,609,555,-54,103,49,-0.088669951,0.185585586,0.08045977
3617,2019,인천,동구,2814000000,초등학교,2019-04-01,여자,333,301,276,-25,57,32,-0.083056478,0.206521739,0.106312292
3618,2019,인천,동구,2814000000,초등학교,2019-04-01,남자,325,308,279,-29,46,17,-0.094155844,0.164874552,0.055194805
3619,2019,인천,연수구,2818500000,초등학교,2019-04-01,전체,3981,3545,3740,195,241,436,0.055007052,0.064438503,0.122990127
3620,2019,인천,연수구,2818500000,초등학교,2019-04-01,여자,1964,1732,1847,115,117,232,0.066397229,0.063345966,0.133949192
3621,2019,인천,연수구,2818500000,초등학교,2019-04-01,남자,2017,1813,1893,80,124,204,0.044125758,0.06550449,0.112520684
3622,2019,인천,미추홀구,2817700000,초등학교,2019-04-01,전체,3144,3497,3442,-55,-298,-353,-0.015727767,-0.086577571,-0.100943666
3623,2019,인천,미추홀구,2817700000,초등학교,2019-04-01,여자,1511,1734,1684,-50,-173,-223,-0.028835063,-0.102731591,-0.128604383
3624,2019,인천,미추홀구,2817700000,초등학교,2019-04-01,남자,1633,1763,1758,-5,-125,-130,-0.002836075,-0.071103527,-0.073737947
3625,2019,인천,남동구,2820000000,초등학교,2019-04-01,전체,5246,5572,5587,15,-341,-326,0.002692032,-0.061034544,-0.05850682
3626,2019,인천,남동구,2820000000,초등학교,2019-04-01,여자,2567,2682,2703,21,-136,-115,0.007829978,-0.050314465,-0.042878449
3627,2019,인천,남동구,2820000000,초등학교,2019-04-01,남자,2679,2890,2884,-6,-205,-211,-0.002076125,-0.071081831,-0.073010381
3628,2019,인천,부평구,2823700000,초등학교,2019-04-01,전체,4246,4570,4324,-246,-78,-324,-0.053829322,-0.018038853,-0.070897155
3629,2019,인천,부평구,2823700000,초등학교,2019-04-01,여자,2076,2248,2115,-133,-39,-172,-0.059163701,-0.018439716,-0.076512456
3630,2019,인천,부평구,2823700000,초등학교,2019-04-01,남자,2170,2322,2209,-113,-39,-152,-0.048664944,-0.017655048,-0.06546081
3631,2019,인천,계양구,2824500000,초등학교,2019-04-01,전체,2465,2755,2585,-170,-120,-290,-0.061705989,-0.046421663,-0.105263158
3632,2019,인천,계양구,2824500000,초등학교,2019-04-01,여자,1207,1351,1270,-81,-63,-144,-0.059955588,-0.049606299,-0.106587713
3633,2019,인천,계양구,2824500000,초등학교,2019-04-01,남자,1258,1404,1315,-89,-57,-146,-0.063390313,-0.043346008,-0.103988604
3634,2019,인천,서구,2826000000,초등학교,2019-04-01,전체,5921,5914,6024,110,-103,7,0.018599932,-0.017098274,0.001183632
3635,2019,인천,서구,2826000000,초등학교,2019-04-01,여자,2826,2854,2902,48,-76,-28,0.0168185,-0.026188835,-0.009810792
3636,2019,인천,서구,2826000000,초등학교,2019-04-01,남자,3095,3060,3122,62,-27,35,0.020261438,-0.008648302,0.011437908
3637,2019,인천,강화군,2871000000,초등학교,2019-04-01,전체,353,381,395,14,-42,-28,0.036745407,-0.106329114,-0.073490814
3638,2019,인천,강화군,2871000000,초등학교,2019-04-01,여자,170,185,190,5,-20,-15,0.027027027,-0.105263158,-0.081081081
3639,2019,인천,강화군,2871000000,초등학교,2019-04-01,남자,183,196,205,9,-22,-13,0.045918367,-0.107317073,-0.066326531
3640,2019,인천,옹진군,2872000000,초등학교,2019-04-01,전체,102,120,123,3,-21,-18,0.025,-0.170731707,-0.15
3641,2019,인천,옹진군,2872000000,초등학교,2019-04-01,여자,55,60,64,4,-9,-5,0.066666667,-0.140625,-0.083333333
3642,2019,인천,옹진군,2872000000,초등학교,2019-04-01,남자,47,60,59,-1,-12,-13,-0.016666667,-0.203389831,-0.216666667
3643,2019,광주,동구,2911000000,초등학교,2019-04-01,전체,587,716,679,-37,-92,-129,-0.051675978,-0.135493373,-0.180167598
3644,2019,광주,동구,2911000000,초등학교,2019-04-01,여자,295,358,337,-21,-42,-63,-0.058659218,-0.12462908,-0.175977654
3645,2019,광주,동구,2911000000,초등학교,2019-04-01,남자,292,358,342,-16,-50,-66,-0.044692737,-0.14619883,-0.184357542
3646,2019,광주,서구,2914000000,초등학교,2019-04-01,전체,2803,2776,2773,-3,30,27,-0.001080692,0.010818608,0.009726225
3647,2019,광주,서구,2914000000,초등학교,2019-04-01,여자,1331,1327,1318,-9,13,4,-0.006782216,0.009863429,0.003014318
3648,2019,광주,서구,2914000000,초등학교,2019-04-01,남자,1472,1449,1455,6,17,23,0.004140787,0.011683849,0.015873016
3649,2019,광주,남구,2915500000,초등학교,2019-04-01,전체,2317,2006,2058,52,259,311,0.025922233,0.12585034,0.155034895
3650,2019,광주,남구,2915500000,초등학교,2019-04-01,여자,1112,944,963,19,149,168,0.020127119,0.154724818,0.177966102
3651,2019,광주,남구,2915500000,초등학교,2019-04-01,남자,1205,1062,1095,33,110,143,0.031073446,0.100456621,0.134651601
3652,2019,광주,북구,2917000000,초등학교,2019-04-01,전체,4081,3868,3943,75,138,213,0.019389866,0.034998732,0.055067218
3653,2019,광주,북구,2917000000,초등학교,2019-04-01,여자,1971,1846,1869,23,102,125,0.012459372,0.054574639,0.067713976
3654,2019,광주,북구,2917000000,초등학교,2019-04-01,남자,2110,2022,2074,52,36,88,0.025717112,0.017357763,0.043521266
3655,2019,광주,광산구,2920000000,초등학교,2019-04-01,전체,5395,5210,5246,36,149,185,0.006909789,0.028402592,0.035508637
3656,2019,광주,광산구,2920000000,초등학교,2019-04-01,여자,2575,2519,2549,30,26,56,0.011909488,0.010200078,0.022231044
3657,2019,광주,광산구,2920000000,초등학교,2019-04-01,남자,2820,2691,2697,6,123,129,0.002229654,0.045606229,0.04793757
3658,2019,대전,동구,3011000000,초등학교,2019-04-01,전체,1869,2074,1946,-128,-77,-205,-0.06171649,-0.039568345,-0.098842816
3659,2019,대전,동구,3011000000,초등학교,2019-04-01,여자,940,1055,976,-79,-36,-115,-0.074881517,-0.036885246,-0.109004739
3660,2019,대전,동구,3011000000,초등학교,2019-04-01,남자,929,1019,970,-49,-41,-90,-0.048086359,-0.042268041,-0.088321884
3661,2019,대전,중구,3014000000,초등학교,2019-04-01,전체,2024,2134,2068,-66,-44,-110,-0.030927835,-0.021276596,-0.051546392
3662,2019,대전,중구,3014000000,초등학교,2019-04-01,여자,986,1041,1020,-21,-34,-55,-0.020172911,-0.033333333,-0.052833814
3663,2019,대전,중구,3014000000,초등학교,2019-04-01,남자,1038,1093,1048,-45,-10,-55,-0.041171089,-0.009541985,-0.05032022
3664,2019,대전,서구,3017000000,초등학교,2019-04-01,전체,4556,4672,4673,1,-117,-116,0.000214041,-0.025037449,-0.024828767
3665,2019,대전,서구,3017000000,초등학교,2019-04-01,여자,2217,2307,2281,-26,-64,-90,-0.011270048,-0.028057869,-0.039011704
3666,2019,대전,서구,3017000000,초등학교,2019-04-01,남자,2339,2365,2392,27,-53,-26,0.01141649,-0.022157191,-0.010993658
3667,2019,대전,유성구,3020000000,초등학교,2019-04-01,전체,4129,4174,4191,17,-62,-45,0.004072832,-0.014793605,-0.010781025
3668,2019,대전,유성구,3020000000,초등학교,2019-04-01,여자,1988,1999,2014,15,-26,-11,0.007503752,-0.012909633,-0.005502751
3669,2019,대전,유성구,3020000000,초등학교,2019-04-01,남자,2141,2175,2177,2,-36,-34,0.00091954,-0.016536518,-0.015632184
3670,2019,대전,대덕구,3023000000,초등학교,2019-04-01,전체,1376,1551,1483,-68,-107,-175,-0.043842682,-0.072151045,-0.112830432
3671,2019,대전,대덕구,3023000000,초등학교,2019-04-01,여자,660,775,744,-31,-84,-115,-0.04,-0.112903226,-0.148387097
3672,2019,대전,대덕구,3023000000,초등학교,2019-04-01,남자,716,776,739,-37,-23,-60,-0.047680412,-0.031123139,-0.077319588
3673,2019,울산,중구,3111000000,초등학교,2019-04-01,전체,2188,2310,2231,-79,-43,-122,-0.034199134,-0.019273868,-0.052813853
3674,2019,울산,중구,3111000000,초등학교,2019-04-01,여자,1001,1108,1077,-31,-76,-107,-0.027978339,-0.070566388,-0.096570397
3675,2019,울산,중구,3111000000,초등학교,2019-04-01,남자,1187,1202,1154,-48,33,-15,-0.039933444,0.028596187,-0.012479201
3676,2019,울산,남구,3114000000,초등학교,2019-04-01,전체,2817,2925,2862,-63,-45,-108,-0.021538462,-0.01572327,-0.036923077
3677,2019,울산,남구,3114000000,초등학교,2019-04-01,여자,1367,1424,1404,-20,-37,-57,-0.014044944,-0.026353276,-0.04002809
3678,2019,울산,남구,3114000000,초등학교,2019-04-01,남자,1450,1501,1458,-43,-8,-51,-0.028647568,-0.005486968,-0.033977348
3679,2019,울산,동구,3117000000,초등학교,2019-04-01,전체,1920,2035,1918,-117,2,-115,-0.057493857,0.001042753,-0.056511057
3680,2019,울산,동구,3117000000,초등학교,2019-04-01,여자,939,985,918,-67,21,-46,-0.068020305,0.022875817,-0.046700508
3681,2019,울산,동구,3117000000,초등학교,2019-04-01,남자,981,1050,1000,-50,-19,-69,-0.047619048,-0.019,-0.065714286
3682,2019,울산,북구,3120000000,초등학교,2019-04-01,전체,2828,2620,2733,113,95,208,0.043129771,0.034760337,0.079389313
3683,2019,울산,북구,3120000000,초등학교,2019-04-01,여자,1369,1279,1343,64,26,90,0.050039093,0.019359643,0.070367475
3684,2019,울산,북구,3120000000,초등학교,2019-04-01,남자,1459,1341,1390,49,69,118,0.036539896,0.049640288,0.087994034
3685,2019,울산,울주군,3171000000,초등학교,2019-04-01,전체,2328,2189,2199,10,129,139,0.004568296,0.058663029,0.063499315
3686,2019,울산,울주군,3171000000,초등학교,2019-04-01,여자,1185,1116,1112,-4,73,69,-0.003584229,0.065647482,0.061827957
3687,2019,울산,울주군,3171000000,초등학교,2019-04-01,남자,1143,1073,1087,14,56,70,0.01304753,0.051517939,0.065237651
3688,2019,세종,세종시,3611000000,초등학교,2019-04-01,전체,5004,3836,4529,693,475,1168,0.180656934,0.104879664,0.304483837
3689,2019,세종,세종시,3611000000,초등학교,2019-04-01,전체,5004,3836,4529,693,475,1168,0.180656934,0.104879664,0.304483837
3690,2019,세종,세종시,3611000000,초등학교,2019-04-01,전체,5004,3836,4529,693,475,1168,0.180656934,0.104879664,0.304483837
3691,2019,세종,세종시,3611000000,초등학교,2019-04-01,전체,5004,3836,4529,693,475,1168,0.180656934,0.104879664,0.304483837
3692,2019,세종,세종시,3611000000,초등학교,2019-04-01,여자,2428,1853,2192,339,236,575,0.182946573,0.107664234,0.310307609
3693,2019,세종,세종시,3611000000,초등학교,2019-04-01,여자,2428,1853,2192,339,236,575,0.182946573,0.107664234,0.310307609
3694,2019,세종,세종시,3611000000,초등학교,2019-04-01,여자,2428,1853,2192,339,236,575,0.182946573,0.107664234,0.310307609
3695,2019,세종,세종시,3611000000,초등학교,2019-04-01,여자,2428,1853,2192,339,236,575,0.182946573,0.107664234,0.310307609
3696,2019,세종,세종시,3611000000,초등학교,2019-04-01,남자,2576,1983,2337,354,239,593,0.178517398,0.102267865,0.299041856
3697,2019,세종,세종시,3611000000,초등학교,2019-04-01,남자,2576,1983,2337,354,239,593,0.178517398,0.102267865,0.299041856
3698,2019,세종,세종시,3611000000,초등학교,2019-04-01,남자,2576,1983,2337,354,239,593,0.178517398,0.102267865,0.299041856
3699,2019,세종,세종시,3611000000,초등학교,2019-04-01,남자,2576,1983,2337,354,239,593,0.178517398,0.102267865,0.299041856
3700,2019,경기,수원시,4111000000,초등학교,2019-04-01,전체,12205,12347,12320,-27,-115,-142,-0.002186766,-0.009334416,-0.011500769
3701,2019,경기,수원시,4111000000,초등학교,2019-04-01,여자,5932,5956,5946,-10,-14,-24,-0.001678979,-0.002354524,-0.00402955
3702,2019,경기,수원시,4111000000,초등학교,2019-04-01,남자,6273,6391,6374,-17,-101,-118,-0.002659991,-0.015845623,-0.018463464
3703,2019,경기,성남시,4113000000,초등학교,2019-04-01,전체,7813,8603,8490,-113,-677,-790,-0.013134953,-0.079740872,-0.091828432
3704,2019,경기,성남시,4113000000,초등학교,2019-04-01,여자,3720,4110,4028,-82,-308,-390,-0.019951338,-0.076464747,-0.094890511
3705,2019,경기,성남시,4113000000,초등학교,2019-04-01,남자,4093,4493,4462,-31,-369,-400,-0.006899622,-0.082698342,-0.089027376
3706,2019,경기,부천시,4119000000,초등학교,2019-04-01,전체,7059,7388,7461,73,-402,-329,0.009880888,-0.053880177,-0.044531673
3707,2019,경기,부천시,4119000000,초등학교,2019-04-01,여자,3421,3565,3588,23,-167,-144,0.006451613,-0.046544036,-0.040392707
3708,2019,경기,부천시,4119000000,초등학교,2019-04-01,남자,3638,3823,3873,50,-235,-185,0.013078734,-0.060676478,-0.048391316
3709,2019,경기,안양시,4117000000,초등학교,2019-04-01,전체,4602,5008,4728,-280,-126,-406,-0.055910543,-0.026649746,-0.081070288
3710,2019,경기,안양시,4117000000,초등학교,2019-04-01,여자,2242,2407,2290,-117,-48,-165,-0.048608226,-0.020960699,-0.068550062
3711,2019,경기,안양시,4117000000,초등학교,2019-04-01,남자,2360,2601,2438,-163,-78,-241,-0.062668205,-0.031993437,-0.092656671
3712,2019,경기,과천시,4129000000,초등학교,2019-04-01,전체,466,455,451,-4,15,11,-0.008791209,0.033259424,0.024175824
3713,2019,경기,과천시,4129000000,초등학교,2019-04-01,여자,224,231,227,-4,-3,-7,-0.017316017,-0.013215859,-0.03030303
3714,2019,경기,과천시,4129000000,초등학교,2019-04-01,남자,242,224,224,0,18,18,0,0.080357143,0.080357143
3715,2019,경기,안산시,4127000000,초등학교,2019-04-01,전체,5611,5962,5532,-430,79,-351,-0.072123449,0.01428055,-0.058872861
3716,2019,경기,안산시,4127000000,초등학교,2019-04-01,여자,2796,2989,2733,-256,63,-193,-0.085647374,0.023051592,-0.06457009
3717,2019,경기,안산시,4127000000,초등학교,2019-04-01,남자,2815,2973,2799,-174,16,-158,-0.058526741,0.005716327,-0.053144971
3718,2019,경기,용인시,4146000000,초등학교,2019-04-01,전체,11990,11745,11916,171,74,245,0.014559387,0.006210138,0.02085994
3719,2019,경기,용인시,4146000000,초등학교,2019-04-01,여자,5899,5722,5809,87,90,177,0.015204474,0.0154932,0.03093324
3720,2019,경기,용인시,4146000000,초등학교,2019-04-01,남자,6091,6023,6107,84,-16,68,0.013946538,-0.002619944,0.011290055
3721,2019,경기,군포시,4141000000,초등학교,2019-04-01,전체,2511,2824,2706,-118,-195,-313,-0.041784703,-0.072062084,-0.110835694
3722,2019,경기,군포시,4141000000,초등학교,2019-04-01,여자,1220,1373,1309,-64,-89,-153,-0.046613256,-0.067990833,-0.111434814
3723,2019,경기,군포시,4141000000,초등학교,2019-04-01,남자,1291,1451,1397,-54,-106,-160,-0.037215713,-0.075876879,-0.11026878
3724,2019,경기,의왕시,4143000000,초등학교,2019-04-01,전체,1313,1521,1474,-47,-161,-208,-0.030900723,-0.109226594,-0.136752137
3725,2019,경기,의왕시,4143000000,초등학교,2019-04-01,여자,627,726,703,-23,-76,-99,-0.031680441,-0.108108108,-0.136363636
3726,2019,경기,의왕시,4143000000,초등학교,2019-04-01,남자,686,795,771,-24,-85,-109,-0.030188679,-0.110246433,-0.137106918
3727,2019,경기,시흥시,4139000000,초등학교,2019-04-01,전체,5317,4125,4600,475,717,1192,0.115151515,0.155869565,0.288969697
3728,2019,경기,시흥시,4139000000,초등학교,2019-04-01,여자,2561,1982,2224,242,337,579,0.12209889,0.151528777,0.292129162
3729,2019,경기,시흥시,4139000000,초등학교,2019-04-01,남자,2756,2143,2376,233,380,613,0.108726085,0.15993266,0.286047597
3730,2019,경기,평택시,4122000000,초등학교,2019-04-01,전체,5410,5016,5092,76,318,394,0.015151515,0.062450903,0.078548644
3731,2019,경기,평택시,4122000000,초등학교,2019-04-01,여자,2643,2452,2505,53,138,191,0.021615008,0.05508982,0.077895595
3732,2019,경기,평택시,4122000000,초등학교,2019-04-01,남자,2767,2564,2587,23,180,203,0.008970359,0.069578663,0.079173167
3733,2019,경기,화성시,4159000000,초등학교,2019-04-01,전체,11743,9888,10826,938,917,1855,0.09486246,0.084703492,0.187601133
3734,2019,경기,화성시,4159000000,초등학교,2019-04-01,여자,5822,4792,5283,491,539,1030,0.102462437,0.102025364,0.214941569
3735,2019,경기,화성시,4159000000,초등학교,2019-04-01,남자,5921,5096,5543,447,378,825,0.087715856,0.068194119,0.16189168
3736,2019,경기,오산시,4137000000,초등학교,2019-04-01,전체,2979,3001,3012,11,-33,-22,0.003665445,-0.010956175,-0.00733089
3737,2019,경기,오산시,4137000000,초등학교,2019-04-01,여자,1424,1432,1423,-9,1,-8,-0.006284916,0.000702741,-0.005586592
3738,2019,경기,오산시,4137000000,초등학교,2019-04-01,남자,1555,1569,1589,20,-34,-14,0.012746973,-0.021397105,-0.008922881
3739,2019,경기,광명시,4121000000,초등학교,2019-04-01,전체,3071,3311,3166,-145,-95,-240,-0.043793416,-0.030006317,-0.072485654
3740,2019,경기,광명시,4121000000,초등학교,2019-04-01,여자,1496,1626,1557,-69,-61,-130,-0.042435424,-0.039177906,-0.0799508
3741,2019,경기,광명시,4121000000,초등학교,2019-04-01,남자,1575,1685,1609,-76,-34,-110,-0.045103858,-0.021131137,-0.065281899
3742,2019,경기,광주시,4161000000,초등학교,2019-04-01,전체,3728,3768,3862,94,-134,-40,0.024946921,-0.034697048,-0.010615711
3743,2019,경기,광주시,4161000000,초등학교,2019-04-01,여자,1797,1836,1899,63,-102,-39,0.034313725,-0.05371248,-0.02124183
3744,2019,경기,광주시,4161000000,초등학교,2019-04-01,남자,1931,1932,1963,31,-32,-1,0.016045549,-0.016301579,-0.000517598
3745,2019,경기,하남시,4145000000,초등학교,2019-04-01,전체,3089,2772,3060,288,29,317,0.103896104,0.009477124,0.114357864
3746,2019,경기,하남시,4145000000,초등학교,2019-04-01,여자,1443,1313,1463,150,-20,130,0.114242193,-0.01367054,0.099009901
3747,2019,경기,하남시,4145000000,초등학교,2019-04-01,남자,1646,1459,1597,138,49,187,0.094585332,0.03068253,0.128169979
3748,2019,경기,김포시,4157000000,초등학교,2019-04-01,전체,6010,5175,5649,474,361,835,0.091594203,0.063905116,0.161352657
3749,2019,경기,김포시,4157000000,초등학교,2019-04-01,여자,2987,2570,2807,237,180,417,0.092217899,0.064125401,0.162256809
3750,2019,경기,김포시,4157000000,초등학교,2019-04-01,남자,3023,2605,2842,237,181,418,0.090978887,0.063687544,0.160460653
3751,2019,경기,이천시,4150000000,초등학교,2019-04-01,전체,2291,2315,2326,11,-35,-24,0.00475162,-0.015047291,-0.010367171
3752,2019,경기,이천시,4150000000,초등학교,2019-04-01,여자,1128,1116,1110,-6,18,12,-0.005376344,0.016216216,0.010752688
3753,2019,경기,이천시,4150000000,초등학교,2019-04-01,남자,1163,1199,1216,17,-53,-36,0.014178482,-0.043585526,-0.030025021
3754,2019,경기,안성시,4155000000,초등학교,2019-04-01,전체,1787,1838,1777,-61,10,-51,-0.033188248,0.005627462,-0.027747552
3755,2019,경기,안성시,4155000000,초등학교,2019-04-01,여자,890,874,854,-20,36,16,-0.022883295,0.042154567,0.018306636
3756,2019,경기,안성시,4155000000,초등학교,2019-04-01,남자,897,964,923,-41,-26,-67,-0.04253112,-0.028169014,-0.069502075
3757,2019,경기,여주시,4167000000,초등학교,2019-04-01,전체,868,945,919,-26,-51,-77,-0.027513228,-0.055495103,-0.081481481
3758,2019,경기,여주시,4167000000,초등학교,2019-04-01,여자,411,435,431,-4,-20,-24,-0.009195402,-0.046403712,-0.055172414
3759,2019,경기,여주시,4167000000,초등학교,2019-04-01,남자,457,510,488,-22,-31,-53,-0.043137255,-0.06352459,-0.103921569
3760,2019,경기,양평군,4183000000,초등학교,2019-04-01,전체,840,823,837,14,3,17,0.017010936,0.003584229,0.020656136
3761,2019,경기,양평군,4183000000,초등학교,2019-04-01,여자,402,387,400,13,2,15,0.033591731,0.005,0.03875969
3762,2019,경기,양평군,4183000000,초등학교,2019-04-01,남자,438,436,437,1,1,2,0.002293578,0.00228833,0.004587156
3763,2019,경기,고양시,4128000000,초등학교,2019-04-01,전체,9283,9663,9617,-46,-334,-380,-0.004760426,-0.034730165,-0.039325261
3764,2019,경기,고양시,4128000000,초등학교,2019-04-01,여자,4496,4683,4655,-28,-159,-187,-0.005979073,-0.034156821,-0.039931668
3765,2019,경기,고양시,4128000000,초등학교,2019-04-01,남자,4787,4980,4962,-18,-175,-193,-0.003614458,-0.035268037,-0.03875502
3766,2019,경기,남양주시,4136000000,초등학교,2019-04-01,전체,7734,7518,7746,228,-12,216,0.030327215,-0.001549187,0.028731045
3767,2019,경기,남양주시,4136000000,초등학교,2019-04-01,여자,3787,3683,3824,141,-37,104,0.038284008,-0.009675732,0.02823785
3768,2019,경기,남양주시,4136000000,초등학교,2019-04-01,남자,3947,3835,3922,87,25,112,0.022685789,0.006374299,0.029204694
3769,2019,경기,구리시,4131000000,초등학교,2019-04-01,전체,1806,1890,1961,71,-155,-84,0.037566138,-0.079041305,-0.044444444
3770,2019,경기,구리시,4131000000,초등학교,2019-04-01,여자,877,914,942,28,-65,-37,0.030634573,-0.069002123,-0.0404814
3771,2019,경기,구리시,4131000000,초등학교,2019-04-01,남자,929,976,1019,43,-90,-47,0.044057377,-0.088321884,-0.048155738
3772,2019,경기,의정부시,4115000000,초등학교,2019-04-01,전체,3868,3843,3931,88,-63,25,0.022898777,-0.016026456,0.006505334
3773,2019,경기,의정부시,4115000000,초등학교,2019-04-01,여자,1901,1887,1928,41,-27,14,0.02172761,-0.014004149,0.007419184
3774,2019,경기,의정부시,4115000000,초등학교,2019-04-01,남자,1967,1956,2003,47,-36,11,0.02402863,-0.01797304,0.005623722
3775,2019,경기,파주시,4148000000,초등학교,2019-04-01,전체,5245,5099,5109,10,136,146,0.001961169,0.026619691,0.028633065
3776,2019,경기,파주시,4148000000,초등학교,2019-04-01,여자,2556,2483,2497,14,59,73,0.005638341,0.023628354,0.029399919
3777,2019,경기,파주시,4148000000,초등학교,2019-04-01,남자,2689,2616,2612,-4,77,73,-0.001529052,0.029479326,0.027905199
3778,2019,경기,동두천시,4125000000,초등학교,2019-04-01,전체,803,851,849,-2,-46,-48,-0.002350176,-0.05418139,-0.05640423
3779,2019,경기,동두천시,4125000000,초등학교,2019-04-01,여자,402,433,439,6,-37,-31,0.013856813,-0.08428246,-0.071593533
3780,2019,경기,동두천시,4125000000,초등학교,2019-04-01,남자,401,418,410,-8,-9,-17,-0.019138756,-0.02195122,-0.040669856
3781,2019,경기,양주시,4163000000,초등학교,2019-04-01,전체,2359,2216,2234,18,125,143,0.008122744,0.055953447,0.064530686
3782,2019,경기,양주시,4163000000,초등학교,2019-04-01,여자,1180,1124,1141,17,39,56,0.015124555,0.034180543,0.049822064
3783,2019,경기,양주시,4163000000,초등학교,2019-04-01,남자,1179,1092,1093,1,86,87,0.000915751,0.078682525,0.07967033
3784,2019,경기,포천시,4165000000,초등학교,2019-04-01,전체,1127,1178,1170,-8,-43,-51,-0.006791171,-0.036752137,-0.043293718
3785,2019,경기,포천시,4165000000,초등학교,2019-04-01,여자,574,591,597,6,-23,-17,0.010152284,-0.038525963,-0.028764805
3786,2019,경기,포천시,4165000000,초등학교,2019-04-01,남자,553,587,573,-14,-20,-34,-0.023850085,-0.034904014,-0.057921635
3787,2019,경기,가평군,4182000000,초등학교,2019-04-01,전체,436,413,420,7,16,23,0.016949153,0.038095238,0.055690073
3788,2019,경기,가평군,4182000000,초등학교,2019-04-01,여자,232,205,210,5,22,27,0.024390244,0.104761905,0.131707317
3789,2019,경기,가평군,4182000000,초등학교,2019-04-01,남자,204,208,210,2,-6,-4,0.009615385,-0.028571429,-0.019230769
3790,2019,경기,연천군,4180000000,초등학교,2019-04-01,전체,286,393,364,-29,-78,-107,-0.073791349,-0.214285714,-0.272264631
3791,2019,경기,연천군,4180000000,초등학교,2019-04-01,여자,130,180,162,-18,-32,-50,-0.1,-0.197530864,-0.277777778
3792,2019,경기,연천군,4180000000,초등학교,2019-04-01,남자,156,213,202,-11,-46,-57,-0.051643192,-0.227722772,-0.267605634
3793,2019,강원,춘천시,4211000000,초등학교,2019-04-01,전체,2544,2513,2565,52,-21,31,0.0206924,-0.008187135,0.012335854
3794,2019,강원,춘천시,4211000000,초등학교,2019-04-01,여자,1236,1209,1251,42,-15,27,0.034739454,-0.011990408,0.022332506
3795,2019,강원,춘천시,4211000000,초등학교,2019-04-01,남자,1308,1304,1314,10,-6,4,0.007668712,-0.00456621,0.003067485
3796,2019,강원,원주시,4213000000,초등학교,2019-04-01,전체,3303,3164,3188,24,115,139,0.007585335,0.036072773,0.043931732
3797,2019,강원,원주시,4213000000,초등학교,2019-04-01,여자,1669,1613,1623,10,46,56,0.006199628,0.028342575,0.034717917
3798,2019,강원,원주시,4213000000,초등학교,2019-04-01,남자,1634,1551,1565,14,69,83,0.009026435,0.044089457,0.053513862
3799,2019,강원,강릉시,4215000000,초등학교,2019-04-01,전체,1627,1572,1587,15,40,55,0.009541985,0.025204789,0.034987277
3800,2019,강원,강릉시,4215000000,초등학교,2019-04-01,여자,803,780,785,5,18,23,0.006410256,0.022929936,0.029487179
3801,2019,강원,강릉시,4215000000,초등학교,2019-04-01,남자,824,792,802,10,22,32,0.012626263,0.027431421,0.04040404
3802,2019,강원,동해시,4217000000,초등학교,2019-04-01,전체,861,842,838,-4,23,19,-0.004750594,0.027446301,0.022565321
3803,2019,강원,동해시,4217000000,초등학교,2019-04-01,여자,422,401,404,3,18,21,0.007481297,0.044554455,0.052369077
3804,2019,강원,동해시,4217000000,초등학교,2019-04-01,남자,439,441,434,-7,5,-2,-0.015873016,0.011520737,-0.004535147
3805,2019,강원,태백시,4219000000,초등학교,2019-04-01,전체,360,375,374,-1,-14,-15,-0.002666667,-0.037433155,-0.04
3806,2019,강원,태백시,4219000000,초등학교,2019-04-01,여자,181,195,195,0,-14,-14,0,-0.071794872,-0.071794872
3807,2019,강원,태백시,4219000000,초등학교,2019-04-01,남자,179,180,179,-1,0,-1,-0.005555556,0,-0.005555556
3808,2019,강원,속초시,4221000000,초등학교,2019-04-01,전체,663,667,674,7,-11,-4,0.010494753,-0.016320475,-0.005997001
3809,2019,강원,속초시,4221000000,초등학교,2019-04-01,여자,339,348,343,-5,-4,-9,-0.014367816,-0.011661808,-0.025862069
3810,2019,강원,속초시,4221000000,초등학교,2019-04-01,남자,324,319,331,12,-7,5,0.037617555,-0.021148036,0.015673981
3811,2019,강원,삼척시,4223000000,초등학교,2019-04-01,전체,486,479,480,1,6,7,0.002087683,0.0125,0.014613779
3812,2019,강원,삼척시,4223000000,초등학교,2019-04-01,여자,226,232,230,-2,-4,-6,-0.00862069,-0.017391304,-0.025862069
3813,2019,강원,삼척시,4223000000,초등학교,2019-04-01,남자,260,247,250,3,10,13,0.012145749,0.04,0.052631579
3814,2019,강원,홍천군,4272000000,초등학교,2019-04-01,전체,443,484,462,-22,-19,-41,-0.045454545,-0.041125541,-0.084710744
3815,2019,강원,홍천군,4272000000,초등학교,2019-04-01,여자,223,242,230,-12,-7,-19,-0.049586777,-0.030434783,-0.078512397
3816,2019,강원,홍천군,4272000000,초등학교,2019-04-01,남자,220,242,232,-10,-12,-22,-0.041322314,-0.051724138,-0.090909091
3817,2019,강원,횡성군,4273000000,초등학교,2019-04-01,전체,265,249,255,6,10,16,0.024096386,0.039215686,0.064257028
3818,2019,강원,횡성군,4273000000,초등학교,2019-04-01,여자,133,131,134,3,-1,2,0.022900763,-0.007462687,0.015267176
3819,2019,강원,횡성군,4273000000,초등학교,2019-04-01,남자,132,118,121,3,11,14,0.025423729,0.090909091,0.118644068
3820,2019,강원,영월군,4275000000,초등학교,2019-04-01,전체,198,207,200,-7,-2,-9,-0.033816425,-0.01,-0.043478261
3821,2019,강원,영월군,4275000000,초등학교,2019-04-01,여자,81,94,86,-8,-5,-13,-0.085106383,-0.058139535,-0.138297872
3822,2019,강원,영월군,4275000000,초등학교,2019-04-01,남자,117,113,114,1,3,4,0.008849558,0.026315789,0.03539823
3823,2019,강원,평창군,4276000000,초등학교,2019-04-01,전체,261,252,252,0,9,9,0,0.035714286,0.035714286
3824,2019,강원,평창군,4276000000,초등학교,2019-04-01,여자,129,115,115,0,14,14,0,0.12173913,0.12173913
3825,2019,강원,평창군,4276000000,초등학교,2019-04-01,남자,132,137,137,0,-5,-5,0,-0.03649635,-0.03649635
3826,2019,강원,정선군,4277000000,초등학교,2019-04-01,전체,251,240,244,4,7,11,0.016666667,0.028688525,0.045833333
3827,2019,강원,정선군,4277000000,초등학교,2019-04-01,여자,115,121,120,-1,-5,-6,-0.008264463,-0.041666667,-0.049586777
3828,2019,강원,정선군,4277000000,초등학교,2019-04-01,남자,136,119,124,5,12,17,0.042016807,0.096774194,0.142857143
3829,2019,강원,철원군,4278000000,초등학교,2019-04-01,전체,336,373,364,-9,-28,-37,-0.024128686,-0.076923077,-0.09919571
3830,2019,강원,철원군,4278000000,초등학교,2019-04-01,여자,176,187,188,1,-12,-11,0.005347594,-0.063829787,-0.058823529
3831,2019,강원,철원군,4278000000,초등학교,2019-04-01,남자,160,186,176,-10,-16,-26,-0.053763441,-0.090909091,-0.139784946
3832,2019,강원,화천군,4279000000,초등학교,2019-04-01,전체,191,242,215,-27,-24,-51,-0.111570248,-0.111627907,-0.210743802
3833,2019,강원,화천군,4279000000,초등학교,2019-04-01,여자,104,123,106,-17,-2,-19,-0.138211382,-0.018867925,-0.154471545
3834,2019,강원,화천군,4279000000,초등학교,2019-04-01,남자,87,119,109,-10,-22,-32,-0.084033613,-0.201834862,-0.268907563
3835,2019,강원,양구군,4280000000,초등학교,2019-04-01,전체,195,207,201,-6,-6,-12,-0.028985507,-0.029850746,-0.057971014
3836,2019,강원,양구군,4280000000,초등학교,2019-04-01,여자,98,109,104,-5,-6,-11,-0.04587156,-0.057692308,-0.100917431
3837,2019,강원,양구군,4280000000,초등학교,2019-04-01,남자,97,98,97,-1,0,-1,-0.010204082,0,-0.010204082
3838,2019,강원,인제군,4281000000,초등학교,2019-04-01,전체,274,313,311,-2,-37,-39,-0.006389776,-0.118971061,-0.124600639
3839,2019,강원,인제군,4281000000,초등학교,2019-04-01,여자,134,152,152,0,-18,-18,0,-0.118421053,-0.118421053
3840,2019,강원,인제군,4281000000,초등학교,2019-04-01,남자,140,161,159,-2,-19,-21,-0.01242236,-0.119496855,-0.130434783
3841,2019,강원,고성군,4282000000,초등학교,2019-04-01,전체,155,144,146,2,9,11,0.013888889,0.061643836,0.076388889
3842,2019,강원,고성군,4282000000,초등학교,2019-04-01,여자,77,64,71,7,6,13,0.109375,0.084507042,0.203125
3843,2019,강원,고성군,4282000000,초등학교,2019-04-01,남자,78,80,75,-5,3,-2,-0.0625,0.04,-0.025
3844,2019,강원,양양군,4283000000,초등학교,2019-04-01,전체,154,165,165,0,-11,-11,0,-0.066666667,-0.066666667
3845,2019,강원,양양군,4283000000,초등학교,2019-04-01,여자,71,72,67,-5,4,-1,-0.069444444,0.059701493,-0.013888889
3846,2019,강원,양양군,4283000000,초등학교,2019-04-01,남자,83,93,98,5,-15,-10,0.053763441,-0.153061224,-0.107526882
3847,2019,충북,청주시,4311000000,초등학교,2019-04-01,전체,8854,8922,8782,-140,72,-68,-0.015691549,0.008198588,-0.00762161
3848,2019,충북,청주시,4311000000,초등학교,2019-04-01,여자,4343,4387,4320,-67,23,-44,-0.015272396,0.005324074,-0.010029633
3849,2019,충북,청주시,4311000000,초등학교,2019-04-01,남자,4511,4535,4462,-73,49,-24,-0.016097023,0.010981623,-0.005292172
3850,2019,충북,충주시,4313000000,초등학교,2019-04-01,전체,1682,1675,1713,38,-31,7,0.022686567,-0.018096906,0.004179104
3851,2019,충북,충주시,4313000000,초등학교,2019-04-01,여자,854,829,850,21,4,25,0.025331725,0.004705882,0.030156815
3852,2019,충북,충주시,4313000000,초등학교,2019-04-01,남자,828,846,863,17,-35,-18,0.020094563,-0.040556199,-0.021276596
3853,2019,충북,제천시,4315000000,초등학교,2019-04-01,전체,1078,1015,1037,22,41,63,0.021674877,0.039537126,0.062068966
3854,2019,충북,제천시,4315000000,초등학교,2019-04-01,여자,542,498,505,7,37,44,0.014056225,0.073267327,0.088353414
3855,2019,충북,제천시,4315000000,초등학교,2019-04-01,남자,536,517,532,15,4,19,0.02901354,0.007518797,0.036750484
3856,2019,충북,보은군,4372000000,초등학교,2019-04-01,전체,184,196,193,-3,-9,-12,-0.015306122,-0.046632124,-0.06122449
3857,2019,충북,보은군,4372000000,초등학교,2019-04-01,여자,91,95,94,-1,-3,-4,-0.010526316,-0.031914894,-0.042105263
3858,2019,충북,보은군,4372000000,초등학교,2019-04-01,남자,93,101,99,-2,-6,-8,-0.01980198,-0.060606061,-0.079207921
3859,2019,충북,옥천군,4373000000,초등학교,2019-04-01,전체,334,320,336,16,-2,14,0.05,-0.005952381,0.04375
3860,2019,충북,옥천군,4373000000,초등학교,2019-04-01,여자,171,154,163,9,8,17,0.058441558,0.049079755,0.11038961
3861,2019,충북,옥천군,4373000000,초등학교,2019-04-01,남자,163,166,173,7,-10,-3,0.042168675,-0.057803468,-0.018072289
3862,2019,충북,영동군,4374000000,초등학교,2019-04-01,전체,266,261,259,-2,7,5,-0.007662835,0.027027027,0.019157088
3863,2019,충북,영동군,4374000000,초등학교,2019-04-01,여자,134,137,138,1,-4,-3,0.00729927,-0.028985507,-0.02189781
3864,2019,충북,영동군,4374000000,초등학교,2019-04-01,남자,132,124,121,-3,11,8,-0.024193548,0.090909091,0.064516129
3865,2019,충북,진천군,4375000000,초등학교,2019-04-01,전체,904,718,802,84,102,186,0.116991643,0.127182045,0.259052925
3866,2019,충북,진천군,4375000000,초등학교,2019-04-01,여자,449,351,396,45,53,98,0.128205128,0.133838384,0.279202279
3867,2019,충북,진천군,4375000000,초등학교,2019-04-01,남자,455,367,406,39,49,88,0.10626703,0.120689655,0.239782016
3868,2019,충북,괴산군,4376000000,초등학교,2019-04-01,전체,170,159,153,-6,17,11,-0.037735849,0.111111111,0.06918239
3869,2019,충북,괴산군,4376000000,초등학교,2019-04-01,여자,74,72,67,-5,7,2,-0.069444444,0.104477612,0.027777778
3870,2019,충북,괴산군,4376000000,초등학교,2019-04-01,남자,96,87,86,-1,10,9,-0.011494253,0.11627907,0.103448276
3871,2019,충북,음성군,4377000000,초등학교,2019-04-01,전체,756,857,813,-44,-57,-101,-0.05134189,-0.070110701,-0.117852975
3872,2019,충북,음성군,4377000000,초등학교,2019-04-01,여자,345,394,374,-20,-29,-49,-0.050761421,-0.077540107,-0.124365482
3873,2019,충북,음성군,4377000000,초등학교,2019-04-01,남자,411,463,439,-24,-28,-52,-0.051835853,-0.063781321,-0.112311015
3874,2019,충북,단양군,4380000000,초등학교,2019-04-01,전체,155,152,154,2,1,3,0.013157895,0.006493506,0.019736842
3875,2019,충북,단양군,4380000000,초등학교,2019-04-01,여자,77,68,73,5,4,9,0.073529412,0.054794521,0.132352941
3876,2019,충북,단양군,4380000000,초등학교,2019-04-01,남자,78,84,81,-3,-3,-6,-0.035714286,-0.037037037,-0.071428571
3877,2019,충북,증평군,4374500000,초등학교,2019-04-01,전체,369,427,425,-2,-56,-58,-0.004683841,-0.131764706,-0.135831382
3878,2019,충북,증평군,4374500000,초등학교,2019-04-01,여자,181,198,199,1,-18,-17,0.005050505,-0.090452261,-0.085858586
3879,2019,충북,증평군,4374500000,초등학교,2019-04-01,남자,188,229,226,-3,-38,-41,-0.013100437,-0.168141593,-0.179039301
3880,2019,충남,천안시,4413000000,초등학교,2019-04-01,전체,7491,7086,7215,129,276,405,0.018204911,0.038253638,0.057154953
3881,2019,충남,천안시,4413000000,초등학교,2019-04-01,여자,3740,3582,3633,51,107,158,0.014237856,0.029452243,0.044109436
3882,2019,충남,천안시,4413000000,초등학교,2019-04-01,남자,3751,3504,3582,78,169,247,0.022260274,0.047180346,0.070490868
3883,2019,충남,공주시,4415000000,초등학교,2019-04-01,전체,734,767,752,-15,-18,-33,-0.019556714,-0.02393617,-0.043024772
3884,2019,충남,공주시,4415000000,초등학교,2019-04-01,여자,345,352,339,-13,6,-7,-0.036931818,0.017699115,-0.019886364
3885,2019,충남,공주시,4415000000,초등학교,2019-04-01,남자,389,415,413,-2,-24,-26,-0.004819277,-0.05811138,-0.062650602
3886,2019,충남,보령시,4418000000,초등학교,2019-04-01,전체,726,745,752,7,-26,-19,0.009395973,-0.034574468,-0.025503356
3887,2019,충남,보령시,4418000000,초등학교,2019-04-01,여자,352,352,356,4,-4,0,0.011363636,-0.011235955,0
3888,2019,충남,보령시,4418000000,초등학교,2019-04-01,남자,374,393,396,3,-22,-19,0.007633588,-0.055555556,-0.048346056
3889,2019,충남,아산시,4420000000,초등학교,2019-04-01,전체,4141,4111,4111,0,30,30,0,0.007297495,0.007297495
3890,2019,충남,아산시,4420000000,초등학교,2019-04-01,여자,2030,1954,1967,13,63,76,0.006653019,0.03202847,0.038894575
3891,2019,충남,아산시,4420000000,초등학교,2019-04-01,남자,2111,2157,2144,-13,-33,-46,-0.006026889,-0.015391791,-0.021325916
3892,2019,충남,서산시,4421000000,초등학교,2019-04-01,전체,1834,1807,1794,-13,40,27,-0.007194245,0.022296544,0.014941893
3893,2019,충남,서산시,4421000000,초등학교,2019-04-01,여자,886,884,879,-5,7,2,-0.005656109,0.007963595,0.002262443
3894,2019,충남,서산시,4421000000,초등학교,2019-04-01,남자,948,923,915,-8,33,25,-0.008667389,0.036065574,0.02708559
3895,2019,충남,논산시,4423000000,초등학교,2019-04-01,전체,905,893,896,3,9,12,0.003359462,0.010044643,0.01343785
3896,2019,충남,논산시,4423000000,초등학교,2019-04-01,여자,439,449,451,2,-12,-10,0.004454343,-0.026607539,-0.022271715
3897,2019,충남,논산시,4423000000,초등학교,2019-04-01,남자,466,444,445,1,21,22,0.002252252,0.047191011,0.04954955
3898,2019,충남,계룡시,4425000000,초등학교,2019-04-01,전체,475,507,532,25,-57,-32,0.049309665,-0.107142857,-0.063116371
3899,2019,충남,계룡시,4425000000,초등학교,2019-04-01,여자,245,241,262,21,-17,4,0.087136929,-0.064885496,0.01659751
3900,2019,충남,계룡시,4425000000,초등학교,2019-04-01,남자,230,266,270,4,-40,-36,0.015037594,-0.148148148,-0.135338346
3901,2019,충남,금산군,4471000000,초등학교,2019-04-01,전체,322,335,332,-3,-10,-13,-0.008955224,-0.030120482,-0.03880597
3902,2019,충남,금산군,4471000000,초등학교,2019-04-01,여자,143,148,147,-1,-4,-5,-0.006756757,-0.027210884,-0.033783784
3903,2019,충남,금산군,4471000000,초등학교,2019-04-01,남자,179,187,185,-2,-6,-8,-0.010695187,-0.032432432,-0.042780749
3904,2019,충남,부여군,4476000000,초등학교,2019-04-01,전체,370,377,381,4,-11,-7,0.01061008,-0.028871391,-0.018567639
3905,2019,충남,부여군,4476000000,초등학교,2019-04-01,여자,180,176,175,-1,5,4,-0.005681818,0.028571429,0.022727273
3906,2019,충남,부여군,4476000000,초등학교,2019-04-01,남자,190,201,206,5,-16,-11,0.024875622,-0.077669903,-0.054726368
3907,2019,충남,서천군,4477000000,초등학교,2019-04-01,전체,266,314,309,-5,-43,-48,-0.015923567,-0.139158576,-0.152866242
3908,2019,충남,서천군,4477000000,초등학교,2019-04-01,여자,133,162,159,-3,-26,-29,-0.018518519,-0.163522013,-0.179012346
3909,2019,충남,서천군,4477000000,초등학교,2019-04-01,남자,133,152,150,-2,-17,-19,-0.013157895,-0.113333333,-0.125
3910,2019,충남,청양군,4479000000,초등학교,2019-04-01,전체,159,177,171,-6,-12,-18,-0.033898305,-0.070175439,-0.101694915
3911,2019,충남,청양군,4479000000,초등학교,2019-04-01,여자,79,87,82,-5,-3,-8,-0.057471264,-0.036585366,-0.091954023
3912,2019,충남,청양군,4479000000,초등학교,2019-04-01,남자,80,90,89,-1,-9,-10,-0.011111111,-0.101123596,-0.111111111
3913,2019,충남,홍성군,4480000000,초등학교,2019-04-01,전체,943,933,968,35,-25,10,0.037513398,-0.025826446,0.010718114
3914,2019,충남,홍성군,4480000000,초등학교,2019-04-01,여자,461,453,462,9,-1,8,0.01986755,-0.002164502,0.017660044
3915,2019,충남,홍성군,4480000000,초등학교,2019-04-01,남자,482,480,506,26,-24,2,0.054166667,-0.04743083,0.004166667
3916,2019,충남,예산군,4481000000,초등학교,2019-04-01,전체,486,451,460,9,26,35,0.019955654,0.056521739,0.077605322
3917,2019,충남,예산군,4481000000,초등학교,2019-04-01,여자,221,225,229,4,-8,-4,0.017777778,-0.034934498,-0.017777778
3918,2019,충남,예산군,4481000000,초등학교,2019-04-01,남자,265,226,231,5,34,39,0.022123894,0.147186147,0.172566372
3919,2019,충남,태안군,4482500000,초등학교,2019-04-01,전체,392,400,398,-2,-6,-8,-0.005,-0.015075377,-0.02
3920,2019,충남,태안군,4482500000,초등학교,2019-04-01,여자,206,202,203,1,3,4,0.004950495,0.014778325,0.01980198
3921,2019,충남,태안군,4482500000,초등학교,2019-04-01,남자,186,198,195,-3,-9,-12,-0.015151515,-0.046153846,-0.060606061
3922,2019,충남,당진시,4427000000,초등학교,2019-04-01,전체,1871,1860,1832,-28,39,11,-0.015053763,0.02128821,0.005913978
3923,2019,충남,당진시,4427000000,초등학교,2019-04-01,여자,896,905,905,0,-9,-9,0,-0.009944751,-0.009944751
3924,2019,충남,당진시,4427000000,초등학교,2019-04-01,남자,975,955,927,-28,48,20,-0.029319372,0.051779935,0.020942408
3925,2019,전북,전주시,4511000000,초등학교,2019-04-01,전체,6708,6311,6421,110,287,397,0.017429884,0.044697088,0.062906037
3926,2019,전북,전주시,4511000000,초등학교,2019-04-01,여자,3273,3071,3121,50,152,202,0.016281342,0.048702339,0.06577662
3927,2019,전북,전주시,4511000000,초등학교,2019-04-01,남자,3435,3240,3300,60,135,195,0.018518519,0.040909091,0.060185185
3928,2019,전북,군산시,4513000000,초등학교,2019-04-01,전체,2706,2768,2760,-8,-54,-62,-0.002890173,-0.019565217,-0.022398844
3929,2019,전북,군산시,4513000000,초등학교,2019-04-01,여자,1290,1349,1344,-5,-54,-59,-0.003706449,-0.040178571,-0.043736101
3930,2019,전북,군산시,4513000000,초등학교,2019-04-01,남자,1416,1419,1416,-3,0,-3,-0.002114165,0,-0.002114165
3931,2019,전북,익산시,4514000000,초등학교,2019-04-01,전체,2591,2647,2585,-62,6,-56,-0.023422743,0.002321083,-0.021156026
3932,2019,전북,익산시,4514000000,초등학교,2019-04-01,여자,1269,1279,1263,-16,6,-10,-0.012509773,0.004750594,-0.007818608
3933,2019,전북,익산시,4514000000,초등학교,2019-04-01,남자,1322,1368,1322,-46,0,-46,-0.033625731,0,-0.033625731
3934,2019,전북,정읍시,4518000000,초등학교,2019-04-01,전체,858,807,814,7,44,51,0.008674102,0.054054054,0.063197026
3935,2019,전북,정읍시,4518000000,초등학교,2019-04-01,여자,412,394,402,8,10,18,0.020304569,0.024875622,0.045685279
3936,2019,전북,정읍시,4518000000,초등학교,2019-04-01,남자,446,413,412,-1,34,33,-0.002421308,0.082524272,0.079903148
3937,2019,전북,남원시,4519000000,초등학교,2019-04-01,전체,572,612,608,-4,-36,-40,-0.006535948,-0.059210526,-0.065359477
3938,2019,전북,남원시,4519000000,초등학교,2019-04-01,여자,262,293,286,-7,-24,-31,-0.023890785,-0.083916084,-0.105802048
3939,2019,전북,남원시,4519000000,초등학교,2019-04-01,남자,310,319,322,3,-12,-9,0.009404389,-0.037267081,-0.028213166
3940,2019,전북,김제시,4521000000,초등학교,2019-04-01,전체,607,581,567,-14,40,26,-0.024096386,0.070546737,0.04475043
3941,2019,전북,김제시,4521000000,초등학교,2019-04-01,여자,291,246,238,-8,53,45,-0.032520325,0.222689076,0.182926829
3942,2019,전북,김제시,4521000000,초등학교,2019-04-01,남자,316,335,329,-6,-13,-19,-0.017910448,-0.039513678,-0.056716418
3943,2019,전북,완주군,4571000000,초등학교,2019-04-01,전체,822,1046,994,-52,-172,-224,-0.049713193,-0.173038229,-0.21414914
3944,2019,전북,완주군,4571000000,초등학교,2019-04-01,여자,377,504,474,-30,-97,-127,-0.05952381,-0.20464135,-0.251984127
3945,2019,전북,완주군,4571000000,초등학교,2019-04-01,남자,445,542,520,-22,-75,-97,-0.040590406,-0.144230769,-0.17896679
3946,2019,전북,진안군,4572000000,초등학교,2019-04-01,전체,148,174,170,-4,-22,-26,-0.022988506,-0.129411765,-0.149425287
3947,2019,전북,진안군,4572000000,초등학교,2019-04-01,여자,81,95,92,-3,-11,-14,-0.031578947,-0.119565217,-0.147368421
3948,2019,전북,진안군,4572000000,초등학교,2019-04-01,남자,67,79,78,-1,-11,-12,-0.012658228,-0.141025641,-0.151898734
3949,2019,전북,무주군,4573000000,초등학교,2019-04-01,전체,155,162,162,0,-7,-7,0,-0.043209877,-0.043209877
3950,2019,전북,무주군,4573000000,초등학교,2019-04-01,여자,71,74,77,3,-6,-3,0.040540541,-0.077922078,-0.040540541
3951,2019,전북,무주군,4573000000,초등학교,2019-04-01,남자,84,88,85,-3,-1,-4,-0.034090909,-0.011764706,-0.045454545
3952,2019,전북,장수군,4574000000,초등학교,2019-04-01,전체,150,176,173,-3,-23,-26,-0.017045455,-0.132947977,-0.147727273
3953,2019,전북,장수군,4574000000,초등학교,2019-04-01,여자,74,82,83,1,-9,-8,0.012195122,-0.108433735,-0.097560976
3954,2019,전북,장수군,4574000000,초등학교,2019-04-01,남자,76,94,90,-4,-14,-18,-0.042553191,-0.155555556,-0.191489362
3955,2019,전북,임실군,4575000000,초등학교,2019-04-01,전체,144,178,167,-11,-23,-34,-0.061797753,-0.137724551,-0.191011236
3956,2019,전북,임실군,4575000000,초등학교,2019-04-01,여자,75,85,91,6,-16,-10,0.070588235,-0.175824176,-0.117647059
3957,2019,전북,임실군,4575000000,초등학교,2019-04-01,남자,69,93,76,-17,-7,-24,-0.182795699,-0.092105263,-0.258064516
3958,2019,전북,순창군,4577000000,초등학교,2019-04-01,전체,153,194,195,1,-42,-41,0.005154639,-0.215384615,-0.211340206
3959,2019,전북,순창군,4577000000,초등학교,2019-04-01,여자,66,84,84,0,-18,-18,0,-0.214285714,-0.214285714
3960,2019,전북,순창군,4577000000,초등학교,2019-04-01,남자,87,110,111,1,-24,-23,0.009090909,-0.216216216,-0.209090909
3961,2019,전북,고창군,4579000000,초등학교,2019-04-01,전체,324,331,331,0,-7,-7,0,-0.021148036,-0.021148036
3962,2019,전북,고창군,4579000000,초등학교,2019-04-01,여자,153,157,157,0,-4,-4,0,-0.025477707,-0.025477707
3963,2019,전북,고창군,4579000000,초등학교,2019-04-01,남자,171,174,174,0,-3,-3,0,-0.017241379,-0.017241379
3964,2019,전북,부안군,4580000000,초등학교,2019-04-01,전체,306,331,329,-2,-23,-25,-0.006042296,-0.069908815,-0.075528701
3965,2019,전북,부안군,4580000000,초등학교,2019-04-01,여자,139,154,151,-3,-12,-15,-0.019480519,-0.079470199,-0.097402597
3966,2019,전북,부안군,4580000000,초등학교,2019-04-01,남자,167,177,178,1,-11,-10,0.005649718,-0.061797753,-0.056497175
3967,2019,전남,목포시,4611000000,초등학교,2019-04-01,전체,2762,2492,2514,22,248,270,0.00882825,0.098647574,0.108346709
3968,2019,전남,목포시,4611000000,초등학교,2019-04-01,여자,1373,1224,1220,-4,153,149,-0.003267974,0.125409836,0.121732026
3969,2019,전남,목포시,4611000000,초등학교,2019-04-01,남자,1389,1268,1294,26,95,121,0.020504732,0.073415765,0.095425868
3970,2019,전남,여수시,4613000000,초등학교,2019-04-01,전체,2486,2454,2456,2,30,32,0.000814996,0.012214984,0.013039935
3971,2019,전남,여수시,4613000000,초등학교,2019-04-01,여자,1277,1228,1244,16,33,49,0.013029316,0.026527331,0.03990228
3972,2019,전남,여수시,4613000000,초등학교,2019-04-01,남자,1209,1226,1212,-14,-3,-17,-0.01141925,-0.002475248,-0.013866232
3973,2019,전남,순천시,4615000000,초등학교,2019-04-01,전체,2857,2684,2695,11,162,173,0.004098361,0.060111317,0.064456036
3974,2019,전남,순천시,4615000000,초등학교,2019-04-01,여자,1390,1346,1337,-9,53,44,-0.006686478,0.039640987,0.03268945
3975,2019,전남,순천시,4615000000,초등학교,2019-04-01,남자,1467,1338,1358,20,109,129,0.014947683,0.080265096,0.096412556
3976,2019,전남,나주시,4617000000,초등학교,2019-04-01,전체,1145,1113,1147,34,-2,32,0.030548068,-0.001743679,0.028751123
3977,2019,전남,나주시,4617000000,초등학교,2019-04-01,여자,561,543,560,17,1,18,0.031307551,0.001785714,0.033149171
3978,2019,전남,나주시,4617000000,초등학교,2019-04-01,남자,584,570,587,17,-3,14,0.029824561,-0.005110733,0.024561404
3979,2019,전남,광양시,4623000000,초등학교,2019-04-01,전체,1648,1703,1692,-11,-44,-55,-0.00645919,-0.026004728,-0.032295948
3980,2019,전남,광양시,4623000000,초등학교,2019-04-01,여자,813,827,830,3,-17,-14,0.00362757,-0.020481928,-0.016928658
3981,2019,전남,광양시,4623000000,초등학교,2019-04-01,남자,835,876,862,-14,-27,-41,-0.015981735,-0.031322506,-0.046803653
3982,2019,전남,담양군,4671000000,초등학교,2019-04-01,전체,242,288,276,-12,-34,-46,-0.041666667,-0.123188406,-0.159722222
3983,2019,전남,담양군,4671000000,초등학교,2019-04-01,여자,116,148,147,-1,-31,-32,-0.006756757,-0.210884354,-0.216216216
3984,2019,전남,담양군,4671000000,초등학교,2019-04-01,남자,126,140,129,-11,-3,-14,-0.078571429,-0.023255814,-0.1
3985,2019,전남,곡성군,4672000000,초등학교,2019-04-01,전체,129,148,137,-11,-8,-19,-0.074324324,-0.058394161,-0.128378378
3986,2019,전남,곡성군,4672000000,초등학교,2019-04-01,여자,59,64,60,-4,-1,-5,-0.0625,-0.016666667,-0.078125
3987,2019,전남,곡성군,4672000000,초등학교,2019-04-01,남자,70,84,77,-7,-7,-14,-0.083333333,-0.090909091,-0.166666667
3988,2019,전남,구례군,4673000000,초등학교,2019-04-01,전체,136,165,155,-10,-19,-29,-0.060606061,-0.122580645,-0.175757576
3989,2019,전남,구례군,4673000000,초등학교,2019-04-01,여자,77,87,87,0,-10,-10,0,-0.114942529,-0.114942529
3990,2019,전남,구례군,4673000000,초등학교,2019-04-01,남자,59,78,68,-10,-9,-19,-0.128205128,-0.132352941,-0.243589744
3991,2019,전남,고흥군,4677000000,초등학교,2019-04-01,전체,310,320,319,-1,-9,-10,-0.003125,-0.028213166,-0.03125
3992,2019,전남,고흥군,4677000000,초등학교,2019-04-01,여자,162,164,166,2,-4,-2,0.012195122,-0.024096386,-0.012195122
3993,2019,전남,고흥군,4677000000,초등학교,2019-04-01,남자,148,156,153,-3,-5,-8,-0.019230769,-0.032679739,-0.051282051
3994,2019,전남,보성군,4678000000,초등학교,2019-04-01,전체,200,264,243,-21,-43,-64,-0.079545455,-0.176954733,-0.242424242
3995,2019,전남,보성군,4678000000,초등학교,2019-04-01,여자,90,118,103,-15,-13,-28,-0.127118644,-0.126213592,-0.237288136
3996,2019,전남,보성군,4678000000,초등학교,2019-04-01,남자,110,146,140,-6,-30,-36,-0.04109589,-0.214285714,-0.246575342
3997,2019,전남,화순군,4679000000,초등학교,2019-04-01,전체,450,437,435,-2,15,13,-0.004576659,0.034482759,0.029748284
3998,2019,전남,화순군,4679000000,초등학교,2019-04-01,여자,224,215,208,-7,16,9,-0.03255814,0.076923077,0.041860465
3999,2019,전남,화순군,4679000000,초등학교,2019-04-01,남자,226,222,227,5,-1,4,0.022522523,-0.004405286,0.018018018
4000,2019,전남,장흥군,4680000000,초등학교,2019-04-01,전체,245,248,245,-3,0,-3,-0.012096774,0,-0.012096774
4001,2019,전남,장흥군,4680000000,초등학교,2019-04-01,여자,117,134,131,-3,-14,-17,-0.02238806,-0.106870229,-0.126865672
4002,2019,전남,장흥군,4680000000,초등학교,2019-04-01,남자,128,114,114,0,14,14,0,0.122807018,0.122807018
4003,2019,전남,강진군,4681000000,초등학교,2019-04-01,전체,192,250,228,-22,-36,-58,-0.088,-0.157894737,-0.232
4004,2019,전남,강진군,4681000000,초등학교,2019-04-01,여자,94,117,107,-10,-13,-23,-0.085470085,-0.121495327,-0.196581197
4005,2019,전남,강진군,4681000000,초등학교,2019-04-01,남자,98,133,121,-12,-23,-35,-0.090225564,-0.190082645,-0.263157895
4006,2019,전남,해남군,4682000000,초등학교,2019-04-01,전체,455,528,504,-24,-49,-73,-0.045454545,-0.097222222,-0.138257576
4007,2019,전남,해남군,4682000000,초등학교,2019-04-01,여자,244,282,272,-10,-28,-38,-0.035460993,-0.102941176,-0.134751773
4008,2019,전남,해남군,4682000000,초등학교,2019-04-01,남자,211,246,232,-14,-21,-35,-0.056910569,-0.090517241,-0.142276423
4009,2019,전남,영암군,4683000000,초등학교,2019-04-01,전체,414,491,464,-27,-50,-77,-0.054989817,-0.107758621,-0.156822811
4010,2019,전남,영암군,4683000000,초등학교,2019-04-01,여자,202,236,230,-6,-28,-34,-0.025423729,-0.12173913,-0.144067797
4011,2019,전남,영암군,4683000000,초등학교,2019-04-01,남자,212,255,234,-21,-22,-43,-0.082352941,-0.094017094,-0.168627451
4012,2019,전남,무안군,4684000000,초등학교,2019-04-01,전체,827,906,924,18,-97,-79,0.01986755,-0.104978355,-0.087196468
4013,2019,전남,무안군,4684000000,초등학교,2019-04-01,여자,389,437,458,21,-69,-48,0.04805492,-0.150655022,-0.109839817
4014,2019,전남,무안군,4684000000,초등학교,2019-04-01,남자,438,469,466,-3,-28,-31,-0.006396588,-0.060085837,-0.066098081
4015,2019,전남,함평군,4686000000,초등학교,2019-04-01,전체,162,207,207,0,-45,-45,0,-0.217391304,-0.217391304
4016,2019,전남,함평군,4686000000,초등학교,2019-04-01,여자,75,90,89,-1,-14,-15,-0.011111111,-0.157303371,-0.166666667
4017,2019,전남,함평군,4686000000,초등학교,2019-04-01,남자,87,117,118,1,-31,-30,0.008547009,-0.262711864,-0.256410256
4018,2019,전남,영광군,4687000000,초등학교,2019-04-01,전체,375,435,420,-15,-45,-60,-0.034482759,-0.107142857,-0.137931034
4019,2019,전남,영광군,4687000000,초등학교,2019-04-01,여자,182,219,210,-9,-28,-37,-0.04109589,-0.133333333,-0.168949772
4020,2019,전남,영광군,4687000000,초등학교,2019-04-01,남자,193,216,210,-6,-17,-23,-0.027777778,-0.080952381,-0.106481481
4021,2019,전남,장성군,4688000000,초등학교,2019-04-01,전체,322,329,319,-10,3,-7,-0.030395137,0.009404389,-0.021276596
4022,2019,전남,장성군,4688000000,초등학교,2019-04-01,여자,165,172,165,-7,0,-7,-0.040697674,0,-0.040697674
4023,2019,전남,장성군,4688000000,초등학교,2019-04-01,남자,157,157,154,-3,3,0,-0.01910828,0.019480519,0
4024,2019,전남,완도군,4689000000,초등학교,2019-04-01,전체,387,394,388,-6,-1,-7,-0.015228426,-0.00257732,-0.017766497
4025,2019,전남,완도군,4689000000,초등학교,2019-04-01,여자,196,196,192,-4,4,0,-0.020408163,0.020833333,0
4026,2019,전남,완도군,4689000000,초등학교,2019-04-01,남자,191,198,196,-2,-5,-7,-0.01010101,-0.025510204,-0.035353535
4027,2019,전남,진도군,4690000000,초등학교,2019-04-01,전체,199,227,227,0,-28,-28,0,-0.123348018,-0.123348018
4028,2019,전남,진도군,4690000000,초등학교,2019-04-01,여자,94,100,99,-1,-5,-6,-0.01,-0.050505051,-0.06
4029,2019,전남,진도군,4690000000,초등학교,2019-04-01,남자,105,127,128,1,-23,-22,0.007874016,-0.1796875,-0.173228346
4030,2019,전남,신안군,4691000000,초등학교,2019-04-01,전체,177,239,228,-11,-51,-62,-0.046025105,-0.223684211,-0.259414226
4031,2019,전남,신안군,4691000000,초등학교,2019-04-01,여자,90,127,115,-12,-25,-37,-0.094488189,-0.217391304,-0.291338583
4032,2019,전남,신안군,4691000000,초등학교,2019-04-01,남자,87,112,113,1,-26,-25,0.008928571,-0.230088496,-0.223214286
4033,2019,경북,포항시,4711000000,초등학교,2019-04-01,전체,4866,4917,4898,-19,-32,-51,-0.003864145,-0.006533279,-0.010372178
4034,2019,경북,포항시,4711000000,초등학교,2019-04-01,여자,2307,2322,2323,1,-16,-15,0.000430663,-0.006887645,-0.006459948
4035,2019,경북,포항시,4711000000,초등학교,2019-04-01,남자,2559,2595,2575,-20,-16,-36,-0.007707129,-0.006213592,-0.013872832
4036,2019,경북,경주시,4713000000,초등학교,2019-04-01,전체,1984,1905,1911,6,73,79,0.003149606,0.038199895,0.041469816
4037,2019,경북,경주시,4713000000,초등학교,2019-04-01,여자,974,934,945,11,29,40,0.011777302,0.030687831,0.042826552
4038,2019,경북,경주시,4713000000,초등학교,2019-04-01,남자,1010,971,966,-5,44,39,-0.005149331,0.045548654,0.040164779
4039,2019,경북,김천시,4715000000,초등학교,2019-04-01,전체,1228,1247,1237,-10,-9,-19,-0.008019246,-0.007275667,-0.015236568
4040,2019,경북,김천시,4715000000,초등학교,2019-04-01,여자,598,612,604,-8,-6,-14,-0.013071895,-0.009933775,-0.022875817
4041,2019,경북,김천시,4715000000,초등학교,2019-04-01,남자,630,635,633,-2,-3,-5,-0.003149606,-0.004739336,-0.007874016
4042,2019,경북,안동시,4717000000,초등학교,2019-04-01,전체,1424,1431,1347,-84,77,-7,-0.05870021,0.057164068,-0.004891684
4043,2019,경북,안동시,4717000000,초등학교,2019-04-01,여자,665,659,627,-32,38,6,-0.048558422,0.060606061,0.009104704
4044,2019,경북,안동시,4717000000,초등학교,2019-04-01,남자,759,772,720,-52,39,-13,-0.067357513,0.054166667,-0.016839378
4045,2019,경북,구미시,4719000000,초등학교,2019-04-01,전체,5161,4942,4991,49,170,219,0.009915014,0.03406131,0.044314043
4046,2019,경북,구미시,4719000000,초등학교,2019-04-01,여자,2501,2373,2397,24,104,128,0.01011378,0.043387568,0.05394016
4047,2019,경북,구미시,4719000000,초등학교,2019-04-01,남자,2660,2569,2594,25,66,91,0.009731413,0.025443331,0.035422343
4048,2019,경북,영주시,4721000000,초등학교,2019-04-01,전체,845,800,802,2,43,45,0.0025,0.05361596,0.05625
4049,2019,경북,영주시,4721000000,초등학교,2019-04-01,여자,400,384,384,0,16,16,0,0.041666667,0.041666667
4050,2019,경북,영주시,4721000000,초등학교,2019-04-01,남자,445,416,418,2,27,29,0.004807692,0.064593301,0.069711538
4051,2019,경북,영천시,4723000000,초등학교,2019-04-01,전체,610,644,641,-3,-31,-34,-0.004658385,-0.048361934,-0.052795031
4052,2019,경북,영천시,4723000000,초등학교,2019-04-01,여자,319,339,333,-6,-14,-20,-0.017699115,-0.042042042,-0.05899705
4053,2019,경북,영천시,4723000000,초등학교,2019-04-01,남자,291,305,308,3,-17,-14,0.009836066,-0.055194805,-0.045901639
4054,2019,경북,상주시,4725000000,초등학교,2019-04-01,전체,606,628,630,2,-24,-22,0.003184713,-0.038095238,-0.035031847
4055,2019,경북,상주시,4725000000,초등학교,2019-04-01,여자,286,294,294,0,-8,-8,0,-0.027210884,-0.027210884
4056,2019,경북,상주시,4725000000,초등학교,2019-04-01,남자,320,334,336,2,-16,-14,0.005988024,-0.047619048,-0.041916168
4057,2019,경북,문경시,4728000000,초등학교,2019-04-01,전체,486,533,510,-23,-24,-47,-0.04315197,-0.047058824,-0.088180113
4058,2019,경북,문경시,4728000000,초등학교,2019-04-01,여자,230,247,237,-10,-7,-17,-0.04048583,-0.029535865,-0.068825911
4059,2019,경북,문경시,4728000000,초등학교,2019-04-01,남자,256,286,273,-13,-17,-30,-0.045454545,-0.062271062,-0.104895105
4060,2019,경북,경산시,4729000000,초등학교,2019-04-01,전체,2437,2462,2455,-7,-18,-25,-0.002843217,-0.007331976,-0.010154346
4061,2019,경북,경산시,4729000000,초등학교,2019-04-01,여자,1196,1230,1217,-13,-21,-34,-0.010569106,-0.017255546,-0.027642276
4062,2019,경북,경산시,4729000000,초등학교,2019-04-01,남자,1241,1232,1238,6,3,9,0.00487013,0.002423263,0.007305195
4063,2019,경북,군위군,4772000000,초등학교,2019-04-01,전체,87,93,91,-2,-4,-6,-0.021505376,-0.043956044,-0.064516129
4064,2019,경북,군위군,4772000000,초등학교,2019-04-01,여자,37,43,40,-3,-3,-6,-0.069767442,-0.075,-0.139534884
4065,2019,경북,군위군,4772000000,초등학교,2019-04-01,남자,50,50,51,1,-1,0,0.02,-0.019607843,0
4066,2019,경북,의성군,4773000000,초등학교,2019-04-01,전체,177,189,182,-7,-5,-12,-0.037037037,-0.027472527,-0.063492063
4067,2019,경북,의성군,4773000000,초등학교,2019-04-01,여자,87,98,93,-5,-6,-11,-0.051020408,-0.064516129,-0.112244898
4068,2019,경북,의성군,4773000000,초등학교,2019-04-01,남자,90,91,89,-2,1,-1,-0.021978022,0.011235955,-0.010989011
4069,2019,경북,청송군,4775000000,초등학교,2019-04-01,전체,115,133,131,-2,-16,-18,-0.015037594,-0.122137405,-0.135338346
4070,2019,경북,청송군,4775000000,초등학교,2019-04-01,여자,56,64,61,-3,-5,-8,-0.046875,-0.081967213,-0.125
4071,2019,경북,청송군,4775000000,초등학교,2019-04-01,남자,59,69,70,1,-11,-10,0.014492754,-0.157142857,-0.144927536
4072,2019,경북,영양군,4776000000,초등학교,2019-04-01,전체,70,89,83,-6,-13,-19,-0.06741573,-0.156626506,-0.213483146
4073,2019,경북,영양군,4776000000,초등학교,2019-04-01,여자,28,41,39,-2,-11,-13,-0.048780488,-0.282051282,-0.317073171
4074,2019,경북,영양군,4776000000,초등학교,2019-04-01,남자,42,48,44,-4,-2,-6,-0.083333333,-0.045454545,-0.125
4075,2019,경북,영덕군,4777000000,초등학교,2019-04-01,전체,174,205,210,5,-36,-31,0.024390244,-0.171428571,-0.151219512
4076,2019,경북,영덕군,4777000000,초등학교,2019-04-01,여자,87,98,99,1,-12,-11,0.010204082,-0.121212121,-0.112244898
4077,2019,경북,영덕군,4777000000,초등학교,2019-04-01,남자,87,107,111,4,-24,-20,0.037383178,-0.216216216,-0.186915888
4078,2019,경북,청도군,4782000000,초등학교,2019-04-01,전체,183,190,185,-5,-2,-7,-0.026315789,-0.010810811,-0.036842105
4079,2019,경북,청도군,4782000000,초등학교,2019-04-01,여자,85,84,83,-1,2,1,-0.011904762,0.024096386,0.011904762
4080,2019,경북,청도군,4782000000,초등학교,2019-04-01,남자,98,106,102,-4,-4,-8,-0.037735849,-0.039215686,-0.075471698
4081,2019,경북,고령군,4783000000,초등학교,2019-04-01,전체,188,227,211,-16,-23,-39,-0.070484581,-0.109004739,-0.171806167
4082,2019,경북,고령군,4783000000,초등학교,2019-04-01,여자,88,123,114,-9,-26,-35,-0.073170732,-0.228070175,-0.284552846
4083,2019,경북,고령군,4783000000,초등학교,2019-04-01,남자,100,104,97,-7,3,-4,-0.067307692,0.030927835,-0.038461538
4084,2019,경북,성주군,4784000000,초등학교,2019-04-01,전체,193,250,227,-23,-34,-57,-0.092,-0.149779736,-0.228
4085,2019,경북,성주군,4784000000,초등학교,2019-04-01,여자,99,126,109,-17,-10,-27,-0.134920635,-0.091743119,-0.214285714
4086,2019,경북,성주군,4784000000,초등학교,2019-04-01,남자,94,124,118,-6,-24,-30,-0.048387097,-0.203389831,-0.241935484
4087,2019,경북,칠곡군,4785000000,초등학교,2019-04-01,전체,1244,1354,1311,-43,-67,-110,-0.031757755,-0.051106026,-0.081240768
4088,2019,경북,칠곡군,4785000000,초등학교,2019-04-01,여자,595,662,646,-16,-51,-67,-0.024169184,-0.078947368,-0.101208459
4089,2019,경북,칠곡군,4785000000,초등학교,2019-04-01,남자,649,692,665,-27,-16,-43,-0.039017341,-0.02406015,-0.062138728
4090,2019,경북,예천군,4790000000,초등학교,2019-04-01,전체,367,306,435,129,-68,61,0.421568627,-0.156321839,0.199346405
4091,2019,경북,예천군,4790000000,초등학교,2019-04-01,여자,157,136,206,70,-49,21,0.514705882,-0.237864078,0.154411765
4092,2019,경북,예천군,4790000000,초등학교,2019-04-01,남자,210,170,229,59,-19,40,0.347058824,-0.082969432,0.235294118
4093,2019,경북,봉화군,4792000000,초등학교,2019-04-01,전체,141,196,187,-9,-46,-55,-0.045918367,-0.245989305,-0.280612245
4094,2019,경북,봉화군,4792000000,초등학교,2019-04-01,여자,63,90,86,-4,-23,-27,-0.044444444,-0.26744186,-0.3
4095,2019,경북,봉화군,4792000000,초등학교,2019-04-01,남자,78,106,101,-5,-23,-28,-0.047169811,-0.227722772,-0.264150943
4096,2019,경북,울진군,4793000000,초등학교,2019-04-01,전체,330,356,350,-6,-20,-26,-0.016853933,-0.057142857,-0.073033708
4097,2019,경북,울진군,4793000000,초등학교,2019-04-01,여자,145,159,158,-1,-13,-14,-0.006289308,-0.082278481,-0.088050314
4098,2019,경북,울진군,4793000000,초등학교,2019-04-01,남자,185,197,192,-5,-7,-12,-0.025380711,-0.036458333,-0.060913706
4099,2019,경북,울릉군,4794000000,초등학교,2019-04-01,전체,50,56,56,0,-6,-6,0,-0.107142857,-0.107142857
4100,2019,경북,울릉군,4794000000,초등학교,2019-04-01,여자,30,32,34,2,-4,-2,0.0625,-0.117647059,-0.0625
4101,2019,경북,울릉군,4794000000,초등학교,2019-04-01,남자,20,24,22,-2,-2,-4,-0.083333333,-0.090909091,-0.166666667
4102,2019,경남,진주시,4817000000,초등학교,2019-04-01,전체,3444,3279,3304,25,140,165,0.007624276,0.042372881,0.05032022
4103,2019,경남,진주시,4817000000,초등학교,2019-04-01,여자,1653,1582,1581,-1,72,71,-0.000632111,0.045540797,0.044879899
4104,2019,경남,진주시,4817000000,초등학교,2019-04-01,남자,1791,1697,1723,26,68,94,0.015321155,0.039466048,0.055391868
4105,2019,경남,통영시,4822000000,초등학교,2019-04-01,전체,1427,1443,1385,-58,42,-16,-0.04019404,0.03032491,-0.011088011
4106,2019,경남,통영시,4822000000,초등학교,2019-04-01,여자,685,697,668,-29,17,-12,-0.041606887,0.025449102,-0.017216643
4107,2019,경남,통영시,4822000000,초등학교,2019-04-01,남자,742,746,717,-29,25,-4,-0.038873995,0.034867503,-0.00536193
4108,2019,경남,사천시,4824000000,초등학교,2019-04-01,전체,1068,1071,1053,-18,15,-3,-0.016806723,0.014245014,-0.00280112
4109,2019,경남,사천시,4824000000,초등학교,2019-04-01,여자,517,489,487,-2,30,28,-0.00408998,0.061601643,0.057259714
4110,2019,경남,사천시,4824000000,초등학교,2019-04-01,남자,551,582,566,-16,-15,-31,-0.027491409,-0.026501767,-0.053264605
4111,2019,경남,김해시,4825000000,초등학교,2019-04-01,전체,6171,5883,5899,16,272,288,0.002719701,0.04610951,0.048954615
4112,2019,경남,김해시,4825000000,초등학교,2019-04-01,여자,3100,2964,2961,-3,139,136,-0.001012146,0.0469436,0.045883941
4113,2019,경남,김해시,4825000000,초등학교,2019-04-01,남자,3071,2919,2938,19,133,152,0.006509078,0.04526889,0.052072628
4114,2019,경남,밀양시,4827000000,초등학교,2019-04-01,전체,673,707,702,-5,-29,-34,-0.007072136,-0.041310541,-0.048090523
4115,2019,경남,밀양시,4827000000,초등학교,2019-04-01,여자,314,340,341,1,-27,-26,0.002941176,-0.079178886,-0.076470588
4116,2019,경남,밀양시,4827000000,초등학교,2019-04-01,남자,359,367,361,-6,-2,-8,-0.016348774,-0.005540166,-0.021798365
4117,2019,경남,거제시,4831000000,초등학교,2019-04-01,전체,3412,3573,3483,-90,-71,-161,-0.025188917,-0.020384726,-0.045060174
4118,2019,경남,거제시,4831000000,초등학교,2019-04-01,여자,1621,1680,1627,-53,-6,-59,-0.031547619,-0.003687769,-0.035119048
4119,2019,경남,거제시,4831000000,초등학교,2019-04-01,남자,1791,1893,1856,-37,-65,-102,-0.019545695,-0.035021552,-0.053882726
4120,2019,경남,양산시,4833000000,초등학교,2019-04-01,전체,4026,3653,3922,269,104,373,0.073638106,0.026517083,0.102107857
4121,2019,경남,양산시,4833000000,초등학교,2019-04-01,여자,1938,1819,1969,150,-31,119,0.082462892,-0.015744033,0.065420561
4122,2019,경남,양산시,4833000000,초등학교,2019-04-01,남자,2088,1834,1953,119,135,254,0.064885496,0.069124424,0.138495093
4123,2019,경남,의령군,4872000000,초등학교,2019-04-01,전체,129,167,156,-11,-27,-38,-0.065868263,-0.173076923,-0.22754491
4124,2019,경남,의령군,4872000000,초등학교,2019-04-01,여자,50,75,69,-6,-19,-25,-0.08,-0.275362319,-0.333333333
4125,2019,경남,의령군,4872000000,초등학교,2019-04-01,남자,79,92,87,-5,-8,-13,-0.054347826,-0.091954023,-0.141304348
4126,2019,경남,함안군,4873000000,초등학교,2019-04-01,전체,592,594,585,-9,7,-2,-0.015151515,0.011965812,-0.003367003
4127,2019,경남,함안군,4873000000,초등학교,2019-04-01,여자,288,282,271,-11,17,6,-0.039007092,0.062730627,0.021276596
4128,2019,경남,함안군,4873000000,초등학교,2019-04-01,남자,304,312,314,2,-10,-8,0.006410256,-0.031847134,-0.025641026
4129,2019,경남,창녕군,4874000000,초등학교,2019-04-01,전체,392,394,403,9,-11,-2,0.02284264,-0.027295285,-0.005076142
4130,2019,경남,창녕군,4874000000,초등학교,2019-04-01,여자,206,190,198,8,8,16,0.042105263,0.04040404,0.084210526
4131,2019,경남,창녕군,4874000000,초등학교,2019-04-01,남자,186,204,205,1,-19,-18,0.004901961,-0.092682927,-0.088235294
4132,2019,경남,고성군,4882000000,초등학교,2019-04-01,전체,382,419,403,-16,-21,-37,-0.038186158,-0.052109181,-0.088305489
4133,2019,경남,고성군,4882000000,초등학교,2019-04-01,여자,185,216,202,-14,-17,-31,-0.064814815,-0.084158416,-0.143518519
4134,2019,경남,고성군,4882000000,초등학교,2019-04-01,남자,197,203,201,-2,-4,-6,-0.009852217,-0.019900498,-0.02955665
4135,2019,경남,남해군,4884000000,초등학교,2019-04-01,전체,183,187,196,9,-13,-4,0.048128342,-0.066326531,-0.021390374
4136,2019,경남,남해군,4884000000,초등학교,2019-04-01,여자,92,91,99,8,-7,1,0.087912088,-0.070707071,0.010989011
4137,2019,경남,남해군,4884000000,초등학교,2019-04-01,남자,91,96,97,1,-6,-5,0.010416667,-0.06185567,-0.052083333
4138,2019,경남,하동군,4885000000,초등학교,2019-04-01,전체,214,242,234,-8,-20,-28,-0.033057851,-0.085470085,-0.115702479
4139,2019,경남,하동군,4885000000,초등학교,2019-04-01,여자,101,111,106,-5,-5,-10,-0.045045045,-0.047169811,-0.09009009
4140,2019,경남,하동군,4885000000,초등학교,2019-04-01,남자,113,131,128,-3,-15,-18,-0.022900763,-0.1171875,-0.13740458
4141,2019,경남,산청군,4886000000,초등학교,2019-04-01,전체,159,188,183,-5,-24,-29,-0.026595745,-0.131147541,-0.154255319
4142,2019,경남,산청군,4886000000,초등학교,2019-04-01,여자,69,96,92,-4,-23,-27,-0.041666667,-0.25,-0.28125
4143,2019,경남,산청군,4886000000,초등학교,2019-04-01,남자,90,92,91,-1,-1,-2,-0.010869565,-0.010989011,-0.02173913
4144,2019,경남,함양군,4887000000,초등학교,2019-04-01,전체,222,229,232,3,-10,-7,0.013100437,-0.043103448,-0.030567686
4145,2019,경남,함양군,4887000000,초등학교,2019-04-01,여자,90,91,92,1,-2,-1,0.010989011,-0.02173913,-0.010989011
4146,2019,경남,함양군,4887000000,초등학교,2019-04-01,남자,132,138,140,2,-8,-6,0.014492754,-0.057142857,-0.043478261
4147,2019,경남,거창군,4888000000,초등학교,2019-04-01,전체,482,444,450,6,32,38,0.013513514,0.071111111,0.085585586
4148,2019,경남,거창군,4888000000,초등학교,2019-04-01,여자,227,218,219,1,8,9,0.004587156,0.03652968,0.041284404
4149,2019,경남,거창군,4888000000,초등학교,2019-04-01,남자,255,226,231,5,24,29,0.022123894,0.103896104,0.128318584
4150,2019,경남,합천군,4889000000,초등학교,2019-04-01,전체,177,226,220,-6,-43,-49,-0.026548673,-0.195454545,-0.216814159
4151,2019,경남,합천군,4889000000,초등학교,2019-04-01,여자,80,103,104,1,-24,-23,0.009708738,-0.230769231,-0.223300971
4152,2019,경남,합천군,4889000000,초등학교,2019-04-01,남자,97,123,116,-7,-19,-26,-0.056910569,-0.163793103,-0.211382114
4153,2019,제주,제주시,5011000000,초등학교,2019-04-01,전체,5533,5130,5311,181,222,403,0.035282651,0.041800038,0.078557505
4154,2019,제주,제주시,5011000000,초등학교,2019-04-01,여자,2712,2548,2645,97,67,164,0.038069074,0.025330813,0.064364207
4155,2019,제주,제주시,5011000000,초등학교,2019-04-01,남자,2821,2582,2666,84,155,239,0.03253292,0.058139535,0.092563904
4156,2019,제주,서귀포시,5013000000,초등학교,2019-04-01,전체,1624,1561,1673,112,-49,63,0.071748879,-0.029288703,0.040358744
4157,2019,제주,서귀포시,5013000000,초등학교,2019-04-01,여자,796,769,818,49,-22,27,0.063719116,-0.026894866,0.035110533
4158,2019,제주,서귀포시,5013000000,초등학교,2019-04-01,남자,828,792,855,63,-27,36,0.079545455,-0.031578947,0.045454545
4159,2020,서울,종로구,1111000000,초등학교,2020-04-01,전체,764,871,862,-9,-98,-107,-0.010332951,-0.113689095,-0.122847302
4160,2020,서울,종로구,1111000000,초등학교,2020-04-01,여자,383,428,439,11,-56,-45,0.025700935,-0.127562642,-0.105140187
4161,2020,서울,종로구,1111000000,초등학교,2020-04-01,남자,381,443,423,-20,-42,-62,-0.045146727,-0.09929078,-0.139954853
4162,2020,서울,중구,1114000000,초등학교,2020-04-01,전체,907,822,789,-33,118,85,-0.040145985,0.149556401,0.103406326
4163,2020,서울,중구,1114000000,초등학교,2020-04-01,여자,452,408,383,-25,69,44,-0.06127451,0.180156658,0.107843137
4164,2020,서울,중구,1114000000,초등학교,2020-04-01,남자,455,414,406,-8,49,41,-0.019323671,0.120689655,0.099033816
4165,2020,서울,용산구,1117000000,초등학교,2020-04-01,전체,1090,1502,1456,-46,-366,-412,-0.030625832,-0.251373626,-0.274300932
4166,2020,서울,용산구,1117000000,초등학교,2020-04-01,여자,537,744,724,-20,-187,-207,-0.02688172,-0.258287293,-0.278225806
4167,2020,서울,용산구,1117000000,초등학교,2020-04-01,남자,553,758,732,-26,-179,-205,-0.034300792,-0.244535519,-0.270448549
4168,2020,서울,성동구,1120000000,초등학교,2020-04-01,전체,1891,2409,2276,-133,-385,-518,-0.055209631,-0.169156415,-0.215026982
4169,2020,서울,성동구,1120000000,초등학교,2020-04-01,여자,904,1184,1126,-58,-222,-280,-0.048986486,-0.197158082,-0.236486486
4170,2020,서울,성동구,1120000000,초등학교,2020-04-01,남자,987,1225,1150,-75,-163,-238,-0.06122449,-0.14173913,-0.194285714
4171,2020,서울,광진구,1121500000,초등학교,2020-04-01,전체,2244,2308,2273,-35,-29,-64,-0.015164645,-0.012758469,-0.027729636
4172,2020,서울,광진구,1121500000,초등학교,2020-04-01,여자,1120,1085,1068,-17,52,35,-0.015668203,0.048689139,0.032258065
4173,2020,서울,광진구,1121500000,초등학교,2020-04-01,남자,1124,1223,1205,-18,-81,-99,-0.014717907,-0.067219917,-0.080948487
4174,2020,서울,동대문구,1123000000,초등학교,2020-04-01,전체,2136,2266,2263,-3,-127,-130,-0.001323919,-0.056120194,-0.057369815
4175,2020,서울,동대문구,1123000000,초등학교,2020-04-01,여자,1019,1103,1111,8,-92,-84,0.007252947,-0.082808281,-0.076155938
4176,2020,서울,동대문구,1123000000,초등학교,2020-04-01,남자,1117,1163,1152,-11,-35,-46,-0.009458298,-0.030381944,-0.03955288
4177,2020,서울,중랑구,1126000000,초등학교,2020-04-01,전체,2369,2834,2695,-139,-326,-465,-0.049047283,-0.12096475,-0.16407904
4178,2020,서울,중랑구,1126000000,초등학교,2020-04-01,여자,1151,1375,1302,-73,-151,-224,-0.053090909,-0.115975422,-0.162909091
4179,2020,서울,중랑구,1126000000,초등학교,2020-04-01,남자,1218,1459,1393,-66,-175,-241,-0.045236463,-0.125628141,-0.165181631
4180,2020,서울,성북구,1129000000,초등학교,2020-04-01,전체,3137,3269,3215,-54,-78,-132,-0.016518813,-0.024261275,-0.040379321
4181,2020,서울,성북구,1129000000,초등학교,2020-04-01,여자,1579,1598,1579,-19,0,-19,-0.011889862,0,-0.011889862
4182,2020,서울,성북구,1129000000,초등학교,2020-04-01,남자,1558,1671,1636,-35,-78,-113,-0.020945542,-0.047677262,-0.067624177
4183,2020,서울,강북구,1130500000,초등학교,2020-04-01,전체,1528,1979,1869,-110,-341,-451,-0.055583628,-0.182450508,-0.227892875
4184,2020,서울,강북구,1130500000,초등학교,2020-04-01,여자,718,969,916,-53,-198,-251,-0.054695562,-0.216157205,-0.259029928
4185,2020,서울,강북구,1130500000,초등학교,2020-04-01,남자,810,1010,953,-57,-143,-200,-0.056435644,-0.150052466,-0.198019802
4186,2020,서울,도봉구,1132000000,초등학교,2020-04-01,전체,2214,2233,2144,-89,70,-19,-0.039856695,0.032649254,-0.008508733
4187,2020,서울,도봉구,1132000000,초등학교,2020-04-01,여자,1077,1078,1043,-35,34,-1,-0.032467532,0.032598274,-0.000927644
4188,2020,서울,도봉구,1132000000,초등학교,2020-04-01,남자,1137,1155,1101,-54,36,-18,-0.046753247,0.032697548,-0.015584416
4189,2020,서울,노원구,1135000000,초등학교,2020-04-01,전체,3821,3790,3653,-137,168,31,-0.036147757,0.045989598,0.00817942
4190,2020,서울,노원구,1135000000,초등학교,2020-04-01,여자,1842,1844,1754,-90,88,-2,-0.048806941,0.050171038,-0.001084599
4191,2020,서울,노원구,1135000000,초등학교,2020-04-01,남자,1979,1946,1899,-47,80,33,-0.024152107,0.042127435,0.016957862
4192,2020,서울,은평구,1138000000,초등학교,2020-04-01,전체,3150,3315,3246,-69,-96,-165,-0.02081448,-0.029574861,-0.049773756
4193,2020,서울,은평구,1138000000,초등학교,2020-04-01,여자,1500,1555,1529,-26,-29,-55,-0.016720257,-0.018966645,-0.035369775
4194,2020,서울,은평구,1138000000,초등학교,2020-04-01,남자,1650,1760,1717,-43,-67,-110,-0.024431818,-0.039021549,-0.0625
4195,2020,서울,서대문구,1141000000,초등학교,2020-04-01,전체,2179,2206,2188,-18,-9,-27,-0.008159565,-0.004113346,-0.012239347
4196,2020,서울,서대문구,1141000000,초등학교,2020-04-01,여자,1075,1097,1082,-15,-7,-22,-0.013673655,-0.006469501,-0.020054695
4197,2020,서울,서대문구,1141000000,초등학교,2020-04-01,남자,1104,1109,1106,-3,-2,-5,-0.00270514,-0.001808318,-0.004508566
4198,2020,서울,마포구,1144000000,초등학교,2020-04-01,전체,2211,2727,2675,-52,-464,-516,-0.019068574,-0.173457944,-0.189218922
4199,2020,서울,마포구,1144000000,초등학교,2020-04-01,여자,1119,1393,1367,-26,-248,-274,-0.018664752,-0.181419166,-0.196697775
4200,2020,서울,마포구,1144000000,초등학교,2020-04-01,남자,1092,1334,1308,-26,-216,-242,-0.019490255,-0.165137615,-0.181409295
4201,2020,서울,양천구,1147000000,초등학교,2020-04-01,전체,3575,3471,3512,41,63,104,0.011812158,0.017938497,0.029962547
4202,2020,서울,양천구,1147000000,초등학교,2020-04-01,여자,1725,1686,1710,24,15,39,0.014234875,0.00877193,0.023131673
4203,2020,서울,양천구,1147000000,초등학교,2020-04-01,남자,1850,1785,1802,17,48,65,0.00952381,0.02663707,0.036414566
4204,2020,서울,강서구,1150000000,초등학교,2020-04-01,전체,4277,5076,4835,-241,-558,-799,-0.047478329,-0.11540848,-0.157407407
4205,2020,서울,강서구,1150000000,초등학교,2020-04-01,여자,2097,2486,2349,-137,-252,-389,-0.055108608,-0.107279693,-0.156476267
4206,2020,서울,강서구,1150000000,초등학교,2020-04-01,남자,2180,2590,2486,-104,-306,-410,-0.04015444,-0.1230893,-0.158301158
4207,2020,서울,구로구,1153000000,초등학교,2020-04-01,전체,3014,3346,3216,-130,-202,-332,-0.038852361,-0.062810945,-0.099222953
4208,2020,서울,구로구,1153000000,초등학교,2020-04-01,여자,1463,1634,1556,-78,-93,-171,-0.047735618,-0.059768638,-0.104651163
4209,2020,서울,구로구,1153000000,초등학교,2020-04-01,남자,1551,1712,1660,-52,-109,-161,-0.030373832,-0.065662651,-0.094042056
4210,2020,서울,금천구,1154500000,초등학교,2020-04-01,전체,1336,1485,1443,-42,-107,-149,-0.028282828,-0.074151074,-0.1003367
4211,2020,서울,금천구,1154500000,초등학교,2020-04-01,여자,660,712,683,-29,-23,-52,-0.040730337,-0.033674963,-0.073033708
4212,2020,서울,금천구,1154500000,초등학교,2020-04-01,남자,676,773,760,-13,-84,-97,-0.016817594,-0.110526316,-0.125485123
4213,2020,서울,영등포구,1156000000,초등학교,2020-04-01,전체,2265,2665,2542,-123,-277,-400,-0.046153846,-0.108969315,-0.150093809
4214,2020,서울,영등포구,1156000000,초등학교,2020-04-01,여자,1097,1263,1220,-43,-123,-166,-0.034045922,-0.100819672,-0.131433096
4215,2020,서울,영등포구,1156000000,초등학교,2020-04-01,남자,1168,1402,1322,-80,-154,-234,-0.057061341,-0.116490166,-0.166904422
4216,2020,서울,동작구,1159000000,초등학교,2020-04-01,전체,2545,2772,2722,-50,-177,-227,-0.018037518,-0.065025716,-0.081890332
4217,2020,서울,동작구,1159000000,초등학교,2020-04-01,여자,1258,1365,1339,-26,-81,-107,-0.019047619,-0.060492905,-0.078388278
4218,2020,서울,동작구,1159000000,초등학교,2020-04-01,남자,1287,1407,1383,-24,-96,-120,-0.017057569,-0.069414317,-0.085287846
4219,2020,서울,관악구,1162000000,초등학교,2020-04-01,전체,2302,2804,2634,-170,-332,-502,-0.060627675,-0.126044039,-0.179029957
4220,2020,서울,관악구,1162000000,초등학교,2020-04-01,여자,1133,1372,1279,-93,-146,-239,-0.067784257,-0.114151681,-0.174198251
4221,2020,서울,관악구,1162000000,초등학교,2020-04-01,남자,1169,1432,1355,-77,-186,-263,-0.05377095,-0.137269373,-0.183659218
4222,2020,서울,서초구,1165000000,초등학교,2020-04-01,전체,3479,3807,3817,10,-338,-328,0.00262674,-0.088551218,-0.086157079
4223,2020,서울,서초구,1165000000,초등학교,2020-04-01,여자,1648,1832,1825,-7,-177,-184,-0.003820961,-0.096986301,-0.100436681
4224,2020,서울,서초구,1165000000,초등학교,2020-04-01,남자,1831,1975,1992,17,-161,-144,0.008607595,-0.080823293,-0.072911392
4225,2020,서울,강남구,1168000000,초등학교,2020-04-01,전체,3913,4013,4061,48,-148,-100,0.011961126,-0.036444226,-0.024919013
4226,2020,서울,강남구,1168000000,초등학교,2020-04-01,여자,1849,1922,1952,30,-103,-73,0.015608741,-0.052766393,-0.03798127
4227,2020,서울,강남구,1168000000,초등학교,2020-04-01,남자,2064,2091,2109,18,-45,-27,0.008608321,-0.021337127,-0.012912482
4228,2020,서울,송파구,1171000000,초등학교,2020-04-01,전체,4926,5268,5402,134,-476,-342,0.025436598,-0.088115513,-0.064920273
4229,2020,서울,송파구,1171000000,초등학교,2020-04-01,여자,2411,2575,2638,63,-227,-164,0.024466019,-0.086050038,-0.06368932
4230,2020,서울,송파구,1171000000,초등학교,2020-04-01,남자,2515,2693,2764,71,-249,-178,0.026364649,-0.090086831,-0.066097289
4231,2020,서울,강동구,1174000000,초등학교,2020-04-01,전체,3404,3293,3176,-117,228,111,-0.035529912,0.071788413,0.033707865
4232,2020,서울,강동구,1174000000,초등학교,2020-04-01,여자,1606,1581,1521,-60,85,25,-0.037950664,0.055884287,0.015812777
4233,2020,서울,강동구,1174000000,초등학교,2020-04-01,남자,1798,1712,1655,-57,143,86,-0.033294393,0.086404834,0.050233645
4234,2020,부산,중구,2611000000,초등학교,2020-04-01,전체,209,183,170,-13,39,26,-0.071038251,0.229411765,0.142076503
4235,2020,부산,중구,2611000000,초등학교,2020-04-01,여자,95,84,75,-9,20,11,-0.107142857,0.266666667,0.130952381
4236,2020,부산,중구,2611000000,초등학교,2020-04-01,남자,114,99,95,-4,19,15,-0.04040404,0.2,0.151515152
4237,2020,부산,서구,2614000000,초등학교,2020-04-01,전체,561,598,628,30,-67,-37,0.050167224,-0.106687898,-0.06187291
4238,2020,부산,서구,2614000000,초등학교,2020-04-01,여자,239,279,295,16,-56,-40,0.05734767,-0.189830508,-0.143369176
4239,2020,부산,서구,2614000000,초등학교,2020-04-01,남자,322,319,333,14,-11,3,0.043887147,-0.033033033,0.009404389
4240,2020,부산,동구,2617000000,초등학교,2020-04-01,전체,422,429,420,-9,2,-7,-0.020979021,0.004761905,-0.016317016
4241,2020,부산,동구,2617000000,초등학교,2020-04-01,여자,198,209,202,-7,-4,-11,-0.033492823,-0.01980198,-0.052631579
4242,2020,부산,동구,2617000000,초등학교,2020-04-01,남자,224,220,218,-2,6,4,-0.009090909,0.027522936,0.018181818
4243,2020,부산,영도구,2620000000,초등학교,2020-04-01,전체,589,658,634,-24,-45,-69,-0.036474164,-0.070977918,-0.104863222
4244,2020,부산,영도구,2620000000,초등학교,2020-04-01,여자,287,320,306,-14,-19,-33,-0.04375,-0.062091503,-0.103125
4245,2020,부산,영도구,2620000000,초등학교,2020-04-01,남자,302,338,328,-10,-26,-36,-0.029585799,-0.079268293,-0.106508876
4246,2020,부산,부산진구,2623000000,초등학교,2020-04-01,전체,2372,2412,2340,-72,32,-40,-0.029850746,0.013675214,-0.016583748
4247,2020,부산,부산진구,2623000000,초등학교,2020-04-01,여자,1192,1154,1126,-28,66,38,-0.024263432,0.058614565,0.032928943
4248,2020,부산,부산진구,2623000000,초등학교,2020-04-01,남자,1180,1258,1214,-44,-34,-78,-0.034976153,-0.02800659,-0.06200318
4249,2020,부산,동래구,2626000000,초등학교,2020-04-01,전체,2036,1872,1964,92,72,164,0.049145299,0.036659878,0.087606838
4250,2020,부산,동래구,2626000000,초등학교,2020-04-01,여자,956,886,932,46,24,70,0.051918736,0.025751073,0.079006772
4251,2020,부산,동래구,2626000000,초등학교,2020-04-01,남자,1080,986,1032,46,48,94,0.046653144,0.046511628,0.095334686
4252,2020,부산,남구,2629000000,초등학교,2020-04-01,전체,2013,1971,2144,173,-131,42,0.087772704,-0.061100746,0.02130898
4253,2020,부산,남구,2629000000,초등학교,2020-04-01,여자,979,974,1062,88,-83,5,0.090349076,-0.078154426,0.00513347
4254,2020,부산,남구,2629000000,초등학교,2020-04-01,남자,1034,997,1082,85,-48,37,0.085255767,-0.044362292,0.037111334
4255,2020,부산,북구,2632000000,초등학교,2020-04-01,전체,2038,2279,2190,-89,-152,-241,-0.039052216,-0.069406393,-0.105748135
4256,2020,부산,북구,2632000000,초등학교,2020-04-01,여자,1009,1102,1062,-40,-53,-93,-0.036297641,-0.049905838,-0.084392015
4257,2020,부산,북구,2632000000,초등학교,2020-04-01,남자,1029,1177,1128,-49,-99,-148,-0.041631266,-0.087765957,-0.125743415
4258,2020,부산,해운대구,2635000000,초등학교,2020-04-01,전체,3075,3142,3161,19,-86,-67,0.006047104,-0.02720658,-0.021323997
4259,2020,부산,해운대구,2635000000,초등학교,2020-04-01,여자,1477,1492,1495,3,-18,-15,0.002010724,-0.012040134,-0.010053619
4260,2020,부산,해운대구,2635000000,초등학교,2020-04-01,남자,1598,1650,1666,16,-68,-52,0.00969697,-0.040816327,-0.031515152
4261,2020,부산,사하구,2638000000,초등학교,2020-04-01,전체,2145,2417,2331,-86,-186,-272,-0.035581299,-0.07979408,-0.112536202
4262,2020,부산,사하구,2638000000,초등학교,2020-04-01,여자,1051,1176,1123,-53,-72,-125,-0.045068027,-0.06411398,-0.106292517
4263,2020,부산,사하구,2638000000,초등학교,2020-04-01,남자,1094,1241,1208,-33,-114,-147,-0.026591459,-0.094370861,-0.118452861
4264,2020,부산,금정구,2641000000,초등학교,2020-04-01,전체,1527,1516,1506,-10,21,11,-0.006596306,0.013944223,0.007255937
4265,2020,부산,금정구,2641000000,초등학교,2020-04-01,여자,762,731,721,-10,41,31,-0.013679891,0.056865465,0.042407661
4266,2020,부산,금정구,2641000000,초등학교,2020-04-01,남자,765,785,785,0,-20,-20,0,-0.025477707,-0.025477707
4267,2020,부산,강서구,2644000000,초등학교,2020-04-01,전체,1956,1962,2027,65,-71,-6,0.03312946,-0.035027134,-0.003058104
4268,2020,부산,강서구,2644000000,초등학교,2020-04-01,여자,942,957,993,36,-51,-15,0.037617555,-0.051359517,-0.015673981
4269,2020,부산,강서구,2644000000,초등학교,2020-04-01,남자,1014,1005,1034,29,-20,9,0.028855721,-0.01934236,0.008955224
4270,2020,부산,연제구,2647000000,초등학교,2020-04-01,전체,1564,1541,1607,66,-43,23,0.042829332,-0.026757934,0.014925373
4271,2020,부산,연제구,2647000000,초등학교,2020-04-01,여자,800,759,803,44,-3,41,0.057971014,-0.00373599,0.054018445
4272,2020,부산,연제구,2647000000,초등학교,2020-04-01,남자,764,782,804,22,-40,-18,0.028132992,-0.049751244,-0.023017903
4273,2020,부산,수영구,2650000000,초등학교,2020-04-01,전체,970,1100,1055,-45,-85,-130,-0.040909091,-0.08056872,-0.118181818
4274,2020,부산,수영구,2650000000,초등학교,2020-04-01,여자,452,504,477,-27,-25,-52,-0.053571429,-0.052410901,-0.103174603
4275,2020,부산,수영구,2650000000,초등학교,2020-04-01,남자,518,596,578,-18,-60,-78,-0.030201342,-0.103806228,-0.130872483
4276,2020,부산,사상구,2653000000,초등학교,2020-04-01,전체,1280,1577,1495,-82,-215,-297,-0.051997464,-0.143812709,-0.188332276
4277,2020,부산,사상구,2653000000,초등학교,2020-04-01,여자,652,795,748,-47,-96,-143,-0.059119497,-0.128342246,-0.179874214
4278,2020,부산,사상구,2653000000,초등학교,2020-04-01,남자,628,782,747,-35,-119,-154,-0.044757033,-0.159303882,-0.196930946
4279,2020,부산,기장군,2671000000,초등학교,2020-04-01,전체,2038,2149,2134,-15,-96,-111,-0.006979991,-0.044985942,-0.051651931
4280,2020,부산,기장군,2671000000,초등학교,2020-04-01,여자,977,1037,1018,-19,-41,-60,-0.018322083,-0.040275049,-0.057859209
4281,2020,부산,기장군,2671000000,초등학교,2020-04-01,남자,1061,1112,1116,4,-55,-51,0.003597122,-0.049283154,-0.045863309
4282,2020,대구,중구,2711000000,초등학교,2020-04-01,전체,717,581,559,-22,158,136,-0.037865749,0.282647585,0.234079174
4283,2020,대구,중구,2711000000,초등학교,2020-04-01,여자,356,288,273,-15,83,68,-0.052083333,0.304029304,0.236111111
4284,2020,대구,중구,2711000000,초등학교,2020-04-01,남자,361,293,286,-7,75,68,-0.023890785,0.262237762,0.232081911
4285,2020,대구,동구,2714000000,초등학교,2020-04-01,전체,2723,2925,2908,-17,-185,-202,-0.005811966,-0.063617607,-0.069059829
4286,2020,대구,동구,2714000000,초등학교,2020-04-01,여자,1362,1433,1420,-13,-58,-71,-0.009071877,-0.04084507,-0.049546406
4287,2020,대구,동구,2714000000,초등학교,2020-04-01,남자,1361,1492,1488,-4,-127,-131,-0.002680965,-0.085349462,-0.087801609
4288,2020,대구,서구,2717000000,초등학교,2020-04-01,전체,869,1039,963,-76,-94,-170,-0.073147257,-0.09761163,-0.163618864
4289,2020,대구,서구,2717000000,초등학교,2020-04-01,여자,445,498,461,-37,-16,-53,-0.074297189,-0.034707158,-0.106425703
4290,2020,대구,서구,2717000000,초등학교,2020-04-01,남자,424,541,502,-39,-78,-117,-0.072088725,-0.155378486,-0.216266174
4291,2020,대구,남구,2720000000,초등학교,2020-04-01,전체,720,827,783,-44,-63,-107,-0.053204353,-0.08045977,-0.129383313
4292,2020,대구,남구,2720000000,초등학교,2020-04-01,여자,367,399,378,-21,-11,-32,-0.052631579,-0.029100529,-0.080200501
4293,2020,대구,남구,2720000000,초등학교,2020-04-01,남자,353,428,405,-23,-52,-75,-0.053738318,-0.128395062,-0.175233645
4294,2020,대구,북구,2723000000,초등학교,2020-04-01,전체,3458,3790,3738,-52,-280,-332,-0.013720317,-0.074906367,-0.087598945
4295,2020,대구,북구,2723000000,초등학교,2020-04-01,여자,1704,1886,1856,-30,-152,-182,-0.015906681,-0.081896552,-0.09650053
4296,2020,대구,북구,2723000000,초등학교,2020-04-01,남자,1754,1904,1882,-22,-128,-150,-0.011554622,-0.068012752,-0.078781513
4297,2020,대구,수성구,2726000000,초등학교,2020-04-01,전체,3323,3103,3288,185,35,220,0.059619723,0.010644769,0.07089913
4298,2020,대구,수성구,2726000000,초등학교,2020-04-01,여자,1634,1498,1585,87,49,136,0.058077437,0.030914826,0.090787717
4299,2020,대구,수성구,2726000000,초등학교,2020-04-01,남자,1689,1605,1703,98,-14,84,0.06105919,-0.008220787,0.052336449
4300,2020,대구,달서구,2729000000,초등학교,2020-04-01,전체,4632,4460,4519,59,113,172,0.0132287,0.025005532,0.038565022
4301,2020,대구,달서구,2729000000,초등학교,2020-04-01,여자,2268,2199,2225,26,43,69,0.011823556,0.019325843,0.031377899
4302,2020,대구,달서구,2729000000,초등학교,2020-04-01,남자,2364,2261,2294,33,70,103,0.014595312,0.030514385,0.045555064
4303,2020,대구,달성군,2771000000,초등학교,2020-04-01,전체,2880,2966,2974,8,-94,-86,0.002697235,-0.031607263,-0.02899528
4304,2020,대구,달성군,2771000000,초등학교,2020-04-01,여자,1399,1475,1477,2,-78,-76,0.001355932,-0.052809749,-0.051525424
4305,2020,대구,달성군,2771000000,초등학교,2020-04-01,남자,1481,1491,1497,6,-16,-10,0.004024145,-0.010688043,-0.006706908
4306,2020,인천,중구,2811000000,초등학교,2020-04-01,전체,1391,1096,1242,146,149,295,0.133211679,0.119967794,0.269160584
4307,2020,인천,중구,2811000000,초등학교,2020-04-01,여자,677,543,619,76,58,134,0.139963168,0.093699515,0.246777164
4308,2020,인천,중구,2811000000,초등학교,2020-04-01,남자,714,553,623,70,91,161,0.126582278,0.146067416,0.291139241
4309,2020,인천,동구,2814000000,초등학교,2020-04-01,전체,539,506,470,-36,69,33,-0.071146245,0.146808511,0.065217391
4310,2020,인천,동구,2814000000,초등학교,2020-04-01,여자,253,247,219,-28,34,6,-0.113360324,0.155251142,0.024291498
4311,2020,인천,동구,2814000000,초등학교,2020-04-01,남자,286,259,251,-8,35,27,-0.030888031,0.139442231,0.104247104
4312,2020,인천,연수구,2818500000,초등학교,2020-04-01,전체,3979,3339,3592,253,387,640,0.075771189,0.107739421,0.191674154
4313,2020,인천,연수구,2818500000,초등학교,2020-04-01,여자,1954,1637,1732,95,222,317,0.058032987,0.12817552,0.193646915
4314,2020,인천,연수구,2818500000,초등학교,2020-04-01,남자,2025,1702,1860,158,165,323,0.092831962,0.088709677,0.189776733
4315,2020,인천,미추홀구,2817700000,초등학교,2020-04-01,전체,2815,3262,3135,-127,-320,-447,-0.03893317,-0.102073365,-0.137032495
4316,2020,인천,미추홀구,2817700000,초등학교,2020-04-01,여자,1362,1608,1558,-50,-196,-246,-0.031094527,-0.125802311,-0.152985075
4317,2020,인천,미추홀구,2817700000,초등학교,2020-04-01,남자,1453,1654,1577,-77,-124,-201,-0.046553809,-0.078630311,-0.121523579
4318,2020,인천,남동구,2820000000,초등학교,2020-04-01,전체,4656,5063,4898,-165,-242,-407,-0.032589374,-0.049407922,-0.080387122
4319,2020,인천,남동구,2820000000,초등학교,2020-04-01,여자,2318,2469,2407,-62,-89,-151,-0.025111381,-0.036975488,-0.061158364
4320,2020,인천,남동구,2820000000,초등학교,2020-04-01,남자,2338,2594,2491,-103,-153,-256,-0.039707016,-0.061421116,-0.098689283
4321,2020,인천,부평구,2823700000,초등학교,2020-04-01,전체,3626,4157,3931,-226,-305,-531,-0.054366129,-0.0775884,-0.127736348
4322,2020,인천,부평구,2823700000,초등학교,2020-04-01,여자,1794,2044,1935,-109,-141,-250,-0.05332681,-0.072868217,-0.122309198
4323,2020,인천,부평구,2823700000,초등학교,2020-04-01,남자,1832,2113,1996,-117,-164,-281,-0.05537151,-0.082164329,-0.132986275
4324,2020,인천,계양구,2824500000,초등학교,2020-04-01,전체,2091,2326,2208,-118,-117,-235,-0.050730868,-0.05298913,-0.101031814
4325,2020,인천,계양구,2824500000,초등학교,2020-04-01,여자,1006,1111,1065,-46,-59,-105,-0.04140414,-0.055399061,-0.094509451
4326,2020,인천,계양구,2824500000,초등학교,2020-04-01,남자,1085,1215,1143,-72,-58,-130,-0.059259259,-0.050743657,-0.106995885
4327,2020,인천,서구,2826000000,초등학교,2020-04-01,전체,5318,5512,5596,84,-278,-194,0.015239478,-0.049678342,-0.035195936
4328,2020,인천,서구,2826000000,초등학교,2020-04-01,여자,2613,2675,2720,45,-107,-62,0.01682243,-0.039338235,-0.02317757
4329,2020,인천,서구,2826000000,초등학교,2020-04-01,남자,2705,2837,2876,39,-171,-132,0.013746916,-0.05945758,-0.046528023
4330,2020,인천,강화군,2871000000,초등학교,2020-04-01,전체,334,305,301,-4,33,29,-0.013114754,0.109634551,0.095081967
4331,2020,인천,강화군,2871000000,초등학교,2020-04-01,여자,168,155,156,1,12,13,0.006451613,0.076923077,0.083870968
4332,2020,인천,강화군,2871000000,초등학교,2020-04-01,남자,166,150,145,-5,21,16,-0.033333333,0.144827586,0.106666667
4333,2020,인천,옹진군,2872000000,초등학교,2020-04-01,전체,97,116,109,-7,-12,-19,-0.060344828,-0.110091743,-0.163793103
4334,2020,인천,옹진군,2872000000,초등학교,2020-04-01,여자,45,52,53,1,-8,-7,0.019230769,-0.150943396,-0.134615385
4335,2020,인천,옹진군,2872000000,초등학교,2020-04-01,남자,52,64,56,-8,-4,-12,-0.125,-0.071428571,-0.1875
4336,2020,광주,동구,2911000000,초등학교,2020-04-01,전체,571,636,636,0,-65,-65,0,-0.102201258,-0.102201258
4337,2020,광주,동구,2911000000,초등학교,2020-04-01,여자,276,307,308,1,-32,-31,0.003257329,-0.103896104,-0.100977199
4338,2020,광주,동구,2911000000,초등학교,2020-04-01,남자,295,329,328,-1,-33,-34,-0.003039514,-0.100609756,-0.103343465
4339,2020,광주,서구,2914000000,초등학교,2020-04-01,전체,2547,2565,2557,-8,-10,-18,-0.003118908,-0.003910833,-0.007017544
4340,2020,광주,서구,2914000000,초등학교,2020-04-01,여자,1234,1260,1243,-17,-9,-26,-0.013492063,-0.007240547,-0.020634921
4341,2020,광주,서구,2914000000,초등학교,2020-04-01,남자,1313,1305,1314,9,-1,8,0.006896552,-0.000761035,0.006130268
4342,2020,광주,남구,2915500000,초등학교,2020-04-01,전체,2173,1867,1925,58,248,306,0.031065881,0.128831169,0.163899304
4343,2020,광주,남구,2915500000,초등학교,2020-04-01,여자,1072,921,940,19,132,151,0.02062975,0.140425532,0.163952226
4344,2020,광주,남구,2915500000,초등학교,2020-04-01,남자,1101,946,985,39,116,155,0.041226216,0.117766497,0.16384778
4345,2020,광주,북구,2917000000,초등학교,2020-04-01,전체,3635,3839,3827,-12,-192,-204,-0.003125814,-0.050169846,-0.053138838
4346,2020,광주,북구,2917000000,초등학교,2020-04-01,여자,1731,1883,1876,-7,-145,-152,-0.003717472,-0.077292111,-0.080722252
4347,2020,광주,북구,2917000000,초등학교,2020-04-01,남자,1904,1956,1951,-5,-47,-52,-0.002556237,-0.02409021,-0.026584867
4348,2020,광주,광산구,2920000000,초등학교,2020-04-01,전체,4616,4489,4543,54,73,127,0.012029405,0.016068677,0.028291379
4349,2020,광주,광산구,2920000000,초등학교,2020-04-01,여자,2279,2219,2242,23,37,60,0.010365029,0.016503122,0.027039207
4350,2020,광주,광산구,2920000000,초등학교,2020-04-01,남자,2337,2270,2301,31,36,67,0.013656388,0.015645372,0.029515419
4351,2020,대전,동구,3011000000,초등학교,2020-04-01,전체,1637,1826,1810,-16,-173,-189,-0.008762322,-0.09558011,-0.103504929
4352,2020,대전,동구,3011000000,초등학교,2020-04-01,여자,834,901,883,-18,-49,-67,-0.019977802,-0.055492639,-0.07436182
4353,2020,대전,동구,3011000000,초등학교,2020-04-01,남자,803,925,927,2,-124,-122,0.002162162,-0.133764833,-0.131891892
4354,2020,대전,중구,3014000000,초등학교,2020-04-01,전체,1788,1851,1830,-21,-42,-63,-0.011345219,-0.02295082,-0.034035656
4355,2020,대전,중구,3014000000,초등학교,2020-04-01,여자,868,885,871,-14,-3,-17,-0.015819209,-0.003444317,-0.01920904
4356,2020,대전,중구,3014000000,초등학교,2020-04-01,남자,920,966,959,-7,-39,-46,-0.007246377,-0.040667362,-0.047619048
4357,2020,대전,서구,3017000000,초등학교,2020-04-01,전체,4192,4303,4275,-28,-83,-111,-0.006507088,-0.019415205,-0.025795956
4358,2020,대전,서구,3017000000,초등학교,2020-04-01,여자,2021,2092,2114,22,-93,-71,0.010516252,-0.043992431,-0.033938815
4359,2020,대전,서구,3017000000,초등학교,2020-04-01,남자,2171,2211,2161,-50,10,-40,-0.022614202,0.004627487,-0.018091361
4360,2020,대전,유성구,3020000000,초등학교,2020-04-01,전체,3737,3923,3911,-12,-174,-186,-0.003058884,-0.0444899,-0.047412694
4361,2020,대전,유성구,3020000000,초등학교,2020-04-01,여자,1863,1888,1895,7,-32,-25,0.003707627,-0.016886544,-0.013241525
4362,2020,대전,유성구,3020000000,초등학교,2020-04-01,남자,1874,2035,2016,-19,-142,-161,-0.009336609,-0.070436508,-0.079115479
4363,2020,대전,대덕구,3023000000,초등학교,2020-04-01,전체,1269,1406,1325,-81,-56,-137,-0.057610242,-0.042264151,-0.097439545
4364,2020,대전,대덕구,3023000000,초등학교,2020-04-01,여자,608,692,646,-46,-38,-84,-0.066473988,-0.058823529,-0.121387283
4365,2020,대전,대덕구,3023000000,초등학교,2020-04-01,남자,661,714,679,-35,-18,-53,-0.049019608,-0.026509573,-0.074229692
4366,2020,울산,중구,3111000000,초등학교,2020-04-01,전체,1911,2108,1994,-114,-83,-197,-0.054079696,-0.041624875,-0.09345351
4367,2020,울산,중구,3111000000,초등학교,2020-04-01,여자,937,1031,972,-59,-35,-94,-0.057225994,-0.03600823,-0.091173618
4368,2020,울산,중구,3111000000,초등학교,2020-04-01,남자,974,1077,1022,-55,-48,-103,-0.051067781,-0.046966732,-0.095636026
4369,2020,울산,남구,3114000000,초등학교,2020-04-01,전체,2519,2708,2688,-20,-169,-189,-0.007385524,-0.062872024,-0.069793205
4370,2020,울산,남구,3114000000,초등학교,2020-04-01,여자,1249,1301,1313,12,-64,-52,0.009223674,-0.048743336,-0.039969254
4371,2020,울산,남구,3114000000,초등학교,2020-04-01,남자,1270,1407,1375,-32,-105,-137,-0.022743426,-0.076363636,-0.097370291
4372,2020,울산,동구,3117000000,초등학교,2020-04-01,전체,1680,1887,1811,-76,-131,-207,-0.04027557,-0.072335726,-0.109697933
4373,2020,울산,동구,3117000000,초등학교,2020-04-01,여자,813,951,915,-36,-102,-138,-0.03785489,-0.11147541,-0.14511041
4374,2020,울산,동구,3117000000,초등학교,2020-04-01,남자,867,936,896,-40,-29,-69,-0.042735043,-0.032366071,-0.073717949
4375,2020,울산,북구,3120000000,초등학교,2020-04-01,전체,2713,2582,2721,139,-8,131,0.053834237,-0.002940096,0.050735864
4376,2020,울산,북구,3120000000,초등학교,2020-04-01,여자,1317,1235,1305,70,12,82,0.056680162,0.009195402,0.066396761
4377,2020,울산,북구,3120000000,초등학교,2020-04-01,남자,1396,1347,1416,69,-20,49,0.051224944,-0.014124294,0.036377134
4378,2020,울산,울주군,3171000000,초등학교,2020-04-01,전체,2032,2017,2008,-9,24,15,-0.004462072,0.011952191,0.007436787
4379,2020,울산,울주군,3171000000,초등학교,2020-04-01,여자,1016,1005,998,-7,18,11,-0.006965174,0.018036072,0.010945274
4380,2020,울산,울주군,3171000000,초등학교,2020-04-01,남자,1016,1012,1010,-2,6,4,-0.001976285,0.005940594,0.003952569
4381,2020,세종,세종시,3611000000,초등학교,2020-04-01,전체,4879,4231,4649,418,230,648,0.098794611,0.049473005,0.153155282
4382,2020,세종,세종시,3611000000,초등학교,2020-04-01,전체,4879,4231,4649,418,230,648,0.098794611,0.049473005,0.153155282
4383,2020,세종,세종시,3611000000,초등학교,2020-04-01,전체,4879,4231,4649,418,230,648,0.098794611,0.049473005,0.153155282
4384,2020,세종,세종시,3611000000,초등학교,2020-04-01,전체,4879,4231,4649,418,230,648,0.098794611,0.049473005,0.153155282
4385,2020,세종,세종시,3611000000,초등학교,2020-04-01,여자,2390,2122,2318,196,72,268,0.092365693,0.03106126,0.126295947
4386,2020,세종,세종시,3611000000,초등학교,2020-04-01,여자,2390,2122,2318,196,72,268,0.092365693,0.03106126,0.126295947
4387,2020,세종,세종시,3611000000,초등학교,2020-04-01,여자,2390,2122,2318,196,72,268,0.092365693,0.03106126,0.126295947
4388,2020,세종,세종시,3611000000,초등학교,2020-04-01,여자,2390,2122,2318,196,72,268,0.092365693,0.03106126,0.126295947
4389,2020,세종,세종시,3611000000,초등학교,2020-04-01,남자,2489,2109,2331,222,158,380,0.105263158,0.067782068,0.18018018
4390,2020,세종,세종시,3611000000,초등학교,2020-04-01,남자,2489,2109,2331,222,158,380,0.105263158,0.067782068,0.18018018
4391,2020,세종,세종시,3611000000,초등학교,2020-04-01,남자,2489,2109,2331,222,158,380,0.105263158,0.067782068,0.18018018
4392,2020,세종,세종시,3611000000,초등학교,2020-04-01,남자,2489,2109,2331,222,158,380,0.105263158,0.067782068,0.18018018
4393,2020,경기,수원시,4111000000,초등학교,2020-04-01,전체,10731,11209,10968,-241,-237,-478,-0.02150058,-0.021608315,-0.042644304
4394,2020,경기,수원시,4111000000,초등학교,2020-04-01,여자,5210,5476,5328,-148,-118,-266,-0.027027027,-0.022147147,-0.048575603
4395,2020,경기,수원시,4111000000,초등학교,2020-04-01,남자,5521,5733,5640,-93,-119,-212,-0.016221873,-0.021099291,-0.036978894
4396,2020,경기,성남시,4113000000,초등학교,2020-04-01,전체,7248,7793,7571,-222,-323,-545,-0.028487104,-0.042662792,-0.069934557
4397,2020,경기,성남시,4113000000,초등학교,2020-04-01,여자,3544,3841,3731,-110,-187,-297,-0.028638375,-0.050120611,-0.077323614
4398,2020,경기,성남시,4113000000,초등학교,2020-04-01,남자,3704,3952,3840,-112,-136,-248,-0.028340081,-0.035416667,-0.062753036
4399,2020,경기,부천시,4119000000,초등학교,2020-04-01,전체,6172,6768,6540,-228,-368,-596,-0.033687943,-0.056269113,-0.088061466
4400,2020,경기,부천시,4119000000,초등학교,2020-04-01,여자,2974,3331,3224,-107,-250,-357,-0.032122486,-0.077543424,-0.107175023
4401,2020,경기,부천시,4119000000,초등학교,2020-04-01,남자,3198,3437,3316,-121,-118,-239,-0.035205121,-0.035585042,-0.069537387
4402,2020,경기,안양시,4117000000,초등학교,2020-04-01,전체,4147,4609,4453,-156,-306,-462,-0.033846821,-0.068717718,-0.100238663
4403,2020,경기,안양시,4117000000,초등학교,2020-04-01,여자,2002,2278,2184,-94,-182,-276,-0.041264267,-0.083333333,-0.121158911
4404,2020,경기,안양시,4117000000,초등학교,2020-04-01,남자,2145,2331,2269,-62,-124,-186,-0.026598027,-0.054649625,-0.07979408
4405,2020,경기,과천시,4129000000,초등학교,2020-04-01,전체,483,444,496,52,-13,39,0.117117117,-0.026209677,0.087837838
4406,2020,경기,과천시,4129000000,초등학교,2020-04-01,여자,230,209,231,22,-1,21,0.105263158,-0.004329004,0.100478469
4407,2020,경기,과천시,4129000000,초등학교,2020-04-01,남자,253,235,265,30,-12,18,0.127659574,-0.045283019,0.076595745
4408,2020,경기,안산시,4127000000,초등학교,2020-04-01,전체,5094,5032,4936,-96,158,62,-0.019077901,0.032009724,0.012321145
4409,2020,경기,안산시,4127000000,초등학교,2020-04-01,여자,2484,2442,2408,-34,76,42,-0.013923014,0.031561462,0.017199017
4410,2020,경기,안산시,4127000000,초등학교,2020-04-01,남자,2610,2590,2528,-62,82,20,-0.023938224,0.032436709,0.007722008
4411,2020,경기,용인시,4146000000,초등학교,2020-04-01,전체,10958,10784,11214,430,-256,174,0.039873887,-0.022828607,0.016135015
4412,2020,경기,용인시,4146000000,초등학교,2020-04-01,여자,5379,5299,5535,236,-156,80,0.044536705,-0.028184282,0.015097188
4413,2020,경기,용인시,4146000000,초등학교,2020-04-01,남자,5579,5485,5679,194,-100,94,0.035369189,-0.017608734,0.017137648
4414,2020,경기,군포시,4141000000,초등학교,2020-04-01,전체,2338,2455,2359,-96,-21,-117,-0.03910387,-0.008902077,-0.047657841
4415,2020,경기,군포시,4141000000,초등학교,2020-04-01,여자,1153,1189,1138,-51,15,-36,-0.042893188,0.013181019,-0.030277544
4416,2020,경기,군포시,4141000000,초등학교,2020-04-01,남자,1185,1266,1221,-45,-36,-81,-0.035545024,-0.029484029,-0.063981043
4417,2020,경기,의왕시,4143000000,초등학교,2020-04-01,전체,1257,1352,1362,10,-105,-95,0.00739645,-0.077092511,-0.070266272
4418,2020,경기,의왕시,4143000000,초등학교,2020-04-01,여자,667,692,699,7,-32,-25,0.010115607,-0.045779685,-0.036127168
4419,2020,경기,의왕시,4143000000,초등학교,2020-04-01,남자,590,660,663,3,-73,-70,0.004545455,-0.110105581,-0.106060606
4420,2020,경기,시흥시,4139000000,초등학교,2020-04-01,전체,4959,4170,4562,392,397,789,0.094004796,0.087023235,0.189208633
4421,2020,경기,시흥시,4139000000,초등학교,2020-04-01,여자,2422,2053,2246,193,176,369,0.094008768,0.078361532,0.17973697
4422,2020,경기,시흥시,4139000000,초등학교,2020-04-01,남자,2537,2117,2316,199,221,420,0.094000945,0.095423143,0.198393954
4423,2020,경기,평택시,4122000000,초등학교,2020-04-01,전체,5066,4686,4870,184,196,380,0.039265898,0.040246407,0.081092616
4424,2020,경기,평택시,4122000000,초등학교,2020-04-01,여자,2551,2334,2416,82,135,217,0.035132819,0.055877483,0.092973436
4425,2020,경기,평택시,4122000000,초등학교,2020-04-01,남자,2515,2352,2454,102,61,163,0.043367347,0.024857376,0.069302721
4426,2020,경기,화성시,4159000000,초등학교,2020-04-01,전체,11118,9928,10749,821,369,1190,0.082695407,0.034328775,0.119863014
4427,2020,경기,화성시,4159000000,초등학교,2020-04-01,여자,5377,4886,5320,434,57,491,0.088825215,0.010714286,0.100491199
4428,2020,경기,화성시,4159000000,초등학교,2020-04-01,남자,5741,5042,5429,387,312,699,0.076755256,0.057469147,0.138635462
4429,2020,경기,오산시,4137000000,초등학교,2020-04-01,전체,2677,2763,2714,-49,-37,-86,-0.017734347,-0.013633014,-0.031125588
4430,2020,경기,오산시,4137000000,초등학교,2020-04-01,여자,1299,1381,1337,-44,-38,-82,-0.03186097,-0.02842184,-0.059377263
4431,2020,경기,오산시,4137000000,초등학교,2020-04-01,남자,1378,1382,1377,-5,1,-4,-0.003617945,0.000726216,-0.002894356
4432,2020,경기,광명시,4121000000,초등학교,2020-04-01,전체,2623,2848,2743,-105,-120,-225,-0.036867978,-0.043747721,-0.079002809
4433,2020,경기,광명시,4121000000,초등학교,2020-04-01,여자,1268,1391,1339,-52,-71,-123,-0.037383178,-0.053024645,-0.088425593
4434,2020,경기,광명시,4121000000,초등학교,2020-04-01,남자,1355,1457,1404,-53,-49,-102,-0.036376115,-0.034900285,-0.070006863
4435,2020,경기,광주시,4161000000,초등학교,2020-04-01,전체,3312,3686,3742,56,-430,-374,0.015192621,-0.114911812,-0.101465003
4436,2020,경기,광주시,4161000000,초등학교,2020-04-01,여자,1632,1785,1811,26,-179,-153,0.014565826,-0.09884042,-0.085714286
4437,2020,경기,광주시,4161000000,초등학교,2020-04-01,남자,1680,1901,1931,30,-251,-221,0.015781168,-0.129984464,-0.116254603
4438,2020,경기,하남시,4145000000,초등학교,2020-04-01,전체,3027,2845,3103,258,-76,182,0.090685413,-0.024492427,0.06397188
4439,2020,경기,하남시,4145000000,초등학교,2020-04-01,여자,1505,1379,1520,141,-15,126,0.102248006,-0.009868421,0.091370558
4440,2020,경기,하남시,4145000000,초등학교,2020-04-01,남자,1522,1466,1583,117,-61,56,0.079809004,-0.038534428,0.038199181
4441,2020,경기,김포시,4157000000,초등학교,2020-04-01,전체,5412,5037,5398,361,14,375,0.071669645,0.002593553,0.074449077
4442,2020,경기,김포시,4157000000,초등학교,2020-04-01,여자,2656,2443,2597,154,59,213,0.063037249,0.022718521,0.087187884
4443,2020,경기,김포시,4157000000,초등학교,2020-04-01,남자,2756,2594,2801,207,-45,162,0.079799537,-0.016065691,0.062451812
4444,2020,경기,이천시,4150000000,초등학교,2020-04-01,전체,2035,2072,2041,-31,-6,-37,-0.01496139,-0.002939735,-0.017857143
4445,2020,경기,이천시,4150000000,초등학교,2020-04-01,여자,1019,1023,1003,-20,16,-4,-0.019550342,0.015952144,-0.003910068
4446,2020,경기,이천시,4150000000,초등학교,2020-04-01,남자,1016,1049,1038,-11,-22,-33,-0.010486177,-0.021194605,-0.031458532
4447,2020,경기,안성시,4155000000,초등학교,2020-04-01,전체,1681,1623,1597,-26,84,58,-0.016019717,0.052598622,0.035736291
4448,2020,경기,안성시,4155000000,초등학교,2020-04-01,여자,795,791,782,-9,13,4,-0.011378003,0.016624041,0.00505689
4449,2020,경기,안성시,4155000000,초등학교,2020-04-01,남자,886,832,815,-17,71,54,-0.020432692,0.087116564,0.064903846
4450,2020,경기,여주시,4167000000,초등학교,2020-04-01,전체,804,863,845,-18,-41,-59,-0.020857474,-0.04852071,-0.068366165
4451,2020,경기,여주시,4167000000,초등학교,2020-04-01,여자,376,396,389,-7,-13,-20,-0.017676768,-0.033419023,-0.050505051
4452,2020,경기,여주시,4167000000,초등학교,2020-04-01,남자,428,467,456,-11,-28,-39,-0.023554604,-0.061403509,-0.083511777
4453,2020,경기,양평군,4183000000,초등학교,2020-04-01,전체,746,811,817,6,-71,-65,0.007398274,-0.086903305,-0.080147965
4454,2020,경기,양평군,4183000000,초등학교,2020-04-01,여자,373,399,403,4,-30,-26,0.010025063,-0.074441687,-0.065162907
4455,2020,경기,양평군,4183000000,초등학교,2020-04-01,남자,373,412,414,2,-41,-39,0.004854369,-0.099033816,-0.094660194
4456,2020,경기,고양시,4128000000,초등학교,2020-04-01,전체,8550,8602,8644,42,-94,-52,0.004882585,-0.010874595,-0.006045106
4457,2020,경기,고양시,4128000000,초등학교,2020-04-01,여자,4245,4207,4240,33,5,38,0.007844069,0.001179245,0.009032565
4458,2020,경기,고양시,4128000000,초등학교,2020-04-01,남자,4305,4395,4404,9,-99,-90,0.002047782,-0.022479564,-0.020477816
4459,2020,경기,남양주시,4136000000,초등학교,2020-04-01,전체,7055,6860,7131,271,-76,195,0.039504373,-0.010657692,0.028425656
4460,2020,경기,남양주시,4136000000,초등학교,2020-04-01,여자,3421,3315,3441,126,-20,106,0.03800905,-0.005812264,0.031975867
4461,2020,경기,남양주시,4136000000,초등학교,2020-04-01,남자,3634,3545,3690,145,-56,89,0.04090268,-0.015176152,0.025105783
4462,2020,경기,구리시,4131000000,초등학교,2020-04-01,전체,1598,1751,1769,18,-171,-153,0.01027984,-0.096664782,-0.087378641
4463,2020,경기,구리시,4131000000,초등학교,2020-04-01,여자,753,805,815,10,-62,-52,0.01242236,-0.07607362,-0.064596273
4464,2020,경기,구리시,4131000000,초등학교,2020-04-01,남자,845,946,954,8,-109,-101,0.00845666,-0.114255765,-0.106765328
4465,2020,경기,의정부시,4115000000,초등학교,2020-04-01,전체,3502,3658,3780,122,-278,-156,0.033351558,-0.073544974,-0.042646255
4466,2020,경기,의정부시,4115000000,초등학교,2020-04-01,여자,1690,1731,1790,59,-100,-41,0.034084344,-0.055865922,-0.023685731
4467,2020,경기,의정부시,4115000000,초등학교,2020-04-01,남자,1812,1927,1990,63,-178,-115,0.032693306,-0.089447236,-0.059678256
4468,2020,경기,파주시,4148000000,초등학교,2020-04-01,전체,4595,4725,4875,150,-280,-130,0.031746032,-0.057435897,-0.027513228
4469,2020,경기,파주시,4148000000,초등학교,2020-04-01,여자,2262,2327,2386,59,-124,-65,0.025354534,-0.051969824,-0.027932961
4470,2020,경기,파주시,4148000000,초등학교,2020-04-01,남자,2333,2398,2489,91,-156,-65,0.03794829,-0.062675773,-0.027105922
4471,2020,경기,동두천시,4125000000,초등학교,2020-04-01,전체,733,799,775,-24,-42,-66,-0.030037547,-0.054193548,-0.082603254
4472,2020,경기,동두천시,4125000000,초등학교,2020-04-01,여자,356,384,367,-17,-11,-28,-0.044270833,-0.029972752,-0.072916667
4473,2020,경기,동두천시,4125000000,초등학교,2020-04-01,남자,377,415,408,-7,-31,-38,-0.01686747,-0.075980392,-0.091566265
4474,2020,경기,양주시,4163000000,초등학교,2020-04-01,전체,2065,1942,2073,131,-8,123,0.067456231,-0.003859141,0.063336766
4475,2020,경기,양주시,4163000000,초등학교,2020-04-01,여자,1030,953,1018,65,12,77,0.068205666,0.011787819,0.080797482
4476,2020,경기,양주시,4163000000,초등학교,2020-04-01,남자,1035,989,1055,66,-20,46,0.066734075,-0.018957346,0.046511628
4477,2020,경기,포천시,4165000000,초등학교,2020-04-01,전체,922,1024,973,-51,-51,-102,-0.049804688,-0.052415211,-0.099609375
4478,2020,경기,포천시,4165000000,초등학교,2020-04-01,여자,436,492,470,-22,-34,-56,-0.044715447,-0.072340426,-0.113821138
4479,2020,경기,포천시,4165000000,초등학교,2020-04-01,남자,486,532,503,-29,-17,-46,-0.054511278,-0.033797217,-0.086466165
4480,2020,경기,가평군,4182000000,초등학교,2020-04-01,전체,357,365,367,2,-10,-8,0.005479452,-0.027247956,-0.021917808
4481,2020,경기,가평군,4182000000,초등학교,2020-04-01,여자,168,172,176,4,-8,-4,0.023255814,-0.045454545,-0.023255814
4482,2020,경기,가평군,4182000000,초등학교,2020-04-01,남자,189,193,191,-2,-2,-4,-0.010362694,-0.010471204,-0.020725389
4483,2020,경기,연천군,4180000000,초등학교,2020-04-01,전체,284,335,308,-27,-24,-51,-0.080597015,-0.077922078,-0.152238806
4484,2020,경기,연천군,4180000000,초등학교,2020-04-01,여자,141,179,167,-12,-26,-38,-0.067039106,-0.155688623,-0.212290503
4485,2020,경기,연천군,4180000000,초등학교,2020-04-01,남자,143,156,141,-15,2,-13,-0.096153846,0.014184397,-0.083333333
4486,2020,강원,춘천시,4211000000,초등학교,2020-04-01,전체,2377,2343,2349,6,28,34,0.002560819,0.011919966,0.01451131
4487,2020,강원,춘천시,4211000000,초등학교,2020-04-01,여자,1165,1136,1123,-13,42,29,-0.011443662,0.037399822,0.025528169
4488,2020,강원,춘천시,4211000000,초등학교,2020-04-01,남자,1212,1207,1226,19,-14,5,0.015741508,-0.01141925,0.004142502
4489,2020,강원,원주시,4213000000,초등학교,2020-04-01,전체,3008,2854,2888,34,120,154,0.011913104,0.041551247,0.053959355
4490,2020,강원,원주시,4213000000,초등학교,2020-04-01,여자,1471,1401,1411,10,60,70,0.007137759,0.042523033,0.049964311
4491,2020,강원,원주시,4213000000,초등학교,2020-04-01,남자,1537,1453,1477,24,60,84,0.01651755,0.040622884,0.057811425
4492,2020,강원,강릉시,4215000000,초등학교,2020-04-01,전체,1451,1440,1488,48,-37,11,0.033333333,-0.024865591,0.007638889
4493,2020,강원,강릉시,4215000000,초등학교,2020-04-01,여자,681,651,673,22,8,30,0.033794163,0.011887073,0.046082949
4494,2020,강원,강릉시,4215000000,초등학교,2020-04-01,남자,770,789,815,26,-45,-19,0.032953105,-0.055214724,-0.024081115
4495,2020,강원,동해시,4217000000,초등학교,2020-04-01,전체,756,764,765,1,-9,-8,0.001308901,-0.011764706,-0.010471204
4496,2020,강원,동해시,4217000000,초등학교,2020-04-01,여자,370,368,380,12,-10,2,0.032608696,-0.026315789,0.005434783
4497,2020,강원,동해시,4217000000,초등학교,2020-04-01,남자,386,396,385,-11,1,-10,-0.027777778,0.002597403,-0.025252525
4498,2020,강원,태백시,4219000000,초등학교,2020-04-01,전체,284,300,287,-13,-3,-16,-0.043333333,-0.010452962,-0.053333333
4499,2020,강원,태백시,4219000000,초등학교,2020-04-01,여자,132,136,130,-6,2,-4,-0.044117647,0.015384615,-0.029411765
4500,2020,강원,태백시,4219000000,초등학교,2020-04-01,남자,152,164,157,-7,-5,-12,-0.042682927,-0.031847134,-0.073170732
4501,2020,강원,속초시,4221000000,초등학교,2020-04-01,전체,579,580,584,4,-5,-1,0.006896552,-0.008561644,-0.001724138
4502,2020,강원,속초시,4221000000,초등학교,2020-04-01,여자,305,304,306,2,-1,1,0.006578947,-0.003267974,0.003289474
4503,2020,강원,속초시,4221000000,초등학교,2020-04-01,남자,274,276,278,2,-4,-2,0.007246377,-0.014388489,-0.007246377
4504,2020,강원,삼척시,4223000000,초등학교,2020-04-01,전체,400,428,427,-1,-27,-28,-0.002336449,-0.06323185,-0.065420561
4505,2020,강원,삼척시,4223000000,초등학교,2020-04-01,여자,201,216,211,-5,-10,-15,-0.023148148,-0.047393365,-0.069444444
4506,2020,강원,삼척시,4223000000,초등학교,2020-04-01,남자,199,212,216,4,-17,-13,0.018867925,-0.078703704,-0.061320755
4507,2020,강원,홍천군,4272000000,초등학교,2020-04-01,전체,384,432,429,-3,-45,-48,-0.006944444,-0.104895105,-0.111111111
4508,2020,강원,홍천군,4272000000,초등학교,2020-04-01,여자,189,226,212,-14,-23,-37,-0.061946903,-0.108490566,-0.163716814
4509,2020,강원,홍천군,4272000000,초등학교,2020-04-01,남자,195,206,217,11,-22,-11,0.053398058,-0.101382488,-0.053398058
4510,2020,강원,횡성군,4273000000,초등학교,2020-04-01,전체,221,226,227,1,-6,-5,0.004424779,-0.026431718,-0.022123894
4511,2020,강원,횡성군,4273000000,초등학교,2020-04-01,여자,107,107,110,3,-3,0,0.028037383,-0.027272727,0
4512,2020,강원,횡성군,4273000000,초등학교,2020-04-01,남자,114,119,117,-2,-3,-5,-0.016806723,-0.025641026,-0.042016807
4513,2020,강원,영월군,4275000000,초등학교,2020-04-01,전체,168,174,176,2,-8,-6,0.011494253,-0.045454545,-0.034482759
4514,2020,강원,영월군,4275000000,초등학교,2020-04-01,여자,80,83,87,4,-7,-3,0.048192771,-0.08045977,-0.036144578
4515,2020,강원,영월군,4275000000,초등학교,2020-04-01,남자,88,91,89,-2,-1,-3,-0.021978022,-0.011235955,-0.032967033
4516,2020,강원,평창군,4276000000,초등학교,2020-04-01,전체,213,217,206,-11,7,-4,-0.050691244,0.033980583,-0.01843318
4517,2020,강원,평창군,4276000000,초등학교,2020-04-01,여자,94,106,104,-2,-10,-12,-0.018867925,-0.096153846,-0.113207547
4518,2020,강원,평창군,4276000000,초등학교,2020-04-01,남자,119,111,102,-9,17,8,-0.081081081,0.166666667,0.072072072
4519,2020,강원,정선군,4277000000,초등학교,2020-04-01,전체,187,201,204,3,-17,-14,0.014925373,-0.083333333,-0.069651741
4520,2020,강원,정선군,4277000000,초등학교,2020-04-01,여자,92,103,105,2,-13,-11,0.019417476,-0.123809524,-0.106796117
4521,2020,강원,정선군,4277000000,초등학교,2020-04-01,남자,95,98,99,1,-4,-3,0.010204082,-0.04040404,-0.030612245
4522,2020,강원,철원군,4278000000,초등학교,2020-04-01,전체,301,326,328,2,-27,-25,0.006134969,-0.082317073,-0.076687117
4523,2020,강원,철원군,4278000000,초등학교,2020-04-01,여자,160,160,158,-2,2,0,-0.0125,0.012658228,0
4524,2020,강원,철원군,4278000000,초등학교,2020-04-01,남자,141,166,170,4,-29,-25,0.024096386,-0.170588235,-0.15060241
4525,2020,강원,화천군,4279000000,초등학교,2020-04-01,전체,180,200,199,-1,-19,-20,-0.005,-0.095477387,-0.1
4526,2020,강원,화천군,4279000000,초등학교,2020-04-01,여자,86,96,94,-2,-8,-10,-0.020833333,-0.085106383,-0.104166667
4527,2020,강원,화천군,4279000000,초등학교,2020-04-01,남자,94,104,105,1,-11,-10,0.009615385,-0.104761905,-0.096153846
4528,2020,강원,양구군,4280000000,초등학교,2020-04-01,전체,166,182,193,11,-27,-16,0.06043956,-0.139896373,-0.087912088
4529,2020,강원,양구군,4280000000,초등학교,2020-04-01,여자,83,89,93,4,-10,-6,0.04494382,-0.107526882,-0.06741573
4530,2020,강원,양구군,4280000000,초등학교,2020-04-01,남자,83,93,100,7,-17,-10,0.075268817,-0.17,-0.107526882
4531,2020,강원,인제군,4281000000,초등학교,2020-04-01,전체,251,269,245,-24,6,-18,-0.089219331,0.024489796,-0.066914498
4532,2020,강원,인제군,4281000000,초등학교,2020-04-01,여자,128,126,118,-8,10,2,-0.063492063,0.084745763,0.015873016
4533,2020,강원,인제군,4281000000,초등학교,2020-04-01,남자,123,143,127,-16,-4,-20,-0.111888112,-0.031496063,-0.13986014
4534,2020,강원,고성군,4282000000,초등학교,2020-04-01,전체,150,133,131,-2,19,17,-0.015037594,0.145038168,0.127819549
4535,2020,강원,고성군,4282000000,초등학교,2020-04-01,여자,74,66,69,3,5,8,0.045454545,0.072463768,0.121212121
4536,2020,강원,고성군,4282000000,초등학교,2020-04-01,남자,76,67,62,-5,14,9,-0.074626866,0.225806452,0.134328358
4537,2020,강원,양양군,4283000000,초등학교,2020-04-01,전체,141,113,117,4,24,28,0.03539823,0.205128205,0.247787611
4538,2020,강원,양양군,4283000000,초등학교,2020-04-01,여자,65,52,51,-1,14,13,-0.019230769,0.274509804,0.25
4539,2020,강원,양양군,4283000000,초등학교,2020-04-01,남자,76,61,66,5,10,15,0.081967213,0.151515152,0.245901639
4540,2020,충북,청주시,4311000000,초등학교,2020-04-01,전체,8056,8027,8028,1,28,29,0.00012458,0.003487793,0.003612807
4541,2020,충북,청주시,4311000000,초등학교,2020-04-01,여자,3938,3938,3924,-14,14,0,-0.003555104,0.003567788,0
4542,2020,충북,청주시,4311000000,초등학교,2020-04-01,남자,4118,4089,4104,15,14,29,0.003668379,0.003411306,0.007092199
4543,2020,충북,충주시,4313000000,초등학교,2020-04-01,전체,1598,1562,1585,23,13,36,0.014724712,0.008201893,0.023047375
4544,2020,충북,충주시,4313000000,초등학교,2020-04-01,여자,792,800,811,11,-19,-8,0.01375,-0.023427867,-0.01
4545,2020,충북,충주시,4313000000,초등학교,2020-04-01,남자,806,762,774,12,32,44,0.015748031,0.041343669,0.057742782
4546,2020,충북,제천시,4315000000,초등학교,2020-04-01,전체,931,1003,988,-15,-57,-72,-0.014955135,-0.057692308,-0.071784646
4547,2020,충북,제천시,4315000000,초등학교,2020-04-01,여자,454,498,490,-8,-36,-44,-0.016064257,-0.073469388,-0.088353414
4548,2020,충북,제천시,4315000000,초등학교,2020-04-01,남자,477,505,498,-7,-21,-28,-0.013861386,-0.042168675,-0.055445545
4549,2020,충북,보은군,4372000000,초등학교,2020-04-01,전체,146,157,149,-8,-3,-11,-0.050955414,-0.020134228,-0.070063694
4550,2020,충북,보은군,4372000000,초등학교,2020-04-01,여자,79,83,78,-5,1,-4,-0.060240964,0.012820513,-0.048192771
4551,2020,충북,보은군,4372000000,초등학교,2020-04-01,남자,67,74,71,-3,-4,-7,-0.040540541,-0.056338028,-0.094594595
4552,2020,충북,옥천군,4373000000,초등학교,2020-04-01,전체,272,297,289,-8,-17,-25,-0.026936027,-0.058823529,-0.084175084
4553,2020,충북,옥천군,4373000000,초등학교,2020-04-01,여자,124,154,149,-5,-25,-30,-0.032467532,-0.167785235,-0.194805195
4554,2020,충북,옥천군,4373000000,초등학교,2020-04-01,남자,148,143,140,-3,8,5,-0.020979021,0.057142857,0.034965035
4555,2020,충북,영동군,4374000000,초등학교,2020-04-01,전체,224,293,273,-20,-49,-69,-0.068259386,-0.179487179,-0.235494881
4556,2020,충북,영동군,4374000000,초등학교,2020-04-01,여자,111,145,134,-11,-23,-34,-0.075862069,-0.171641791,-0.234482759
4557,2020,충북,영동군,4374000000,초등학교,2020-04-01,남자,113,148,139,-9,-26,-35,-0.060810811,-0.18705036,-0.236486486
4558,2020,충북,진천군,4375000000,초등학교,2020-04-01,전체,837,704,760,56,77,133,0.079545455,0.101315789,0.188920455
4559,2020,충북,진천군,4375000000,초등학교,2020-04-01,여자,422,342,371,29,51,80,0.084795322,0.137466307,0.233918129
4560,2020,충북,진천군,4375000000,초등학교,2020-04-01,남자,415,362,389,27,26,53,0.074585635,0.066838046,0.14640884
4561,2020,충북,괴산군,4376000000,초등학교,2020-04-01,전체,143,159,169,10,-26,-16,0.062893082,-0.153846154,-0.100628931
4562,2020,충북,괴산군,4376000000,초등학교,2020-04-01,여자,81,91,96,5,-15,-10,0.054945055,-0.15625,-0.10989011
4563,2020,충북,괴산군,4376000000,초등학교,2020-04-01,남자,62,68,73,5,-11,-6,0.073529412,-0.150684932,-0.088235294
4564,2020,충북,음성군,4377000000,초등학교,2020-04-01,전체,670,756,703,-53,-33,-86,-0.07010582,-0.046941679,-0.113756614
4565,2020,충북,음성군,4377000000,초등학교,2020-04-01,여자,330,382,348,-34,-18,-52,-0.089005236,-0.051724138,-0.136125654
4566,2020,충북,음성군,4377000000,초등학교,2020-04-01,남자,340,374,355,-19,-15,-34,-0.050802139,-0.042253521,-0.090909091
4567,2020,충북,단양군,4380000000,초등학교,2020-04-01,전체,117,125,124,-1,-7,-8,-0.008,-0.056451613,-0.064
4568,2020,충북,단양군,4380000000,초등학교,2020-04-01,여자,57,57,60,3,-3,0,0.052631579,-0.05,0
4569,2020,충북,단양군,4380000000,초등학교,2020-04-01,남자,60,68,64,-4,-4,-8,-0.058823529,-0.0625,-0.117647059
4570,2020,충북,증평군,4374500000,초등학교,2020-04-01,전체,355,421,394,-27,-39,-66,-0.064133017,-0.098984772,-0.156769596
4571,2020,충북,증평군,4374500000,초등학교,2020-04-01,여자,171,202,189,-13,-18,-31,-0.064356436,-0.095238095,-0.153465347
4572,2020,충북,증평군,4374500000,초등학교,2020-04-01,남자,184,219,205,-14,-21,-35,-0.063926941,-0.102439024,-0.159817352
4573,2020,충남,천안시,4413000000,초등학교,2020-04-01,전체,6790,6577,6708,131,82,213,0.019917896,0.01222421,0.032385586
4574,2020,충남,천안시,4413000000,초등학교,2020-04-01,여자,3332,3160,3248,88,84,172,0.027848101,0.025862069,0.05443038
4575,2020,충남,천안시,4413000000,초등학교,2020-04-01,남자,3458,3417,3460,43,-2,41,0.012584138,-0.000578035,0.011998829
4576,2020,충남,공주시,4415000000,초등학교,2020-04-01,전체,670,636,639,3,31,34,0.004716981,0.048513302,0.053459119
4577,2020,충남,공주시,4415000000,초등학교,2020-04-01,여자,317,278,288,10,29,39,0.035971223,0.100694444,0.14028777
4578,2020,충남,공주시,4415000000,초등학교,2020-04-01,남자,353,358,351,-7,2,-5,-0.019553073,0.005698006,-0.01396648
4579,2020,충남,보령시,4418000000,초등학교,2020-04-01,전체,644,678,664,-14,-20,-34,-0.020648968,-0.030120482,-0.050147493
4580,2020,충남,보령시,4418000000,초등학교,2020-04-01,여자,303,336,330,-6,-27,-33,-0.017857143,-0.081818182,-0.098214286
4581,2020,충남,보령시,4418000000,초등학교,2020-04-01,남자,341,342,334,-8,7,-1,-0.023391813,0.020958084,-0.002923977
4582,2020,충남,아산시,4420000000,초등학교,2020-04-01,전체,3646,3862,3756,-106,-110,-216,-0.027446919,-0.029286475,-0.05592957
4583,2020,충남,아산시,4420000000,초등학교,2020-04-01,여자,1751,1843,1788,-55,-37,-92,-0.029842648,-0.020693512,-0.049918611
4584,2020,충남,아산시,4420000000,초등학교,2020-04-01,남자,1895,2019,1968,-51,-73,-124,-0.02526003,-0.037093496,-0.061416543
4585,2020,충남,서산시,4421000000,초등학교,2020-04-01,전체,1655,1681,1708,27,-53,-26,0.016061868,-0.031030445,-0.015466984
4586,2020,충남,서산시,4421000000,초등학교,2020-04-01,여자,839,825,843,18,-4,14,0.021818182,-0.004744958,0.016969697
4587,2020,충남,서산시,4421000000,초등학교,2020-04-01,남자,816,856,865,9,-49,-40,0.010514019,-0.056647399,-0.046728972
4588,2020,충남,논산시,4423000000,초등학교,2020-04-01,전체,794,780,764,-16,30,14,-0.020512821,0.039267016,0.017948718
4589,2020,충남,논산시,4423000000,초등학교,2020-04-01,여자,385,387,375,-12,10,-2,-0.031007752,0.026666667,-0.005167959
4590,2020,충남,논산시,4423000000,초등학교,2020-04-01,남자,409,393,389,-4,20,16,-0.010178117,0.051413882,0.040712468
4591,2020,충남,계룡시,4425000000,초등학교,2020-04-01,전체,419,442,462,20,-43,-23,0.045248869,-0.093073593,-0.052036199
4592,2020,충남,계룡시,4425000000,초등학교,2020-04-01,여자,225,205,230,25,-5,20,0.12195122,-0.02173913,0.097560976
4593,2020,충남,계룡시,4425000000,초등학교,2020-04-01,남자,194,237,232,-5,-38,-43,-0.021097046,-0.163793103,-0.181434599
4594,2020,충남,금산군,4471000000,초등학교,2020-04-01,전체,298,309,310,1,-12,-11,0.003236246,-0.038709677,-0.035598706
4595,2020,충남,금산군,4471000000,초등학교,2020-04-01,여자,131,150,144,-6,-13,-19,-0.04,-0.090277778,-0.126666667
4596,2020,충남,금산군,4471000000,초등학교,2020-04-01,남자,167,159,166,7,1,8,0.044025157,0.006024096,0.050314465
4597,2020,충남,부여군,4476000000,초등학교,2020-04-01,전체,314,336,343,7,-29,-22,0.020833333,-0.084548105,-0.06547619
4598,2020,충남,부여군,4476000000,초등학교,2020-04-01,여자,138,161,162,1,-24,-23,0.00621118,-0.148148148,-0.142857143
4599,2020,충남,부여군,4476000000,초등학교,2020-04-01,남자,176,175,181,6,-5,1,0.034285714,-0.027624309,0.005714286
4600,2020,충남,서천군,4477000000,초등학교,2020-04-01,전체,261,268,265,-3,-4,-7,-0.01119403,-0.01509434,-0.026119403
4601,2020,충남,서천군,4477000000,초등학교,2020-04-01,여자,134,136,137,1,-3,-2,0.007352941,-0.02189781,-0.014705882
4602,2020,충남,서천군,4477000000,초등학교,2020-04-01,남자,127,132,128,-4,-1,-5,-0.03030303,-0.0078125,-0.037878788
4603,2020,충남,청양군,4479000000,초등학교,2020-04-01,전체,143,157,152,-5,-9,-14,-0.031847134,-0.059210526,-0.089171975
4604,2020,충남,청양군,4479000000,초등학교,2020-04-01,여자,69,82,78,-4,-9,-13,-0.048780488,-0.115384615,-0.158536585
4605,2020,충남,청양군,4479000000,초등학교,2020-04-01,남자,74,75,74,-1,0,-1,-0.013333333,0,-0.013333333
4606,2020,충남,홍성군,4480000000,초등학교,2020-04-01,전체,865,824,824,0,41,41,0,0.049757282,0.049757282
4607,2020,충남,홍성군,4480000000,초등학교,2020-04-01,여자,403,387,373,-14,30,16,-0.036175711,0.080428954,0.041343669
4608,2020,충남,홍성군,4480000000,초등학교,2020-04-01,남자,462,437,451,14,11,25,0.032036613,0.024390244,0.057208238
4609,2020,충남,예산군,4481000000,초등학교,2020-04-01,전체,441,408,418,10,23,33,0.024509804,0.055023923,0.080882353
4610,2020,충남,예산군,4481000000,초등학교,2020-04-01,여자,212,200,209,9,3,12,0.045,0.014354067,0.06
4611,2020,충남,예산군,4481000000,초등학교,2020-04-01,남자,229,208,209,1,20,21,0.004807692,0.09569378,0.100961538
4612,2020,충남,태안군,4482500000,초등학교,2020-04-01,전체,356,369,359,-10,-3,-13,-0.027100271,-0.008356546,-0.035230352
4613,2020,충남,태안군,4482500000,초등학교,2020-04-01,여자,182,183,186,3,-4,-1,0.016393443,-0.021505376,-0.005464481
4614,2020,충남,태안군,4482500000,초등학교,2020-04-01,남자,174,186,173,-13,1,-12,-0.069892473,0.005780347,-0.064516129
4615,2020,충남,당진시,4427000000,초등학교,2020-04-01,전체,1703,1830,1798,-32,-95,-127,-0.017486339,-0.052836485,-0.069398907
4616,2020,충남,당진시,4427000000,초등학교,2020-04-01,여자,853,909,894,-15,-41,-56,-0.01650165,-0.045861298,-0.061606161
4617,2020,충남,당진시,4427000000,초등학교,2020-04-01,남자,850,921,904,-17,-54,-71,-0.018458198,-0.059734513,-0.077090119
4618,2020,전북,전주시,4511000000,초등학교,2020-04-01,전체,6166,5849,5959,110,207,317,0.018806634,0.034737372,0.054197299
4619,2020,전북,전주시,4511000000,초등학교,2020-04-01,여자,3009,2857,2927,70,82,152,0.024501225,0.028015032,0.05320266
4620,2020,전북,전주시,4511000000,초등학교,2020-04-01,남자,3157,2992,3032,40,125,165,0.013368984,0.041226913,0.055147059
4621,2020,전북,군산시,4513000000,초등학교,2020-04-01,전체,2503,2551,2542,-9,-39,-48,-0.003528028,-0.01534225,-0.018816151
4622,2020,전북,군산시,4513000000,초등학교,2020-04-01,여자,1226,1240,1236,-4,-10,-14,-0.003225806,-0.008090615,-0.011290323
4623,2020,전북,군산시,4513000000,초등학교,2020-04-01,남자,1277,1311,1306,-5,-29,-34,-0.003813883,-0.022205207,-0.025934401
4624,2020,전북,익산시,4514000000,초등학교,2020-04-01,전체,2153,2268,2208,-60,-55,-115,-0.026455026,-0.02490942,-0.050705467
4625,2020,전북,익산시,4514000000,초등학교,2020-04-01,여자,1004,1093,1065,-28,-61,-89,-0.025617566,-0.057276995,-0.081427264
4626,2020,전북,익산시,4514000000,초등학교,2020-04-01,남자,1149,1175,1143,-32,6,-26,-0.027234043,0.005249344,-0.02212766
4627,2020,전북,정읍시,4518000000,초등학교,2020-04-01,전체,698,734,738,4,-40,-36,0.005449591,-0.054200542,-0.049046322
4628,2020,전북,정읍시,4518000000,초등학교,2020-04-01,여자,333,351,348,-3,-15,-18,-0.008547009,-0.043103448,-0.051282051
4629,2020,전북,정읍시,4518000000,초등학교,2020-04-01,남자,365,383,390,7,-25,-18,0.018276762,-0.064102564,-0.046997389
4630,2020,전북,남원시,4519000000,초등학교,2020-04-01,전체,531,528,519,-9,12,3,-0.017045455,0.023121387,0.005681818
4631,2020,전북,남원시,4519000000,초등학교,2020-04-01,여자,255,250,251,1,4,5,0.004,0.015936255,0.02
4632,2020,전북,남원시,4519000000,초등학교,2020-04-01,남자,276,278,268,-10,8,-2,-0.035971223,0.029850746,-0.007194245
4633,2020,전북,김제시,4521000000,초등학교,2020-04-01,전체,490,520,514,-6,-24,-30,-0.011538462,-0.046692607,-0.057692308
4634,2020,전북,김제시,4521000000,초등학교,2020-04-01,여자,222,247,245,-2,-23,-25,-0.008097166,-0.093877551,-0.101214575
4635,2020,전북,김제시,4521000000,초등학교,2020-04-01,남자,268,273,269,-4,-1,-5,-0.014652015,-0.003717472,-0.018315018
4636,2020,전북,완주군,4571000000,초등학교,2020-04-01,전체,702,904,875,-29,-173,-202,-0.032079646,-0.197714286,-0.223451327
4637,2020,전북,완주군,4571000000,초등학교,2020-04-01,여자,359,462,439,-23,-80,-103,-0.04978355,-0.182232346,-0.222943723
4638,2020,전북,완주군,4571000000,초등학교,2020-04-01,남자,343,442,436,-6,-93,-99,-0.013574661,-0.213302752,-0.2239819
4639,2020,전북,진안군,4572000000,초등학교,2020-04-01,전체,116,148,141,-7,-25,-32,-0.047297297,-0.177304965,-0.216216216
4640,2020,전북,진안군,4572000000,초등학교,2020-04-01,여자,66,82,80,-2,-14,-16,-0.024390244,-0.175,-0.195121951
4641,2020,전북,진안군,4572000000,초등학교,2020-04-01,남자,50,66,61,-5,-11,-16,-0.075757576,-0.180327869,-0.242424242
4642,2020,전북,무주군,4573000000,초등학교,2020-04-01,전체,123,139,139,0,-16,-16,0,-0.115107914,-0.115107914
4643,2020,전북,무주군,4573000000,초등학교,2020-04-01,여자,58,66,67,1,-9,-8,0.015151515,-0.134328358,-0.121212121
4644,2020,전북,무주군,4573000000,초등학교,2020-04-01,남자,65,73,72,-1,-7,-8,-0.01369863,-0.097222222,-0.109589041
4645,2020,전북,장수군,4574000000,초등학교,2020-04-01,전체,136,144,148,4,-12,-8,0.027777778,-0.081081081,-0.055555556
4646,2020,전북,장수군,4574000000,초등학교,2020-04-01,여자,61,70,70,0,-9,-9,0,-0.128571429,-0.128571429
4647,2020,전북,장수군,4574000000,초등학교,2020-04-01,남자,75,74,78,4,-3,1,0.054054054,-0.038461538,0.013513514
4648,2020,전북,임실군,4575000000,초등학교,2020-04-01,전체,139,157,146,-11,-7,-18,-0.070063694,-0.047945205,-0.114649682
4649,2020,전북,임실군,4575000000,초등학교,2020-04-01,여자,75,79,74,-5,1,-4,-0.063291139,0.013513514,-0.050632911
4650,2020,전북,임실군,4575000000,초등학교,2020-04-01,남자,64,78,72,-6,-8,-14,-0.076923077,-0.111111111,-0.179487179
4651,2020,전북,순창군,4577000000,초등학교,2020-04-01,전체,133,159,154,-5,-21,-26,-0.031446541,-0.136363636,-0.163522013
4652,2020,전북,순창군,4577000000,초등학교,2020-04-01,여자,59,80,75,-5,-16,-21,-0.0625,-0.213333333,-0.2625
4653,2020,전북,순창군,4577000000,초등학교,2020-04-01,남자,74,79,79,0,-5,-5,0,-0.063291139,-0.063291139
4654,2020,전북,고창군,4579000000,초등학교,2020-04-01,전체,273,324,321,-3,-48,-51,-0.009259259,-0.14953271,-0.157407407
4655,2020,전북,고창군,4579000000,초등학교,2020-04-01,여자,127,143,143,0,-16,-16,0,-0.111888112,-0.111888112
4656,2020,전북,고창군,4579000000,초등학교,2020-04-01,남자,146,181,178,-3,-32,-35,-0.016574586,-0.179775281,-0.193370166
4657,2020,전북,부안군,4580000000,초등학교,2020-04-01,전체,279,321,310,-11,-31,-42,-0.034267913,-0.1,-0.130841121
4658,2020,전북,부안군,4580000000,초등학교,2020-04-01,여자,133,169,163,-6,-30,-36,-0.035502959,-0.18404908,-0.213017751
4659,2020,전북,부안군,4580000000,초등학교,2020-04-01,남자,146,152,147,-5,-1,-6,-0.032894737,-0.006802721,-0.039473684
4660,2020,전남,목포시,4611000000,초등학교,2020-04-01,전체,2389,2164,2169,5,220,225,0.002310536,0.10142923,0.103974122
4661,2020,전남,목포시,4611000000,초등학교,2020-04-01,여자,1179,1049,1059,10,120,130,0.009532888,0.113314448,0.12392755
4662,2020,전남,목포시,4611000000,초등학교,2020-04-01,남자,1210,1115,1110,-5,100,95,-0.004484305,0.09009009,0.085201794
4663,2020,전남,여수시,4613000000,초등학교,2020-04-01,전체,2306,2366,2322,-44,-16,-60,-0.018596788,-0.006890612,-0.025359256
4664,2020,전남,여수시,4613000000,초등학교,2020-04-01,여자,1104,1110,1082,-28,22,-6,-0.025225225,0.020332717,-0.005405405
4665,2020,전남,여수시,4613000000,초등학교,2020-04-01,남자,1202,1256,1240,-16,-38,-54,-0.012738854,-0.030645161,-0.042993631
4666,2020,전남,순천시,4615000000,초등학교,2020-04-01,전체,2627,2480,2548,68,79,147,0.027419355,0.03100471,0.059274194
4667,2020,전남,순천시,4615000000,초등학교,2020-04-01,여자,1297,1230,1272,42,25,67,0.034146341,0.019654088,0.054471545
4668,2020,전남,순천시,4615000000,초등학교,2020-04-01,남자,1330,1250,1276,26,54,80,0.0208,0.042319749,0.064
4669,2020,전남,나주시,4617000000,초등학교,2020-04-01,전체,989,1067,1088,21,-99,-78,0.01968135,-0.090992647,-0.073102156
4670,2020,전남,나주시,4617000000,초등학교,2020-04-01,여자,469,490,501,11,-32,-21,0.02244898,-0.063872255,-0.042857143
4671,2020,전남,나주시,4617000000,초등학교,2020-04-01,남자,520,577,587,10,-67,-57,0.017331023,-0.114139693,-0.098786828
4672,2020,전남,광양시,4623000000,초등학교,2020-04-01,전체,1444,1541,1486,-55,-42,-97,-0.03569111,-0.028263795,-0.062946139
4673,2020,전남,광양시,4623000000,초등학교,2020-04-01,여자,711,793,762,-31,-51,-82,-0.039092055,-0.066929134,-0.103404792
4674,2020,전남,광양시,4623000000,초등학교,2020-04-01,남자,733,748,724,-24,9,-15,-0.032085561,0.012430939,-0.020053476
4675,2020,전남,담양군,4671000000,초등학교,2020-04-01,전체,198,236,231,-5,-33,-38,-0.021186441,-0.142857143,-0.161016949
4676,2020,전남,담양군,4671000000,초등학교,2020-04-01,여자,100,106,108,2,-8,-6,0.018867925,-0.074074074,-0.056603774
4677,2020,전남,담양군,4671000000,초등학교,2020-04-01,남자,98,130,123,-7,-25,-32,-0.053846154,-0.203252033,-0.246153846
4678,2020,전남,곡성군,4672000000,초등학교,2020-04-01,전체,113,129,121,-8,-8,-16,-0.062015504,-0.066115702,-0.124031008
4679,2020,전남,곡성군,4672000000,초등학교,2020-04-01,여자,48,64,60,-4,-12,-16,-0.0625,-0.2,-0.25
4680,2020,전남,곡성군,4672000000,초등학교,2020-04-01,남자,65,65,61,-4,4,0,-0.061538462,0.06557377,0
4681,2020,전남,구례군,4673000000,초등학교,2020-04-01,전체,139,131,139,8,0,8,0.061068702,0,0.061068702
4682,2020,전남,구례군,4673000000,초등학교,2020-04-01,여자,69,65,65,0,4,4,0,0.061538462,0.061538462
4683,2020,전남,구례군,4673000000,초등학교,2020-04-01,남자,70,66,74,8,-4,4,0.121212121,-0.054054054,0.060606061
4684,2020,전남,고흥군,4677000000,초등학교,2020-04-01,전체,260,274,266,-8,-6,-14,-0.02919708,-0.022556391,-0.051094891
4685,2020,전남,고흥군,4677000000,초등학교,2020-04-01,여자,115,129,127,-2,-12,-14,-0.015503876,-0.094488189,-0.108527132
4686,2020,전남,고흥군,4677000000,초등학교,2020-04-01,남자,145,145,139,-6,6,0,-0.04137931,0.043165468,0
4687,2020,전남,보성군,4678000000,초등학교,2020-04-01,전체,170,232,212,-20,-42,-62,-0.086206897,-0.198113208,-0.267241379
4688,2020,전남,보성군,4678000000,초등학교,2020-04-01,여자,85,116,105,-11,-20,-31,-0.094827586,-0.19047619,-0.267241379
4689,2020,전남,보성군,4678000000,초등학교,2020-04-01,남자,85,116,107,-9,-22,-31,-0.077586207,-0.205607477,-0.267241379
4690,2020,전남,화순군,4679000000,초등학교,2020-04-01,전체,378,408,397,-11,-19,-30,-0.026960784,-0.047858942,-0.073529412
4691,2020,전남,화순군,4679000000,초등학교,2020-04-01,여자,179,202,198,-4,-19,-23,-0.01980198,-0.095959596,-0.113861386
4692,2020,전남,화순군,4679000000,초등학교,2020-04-01,남자,199,206,199,-7,0,-7,-0.033980583,0,-0.033980583
4693,2020,전남,장흥군,4680000000,초등학교,2020-04-01,전체,221,220,225,5,-4,1,0.022727273,-0.017777778,0.004545455
4694,2020,전남,장흥군,4680000000,초등학교,2020-04-01,여자,121,105,107,2,14,16,0.019047619,0.130841121,0.152380952
4695,2020,전남,장흥군,4680000000,초등학교,2020-04-01,남자,100,115,118,3,-18,-15,0.026086957,-0.152542373,-0.130434783
4696,2020,전남,강진군,4681000000,초등학교,2020-04-01,전체,181,221,204,-17,-23,-40,-0.076923077,-0.112745098,-0.180995475
4697,2020,전남,강진군,4681000000,초등학교,2020-04-01,여자,86,104,99,-5,-13,-18,-0.048076923,-0.131313131,-0.173076923
4698,2020,전남,강진군,4681000000,초등학교,2020-04-01,남자,95,117,105,-12,-10,-22,-0.102564103,-0.095238095,-0.188034188
4699,2020,전남,해남군,4682000000,초등학교,2020-04-01,전체,376,450,420,-30,-44,-74,-0.066666667,-0.104761905,-0.164444444
4700,2020,전남,해남군,4682000000,초등학교,2020-04-01,여자,203,246,218,-28,-15,-43,-0.113821138,-0.068807339,-0.174796748
4701,2020,전남,해남군,4682000000,초등학교,2020-04-01,남자,173,204,202,-2,-29,-31,-0.009803922,-0.143564356,-0.151960784
4702,2020,전남,영암군,4683000000,초등학교,2020-04-01,전체,412,434,414,-20,-2,-22,-0.046082949,-0.004830918,-0.050691244
4703,2020,전남,영암군,4683000000,초등학교,2020-04-01,여자,208,218,210,-8,-2,-10,-0.036697248,-0.00952381,-0.04587156
4704,2020,전남,영암군,4683000000,초등학교,2020-04-01,남자,204,216,204,-12,0,-12,-0.055555556,0,-0.055555556
4705,2020,전남,무안군,4684000000,초등학교,2020-04-01,전체,702,797,804,7,-102,-95,0.008782936,-0.126865672,-0.119196989
4706,2020,전남,무안군,4684000000,초등학교,2020-04-01,여자,340,394,392,-2,-52,-54,-0.005076142,-0.132653061,-0.137055838
4707,2020,전남,무안군,4684000000,초등학교,2020-04-01,남자,362,403,412,9,-50,-41,0.022332506,-0.121359223,-0.101736973
4708,2020,전남,함평군,4686000000,초등학교,2020-04-01,전체,152,185,171,-14,-19,-33,-0.075675676,-0.111111111,-0.178378378
4709,2020,전남,함평군,4686000000,초등학교,2020-04-01,여자,74,91,86,-5,-12,-17,-0.054945055,-0.139534884,-0.186813187
4710,2020,전남,함평군,4686000000,초등학교,2020-04-01,남자,78,94,85,-9,-7,-16,-0.095744681,-0.082352941,-0.170212766
4711,2020,전남,영광군,4687000000,초등학교,2020-04-01,전체,312,325,330,5,-18,-13,0.015384615,-0.054545455,-0.04
4712,2020,전남,영광군,4687000000,초등학교,2020-04-01,여자,160,172,177,5,-17,-12,0.029069767,-0.096045198,-0.069767442
4713,2020,전남,영광군,4687000000,초등학교,2020-04-01,남자,152,153,153,0,-1,-1,0,-0.006535948,-0.006535948
4714,2020,전남,장성군,4688000000,초등학교,2020-04-01,전체,271,331,317,-14,-46,-60,-0.042296073,-0.14511041,-0.181268882
4715,2020,전남,장성군,4688000000,초등학교,2020-04-01,여자,133,155,147,-8,-14,-22,-0.051612903,-0.095238095,-0.141935484
4716,2020,전남,장성군,4688000000,초등학교,2020-04-01,남자,138,176,170,-6,-32,-38,-0.034090909,-0.188235294,-0.215909091
4717,2020,전남,완도군,4689000000,초등학교,2020-04-01,전체,315,390,367,-23,-52,-75,-0.058974359,-0.141689373,-0.192307692
4718,2020,전남,완도군,4689000000,초등학교,2020-04-01,여자,153,196,186,-10,-33,-43,-0.051020408,-0.177419355,-0.219387755
4719,2020,전남,완도군,4689000000,초등학교,2020-04-01,남자,162,194,181,-13,-19,-32,-0.067010309,-0.104972376,-0.164948454
4720,2020,전남,진도군,4690000000,초등학교,2020-04-01,전체,171,175,175,0,-4,-4,0,-0.022857143,-0.022857143
4721,2020,전남,진도군,4690000000,초등학교,2020-04-01,여자,78,94,95,1,-17,-16,0.010638298,-0.178947368,-0.170212766
4722,2020,전남,진도군,4690000000,초등학교,2020-04-01,남자,93,81,80,-1,13,12,-0.012345679,0.1625,0.148148148
4723,2020,전남,신안군,4691000000,초등학교,2020-04-01,전체,143,205,185,-20,-42,-62,-0.097560976,-0.227027027,-0.302439024
4724,2020,전남,신안군,4691000000,초등학교,2020-04-01,여자,67,99,89,-10,-22,-32,-0.101010101,-0.247191011,-0.323232323
4725,2020,전남,신안군,4691000000,초등학교,2020-04-01,남자,76,106,96,-10,-20,-30,-0.094339623,-0.208333333,-0.283018868
4726,2020,경북,포항시,4711000000,초등학교,2020-04-01,전체,4488,4540,4583,43,-95,-52,0.009471366,-0.02072878,-0.011453744
4727,2020,경북,포항시,4711000000,초등학교,2020-04-01,여자,2190,2179,2221,42,-31,11,0.019274897,-0.013957677,0.005048187
4728,2020,경북,포항시,4711000000,초등학교,2020-04-01,남자,2298,2361,2362,1,-64,-63,0.000423549,-0.027095682,-0.026683609
4729,2020,경북,경주시,4713000000,초등학교,2020-04-01,전체,1768,1784,1806,22,-38,-16,0.012331839,-0.021040975,-0.00896861
4730,2020,경북,경주시,4713000000,초등학교,2020-04-01,여자,827,856,869,13,-42,-29,0.015186916,-0.048331415,-0.033878505
4731,2020,경북,경주시,4713000000,초등학교,2020-04-01,남자,941,928,937,9,4,13,0.009698276,0.004268943,0.014008621
4732,2020,경북,김천시,4715000000,초등학교,2020-04-01,전체,1118,1182,1163,-19,-45,-64,-0.01607445,-0.038693035,-0.054145516
4733,2020,경북,김천시,4715000000,초등학교,2020-04-01,여자,516,571,561,-10,-45,-55,-0.017513135,-0.080213904,-0.096322242
4734,2020,경북,김천시,4715000000,초등학교,2020-04-01,남자,602,611,602,-9,0,-9,-0.014729951,0,-0.014729951
4735,2020,경북,안동시,4717000000,초등학교,2020-04-01,전체,1315,1212,1199,-13,116,103,-0.010726073,0.096747289,0.084983498
4736,2020,경북,안동시,4717000000,초등학교,2020-04-01,여자,629,601,581,-20,48,28,-0.03327787,0.082616179,0.046589018
4737,2020,경북,안동시,4717000000,초등학교,2020-04-01,남자,686,611,618,7,68,75,0.011456628,0.110032362,0.122749591
4738,2020,경북,구미시,4719000000,초등학교,2020-04-01,전체,4552,4663,4638,-25,-86,-111,-0.005361355,-0.018542475,-0.023804418
4739,2020,경북,구미시,4719000000,초등학교,2020-04-01,여자,2190,2228,2217,-11,-27,-38,-0.004937163,-0.01217862,-0.017055655
4740,2020,경북,구미시,4719000000,초등학교,2020-04-01,남자,2362,2435,2421,-14,-59,-73,-0.005749487,-0.024370095,-0.029979466
4741,2020,경북,영주시,4721000000,초등학교,2020-04-01,전체,666,719,713,-6,-47,-53,-0.008344924,-0.065918654,-0.073713491
4742,2020,경북,영주시,4721000000,초등학교,2020-04-01,여자,333,333,330,-3,3,0,-0.009009009,0.009090909,0
4743,2020,경북,영주시,4721000000,초등학교,2020-04-01,남자,333,386,383,-3,-50,-53,-0.007772021,-0.130548303,-0.137305699
4744,2020,경북,영천시,4723000000,초등학교,2020-04-01,전체,542,620,601,-19,-59,-78,-0.030645161,-0.098169717,-0.125806452
4745,2020,경북,영천시,4723000000,초등학교,2020-04-01,여자,271,289,283,-6,-12,-18,-0.020761246,-0.042402827,-0.062283737
4746,2020,경북,영천시,4723000000,초등학교,2020-04-01,남자,271,331,318,-13,-47,-60,-0.039274924,-0.147798742,-0.181268882
4747,2020,경북,상주시,4725000000,초등학교,2020-04-01,전체,564,553,544,-9,20,11,-0.016274864,0.036764706,0.019891501
4748,2020,경북,상주시,4725000000,초등학교,2020-04-01,여자,276,269,264,-5,12,7,-0.018587361,0.045454545,0.026022305
4749,2020,경북,상주시,4725000000,초등학교,2020-04-01,남자,288,284,280,-4,8,4,-0.014084507,0.028571429,0.014084507
4750,2020,경북,문경시,4728000000,초등학교,2020-04-01,전체,415,455,444,-11,-29,-40,-0.024175824,-0.065315315,-0.087912088
4751,2020,경북,문경시,4728000000,초등학교,2020-04-01,여자,192,217,216,-1,-24,-25,-0.004608295,-0.111111111,-0.115207373
4752,2020,경북,문경시,4728000000,초등학교,2020-04-01,남자,223,238,228,-10,-5,-15,-0.042016807,-0.021929825,-0.06302521
4753,2020,경북,경산시,4729000000,초등학교,2020-04-01,전체,2228,2359,2365,6,-137,-131,0.002543451,-0.057928118,-0.055532005
4754,2020,경북,경산시,4729000000,초등학교,2020-04-01,여자,1098,1173,1194,21,-96,-75,0.017902813,-0.08040201,-0.063938619
4755,2020,경북,경산시,4729000000,초등학교,2020-04-01,남자,1130,1186,1171,-15,-41,-56,-0.012647555,-0.03501281,-0.047217538
4756,2020,경북,군위군,4772000000,초등학교,2020-04-01,전체,66,82,73,-9,-7,-16,-0.109756098,-0.095890411,-0.195121951
4757,2020,경북,군위군,4772000000,초등학교,2020-04-01,여자,22,41,36,-5,-14,-19,-0.12195122,-0.388888889,-0.463414634
4758,2020,경북,군위군,4772000000,초등학교,2020-04-01,남자,44,41,37,-4,7,3,-0.097560976,0.189189189,0.073170732
4759,2020,경북,의성군,4773000000,초등학교,2020-04-01,전체,162,221,210,-11,-48,-59,-0.049773756,-0.228571429,-0.266968326
4760,2020,경북,의성군,4773000000,초등학교,2020-04-01,여자,79,104,99,-5,-20,-25,-0.048076923,-0.202020202,-0.240384615
4761,2020,경북,의성군,4773000000,초등학교,2020-04-01,남자,83,117,111,-6,-28,-34,-0.051282051,-0.252252252,-0.290598291
4762,2020,경북,청송군,4775000000,초등학교,2020-04-01,전체,104,125,117,-8,-13,-21,-0.064,-0.111111111,-0.168
4763,2020,경북,청송군,4775000000,초등학교,2020-04-01,여자,59,62,62,0,-3,-3,0,-0.048387097,-0.048387097
4764,2020,경북,청송군,4775000000,초등학교,2020-04-01,남자,45,63,55,-8,-10,-18,-0.126984127,-0.181818182,-0.285714286
4765,2020,경북,영양군,4776000000,초등학교,2020-04-01,전체,77,83,77,-6,0,-6,-0.072289157,0,-0.072289157
4766,2020,경북,영양군,4776000000,초등학교,2020-04-01,여자,31,32,28,-4,3,-1,-0.125,0.107142857,-0.03125
4767,2020,경북,영양군,4776000000,초등학교,2020-04-01,남자,46,51,49,-2,-3,-5,-0.039215686,-0.06122449,-0.098039216
4768,2020,경북,영덕군,4777000000,초등학교,2020-04-01,전체,169,204,201,-3,-32,-35,-0.014705882,-0.15920398,-0.171568627
4769,2020,경북,영덕군,4777000000,초등학교,2020-04-01,여자,81,98,92,-6,-11,-17,-0.06122449,-0.119565217,-0.173469388
4770,2020,경북,영덕군,4777000000,초등학교,2020-04-01,남자,88,106,109,3,-21,-18,0.028301887,-0.19266055,-0.169811321
4771,2020,경북,청도군,4782000000,초등학교,2020-04-01,전체,145,170,168,-2,-23,-25,-0.011764706,-0.136904762,-0.147058824
4772,2020,경북,청도군,4782000000,초등학교,2020-04-01,여자,71,91,90,-1,-19,-20,-0.010989011,-0.211111111,-0.21978022
4773,2020,경북,청도군,4782000000,초등학교,2020-04-01,남자,74,79,78,-1,-4,-5,-0.012658228,-0.051282051,-0.063291139
4774,2020,경북,고령군,4783000000,초등학교,2020-04-01,전체,153,206,185,-21,-32,-53,-0.101941748,-0.172972973,-0.257281553
4775,2020,경북,고령군,4783000000,초등학교,2020-04-01,여자,77,96,85,-11,-8,-19,-0.114583333,-0.094117647,-0.197916667
4776,2020,경북,고령군,4783000000,초등학교,2020-04-01,남자,76,110,100,-10,-24,-34,-0.090909091,-0.24,-0.309090909
4777,2020,경북,성주군,4784000000,초등학교,2020-04-01,전체,162,198,188,-10,-26,-36,-0.050505051,-0.138297872,-0.181818182
4778,2020,경북,성주군,4784000000,초등학교,2020-04-01,여자,82,102,98,-4,-16,-20,-0.039215686,-0.163265306,-0.196078431
4779,2020,경북,성주군,4784000000,초등학교,2020-04-01,남자,80,96,90,-6,-10,-16,-0.0625,-0.111111111,-0.166666667
4780,2020,경북,칠곡군,4785000000,초등학교,2020-04-01,전체,1123,1156,1133,-23,-10,-33,-0.019896194,-0.008826125,-0.028546713
4781,2020,경북,칠곡군,4785000000,초등학교,2020-04-01,여자,523,530,523,-7,0,-7,-0.013207547,0,-0.013207547
4782,2020,경북,칠곡군,4785000000,초등학교,2020-04-01,남자,600,626,610,-16,-10,-26,-0.025559105,-0.016393443,-0.041533546
4783,2020,경북,예천군,4790000000,초등학교,2020-04-01,전체,394,430,486,56,-92,-36,0.130232558,-0.189300412,-0.08372093
4784,2020,경북,예천군,4790000000,초등학교,2020-04-01,여자,190,214,249,35,-59,-24,0.163551402,-0.236947791,-0.112149533
4785,2020,경북,예천군,4790000000,초등학교,2020-04-01,남자,204,216,237,21,-33,-12,0.097222222,-0.139240506,-0.055555556
4786,2020,경북,봉화군,4792000000,초등학교,2020-04-01,전체,132,166,153,-13,-21,-34,-0.078313253,-0.137254902,-0.204819277
4787,2020,경북,봉화군,4792000000,초등학교,2020-04-01,여자,63,79,71,-8,-8,-16,-0.101265823,-0.112676056,-0.202531646
4788,2020,경북,봉화군,4792000000,초등학교,2020-04-01,남자,69,87,82,-5,-13,-18,-0.057471264,-0.158536585,-0.206896552
4789,2020,경북,울진군,4793000000,초등학교,2020-04-01,전체,299,342,328,-14,-29,-43,-0.040935673,-0.088414634,-0.125730994
4790,2020,경북,울진군,4793000000,초등학교,2020-04-01,여자,151,179,172,-7,-21,-28,-0.039106145,-0.122093023,-0.156424581
4791,2020,경북,울진군,4793000000,초등학교,2020-04-01,남자,148,163,156,-7,-8,-15,-0.042944785,-0.051282051,-0.09202454
4792,2020,경북,울릉군,4794000000,초등학교,2020-04-01,전체,50,50,53,3,-3,0,0.06,-0.056603774,0
4793,2020,경북,울릉군,4794000000,초등학교,2020-04-01,여자,28,31,30,-1,-2,-3,-0.032258065,-0.066666667,-0.096774194
4794,2020,경북,울릉군,4794000000,초등학교,2020-04-01,남자,22,19,23,4,-1,3,0.210526316,-0.043478261,0.157894737
4795,2020,경남,진주시,4817000000,초등학교,2020-04-01,전체,3121,3091,3162,71,-41,30,0.022969913,-0.012966477,0.009705597
4796,2020,경남,진주시,4817000000,초등학교,2020-04-01,여자,1451,1455,1492,37,-41,-4,0.025429553,-0.027479893,-0.002749141
4797,2020,경남,진주시,4817000000,초등학교,2020-04-01,남자,1670,1636,1670,34,0,34,0.020782396,0,0.020782396
4798,2020,경남,통영시,4822000000,초등학교,2020-04-01,전체,1103,1197,1179,-18,-76,-94,-0.015037594,-0.064461408,-0.078529657
4799,2020,경남,통영시,4822000000,초등학교,2020-04-01,여자,534,591,580,-11,-46,-57,-0.018612521,-0.079310345,-0.096446701
4800,2020,경남,통영시,4822000000,초등학교,2020-04-01,남자,569,606,599,-7,-30,-37,-0.011551155,-0.050083472,-0.061056106
4801,2020,경남,사천시,4824000000,초등학교,2020-04-01,전체,904,1013,1001,-12,-97,-109,-0.011846002,-0.096903097,-0.107601185
4802,2020,경남,사천시,4824000000,초등학교,2020-04-01,여자,423,517,510,-7,-87,-94,-0.013539652,-0.170588235,-0.181818182
4803,2020,경남,사천시,4824000000,초등학교,2020-04-01,남자,481,496,491,-5,-10,-15,-0.010080645,-0.020366599,-0.030241935
4804,2020,경남,김해시,4825000000,초등학교,2020-04-01,전체,5602,5431,5500,69,102,171,0.012704843,0.018545455,0.031485914
4805,2020,경남,김해시,4825000000,초등학교,2020-04-01,여자,2773,2700,2734,34,39,73,0.012592593,0.014264813,0.027037037
4806,2020,경남,김해시,4825000000,초등학교,2020-04-01,남자,2829,2731,2766,35,63,98,0.012815818,0.022776573,0.035884291
4807,2020,경남,밀양시,4827000000,초등학교,2020-04-01,전체,607,603,599,-4,8,4,-0.006633499,0.013355593,0.006633499
4808,2020,경남,밀양시,4827000000,초등학교,2020-04-01,여자,309,302,300,-2,9,7,-0.006622517,0.03,0.023178808
4809,2020,경남,밀양시,4827000000,초등학교,2020-04-01,남자,298,301,299,-2,-1,-3,-0.006644518,-0.003344482,-0.009966777
4810,2020,경남,거제시,4831000000,초등학교,2020-04-01,전체,3038,3225,3151,-74,-113,-187,-0.022945736,-0.035861631,-0.057984496
4811,2020,경남,거제시,4831000000,초등학교,2020-04-01,여자,1465,1594,1558,-36,-93,-129,-0.022584693,-0.059691913,-0.080928482
4812,2020,경남,거제시,4831000000,초등학교,2020-04-01,남자,1573,1631,1593,-38,-20,-58,-0.02329859,-0.012554928,-0.035561006
4813,2020,경남,양산시,4833000000,초등학교,2020-04-01,전체,3713,3882,3861,-21,-148,-169,-0.005409583,-0.038332038,-0.043534261
4814,2020,경남,양산시,4833000000,초등학교,2020-04-01,여자,1851,1905,1892,-13,-41,-54,-0.006824147,-0.02167019,-0.028346457
4815,2020,경남,양산시,4833000000,초등학교,2020-04-01,남자,1862,1977,1969,-8,-107,-115,-0.004046535,-0.054342306,-0.058168943
4816,2020,경남,의령군,4872000000,초등학교,2020-04-01,전체,96,129,123,-6,-27,-33,-0.046511628,-0.219512195,-0.255813953
4817,2020,경남,의령군,4872000000,초등학교,2020-04-01,여자,44,51,51,0,-7,-7,0,-0.137254902,-0.137254902
4818,2020,경남,의령군,4872000000,초등학교,2020-04-01,남자,52,78,72,-6,-20,-26,-0.076923077,-0.277777778,-0.333333333
4819,2020,경남,함안군,4873000000,초등학교,2020-04-01,전체,502,540,532,-8,-30,-38,-0.014814815,-0.056390977,-0.07037037
4820,2020,경남,함안군,4873000000,초등학교,2020-04-01,여자,257,282,275,-7,-18,-25,-0.024822695,-0.065454545,-0.088652482
4821,2020,경남,함안군,4873000000,초등학교,2020-04-01,남자,245,258,257,-1,-12,-13,-0.003875969,-0.046692607,-0.050387597
4822,2020,경남,창녕군,4874000000,초등학교,2020-04-01,전체,354,418,405,-13,-51,-64,-0.031100478,-0.125925926,-0.153110048
4823,2020,경남,창녕군,4874000000,초등학교,2020-04-01,여자,161,193,191,-2,-30,-32,-0.010362694,-0.157068063,-0.165803109
4824,2020,경남,창녕군,4874000000,초등학교,2020-04-01,남자,193,225,214,-11,-21,-32,-0.048888889,-0.098130841,-0.142222222
4825,2020,경남,고성군,4882000000,초등학교,2020-04-01,전체,309,334,327,-7,-18,-25,-0.020958084,-0.055045872,-0.074850299
4826,2020,경남,고성군,4882000000,초등학교,2020-04-01,여자,167,185,181,-4,-14,-18,-0.021621622,-0.077348066,-0.097297297
4827,2020,경남,고성군,4882000000,초등학교,2020-04-01,남자,142,149,146,-3,-4,-7,-0.020134228,-0.02739726,-0.046979866
4828,2020,경남,남해군,4884000000,초등학교,2020-04-01,전체,152,161,168,7,-16,-9,0.043478261,-0.095238095,-0.055900621
4829,2020,경남,남해군,4884000000,초등학교,2020-04-01,여자,81,78,80,2,1,3,0.025641026,0.0125,0.038461538
4830,2020,경남,남해군,4884000000,초등학교,2020-04-01,남자,71,83,88,5,-17,-12,0.060240964,-0.193181818,-0.144578313
4831,2020,경남,하동군,4885000000,초등학교,2020-04-01,전체,171,188,180,-8,-9,-17,-0.042553191,-0.05,-0.090425532
4832,2020,경남,하동군,4885000000,초등학교,2020-04-01,여자,75,77,76,-1,-1,-2,-0.012987013,-0.013157895,-0.025974026
4833,2020,경남,하동군,4885000000,초등학교,2020-04-01,남자,96,111,104,-7,-8,-15,-0.063063063,-0.076923077,-0.135135135
4834,2020,경남,산청군,4886000000,초등학교,2020-04-01,전체,139,164,150,-14,-11,-25,-0.085365854,-0.073333333,-0.152439024
4835,2020,경남,산청군,4886000000,초등학교,2020-04-01,여자,62,71,70,-1,-8,-9,-0.014084507,-0.114285714,-0.126760563
4836,2020,경남,산청군,4886000000,초등학교,2020-04-01,남자,77,93,80,-13,-3,-16,-0.139784946,-0.0375,-0.172043011
4837,2020,경남,함양군,4887000000,초등학교,2020-04-01,전체,216,219,223,4,-7,-3,0.01826484,-0.031390135,-0.01369863
4838,2020,경남,함양군,4887000000,초등학교,2020-04-01,여자,111,109,111,2,0,2,0.018348624,0,0.018348624
4839,2020,경남,함양군,4887000000,초등학교,2020-04-01,남자,105,110,112,2,-7,-5,0.018181818,-0.0625,-0.045454545
4840,2020,경남,거창군,4888000000,초등학교,2020-04-01,전체,427,455,458,3,-31,-28,0.006593407,-0.06768559,-0.061538462
4841,2020,경남,거창군,4888000000,초등학교,2020-04-01,여자,208,223,227,4,-19,-15,0.01793722,-0.083700441,-0.067264574
4842,2020,경남,거창군,4888000000,초등학교,2020-04-01,남자,219,232,231,-1,-12,-13,-0.004310345,-0.051948052,-0.056034483
4843,2020,경남,합천군,4889000000,초등학교,2020-04-01,전체,183,213,207,-6,-24,-30,-0.028169014,-0.115942029,-0.14084507
4844,2020,경남,합천군,4889000000,초등학교,2020-04-01,여자,88,108,108,0,-20,-20,0,-0.185185185,-0.185185185
4845,2020,경남,합천군,4889000000,초등학교,2020-04-01,남자,95,105,99,-6,-4,-10,-0.057142857,-0.04040404,-0.095238095
4846,2020,제주,제주시,5011000000,초등학교,2020-04-01,전체,4989,4883,5005,122,-16,106,0.024984641,-0.003196803,0.021707966
4847,2020,제주,제주시,5011000000,초등학교,2020-04-01,여자,2422,2392,2463,71,-41,30,0.029682274,-0.016646366,0.012541806
4848,2020,제주,제주시,5011000000,초등학교,2020-04-01,남자,2567,2491,2542,51,25,76,0.020473705,0.009834776,0.030509835
4849,2020,제주,서귀포시,5013000000,초등학교,2020-04-01,전체,1437,1543,1542,-1,-105,-106,-0.000648088,-0.068093385,-0.068697343
4850,2020,제주,서귀포시,5013000000,초등학교,2020-04-01,여자,731,769,779,10,-48,-38,0.013003901,-0.061617458,-0.049414824
4851,2020,제주,서귀포시,5013000000,초등학교,2020-04-01,남자,706,774,763,-11,-57,-68,-0.014211886,-0.074705111,-0.087855297
4852,2013,서울,종로구,1111000000,초등학교,2013-04-01,전체,988,1059,1047,-12,-59,-71,-0.011331445,-0.05635148,-0.067044381
4853,2013,서울,종로구,1111000000,초등학교,2013-04-01,여자,460,514,519,5,-59,-54,0.009727626,-0.113680154,-0.105058366
4854,2013,서울,종로구,1111000000,초등학교,2013-04-01,남자,528,545,528,-17,0,-17,-0.031192661,0,-0.031192661
4855,2013,서울,중구,1114000000,초등학교,2013-04-01,전체,951,912,914,2,37,39,0.002192982,0.0404814,0.042763158
4856,2013,서울,중구,1114000000,초등학교,2013-04-01,여자,482,429,429,0,53,53,0,0.123543124,0.123543124
4857,2013,서울,중구,1114000000,초등학교,2013-04-01,남자,469,483,485,2,-16,-14,0.004140787,-0.032989691,-0.028985507
4858,2013,서울,용산구,1117000000,초등학교,2013-04-01,전체,1386,1848,1848,0,-462,-462,0,-0.25,-0.25
4859,2013,서울,용산구,1117000000,초등학교,2013-04-01,여자,659,908,899,-9,-240,-249,-0.009911894,-0.266963293,-0.274229075
4860,2013,서울,용산구,1117000000,초등학교,2013-04-01,남자,727,940,949,9,-222,-213,0.009574468,-0.233930453,-0.226595745
4861,2013,서울,성동구,1120000000,초등학교,2013-04-01,전체,2223,2527,2395,-132,-172,-304,-0.052235853,-0.071816284,-0.120300752
4862,2013,서울,성동구,1120000000,초등학교,2013-04-01,여자,1068,1229,1160,-69,-92,-161,-0.056143206,-0.079310345,-0.131000814
4863,2013,서울,성동구,1120000000,초등학교,2013-04-01,남자,1155,1298,1235,-63,-80,-143,-0.04853621,-0.064777328,-0.110169492
4864,2013,서울,광진구,1121500000,초등학교,2013-04-01,전체,2689,2769,2676,-93,13,-80,-0.033586132,0.004857997,-0.028891296
4865,2013,서울,광진구,1121500000,초등학교,2013-04-01,여자,1348,1420,1376,-44,-28,-72,-0.030985915,-0.020348837,-0.050704225
4866,2013,서울,광진구,1121500000,초등학교,2013-04-01,남자,1341,1349,1300,-49,41,-8,-0.036323202,0.031538462,-0.005930319
4867,2013,서울,동대문구,1123000000,초등학교,2013-04-01,전체,2501,2764,2682,-82,-181,-263,-0.029667149,-0.06748695,-0.095151954
4868,2013,서울,동대문구,1123000000,초등학교,2013-04-01,여자,1241,1415,1358,-57,-117,-174,-0.040282686,-0.086156112,-0.122968198
4869,2013,서울,동대문구,1123000000,초등학교,2013-04-01,남자,1260,1349,1324,-25,-64,-89,-0.018532246,-0.048338369,-0.065974796
4870,2013,서울,중랑구,1126000000,초등학교,2013-04-01,전체,2747,3203,3133,-70,-386,-456,-0.021854511,-0.123204596,-0.142366531
4871,2013,서울,중랑구,1126000000,초등학교,2013-04-01,여자,1295,1500,1503,3,-208,-205,0.002,-0.138389887,-0.136666667
4872,2013,서울,중랑구,1126000000,초등학교,2013-04-01,남자,1452,1703,1630,-73,-178,-251,-0.042865531,-0.109202454,-0.147386964
4873,2013,서울,성북구,1129000000,초등학교,2013-04-01,전체,4035,4441,4295,-146,-260,-406,-0.032875478,-0.060535506,-0.091420851
4874,2013,서울,성북구,1129000000,초등학교,2013-04-01,여자,1966,2158,2095,-63,-129,-192,-0.029193698,-0.061575179,-0.08897127
4875,2013,서울,성북구,1129000000,초등학교,2013-04-01,남자,2069,2283,2200,-83,-131,-214,-0.036355672,-0.059545455,-0.093736312
4876,2013,서울,강북구,1130500000,초등학교,2013-04-01,전체,1972,2536,2504,-32,-532,-564,-0.012618297,-0.212460064,-0.222397476
4877,2013,서울,강북구,1130500000,초등학교,2013-04-01,여자,960,1251,1236,-15,-276,-291,-0.011990408,-0.223300971,-0.232613909
4878,2013,서울,강북구,1130500000,초등학교,2013-04-01,남자,1012,1285,1268,-17,-256,-273,-0.013229572,-0.201892744,-0.212451362
4879,2013,서울,도봉구,1132000000,초등학교,2013-04-01,전체,2891,2795,2799,4,92,96,0.001431127,0.032868882,0.034347048
4880,2013,서울,도봉구,1132000000,초등학교,2013-04-01,여자,1374,1369,1370,1,4,5,0.00073046,0.002919708,0.003652301
4881,2013,서울,도봉구,1132000000,초등학교,2013-04-01,남자,1517,1426,1429,3,88,91,0.002103787,0.061581526,0.063814867
4882,2013,서울,노원구,1135000000,초등학교,2013-04-01,전체,4883,4997,4988,-9,-105,-114,-0.001801081,-0.021050521,-0.022813688
4883,2013,서울,노원구,1135000000,초등학교,2013-04-01,여자,2351,2405,2416,11,-65,-54,0.004573805,-0.026903974,-0.022453222
4884,2013,서울,노원구,1135000000,초등학교,2013-04-01,남자,2532,2592,2572,-20,-40,-60,-0.007716049,-0.0155521,-0.023148148
4885,2013,서울,은평구,1138000000,초등학교,2013-04-01,전체,4137,4177,4217,40,-80,-40,0.009576251,-0.018970832,-0.009576251
4886,2013,서울,은평구,1138000000,초등학교,2013-04-01,여자,2010,2025,2052,27,-42,-15,0.013333333,-0.020467836,-0.007407407
4887,2013,서울,은평구,1138000000,초등학교,2013-04-01,남자,2127,2152,2165,13,-38,-25,0.006040892,-0.017551963,-0.0116171
4888,2013,서울,서대문구,1141000000,초등학교,2013-04-01,전체,2272,2405,2301,-104,-29,-133,-0.043243243,-0.012603216,-0.055301455
4889,2013,서울,서대문구,1141000000,초등학교,2013-04-01,여자,1120,1203,1141,-62,-21,-83,-0.051537822,-0.018404908,-0.068994181
4890,2013,서울,서대문구,1141000000,초등학교,2013-04-01,남자,1152,1202,1160,-42,-8,-50,-0.034941764,-0.006896552,-0.041597338
4891,2013,서울,마포구,1144000000,초등학교,2013-04-01,전체,2813,3358,3225,-133,-412,-545,-0.039606909,-0.127751938,-0.162298987
4892,2013,서울,마포구,1144000000,초등학교,2013-04-01,여자,1374,1622,1552,-70,-178,-248,-0.043156597,-0.114690722,-0.152897657
4893,2013,서울,마포구,1144000000,초등학교,2013-04-01,남자,1439,1736,1673,-63,-234,-297,-0.036290323,-0.1398685,-0.171082949
4894,2013,서울,양천구,1147000000,초등학교,2013-04-01,전체,3764,3916,4071,155,-307,-152,0.039581205,-0.075411447,-0.038815117
4895,2013,서울,양천구,1147000000,초등학교,2013-04-01,여자,1887,1982,2074,92,-187,-95,0.04641776,-0.090163934,-0.047931382
4896,2013,서울,양천구,1147000000,초등학교,2013-04-01,남자,1877,1934,1997,63,-120,-57,0.032574974,-0.060090135,-0.029472596
4897,2013,서울,강서구,1150000000,초등학교,2013-04-01,전체,4427,4962,4738,-224,-311,-535,-0.045143087,-0.06563951,-0.107819428
4898,2013,서울,강서구,1150000000,초등학교,2013-04-01,여자,2103,2381,2289,-92,-186,-278,-0.038639227,-0.081258191,-0.116757665
4899,2013,서울,강서구,1150000000,초등학교,2013-04-01,남자,2324,2581,2449,-132,-125,-257,-0.051142968,-0.051041241,-0.099573809
4900,2013,서울,구로구,1153000000,초등학교,2013-04-01,전체,3371,3866,3834,-32,-463,-495,-0.008277289,-0.120761607,-0.128039317
4901,2013,서울,구로구,1153000000,초등학교,2013-04-01,여자,1645,1890,1873,-17,-228,-245,-0.008994709,-0.121729845,-0.12962963
4902,2013,서울,구로구,1153000000,초등학교,2013-04-01,남자,1726,1976,1961,-15,-235,-250,-0.007591093,-0.119836818,-0.126518219
4903,2013,서울,금천구,1154500000,초등학교,2013-04-01,전체,1661,1868,1793,-75,-132,-207,-0.040149893,-0.073619632,-0.110813704
4904,2013,서울,금천구,1154500000,초등학교,2013-04-01,여자,811,939,898,-41,-87,-128,-0.043663472,-0.09688196,-0.136315229
4905,2013,서울,금천구,1154500000,초등학교,2013-04-01,남자,850,929,895,-34,-45,-79,-0.036598493,-0.05027933,-0.085037675
4906,2013,서울,영등포구,1156000000,초등학교,2013-04-01,전체,2660,3488,3267,-221,-607,-828,-0.063360092,-0.185797368,-0.237385321
4907,2013,서울,영등포구,1156000000,초등학교,2013-04-01,여자,1263,1709,1596,-113,-333,-446,-0.066120538,-0.208646617,-0.260971328
4908,2013,서울,영등포구,1156000000,초등학교,2013-04-01,남자,1397,1779,1671,-108,-274,-382,-0.060708263,-0.163973668,-0.214727375
4909,2013,서울,동작구,1159000000,초등학교,2013-04-01,전체,3028,3212,3110,-102,-82,-184,-0.031755915,-0.026366559,-0.057285181
4910,2013,서울,동작구,1159000000,초등학교,2013-04-01,여자,1476,1563,1522,-41,-46,-87,-0.026231606,-0.03022339,-0.055662188
4911,2013,서울,동작구,1159000000,초등학교,2013-04-01,남자,1552,1649,1588,-61,-36,-97,-0.036992116,-0.022670025,-0.058823529
4912,2013,서울,관악구,1162000000,초등학교,2013-04-01,전체,3029,3929,3757,-172,-728,-900,-0.043777043,-0.193771626,-0.22906592
4913,2013,서울,관악구,1162000000,초등학교,2013-04-01,여자,1423,1902,1815,-87,-392,-479,-0.045741325,-0.215977961,-0.251840168
4914,2013,서울,관악구,1162000000,초등학교,2013-04-01,남자,1606,2027,1942,-85,-336,-421,-0.041933892,-0.173017508,-0.207696103
4915,2013,서울,서초구,1165000000,초등학교,2013-04-01,전체,3547,3598,3717,119,-170,-51,0.03307393,-0.045735808,-0.014174541
4916,2013,서울,서초구,1165000000,초등학교,2013-04-01,여자,1743,1725,1775,50,-32,18,0.028985507,-0.018028169,0.010434783
4917,2013,서울,서초구,1165000000,초등학교,2013-04-01,남자,1804,1873,1942,69,-138,-69,0.036839295,-0.071060762,-0.036839295
4918,2013,서울,강남구,1168000000,초등학교,2013-04-01,전체,3320,3924,3927,3,-607,-604,0.000764526,-0.154570919,-0.153924567
4919,2013,서울,강남구,1168000000,초등학교,2013-04-01,여자,1622,1947,1948,1,-326,-325,0.000513611,-0.167351129,-0.166923472
4920,2013,서울,강남구,1168000000,초등학교,2013-04-01,남자,1698,1977,1979,2,-281,-279,0.001011634,-0.141990904,-0.141122914
4921,2013,서울,송파구,1171000000,초등학교,2013-04-01,전체,5184,5662,5690,28,-506,-478,0.004945249,-0.088927944,-0.084422466
4922,2013,서울,송파구,1171000000,초등학교,2013-04-01,여자,2485,2733,2769,36,-284,-248,0.013172338,-0.102564103,-0.090742774
4923,2013,서울,송파구,1171000000,초등학교,2013-04-01,남자,2699,2929,2921,-8,-222,-230,-0.002731308,-0.076001369,-0.078525094
4924,2013,서울,강동구,1174000000,초등학교,2013-04-01,전체,3587,4053,3982,-71,-395,-466,-0.017517888,-0.099196384,-0.114976561
4925,2013,서울,강동구,1174000000,초등학교,2013-04-01,여자,1714,1914,1862,-52,-148,-200,-0.027168234,-0.079484425,-0.104493208
4926,2013,서울,강동구,1174000000,초등학교,2013-04-01,남자,1873,2139,2120,-19,-247,-266,-0.008882655,-0.116509434,-0.124357176
4927,2013,부산,중구,2611000000,초등학교,2013-04-01,전체,275,246,236,-10,39,29,-0.040650407,0.165254237,0.117886179
4928,2013,부산,중구,2611000000,초등학교,2013-04-01,여자,133,119,115,-4,18,14,-0.033613445,0.156521739,0.117647059
4929,2013,부산,중구,2611000000,초등학교,2013-04-01,남자,142,127,121,-6,21,15,-0.047244094,0.173553719,0.118110236
4930,2013,부산,서구,2614000000,초등학교,2013-04-01,전체,626,715,693,-22,-67,-89,-0.030769231,-0.096681097,-0.124475524
4931,2013,부산,서구,2614000000,초등학교,2013-04-01,여자,310,355,345,-10,-35,-45,-0.028169014,-0.101449275,-0.126760563
4932,2013,부산,서구,2614000000,초등학교,2013-04-01,남자,316,360,348,-12,-32,-44,-0.033333333,-0.091954023,-0.122222222
4933,2013,부산,동구,2617000000,초등학교,2013-04-01,전체,454,537,540,3,-86,-83,0.005586592,-0.159259259,-0.154562384
4934,2013,부산,동구,2617000000,초등학교,2013-04-01,여자,238,268,271,3,-33,-30,0.01119403,-0.121771218,-0.111940299
4935,2013,부산,동구,2617000000,초등학교,2013-04-01,남자,216,269,269,0,-53,-53,0,-0.197026022,-0.197026022
4936,2013,부산,영도구,2620000000,초등학교,2013-04-01,전체,746,840,829,-11,-83,-94,-0.013095238,-0.100120627,-0.111904762
4937,2013,부산,영도구,2620000000,초등학교,2013-04-01,여자,369,382,384,2,-15,-13,0.005235602,-0.0390625,-0.034031414
4938,2013,부산,영도구,2620000000,초등학교,2013-04-01,남자,377,458,445,-13,-68,-81,-0.028384279,-0.152808989,-0.176855895
4939,2013,부산,부산진구,2623000000,초등학교,2013-04-01,전체,2738,2737,2764,27,-26,1,0.009864815,-0.009406657,0.000365364
4940,2013,부산,부산진구,2623000000,초등학교,2013-04-01,여자,1334,1352,1376,24,-42,-18,0.017751479,-0.030523256,-0.013313609
4941,2013,부산,부산진구,2623000000,초등학교,2013-04-01,남자,1404,1385,1388,3,16,19,0.002166065,0.011527378,0.013718412
4942,2013,부산,동래구,2626000000,초등학교,2013-04-01,전체,1857,1947,1964,17,-107,-90,0.008731382,-0.054480652,-0.046224961
4943,2013,부산,동래구,2626000000,초등학교,2013-04-01,여자,907,966,955,-11,-48,-59,-0.011387164,-0.05026178,-0.061076605
4944,2013,부산,동래구,2626000000,초등학교,2013-04-01,남자,950,981,1009,28,-59,-31,0.028542304,-0.058473736,-0.031600408
4945,2013,부산,남구,2629000000,초등학교,2013-04-01,전체,1895,2173,2127,-46,-232,-278,-0.021168891,-0.109073813,-0.127933732
4946,2013,부산,남구,2629000000,초등학교,2013-04-01,여자,927,1032,1017,-15,-90,-105,-0.014534884,-0.088495575,-0.101744186
4947,2013,부산,남구,2629000000,초등학교,2013-04-01,남자,968,1141,1110,-31,-142,-173,-0.02716915,-0.127927928,-0.151621385
4948,2013,부산,북구,2632000000,초등학교,2013-04-01,전체,2273,2215,2206,-9,67,58,-0.004063205,0.030371714,0.026185102
4949,2013,부산,북구,2632000000,초등학교,2013-04-01,여자,1054,1042,1052,10,2,12,0.009596929,0.001901141,0.011516315
4950,2013,부산,북구,2632000000,초등학교,2013-04-01,남자,1219,1173,1154,-19,65,46,-0.016197783,0.056325823,0.039215686
4951,2013,부산,해운대구,2635000000,초등학교,2013-04-01,전체,3499,3537,3632,95,-133,-38,0.02685892,-0.036618943,-0.010743568
4952,2013,부산,해운대구,2635000000,초등학교,2013-04-01,여자,1710,1739,1781,42,-71,-29,0.024151811,-0.039865244,-0.016676251
4953,2013,부산,해운대구,2635000000,초등학교,2013-04-01,남자,1789,1798,1851,53,-62,-9,0.029477197,-0.033495408,-0.005005562
4954,2013,부산,사하구,2638000000,초등학교,2013-04-01,전체,2520,2707,2642,-65,-122,-187,-0.024011821,-0.046177139,-0.069080163
4955,2013,부산,사하구,2638000000,초등학교,2013-04-01,여자,1240,1297,1263,-34,-23,-57,-0.026214341,-0.01821061,-0.043947571
4956,2013,부산,사하구,2638000000,초등학교,2013-04-01,남자,1280,1410,1379,-31,-99,-130,-0.021985816,-0.071791153,-0.092198582
4957,2013,부산,금정구,2641000000,초등학교,2013-04-01,전체,1625,1585,1602,17,23,40,0.010725552,0.014357054,0.025236593
4958,2013,부산,금정구,2641000000,초등학교,2013-04-01,여자,759,766,777,11,-18,-7,0.014360313,-0.023166023,-0.009138381
4959,2013,부산,금정구,2641000000,초등학교,2013-04-01,남자,866,819,825,6,41,47,0.007326007,0.04969697,0.057387057
4960,2013,부산,강서구,2644000000,초등학교,2013-04-01,전체,474,468,505,37,-31,6,0.079059829,-0.061386139,0.012820513
4961,2013,부산,강서구,2644000000,초등학교,2013-04-01,여자,241,230,258,28,-17,11,0.12173913,-0.065891473,0.047826087
4962,2013,부산,강서구,2644000000,초등학교,2013-04-01,남자,233,238,247,9,-14,-5,0.037815126,-0.056680162,-0.021008403
4963,2013,부산,연제구,2647000000,초등학교,2013-04-01,전체,1552,1606,1599,-7,-47,-54,-0.004358655,-0.029393371,-0.03362391
4964,2013,부산,연제구,2647000000,초등학교,2013-04-01,여자,734,753,744,-9,-10,-19,-0.011952191,-0.01344086,-0.025232404
4965,2013,부산,연제구,2647000000,초등학교,2013-04-01,남자,818,853,855,2,-37,-35,0.002344666,-0.043274854,-0.041031653
4966,2013,부산,수영구,2650000000,초등학교,2013-04-01,전체,1010,1183,1142,-41,-132,-173,-0.03465765,-0.11558669,-0.146238377
4967,2013,부산,수영구,2650000000,초등학교,2013-04-01,여자,465,553,533,-20,-68,-88,-0.036166365,-0.127579737,-0.159132007
4968,2013,부산,수영구,2650000000,초등학교,2013-04-01,남자,545,630,609,-21,-64,-85,-0.033333333,-0.105090312,-0.134920635
4969,2013,부산,사상구,2653000000,초등학교,2013-04-01,전체,1526,1818,1757,-61,-231,-292,-0.033553355,-0.131474104,-0.160616062
4970,2013,부산,사상구,2653000000,초등학교,2013-04-01,여자,742,873,833,-40,-91,-131,-0.045819015,-0.109243697,-0.150057274
4971,2013,부산,사상구,2653000000,초등학교,2013-04-01,남자,784,945,924,-21,-140,-161,-0.022222222,-0.151515152,-0.17037037
4972,2013,부산,기장군,2671000000,초등학교,2013-04-01,전체,1207,1022,1104,82,103,185,0.080234834,0.093297101,0.181017613
4973,2013,부산,기장군,2671000000,초등학교,2013-04-01,여자,579,480,535,55,44,99,0.114583333,0.082242991,0.20625
4974,2013,부산,기장군,2671000000,초등학교,2013-04-01,남자,628,542,569,27,59,86,0.049815498,0.103690685,0.158671587
4975,2013,대구,중구,2711000000,초등학교,2013-04-01,전체,701,519,494,-25,207,182,-0.048169557,0.41902834,0.350674374
4976,2013,대구,중구,2711000000,초등학교,2013-04-01,여자,355,250,239,-11,116,105,-0.044,0.485355649,0.42
4977,2013,대구,중구,2711000000,초등학교,2013-04-01,남자,346,269,255,-14,91,77,-0.05204461,0.356862745,0.286245353
4978,2013,대구,동구,2714000000,초등학교,2013-04-01,전체,2592,2803,2796,-7,-204,-211,-0.002497324,-0.072961373,-0.075276489
4979,2013,대구,동구,2714000000,초등학교,2013-04-01,여자,1207,1332,1322,-10,-115,-125,-0.007507508,-0.08698941,-0.093843844
4980,2013,대구,동구,2714000000,초등학교,2013-04-01,남자,1385,1471,1474,3,-89,-86,0.002039429,-0.060379919,-0.05846363
4981,2013,대구,서구,2717000000,초등학교,2013-04-01,전체,1136,1300,1289,-11,-153,-164,-0.008461538,-0.118696664,-0.126153846
4982,2013,대구,서구,2717000000,초등학교,2013-04-01,여자,566,653,663,10,-97,-87,0.015313936,-0.146304676,-0.13323124
4983,2013,대구,서구,2717000000,초등학교,2013-04-01,남자,570,647,626,-21,-56,-77,-0.032457496,-0.089456869,-0.119010819
4984,2013,대구,남구,2720000000,초등학교,2013-04-01,전체,857,982,987,5,-130,-125,0.00509165,-0.131712259,-0.127291242
4985,2013,대구,남구,2720000000,초등학교,2013-04-01,여자,382,460,448,-12,-66,-78,-0.026086957,-0.147321429,-0.169565217
4986,2013,대구,남구,2720000000,초등학교,2013-04-01,남자,475,522,539,17,-64,-47,0.03256705,-0.118738404,-0.090038314
4987,2013,대구,북구,2723000000,초등학교,2013-04-01,전체,4109,4496,4456,-40,-347,-387,-0.008896797,-0.077872531,-0.086076512
4988,2013,대구,북구,2723000000,초등학교,2013-04-01,여자,1988,2153,2132,-21,-144,-165,-0.009753832,-0.067542214,-0.07663725
4989,2013,대구,북구,2723000000,초등학교,2013-04-01,남자,2121,2343,2324,-19,-203,-222,-0.008109262,-0.087349398,-0.09475032
4990,2013,대구,수성구,2726000000,초등학교,2013-04-01,전체,3735,3607,3809,202,-74,128,0.056002218,-0.019427671,0.035486554
4991,2013,대구,수성구,2726000000,초등학교,2013-04-01,여자,1753,1751,1850,99,-97,2,0.056539121,-0.052432432,0.001142204
4992,2013,대구,수성구,2726000000,초등학교,2013-04-01,남자,1982,1856,1959,103,23,126,0.05549569,0.011740684,0.067887931
4993,2013,대구,달서구,2729000000,초등학교,2013-04-01,전체,5330,5157,5198,41,132,173,0.007950359,0.025394382,0.033546636
4994,2013,대구,달서구,2729000000,초등학교,2013-04-01,여자,2584,2496,2527,31,57,88,0.012419872,0.022556391,0.03525641
4995,2013,대구,달서구,2729000000,초등학교,2013-04-01,남자,2746,2661,2671,10,75,85,0.003757986,0.028079371,0.031942879
4996,2013,대구,달성군,2771000000,초등학교,2013-04-01,전체,1761,1923,1910,-13,-149,-162,-0.00676027,-0.078010471,-0.08424337
4997,2013,대구,달성군,2771000000,초등학교,2013-04-01,여자,844,927,918,-9,-74,-83,-0.009708738,-0.080610022,-0.089536138
4998,2013,대구,달성군,2771000000,초등학교,2013-04-01,남자,917,996,992,-4,-75,-79,-0.004016064,-0.075604839,-0.079317269
4999,2013,인천,중구,2811000000,초등학교,2013-04-01,전체,1066,865,883,18,183,201,0.020809249,0.207248018,0.232369942
5000,2013,인천,중구,2811000000,초등학교,2013-04-01,여자,494,407,426,19,68,87,0.046683047,0.159624413,0.213759214
5001,2013,인천,중구,2811000000,초등학교,2013-04-01,남자,572,458,457,-1,115,114,-0.002183406,0.251641138,0.248908297
5002,2013,인천,동구,2814000000,초등학교,2013-04-01,전체,747,740,711,-29,36,7,-0.039189189,0.050632911,0.009459459
5003,2013,인천,동구,2814000000,초등학교,2013-04-01,여자,353,360,343,-17,10,-7,-0.047222222,0.029154519,-0.019444444
5004,2013,인천,동구,2814000000,초등학교,2013-04-01,남자,394,380,368,-12,26,14,-0.031578947,0.070652174,0.036842105
5005,2013,인천,미추홀구,2817700000,초등학교,2013-04-01,전체,2839,3393,3317,-76,-478,-554,-0.022399057,-0.14410612,-0.163277336
5006,2013,인천,미추홀구,2817700000,초등학교,2013-04-01,여자,1391,1607,1572,-35,-181,-216,-0.021779714,-0.115139949,-0.134411948
5007,2013,인천,미추홀구,2817700000,초등학교,2013-04-01,남자,1448,1786,1745,-41,-297,-338,-0.022956327,-0.170200573,-0.18924972
5008,2013,인천,연수구,2818500000,초등학교,2013-04-01,전체,2738,2461,2629,168,109,277,0.068264933,0.041460631,0.112555872
5009,2013,인천,연수구,2818500000,초등학교,2013-04-01,여자,1329,1195,1265,70,64,134,0.058577406,0.050592885,0.112133891
5010,2013,인천,연수구,2818500000,초등학교,2013-04-01,남자,1409,1266,1364,98,45,143,0.077409163,0.032991202,0.112954186
5011,2013,인천,남동구,2820000000,초등학교,2013-04-01,전체,4671,4921,5107,186,-436,-250,0.037797196,-0.085373017,-0.050802682
5012,2013,인천,남동구,2820000000,초등학교,2013-04-01,여자,2174,2344,2447,103,-273,-170,0.04394198,-0.111565182,-0.072525597
5013,2013,인천,남동구,2820000000,초등학교,2013-04-01,남자,2497,2577,2660,83,-163,-80,0.032207994,-0.061278195,-0.031043849
5014,2013,인천,부평구,2823700000,초등학교,2013-04-01,전체,4448,5138,5033,-105,-585,-690,-0.020435967,-0.116232863,-0.134293499
5015,2013,인천,부평구,2823700000,초등학교,2013-04-01,여자,2119,2491,2430,-61,-311,-372,-0.024488157,-0.127983539,-0.149337615
5016,2013,인천,부평구,2823700000,초등학교,2013-04-01,남자,2329,2647,2603,-44,-274,-318,-0.016622592,-0.105263158,-0.120136003
5017,2013,인천,계양구,2824500000,초등학교,2013-04-01,전체,2919,3232,3130,-102,-211,-313,-0.031559406,-0.067412141,-0.096844059
5018,2013,인천,계양구,2824500000,초등학교,2013-04-01,여자,1407,1575,1532,-43,-125,-168,-0.027301587,-0.081592689,-0.106666667
5019,2013,인천,계양구,2824500000,초등학교,2013-04-01,남자,1512,1657,1598,-59,-86,-145,-0.035606518,-0.053817272,-0.087507544
5020,2013,인천,서구,2826000000,초등학교,2013-04-01,전체,5127,4686,5091,405,36,441,0.086427657,0.007071302,0.094110115
5021,2013,인천,서구,2826000000,초등학교,2013-04-01,여자,2485,2278,2485,207,0,207,0.090869183,0,0.090869183
5022,2013,인천,서구,2826000000,초등학교,2013-04-01,남자,2642,2408,2606,198,36,234,0.082225914,0.013814275,0.09717608
5023,2013,인천,강화군,2871000000,초등학교,2013-04-01,전체,377,344,366,22,11,33,0.063953488,0.030054645,0.095930233
5024,2013,인천,강화군,2871000000,초등학교,2013-04-01,여자,194,179,188,9,6,15,0.05027933,0.031914894,0.083798883
5025,2013,인천,강화군,2871000000,초등학교,2013-04-01,남자,183,165,178,13,5,18,0.078787879,0.028089888,0.109090909
5026,2013,인천,옹진군,2872000000,초등학교,2013-04-01,전체,122,164,151,-13,-29,-42,-0.079268293,-0.19205298,-0.256097561
5027,2013,인천,옹진군,2872000000,초등학교,2013-04-01,여자,65,88,80,-8,-15,-23,-0.090909091,-0.1875,-0.261363636
5028,2013,인천,옹진군,2872000000,초등학교,2013-04-01,남자,57,76,71,-5,-14,-19,-0.065789474,-0.197183099,-0.25
5029,2013,광주,동구,2911000000,초등학교,2013-04-01,전체,673,611,662,51,11,62,0.083469722,0.016616314,0.101472995
5030,2013,광주,동구,2911000000,초등학교,2013-04-01,여자,323,292,312,20,11,31,0.068493151,0.03525641,0.106164384
5031,2013,광주,동구,2911000000,초등학교,2013-04-01,남자,350,319,350,31,0,31,0.097178683,0,0.097178683
5032,2013,광주,서구,2914000000,초등학교,2013-04-01,전체,2924,2897,3237,340,-313,27,0.117362789,-0.09669447,0.009319986
5033,2013,광주,서구,2914000000,초등학교,2013-04-01,여자,1404,1380,1568,188,-164,24,0.136231884,-0.104591837,0.017391304
5034,2013,광주,서구,2914000000,초등학교,2013-04-01,남자,1520,1517,1669,152,-149,3,0.100197759,-0.089275015,0.001977587
5035,2013,광주,남구,2915500000,초등학교,2013-04-01,전체,1941,1716,1743,27,198,225,0.015734266,0.113597246,0.131118881
5036,2013,광주,남구,2915500000,초등학교,2013-04-01,여자,951,828,849,21,102,123,0.025362319,0.120141343,0.148550725
5037,2013,광주,남구,2915500000,초등학교,2013-04-01,남자,990,888,894,6,96,102,0.006756757,0.10738255,0.114864865
5038,2013,광주,북구,2917000000,초등학교,2013-04-01,전체,3856,4487,4073,-414,-217,-631,-0.092266548,-0.053277682,-0.140628482
5039,2013,광주,북구,2917000000,초등학교,2013-04-01,여자,1853,2174,1964,-210,-111,-321,-0.096596136,-0.056517312,-0.147654094
5040,2013,광주,북구,2917000000,초등학교,2013-04-01,남자,2003,2313,2109,-204,-106,-310,-0.088197147,-0.050260787,-0.134025076
5041,2013,광주,광산구,2920000000,초등학교,2013-04-01,전체,5131,5045,5186,141,-55,86,0.027948464,-0.010605476,0.017046581
5042,2013,광주,광산구,2920000000,초등학교,2013-04-01,여자,2449,2424,2494,70,-45,25,0.028877888,-0.018043304,0.010313531
5043,2013,광주,광산구,2920000000,초등학교,2013-04-01,남자,2682,2621,2692,71,-10,61,0.027088897,-0.00371471,0.02327356
5044,2013,대전,동구,3011000000,초등학교,2013-04-01,전체,2170,2370,2427,57,-257,-200,0.024050633,-0.105892048,-0.084388186
5045,2013,대전,동구,3011000000,초등학교,2013-04-01,여자,1055,1158,1191,33,-136,-103,0.028497409,-0.114189757,-0.088946459
5046,2013,대전,동구,3011000000,초등학교,2013-04-01,남자,1115,1212,1236,24,-121,-97,0.01980198,-0.09789644,-0.080033003
5047,2013,대전,중구,3014000000,초등학교,2013-04-01,전체,2339,2315,2323,8,16,24,0.003455724,0.006887645,0.010367171
5048,2013,대전,중구,3014000000,초등학교,2013-04-01,여자,1148,1120,1120,0,28,28,0,0.025,0.025
5049,2013,대전,중구,3014000000,초등학교,2013-04-01,남자,1191,1195,1203,8,-12,-4,0.006694561,-0.009975062,-0.00334728
5050,2013,대전,서구,3017000000,초등학교,2013-04-01,전체,4487,4627,4649,22,-162,-140,0.004754701,-0.034846203,-0.030257186
5051,2013,대전,서구,3017000000,초등학교,2013-04-01,여자,2155,2206,2217,11,-62,-51,0.004986401,-0.027965719,-0.023118767
5052,2013,대전,서구,3017000000,초등학교,2013-04-01,남자,2332,2421,2432,11,-100,-89,0.004543577,-0.041118421,-0.036761669
5053,2013,대전,유성구,3020000000,초등학교,2013-04-01,전체,3957,3723,3919,196,38,234,0.052645716,0.009696351,0.062852538
5054,2013,대전,유성구,3020000000,초등학교,2013-04-01,여자,1870,1851,1964,113,-94,19,0.061048082,-0.047861507,0.010264722
5055,2013,대전,유성구,3020000000,초등학교,2013-04-01,남자,2087,1872,1955,83,132,215,0.044337607,0.067519182,0.114850427
5056,2013,대전,대덕구,3023000000,초등학교,2013-04-01,전체,1763,1905,1863,-42,-100,-142,-0.022047244,-0.053676865,-0.074540682
5057,2013,대전,대덕구,3023000000,초등학교,2013-04-01,여자,836,925,885,-40,-49,-89,-0.043243243,-0.055367232,-0.096216216
5058,2013,대전,대덕구,3023000000,초등학교,2013-04-01,남자,927,980,978,-2,-51,-53,-0.002040816,-0.052147239,-0.054081633
5059,2013,울산,중구,3111000000,초등학교,2013-04-01,전체,1774,1859,1850,-9,-76,-85,-0.004841313,-0.041081081,-0.045723507
5060,2013,울산,중구,3111000000,초등학교,2013-04-01,여자,825,858,860,2,-35,-33,0.002331002,-0.040697674,-0.038461538
5061,2013,울산,중구,3111000000,초등학교,2013-04-01,남자,949,1001,990,-11,-41,-52,-0.010989011,-0.041414141,-0.051948052
5062,2013,울산,남구,3114000000,초등학교,2013-04-01,전체,2734,2918,2962,44,-228,-184,0.015078821,-0.076975017,-0.063056888
5063,2013,울산,남구,3114000000,초등학교,2013-04-01,여자,1351,1379,1401,22,-50,-28,0.01595359,-0.035688794,-0.020304569
5064,2013,울산,남구,3114000000,초등학교,2013-04-01,남자,1383,1539,1561,22,-178,-156,0.014294997,-0.114029468,-0.101364522
5065,2013,울산,동구,3117000000,초등학교,2013-04-01,전체,1650,1646,1673,27,-23,4,0.016403402,-0.013747759,0.002430134
5066,2013,울산,동구,3117000000,초등학교,2013-04-01,여자,767,762,784,22,-17,5,0.028871391,-0.021683673,0.00656168
5067,2013,울산,동구,3117000000,초등학교,2013-04-01,남자,883,884,889,5,-6,-1,0.005656109,-0.006749156,-0.001131222
5068,2013,울산,북구,3120000000,초등학교,2013-04-01,전체,2248,2446,2430,-16,-182,-198,-0.006541292,-0.074897119,-0.080948487
5069,2013,울산,북구,3120000000,초등학교,2013-04-01,여자,1096,1212,1188,-24,-92,-116,-0.01980198,-0.077441077,-0.095709571
5070,2013,울산,북구,3120000000,초등학교,2013-04-01,남자,1152,1234,1242,8,-90,-82,0.006482982,-0.072463768,-0.066450567
5071,2013,울산,울주군,3171000000,초등학교,2013-04-01,전체,2145,2127,2133,6,12,18,0.002820874,0.005625879,0.008462623
5072,2013,울산,울주군,3171000000,초등학교,2013-04-01,여자,985,1017,1028,11,-43,-32,0.010816126,-0.041828794,-0.031465093
5073,2013,울산,울주군,3171000000,초등학교,2013-04-01,남자,1160,1110,1105,-5,55,50,-0.004504505,0.049773756,0.045045045
5074,2013,경기,수원시,4111000000,초등학교,2013-04-01,전체,11042,10721,10948,227,94,321,0.021173398,0.008586043,0.029941237
5075,2013,경기,수원시,4111000000,초등학교,2013-04-01,여자,5411,5188,5288,100,123,223,0.019275251,0.023260212,0.042983809
5076,2013,경기,수원시,4111000000,초등학교,2013-04-01,남자,5631,5533,5660,127,-29,98,0.02295319,-0.005123675,0.01771191
5077,2013,경기,성남시,4113000000,초등학교,2013-04-01,전체,7917,8649,8641,-8,-724,-732,-0.000924962,-0.083786599,-0.084634062
5078,2013,경기,성남시,4113000000,초등학교,2013-04-01,여자,3841,4260,4253,-7,-412,-419,-0.001643192,-0.096872796,-0.098356808
5079,2013,경기,성남시,4113000000,초등학교,2013-04-01,남자,4076,4389,4388,-1,-312,-313,-0.000227842,-0.071103008,-0.07131465
5080,2013,경기,부천시,4119000000,초등학교,2013-04-01,전체,7249,8035,7880,-155,-631,-786,-0.019290604,-0.080076142,-0.097822029
5081,2013,경기,부천시,4119000000,초등학교,2013-04-01,여자,3494,3786,3724,-62,-230,-292,-0.016376123,-0.061761547,-0.077126255
5082,2013,경기,부천시,4119000000,초등학교,2013-04-01,남자,3755,4249,4156,-93,-401,-494,-0.021887503,-0.096487007,-0.11626265
5083,2013,경기,안양시,4117000000,초등학교,2013-04-01,전체,5291,5466,5356,-110,-65,-175,-0.020124405,-0.012135922,-0.0320161
5084,2013,경기,안양시,4117000000,초등학교,2013-04-01,여자,2603,2674,2630,-44,-27,-71,-0.016454749,-0.01026616,-0.026551982
5085,2013,경기,안양시,4117000000,초등학교,2013-04-01,남자,2688,2792,2726,-66,-38,-104,-0.023638968,-0.013939839,-0.037249284
5086,2013,경기,과천시,4129000000,초등학교,2013-04-01,전체,590,629,628,-1,-38,-39,-0.001589825,-0.060509554,-0.06200318
5087,2013,경기,과천시,4129000000,초등학교,2013-04-01,여자,259,278,274,-4,-15,-19,-0.014388489,-0.054744526,-0.068345324
5088,2013,경기,과천시,4129000000,초등학교,2013-04-01,남자,331,351,354,3,-23,-20,0.008547009,-0.064971751,-0.056980057
5089,2013,경기,안산시,4127000000,초등학교,2013-04-01,전체,6424,6954,6833,-121,-409,-530,-0.017400058,-0.059856578,-0.076215128
5090,2013,경기,안산시,4127000000,초등학교,2013-04-01,여자,3126,3418,3376,-42,-250,-292,-0.012287888,-0.074052133,-0.085430076
5091,2013,경기,안산시,4127000000,초등학교,2013-04-01,남자,3298,3536,3457,-79,-159,-238,-0.022341629,-0.045993636,-0.067307692
5092,2013,경기,용인시,4146000000,초등학교,2013-04-01,전체,11055,11778,11928,150,-873,-723,0.012735609,-0.073189135,-0.061385634
5093,2013,경기,용인시,4146000000,초등학교,2013-04-01,여자,5317,5702,5748,46,-431,-385,0.008067345,-0.074982603,-0.067520168
5094,2013,경기,용인시,4146000000,초등학교,2013-04-01,남자,5738,6076,6180,104,-442,-338,0.017116524,-0.071521036,-0.055628703
5095,2013,경기,군포시,4141000000,초등학교,2013-04-01,전체,2838,3177,3077,-100,-239,-339,-0.031476235,-0.077673058,-0.106704438
5096,2013,경기,군포시,4141000000,초등학교,2013-04-01,여자,1375,1510,1463,-47,-88,-135,-0.031125828,-0.060150376,-0.089403974
5097,2013,경기,군포시,4141000000,초등학교,2013-04-01,남자,1463,1667,1614,-53,-151,-204,-0.031793641,-0.093556382,-0.122375525
5098,2013,경기,의왕시,4143000000,초등학교,2013-04-01,전체,1407,1514,1512,-2,-105,-107,-0.001321004,-0.069444444,-0.070673712
5099,2013,경기,의왕시,4143000000,초등학교,2013-04-01,여자,686,770,757,-13,-71,-84,-0.016883117,-0.093791281,-0.109090909
5100,2013,경기,의왕시,4143000000,초등학교,2013-04-01,남자,721,744,755,11,-34,-23,0.014784946,-0.045033113,-0.030913978
5101,2013,경기,시흥시,4139000000,초등학교,2013-04-01,전체,4245,4503,4423,-80,-178,-258,-0.017765934,-0.040244178,-0.057295137
5102,2013,경기,시흥시,4139000000,초등학교,2013-04-01,여자,2123,2239,2175,-64,-52,-116,-0.028584189,-0.023908046,-0.051808843
5103,2013,경기,시흥시,4139000000,초등학교,2013-04-01,남자,2122,2264,2248,-16,-126,-142,-0.007067138,-0.056049822,-0.062720848
5104,2013,경기,평택시,4122000000,초등학교,2013-04-01,전체,4508,4659,4747,88,-239,-151,0.018888173,-0.050347588,-0.032410388
5105,2013,경기,평택시,4122000000,초등학교,2013-04-01,여자,2190,2301,2332,31,-142,-111,0.013472403,-0.060891938,-0.048239896
5106,2013,경기,평택시,4122000000,초등학교,2013-04-01,남자,2318,2358,2415,57,-97,-40,0.024173028,-0.040165631,-0.016963528
5107,2013,경기,화성시,4159000000,초등학교,2013-04-01,전체,7351,7976,7823,-153,-472,-625,-0.019182548,-0.06033491,-0.07836008
5108,2013,경기,화성시,4159000000,초등학교,2013-04-01,여자,3589,3873,3821,-52,-232,-284,-0.013426285,-0.06071709,-0.073328169
5109,2013,경기,화성시,4159000000,초등학교,2013-04-01,남자,3762,4103,4002,-101,-240,-341,-0.024616135,-0.059970015,-0.08310992
5110,2013,경기,오산시,4137000000,초등학교,2013-04-01,전체,2583,2700,2792,92,-209,-117,0.034074074,-0.074856734,-0.043333333
5111,2013,경기,오산시,4137000000,초등학교,2013-04-01,여자,1307,1320,1354,34,-47,-13,0.025757576,-0.034711965,-0.009848485
5112,2013,경기,오산시,4137000000,초등학교,2013-04-01,남자,1276,1380,1438,58,-162,-104,0.042028986,-0.112656467,-0.075362319
5113,2013,경기,광명시,4121000000,초등학교,2013-04-01,전체,3595,3811,3773,-38,-178,-216,-0.009971136,-0.047177312,-0.056678037
5114,2013,경기,광명시,4121000000,초등학교,2013-04-01,여자,1736,1862,1834,-28,-98,-126,-0.015037594,-0.053435115,-0.067669173
5115,2013,경기,광명시,4121000000,초등학교,2013-04-01,남자,1859,1949,1939,-10,-80,-90,-0.005130836,-0.041258381,-0.046177527
5116,2013,경기,광주시,4161000000,초등학교,2013-04-01,전체,2725,2884,2974,90,-249,-159,0.031206657,-0.083725622,-0.055131761
5117,2013,경기,광주시,4161000000,초등학교,2013-04-01,여자,1320,1396,1444,48,-124,-76,0.034383954,-0.085872576,-0.054441261
5118,2013,경기,광주시,4161000000,초등학교,2013-04-01,남자,1405,1488,1530,42,-125,-83,0.028225806,-0.081699346,-0.05577957
5119,2013,경기,하남시,4145000000,초등학교,2013-04-01,전체,1189,1393,1348,-45,-159,-204,-0.032304379,-0.117952522,-0.146446518
5120,2013,경기,하남시,4145000000,초등학교,2013-04-01,여자,565,661,637,-24,-72,-96,-0.036308623,-0.113029827,-0.145234493
5121,2013,경기,하남시,4145000000,초등학교,2013-04-01,남자,624,732,711,-21,-87,-108,-0.028688525,-0.122362869,-0.147540984
5122,2013,경기,김포시,4157000000,초등학교,2013-04-01,전체,3302,2627,2969,342,333,675,0.130186525,0.112158976,0.256947088
5123,2013,경기,김포시,4157000000,초등학교,2013-04-01,여자,1583,1295,1454,159,129,288,0.122779923,0.08872077,0.222393822
5124,2013,경기,김포시,4157000000,초등학교,2013-04-01,남자,1719,1332,1515,183,204,387,0.137387387,0.134653465,0.290540541
5125,2013,경기,이천시,4150000000,초등학교,2013-04-01,전체,2165,2287,2288,1,-123,-122,0.000437254,-0.053758741,-0.053344993
5126,2013,경기,이천시,4150000000,초등학교,2013-04-01,여자,1023,1090,1104,14,-81,-67,0.012844037,-0.073369565,-0.06146789
5127,2013,경기,이천시,4150000000,초등학교,2013-04-01,남자,1142,1197,1184,-13,-42,-55,-0.010860485,-0.035472973,-0.045948204
5128,2013,경기,안성시,4155000000,초등학교,2013-04-01,전체,1813,1938,1932,-6,-119,-125,-0.003095975,-0.061594203,-0.064499484
5129,2013,경기,안성시,4155000000,초등학교,2013-04-01,여자,847,921,921,0,-74,-74,0,-0.080347448,-0.080347448
5130,2013,경기,안성시,4155000000,초등학교,2013-04-01,남자,966,1017,1011,-6,-45,-51,-0.005899705,-0.044510386,-0.050147493
5131,2013,경기,여주시,4167000000,초등학교,2013-04-01,전체,891,952,965,13,-74,-61,0.013655462,-0.076683938,-0.06407563
5132,2013,경기,여주시,4167000000,초등학교,2013-04-01,여자,446,477,478,1,-32,-31,0.002096436,-0.066945607,-0.064989518
5133,2013,경기,여주시,4167000000,초등학교,2013-04-01,남자,445,475,487,12,-42,-30,0.025263158,-0.0862423,-0.063157895
5134,2013,경기,양평군,4183000000,초등학교,2013-04-01,전체,776,772,819,47,-43,4,0.060880829,-0.052503053,0.005181347
5135,2013,경기,양평군,4183000000,초등학교,2013-04-01,여자,386,374,400,26,-14,12,0.069518717,-0.035,0.032085561
5136,2013,경기,양평군,4183000000,초등학교,2013-04-01,남자,390,398,419,21,-29,-8,0.052763819,-0.069212411,-0.020100503
5137,2013,경기,고양시,4128000000,초등학교,2013-04-01,전체,8587,8987,9081,94,-494,-400,0.010459553,-0.054399295,-0.044508735
5138,2013,경기,고양시,4128000000,초등학교,2013-04-01,여자,4200,4352,4412,60,-212,-152,0.013786765,-0.048050771,-0.034926471
5139,2013,경기,고양시,4128000000,초등학교,2013-04-01,남자,4387,4635,4669,34,-282,-248,0.007335491,-0.060398372,-0.053505933
5140,2013,경기,남양주시,4136000000,초등학교,2013-04-01,전체,6846,7159,7200,41,-354,-313,0.005727057,-0.049166667,-0.04372119
5141,2013,경기,남양주시,4136000000,초등학교,2013-04-01,여자,3302,3444,3457,13,-155,-142,0.003774681,-0.044836563,-0.041231127
5142,2013,경기,남양주시,4136000000,초등학교,2013-04-01,남자,3544,3715,3743,28,-199,-171,0.007537012,-0.05316591,-0.04602961
5143,2013,경기,구리시,4131000000,초등학교,2013-04-01,전체,1736,1933,1895,-38,-159,-197,-0.019658562,-0.083905013,-0.101914123
5144,2013,경기,구리시,4131000000,초등학교,2013-04-01,여자,790,954,923,-31,-133,-164,-0.032494759,-0.144095341,-0.171907757
5145,2013,경기,구리시,4131000000,초등학교,2013-04-01,남자,946,979,972,-7,-26,-33,-0.007150153,-0.026748971,-0.033707865
5146,2013,경기,의정부시,4115000000,초등학교,2013-04-01,전체,3720,4157,4079,-78,-359,-437,-0.018763531,-0.088011768,-0.105123887
5147,2013,경기,의정부시,4115000000,초등학교,2013-04-01,여자,1847,2016,2009,-7,-162,-169,-0.003472222,-0.080637133,-0.083829365
5148,2013,경기,의정부시,4115000000,초등학교,2013-04-01,남자,1873,2141,2070,-71,-197,-268,-0.033162074,-0.095169082,-0.125175152
5149,2013,경기,파주시,4148000000,초등학교,2013-04-01,전체,4441,4237,4501,264,-60,204,0.062308237,-0.013330371,0.048147274
5150,2013,경기,파주시,4148000000,초등학교,2013-04-01,여자,2198,2082,2211,129,-13,116,0.061959654,-0.005879692,0.055715658
5151,2013,경기,파주시,4148000000,초등학교,2013-04-01,남자,2243,2155,2290,135,-47,88,0.062645012,-0.020524017,0.040835267
5152,2013,경기,동두천시,4125000000,초등학교,2013-04-01,전체,896,981,984,3,-88,-85,0.003058104,-0.089430894,-0.086646279
5153,2013,경기,동두천시,4125000000,초등학교,2013-04-01,여자,436,465,468,3,-32,-29,0.006451613,-0.068376068,-0.062365591
5154,2013,경기,동두천시,4125000000,초등학교,2013-04-01,남자,460,516,516,0,-56,-56,0,-0.108527132,-0.108527132
5155,2013,경기,양주시,4163000000,초등학교,2013-04-01,전체,2158,2343,2265,-78,-107,-185,-0.033290653,-0.047240618,-0.0789586
5156,2013,경기,양주시,4163000000,초등학교,2013-04-01,여자,1014,1148,1114,-34,-100,-134,-0.029616725,-0.089766607,-0.116724739
5157,2013,경기,양주시,4163000000,초등학교,2013-04-01,남자,1144,1195,1151,-44,-7,-51,-0.036820084,-0.006081668,-0.042677824
5158,2013,경기,포천시,4165000000,초등학교,2013-04-01,전체,1322,1396,1390,-6,-68,-74,-0.004297994,-0.048920863,-0.053008596
5159,2013,경기,포천시,4165000000,초등학교,2013-04-01,여자,633,654,648,-6,-15,-21,-0.009174312,-0.023148148,-0.032110092
5160,2013,경기,포천시,4165000000,초등학교,2013-04-01,남자,689,742,742,0,-53,-53,0,-0.071428571,-0.071428571
5161,2013,경기,가평군,4182000000,초등학교,2013-04-01,전체,440,424,434,10,6,16,0.023584906,0.013824885,0.037735849
5162,2013,경기,가평군,4182000000,초등학교,2013-04-01,여자,207,196,205,9,2,11,0.045918367,0.009756098,0.056122449
5163,2013,경기,가평군,4182000000,초등학교,2013-04-01,남자,233,228,229,1,4,5,0.004385965,0.017467249,0.021929825
5164,2013,경기,연천군,4180000000,초등학교,2013-04-01,전체,281,324,302,-22,-21,-43,-0.067901235,-0.069536424,-0.132716049
5165,2013,경기,연천군,4180000000,초등학교,2013-04-01,여자,134,149,131,-18,3,-15,-0.120805369,0.022900763,-0.100671141
5166,2013,경기,연천군,4180000000,초등학교,2013-04-01,남자,147,175,171,-4,-24,-28,-0.022857143,-0.140350877,-0.16
5167,2013,강원,춘천시,4211000000,초등학교,2013-04-01,전체,2271,2358,2359,1,-88,-87,0.000424088,-0.037303942,-0.036895674
5168,2013,강원,춘천시,4211000000,초등학교,2013-04-01,여자,1072,1140,1118,-22,-46,-68,-0.019298246,-0.041144902,-0.059649123
5169,2013,강원,춘천시,4211000000,초등학교,2013-04-01,남자,1199,1218,1241,23,-42,-19,0.018883415,-0.033843674,-0.015599343
5170,2013,강원,원주시,4213000000,초등학교,2013-04-01,전체,3061,3053,3090,37,-29,8,0.012119227,-0.009385113,0.002620373
5171,2013,강원,원주시,4213000000,초등학교,2013-04-01,여자,1485,1499,1526,27,-41,-14,0.018012008,-0.026867628,-0.00933956
5172,2013,강원,원주시,4213000000,초등학교,2013-04-01,남자,1576,1554,1564,10,12,22,0.006435006,0.007672634,0.014157014
5173,2013,강원,강릉시,4215000000,초등학교,2013-04-01,전체,1704,1722,1733,11,-29,-18,0.006387921,-0.016733987,-0.010452962
5174,2013,강원,강릉시,4215000000,초등학교,2013-04-01,여자,781,759,773,14,8,22,0.018445323,0.010349288,0.028985507
5175,2013,강원,강릉시,4215000000,초등학교,2013-04-01,남자,923,963,960,-3,-37,-40,-0.003115265,-0.038541667,-0.041536864
5176,2013,강원,동해시,4217000000,초등학교,2013-04-01,전체,845,806,822,16,23,39,0.019851117,0.027980535,0.048387097
5177,2013,강원,동해시,4217000000,초등학교,2013-04-01,여자,400,397,410,13,-10,3,0.032745592,-0.024390244,0.007556675
5178,2013,강원,동해시,4217000000,초등학교,2013-04-01,남자,445,409,412,3,33,36,0.007334963,0.080097087,0.08801956
5179,2013,강원,태백시,4219000000,초등학교,2013-04-01,전체,415,443,436,-7,-21,-28,-0.015801354,-0.048165138,-0.063205418
5180,2013,강원,태백시,4219000000,초등학교,2013-04-01,여자,219,223,220,-3,-1,-4,-0.013452915,-0.004545455,-0.01793722
5181,2013,강원,태백시,4219000000,초등학교,2013-04-01,남자,196,220,216,-4,-20,-24,-0.018181818,-0.092592593,-0.109090909
5182,2013,강원,속초시,4221000000,초등학교,2013-04-01,전체,680,701,701,0,-21,-21,0,-0.029957204,-0.029957204
5183,2013,강원,속초시,4221000000,초등학교,2013-04-01,여자,340,334,334,0,6,6,0,0.017964072,0.017964072
5184,2013,강원,속초시,4221000000,초등학교,2013-04-01,남자,340,367,367,0,-27,-27,0,-0.073569482,-0.073569482
5185,2013,강원,삼척시,4223000000,초등학교,2013-04-01,전체,464,514,510,-4,-46,-50,-0.007782101,-0.090196078,-0.097276265
5186,2013,강원,삼척시,4223000000,초등학교,2013-04-01,여자,208,231,232,1,-24,-23,0.004329004,-0.103448276,-0.0995671
5187,2013,강원,삼척시,4223000000,초등학교,2013-04-01,남자,256,283,278,-5,-22,-27,-0.017667845,-0.079136691,-0.09540636
5188,2013,강원,홍천군,4272000000,초등학교,2013-04-01,전체,456,493,473,-20,-17,-37,-0.040567951,-0.035940803,-0.07505071
5189,2013,강원,홍천군,4272000000,초등학교,2013-04-01,여자,216,224,208,-16,8,-8,-0.071428571,0.038461538,-0.035714286
5190,2013,강원,홍천군,4272000000,초등학교,2013-04-01,남자,240,269,265,-4,-25,-29,-0.014869888,-0.094339623,-0.107806691
5191,2013,강원,횡성군,4273000000,초등학교,2013-04-01,전체,292,299,313,14,-21,-7,0.046822742,-0.067092652,-0.023411371
5192,2013,강원,횡성군,4273000000,초등학교,2013-04-01,여자,136,148,152,4,-16,-12,0.027027027,-0.105263158,-0.081081081
5193,2013,강원,횡성군,4273000000,초등학교,2013-04-01,남자,156,151,161,10,-5,5,0.066225166,-0.031055901,0.033112583
5194,2013,강원,영월군,4275000000,초등학교,2013-04-01,전체,253,236,255,19,-2,17,0.080508475,-0.007843137,0.072033898
5195,2013,강원,영월군,4275000000,초등학교,2013-04-01,여자,116,114,115,1,1,2,0.00877193,0.008695652,0.01754386
5196,2013,강원,영월군,4275000000,초등학교,2013-04-01,남자,137,122,140,18,-3,15,0.147540984,-0.021428571,0.12295082
5197,2013,강원,평창군,4276000000,초등학교,2013-04-01,전체,286,283,299,16,-13,3,0.056537102,-0.043478261,0.010600707
5198,2013,강원,평창군,4276000000,초등학교,2013-04-01,여자,140,125,127,2,13,15,0.016,0.102362205,0.12
5199,2013,강원,평창군,4276000000,초등학교,2013-04-01,남자,146,158,172,14,-26,-12,0.088607595,-0.151162791,-0.075949367
5200,2013,강원,정선군,4277000000,초등학교,2013-04-01,전체,227,246,246,0,-19,-19,0,-0.077235772,-0.077235772
5201,2013,강원,정선군,4277000000,초등학교,2013-04-01,여자,115,122,123,1,-8,-7,0.008196721,-0.06504065,-0.057377049
5202,2013,강원,정선군,4277000000,초등학교,2013-04-01,남자,112,124,123,-1,-11,-12,-0.008064516,-0.089430894,-0.096774194
5203,2013,강원,철원군,4278000000,초등학교,2013-04-01,전체,441,466,458,-8,-17,-25,-0.017167382,-0.037117904,-0.053648069
5204,2013,강원,철원군,4278000000,초등학교,2013-04-01,여자,216,215,216,1,0,1,0.004651163,0,0.004651163
5205,2013,강원,철원군,4278000000,초등학교,2013-04-01,남자,225,251,242,-9,-17,-26,-0.035856574,-0.070247934,-0.103585657
5206,2013,강원,화천군,4279000000,초등학교,2013-04-01,전체,190,216,218,2,-28,-26,0.009259259,-0.128440367,-0.12037037
5207,2013,강원,화천군,4279000000,초등학교,2013-04-01,여자,97,110,115,5,-18,-13,0.045454545,-0.156521739,-0.118181818
5208,2013,강원,화천군,4279000000,초등학교,2013-04-01,남자,93,106,103,-3,-10,-13,-0.028301887,-0.097087379,-0.122641509
5209,2013,강원,양구군,4280000000,초등학교,2013-04-01,전체,199,202,207,5,-8,-3,0.024752475,-0.038647343,-0.014851485
5210,2013,강원,양구군,4280000000,초등학교,2013-04-01,여자,89,94,91,-3,-2,-5,-0.031914894,-0.021978022,-0.053191489
5211,2013,강원,양구군,4280000000,초등학교,2013-04-01,남자,110,108,116,8,-6,2,0.074074074,-0.051724138,0.018518519
5212,2013,강원,인제군,4281000000,초등학교,2013-04-01,전체,291,323,305,-18,-14,-32,-0.055727554,-0.045901639,-0.099071207
5213,2013,강원,인제군,4281000000,초등학교,2013-04-01,여자,151,159,147,-12,4,-8,-0.075471698,0.027210884,-0.050314465
5214,2013,강원,인제군,4281000000,초등학교,2013-04-01,남자,140,164,158,-6,-18,-24,-0.036585366,-0.113924051,-0.146341463
5215,2013,강원,고성군,4282000000,초등학교,2013-04-01,전체,181,183,183,0,-2,-2,0,-0.010928962,-0.010928962
5216,2013,강원,고성군,4282000000,초등학교,2013-04-01,여자,82,84,86,2,-4,-2,0.023809524,-0.046511628,-0.023809524
5217,2013,강원,고성군,4282000000,초등학교,2013-04-01,남자,99,99,97,-2,2,0,-0.02020202,0.020618557,0
5218,2013,강원,양양군,4283000000,초등학교,2013-04-01,전체,168,194,191,-3,-23,-26,-0.015463918,-0.120418848,-0.134020619
5219,2013,강원,양양군,4283000000,초등학교,2013-04-01,여자,86,95,90,-5,-4,-9,-0.052631579,-0.044444444,-0.094736842
5220,2013,강원,양양군,4283000000,초등학교,2013-04-01,남자,82,99,101,2,-19,-17,0.02020202,-0.188118812,-0.171717172
5221,2013,충북,청주시,4311000000,초등학교,2013-04-01,전체,6508,6700,6677,-23,-169,-192,-0.003432836,-0.025310768,-0.028656716
5222,2013,충북,청주시,4311000000,초등학교,2013-04-01,여자,3218,3291,3278,-13,-60,-73,-0.003950167,-0.018303844,-0.022181708
5223,2013,충북,청주시,4311000000,초등학교,2013-04-01,남자,3290,3409,3399,-10,-109,-119,-0.002933412,-0.032068255,-0.034907598
5224,2013,충북,충주시,4313000000,초등학교,2013-04-01,전체,1676,1738,1747,9,-71,-62,0.005178366,-0.040641099,-0.035673188
5225,2013,충북,충주시,4313000000,초등학교,2013-04-01,여자,811,816,810,-6,1,-5,-0.007352941,0.001234568,-0.006127451
5226,2013,충북,충주시,4313000000,초등학교,2013-04-01,남자,865,922,937,15,-72,-57,0.01626898,-0.076840982,-0.061822126
5227,2013,충북,제천시,4315000000,초등학교,2013-04-01,전체,1082,1074,1083,9,-1,8,0.008379888,-0.000923361,0.00744879
5228,2013,충북,제천시,4315000000,초등학교,2013-04-01,여자,520,528,535,7,-15,-8,0.013257576,-0.028037383,-0.015151515
5229,2013,충북,제천시,4315000000,초등학교,2013-04-01,남자,562,546,548,2,14,16,0.003663004,0.025547445,0.029304029
5230,2013,충북,청주시,4311000000,초등학교,2013-04-01,전체,1618,1717,1781,64,-163,-99,0.037274316,-0.091521617,-0.057658707
5231,2013,충북,청주시,4311000000,초등학교,2013-04-01,여자,793,848,871,23,-78,-55,0.027122642,-0.089552239,-0.064858491
5232,2013,충북,청주시,4311000000,초등학교,2013-04-01,남자,825,869,910,41,-85,-44,0.047180667,-0.093406593,-0.050632911
5233,2013,충북,보은군,4372000000,초등학교,2013-04-01,전체,188,188,187,-1,1,0,-0.005319149,0.005347594,0
5234,2013,충북,보은군,4372000000,초등학교,2013-04-01,여자,85,86,83,-3,2,-1,-0.034883721,0.024096386,-0.011627907
5235,2013,충북,보은군,4372000000,초등학교,2013-04-01,남자,103,102,104,2,-1,1,0.019607843,-0.009615385,0.009803922
5236,2013,충북,옥천군,4373000000,초등학교,2013-04-01,전체,374,401,394,-7,-20,-27,-0.017456359,-0.050761421,-0.067331671
5237,2013,충북,옥천군,4373000000,초등학교,2013-04-01,여자,176,206,198,-8,-22,-30,-0.038834951,-0.111111111,-0.145631068
5238,2013,충북,옥천군,4373000000,초등학교,2013-04-01,남자,198,195,196,1,2,3,0.005128205,0.010204082,0.015384615
5239,2013,충북,영동군,4374000000,초등학교,2013-04-01,전체,296,310,326,16,-30,-14,0.051612903,-0.09202454,-0.04516129
5240,2013,충북,영동군,4374000000,초등학교,2013-04-01,여자,146,157,161,4,-15,-11,0.025477707,-0.093167702,-0.070063694
5241,2013,충북,영동군,4374000000,초등학교,2013-04-01,남자,150,153,165,12,-15,-3,0.078431373,-0.090909091,-0.019607843
5242,2013,충북,진천군,4375000000,초등학교,2013-04-01,전체,564,600,602,2,-38,-36,0.003333333,-0.063122924,-0.06
5243,2013,충북,진천군,4375000000,초등학교,2013-04-01,여자,264,288,293,5,-29,-24,0.017361111,-0.098976109,-0.083333333
5244,2013,충북,진천군,4375000000,초등학교,2013-04-01,남자,300,312,309,-3,-9,-12,-0.009615385,-0.029126214,-0.038461538
5245,2013,충북,괴산군,4376000000,초등학교,2013-04-01,전체,166,163,173,10,-7,3,0.061349693,-0.040462428,0.018404908
5246,2013,충북,괴산군,4376000000,초등학교,2013-04-01,여자,83,88,94,6,-11,-5,0.068181818,-0.117021277,-0.056818182
5247,2013,충북,괴산군,4376000000,초등학교,2013-04-01,남자,83,75,79,4,4,8,0.053333333,0.050632911,0.106666667
5248,2013,충북,음성군,4377000000,초등학교,2013-04-01,전체,727,792,799,7,-72,-65,0.008838384,-0.090112641,-0.082070707
5249,2013,충북,음성군,4377000000,초등학교,2013-04-01,여자,378,394,404,10,-26,-16,0.025380711,-0.064356436,-0.040609137
5250,2013,충북,음성군,4377000000,초등학교,2013-04-01,남자,349,398,395,-3,-46,-49,-0.007537688,-0.116455696,-0.123115578
5251,2013,충북,단양군,4380000000,초등학교,2013-04-01,전체,184,204,196,-8,-12,-20,-0.039215686,-0.06122449,-0.098039216
5252,2013,충북,단양군,4380000000,초등학교,2013-04-01,여자,89,104,97,-7,-8,-15,-0.067307692,-0.082474227,-0.144230769
5253,2013,충북,단양군,4380000000,초등학교,2013-04-01,남자,95,100,99,-1,-4,-5,-0.01,-0.04040404,-0.05
5254,2013,충북,증평군,4374500000,초등학교,2013-04-01,전체,323,329,335,6,-12,-6,0.018237082,-0.035820896,-0.018237082
5255,2013,충북,증평군,4374500000,초등학교,2013-04-01,여자,151,147,153,6,-2,4,0.040816327,-0.013071895,0.027210884
5256,2013,충북,증평군,4374500000,초등학교,2013-04-01,남자,172,182,182,0,-10,-10,0,-0.054945055,-0.054945055
5257,2013,충남,천안시,4413000000,초등학교,2013-04-01,전체,6104,6226,6274,48,-170,-122,0.007709605,-0.027095952,-0.019595246
5258,2013,충남,천안시,4413000000,초등학교,2013-04-01,여자,2914,3028,3065,37,-151,-114,0.012219287,-0.049265905,-0.037648613
5259,2013,충남,천안시,4413000000,초등학교,2013-04-01,남자,3190,3198,3209,11,-19,-8,0.00343965,-0.005920848,-0.002501563
5260,2013,충남,공주시,4415000000,초등학교,2013-04-01,전체,887,918,939,21,-52,-31,0.022875817,-0.055378062,-0.033769063
5261,2013,충남,공주시,4415000000,초등학교,2013-04-01,여자,451,447,462,15,-11,4,0.033557047,-0.023809524,0.008948546
5262,2013,충남,공주시,4415000000,초등학교,2013-04-01,남자,436,471,477,6,-41,-35,0.012738854,-0.085953878,-0.074309979
5263,2013,충남,보령시,4418000000,초등학교,2013-04-01,전체,813,844,842,-2,-29,-31,-0.002369668,-0.034441805,-0.036729858
5264,2013,충남,보령시,4418000000,초등학교,2013-04-01,여자,379,386,384,-2,-5,-7,-0.005181347,-0.013020833,-0.018134715
5265,2013,충남,보령시,4418000000,초등학교,2013-04-01,남자,434,458,458,0,-24,-24,0,-0.052401747,-0.052401747
5266,2013,충남,아산시,4420000000,초등학교,2013-04-01,전체,3235,3425,3426,1,-191,-190,0.000291971,-0.055750146,-0.055474453
5267,2013,충남,아산시,4420000000,초등학교,2013-04-01,여자,1573,1697,1685,-12,-112,-124,-0.007071302,-0.066468843,-0.073070124
5268,2013,충남,아산시,4420000000,초등학교,2013-04-01,남자,1662,1728,1741,13,-79,-66,0.007523148,-0.045376221,-0.038194444
5269,2013,충남,서산시,4421000000,초등학교,2013-04-01,전체,1599,1665,1673,8,-74,-66,0.004804805,-0.044231919,-0.03963964
5270,2013,충남,서산시,4421000000,초등학교,2013-04-01,여자,768,813,812,-1,-44,-45,-0.001230012,-0.054187192,-0.055350554
5271,2013,충남,서산시,4421000000,초등학교,2013-04-01,남자,831,852,861,9,-30,-21,0.01056338,-0.034843206,-0.024647887
5272,2013,충남,논산시,4423000000,초등학교,2013-04-01,전체,999,987,1001,14,-2,12,0.014184397,-0.001998002,0.012158055
5273,2013,충남,논산시,4423000000,초등학교,2013-04-01,여자,481,469,469,0,12,12,0,0.025586354,0.025586354
5274,2013,충남,논산시,4423000000,초등학교,2013-04-01,남자,518,518,532,14,-14,0,0.027027027,-0.026315789,0
5275,2013,충남,계룡시,4425000000,초등학교,2013-04-01,전체,532,549,524,-25,8,-17,-0.045537341,0.015267176,-0.030965392
5276,2013,충남,계룡시,4425000000,초등학교,2013-04-01,여자,257,267,253,-14,4,-10,-0.052434457,0.015810277,-0.037453184
5277,2013,충남,계룡시,4425000000,초등학교,2013-04-01,남자,275,282,271,-11,4,-7,-0.039007092,0.014760148,-0.024822695
5278,2013,충남,금산군,4471000000,초등학교,2013-04-01,전체,377,429,427,-2,-50,-52,-0.004662005,-0.117096019,-0.121212121
5279,2013,충남,금산군,4471000000,초등학교,2013-04-01,여자,176,209,208,-1,-32,-33,-0.004784689,-0.153846154,-0.157894737
5280,2013,충남,금산군,4471000000,초등학교,2013-04-01,남자,201,220,219,-1,-18,-19,-0.004545455,-0.082191781,-0.086363636
5281,2013,충남,부여군,4476000000,초등학교,2013-04-01,전체,455,428,438,10,17,27,0.023364486,0.038812785,0.063084112
5282,2013,충남,부여군,4476000000,초등학교,2013-04-01,여자,212,195,194,-1,18,17,-0.005128205,0.092783505,0.087179487
5283,2013,충남,부여군,4476000000,초등학교,2013-04-01,남자,243,233,244,11,-1,10,0.0472103,-0.004098361,0.042918455
5284,2013,충남,서천군,4477000000,초등학교,2013-04-01,전체,310,332,324,-8,-14,-22,-0.024096386,-0.043209877,-0.06626506
5285,2013,충남,서천군,4477000000,초등학교,2013-04-01,여자,150,173,166,-7,-16,-23,-0.040462428,-0.096385542,-0.132947977
5286,2013,충남,서천군,4477000000,초등학교,2013-04-01,남자,160,159,158,-1,2,1,-0.006289308,0.012658228,0.006289308
5287,2013,충남,청양군,4479000000,초등학교,2013-04-01,전체,173,184,183,-1,-10,-11,-0.005434783,-0.054644809,-0.059782609
5288,2013,충남,청양군,4479000000,초등학교,2013-04-01,여자,85,92,93,1,-8,-7,0.010869565,-0.086021505,-0.076086957
5289,2013,충남,청양군,4479000000,초등학교,2013-04-01,남자,88,92,90,-2,-2,-4,-0.02173913,-0.022222222,-0.043478261
5290,2013,충남,홍성군,4480000000,초등학교,2013-04-01,전체,716,661,662,1,54,55,0.001512859,0.081570997,0.083207262
5291,2013,충남,홍성군,4480000000,초등학교,2013-04-01,여자,338,322,314,-8,24,16,-0.02484472,0.076433121,0.049689441
5292,2013,충남,홍성군,4480000000,초등학교,2013-04-01,남자,378,339,348,9,30,39,0.026548673,0.086206897,0.115044248
5293,2013,충남,예산군,4481000000,초등학교,2013-04-01,전체,557,594,603,9,-46,-37,0.015151515,-0.07628524,-0.062289562
5294,2013,충남,예산군,4481000000,초등학교,2013-04-01,여자,286,283,285,2,1,3,0.007067138,0.003508772,0.010600707
5295,2013,충남,예산군,4481000000,초등학교,2013-04-01,남자,271,311,318,7,-47,-40,0.022508039,-0.147798742,-0.128617363
5296,2013,충남,태안군,4482500000,초등학교,2013-04-01,전체,429,442,437,-5,-8,-13,-0.011312217,-0.018306636,-0.029411765
5297,2013,충남,태안군,4482500000,초등학교,2013-04-01,여자,217,218,219,1,-2,-1,0.004587156,-0.00913242,-0.004587156
5298,2013,충남,태안군,4482500000,초등학교,2013-04-01,남자,212,224,218,-6,-6,-12,-0.026785714,-0.027522936,-0.053571429
5299,2013,전북,전주시,4511000000,초등학교,2013-04-01,전체,5965,6169,6256,87,-291,-204,0.014102772,-0.046515345,-0.033068569
5300,2013,전북,전주시,4511000000,초등학교,2013-04-01,여자,2867,2913,2972,59,-105,-46,0.020254034,-0.035329744,-0.01579128
5301,2013,전북,전주시,4511000000,초등학교,2013-04-01,남자,3098,3256,3284,28,-186,-158,0.008599509,-0.056638246,-0.048525799
5302,2013,전북,군산시,4513000000,초등학교,2013-04-01,전체,2525,2609,2644,35,-119,-84,0.013415102,-0.045007564,-0.032196244
5303,2013,전북,군산시,4513000000,초등학교,2013-04-01,여자,1223,1280,1309,29,-86,-57,0.02265625,-0.065699007,-0.04453125
5304,2013,전북,군산시,4513000000,초등학교,2013-04-01,남자,1302,1329,1335,6,-33,-27,0.004514673,-0.024719101,-0.020316027
5305,2013,전북,익산시,4514000000,초등학교,2013-04-01,전체,2643,2697,2713,16,-70,-54,0.005932518,-0.025801696,-0.020022247
5306,2013,전북,익산시,4514000000,초등학교,2013-04-01,여자,1314,1334,1351,17,-37,-20,0.012743628,-0.027387121,-0.014992504
5307,2013,전북,익산시,4514000000,초등학교,2013-04-01,남자,1329,1363,1362,-1,-33,-34,-0.000733676,-0.024229075,-0.024944974
5308,2013,전북,정읍시,4518000000,초등학교,2013-04-01,전체,855,936,930,-6,-75,-81,-0.006410256,-0.080645161,-0.086538462
5309,2013,전북,정읍시,4518000000,초등학교,2013-04-01,여자,402,469,466,-3,-64,-67,-0.006396588,-0.137339056,-0.142857143
5310,2013,전북,정읍시,4518000000,초등학교,2013-04-01,남자,453,467,464,-3,-11,-14,-0.006423983,-0.023706897,-0.029978587
5311,2013,전북,남원시,4519000000,초등학교,2013-04-01,전체,697,731,743,12,-46,-34,0.016415869,-0.061911171,-0.046511628
5312,2013,전북,남원시,4519000000,초등학교,2013-04-01,여자,343,367,376,9,-33,-24,0.024523161,-0.087765957,-0.065395095
5313,2013,전북,남원시,4519000000,초등학교,2013-04-01,남자,354,364,367,3,-13,-10,0.008241758,-0.035422343,-0.027472527
5314,2013,전북,김제시,4521000000,초등학교,2013-04-01,전체,645,629,641,12,4,16,0.019077901,0.00624025,0.025437202
5315,2013,전북,김제시,4521000000,초등학교,2013-04-01,여자,298,300,303,3,-5,-2,0.01,-0.01650165,-0.006666667
5316,2013,전북,김제시,4521000000,초등학교,2013-04-01,남자,347,329,338,9,9,18,0.027355623,0.026627219,0.054711246
5317,2013,전북,완주군,4571000000,초등학교,2013-04-01,전체,871,881,874,-7,-3,-10,-0.007945516,-0.003432494,-0.011350738
5318,2013,전북,완주군,4571000000,초등학교,2013-04-01,여자,427,435,422,-13,5,-8,-0.029885057,0.011848341,-0.018390805
5319,2013,전북,완주군,4571000000,초등학교,2013-04-01,남자,444,446,452,6,-8,-2,0.013452915,-0.017699115,-0.004484305
5320,2013,전북,진안군,4572000000,초등학교,2013-04-01,전체,169,171,179,8,-10,-2,0.046783626,-0.055865922,-0.011695906
5321,2013,전북,진안군,4572000000,초등학교,2013-04-01,여자,81,77,84,7,-3,4,0.090909091,-0.035714286,0.051948052
5322,2013,전북,진안군,4572000000,초등학교,2013-04-01,남자,88,94,95,1,-7,-6,0.010638298,-0.073684211,-0.063829787
5323,2013,전북,무주군,4573000000,초등학교,2013-04-01,전체,170,196,193,-3,-23,-26,-0.015306122,-0.119170984,-0.132653061
5324,2013,전북,무주군,4573000000,초등학교,2013-04-01,여자,81,101,97,-4,-16,-20,-0.03960396,-0.164948454,-0.198019802
5325,2013,전북,무주군,4573000000,초등학교,2013-04-01,남자,89,95,96,1,-7,-6,0.010526316,-0.072916667,-0.063157895
5326,2013,전북,장수군,4574000000,초등학교,2013-04-01,전체,134,155,152,-3,-18,-21,-0.019354839,-0.118421053,-0.135483871
5327,2013,전북,장수군,4574000000,초등학교,2013-04-01,여자,63,80,77,-3,-14,-17,-0.0375,-0.181818182,-0.2125
5328,2013,전북,장수군,4574000000,초등학교,2013-04-01,남자,71,75,75,0,-4,-4,0,-0.053333333,-0.053333333
5329,2013,전북,임실군,4575000000,초등학교,2013-04-01,전체,166,189,188,-1,-22,-23,-0.005291005,-0.117021277,-0.121693122
5330,2013,전북,임실군,4575000000,초등학교,2013-04-01,여자,84,86,83,-3,1,-2,-0.034883721,0.012048193,-0.023255814
5331,2013,전북,임실군,4575000000,초등학교,2013-04-01,남자,82,103,105,2,-23,-21,0.019417476,-0.219047619,-0.203883495
5332,2013,전북,순창군,4577000000,초등학교,2013-04-01,전체,177,199,195,-4,-18,-22,-0.020100503,-0.092307692,-0.110552764
5333,2013,전북,순창군,4577000000,초등학교,2013-04-01,여자,81,93,92,-1,-11,-12,-0.010752688,-0.119565217,-0.129032258
5334,2013,전북,순창군,4577000000,초등학교,2013-04-01,남자,96,106,103,-3,-7,-10,-0.028301887,-0.067961165,-0.094339623
5335,2013,전북,고창군,4579000000,초등학교,2013-04-01,전체,335,339,334,-5,1,-4,-0.014749263,0.002994012,-0.01179941
5336,2013,전북,고창군,4579000000,초등학교,2013-04-01,여자,159,148,144,-4,15,11,-0.027027027,0.104166667,0.074324324
5337,2013,전북,고창군,4579000000,초등학교,2013-04-01,남자,176,191,190,-1,-14,-15,-0.005235602,-0.073684211,-0.078534031
5338,2013,전북,부안군,4580000000,초등학교,2013-04-01,전체,313,322,312,-10,1,-9,-0.031055901,0.003205128,-0.027950311
5339,2013,전북,부안군,4580000000,초등학교,2013-04-01,여자,147,146,145,-1,2,1,-0.006849315,0.013793103,0.006849315
5340,2013,전북,부안군,4580000000,초등학교,2013-04-01,남자,166,176,167,-9,-1,-10,-0.051136364,-0.005988024,-0.056818182
5341,2013,전남,목포시,4611000000,초등학교,2013-04-01,전체,2638,2539,2538,-1,100,99,-0.000393856,0.039401103,0.038991729
5342,2013,전남,목포시,4611000000,초등학교,2013-04-01,여자,1288,1221,1213,-8,75,67,-0.006552007,0.061830173,0.054873055
5343,2013,전남,목포시,4611000000,초등학교,2013-04-01,남자,1350,1318,1325,7,25,32,0.005311077,0.018867925,0.024279211
5344,2013,전남,여수시,4613000000,초등학교,2013-04-01,전체,2482,2556,2600,44,-118,-74,0.017214397,-0.045384615,-0.028951487
5345,2013,전남,여수시,4613000000,초등학교,2013-04-01,여자,1206,1240,1252,12,-46,-34,0.009677419,-0.036741214,-0.027419355
5346,2013,전남,여수시,4613000000,초등학교,2013-04-01,남자,1276,1316,1348,32,-72,-40,0.024316109,-0.053412463,-0.030395137
5347,2013,전남,순천시,4615000000,초등학교,2013-04-01,전체,2593,2560,2603,43,-10,33,0.016796875,-0.003841721,0.012890625
5348,2013,전남,순천시,4615000000,초등학교,2013-04-01,여자,1279,1244,1280,36,-1,35,0.028938907,-0.00078125,0.028135048
5349,2013,전남,순천시,4615000000,초등학교,2013-04-01,남자,1314,1316,1323,7,-9,-2,0.005319149,-0.006802721,-0.001519757
5350,2013,전남,나주시,4617000000,초등학교,2013-04-01,전체,552,567,571,4,-19,-15,0.007054674,-0.033274956,-0.026455026
5351,2013,전남,나주시,4617000000,초등학교,2013-04-01,여자,262,271,263,-8,-1,-9,-0.029520295,-0.003802281,-0.033210332
5352,2013,전남,나주시,4617000000,초등학교,2013-04-01,남자,290,296,308,12,-18,-6,0.040540541,-0.058441558,-0.02027027
5353,2013,전남,광양시,4623000000,초등학교,2013-04-01,전체,1462,1472,1508,36,-46,-10,0.024456522,-0.030503979,-0.006793478
5354,2013,전남,광양시,4623000000,초등학교,2013-04-01,여자,732,727,737,10,-5,5,0.013755158,-0.006784261,0.006877579
5355,2013,전남,광양시,4623000000,초등학교,2013-04-01,남자,730,745,771,26,-41,-15,0.034899329,-0.053177691,-0.020134228
5356,2013,전남,담양군,4671000000,초등학교,2013-04-01,전체,212,271,255,-16,-43,-59,-0.05904059,-0.168627451,-0.217712177
5357,2013,전남,담양군,4671000000,초등학교,2013-04-01,여자,99,122,117,-5,-18,-23,-0.040983607,-0.153846154,-0.18852459
5358,2013,전남,담양군,4671000000,초등학교,2013-04-01,남자,113,149,138,-11,-25,-36,-0.073825503,-0.18115942,-0.241610738
5359,2013,전남,곡성군,4672000000,초등학교,2013-04-01,전체,177,204,193,-11,-16,-27,-0.053921569,-0.082901554,-0.132352941
5360,2013,전남,곡성군,4672000000,초등학교,2013-04-01,여자,75,92,89,-3,-14,-17,-0.032608696,-0.157303371,-0.184782609
5361,2013,전남,곡성군,4672000000,초등학교,2013-04-01,남자,102,112,104,-8,-2,-10,-0.071428571,-0.019230769,-0.089285714
5362,2013,전남,구례군,4673000000,초등학교,2013-04-01,전체,162,180,182,2,-20,-18,0.011111111,-0.10989011,-0.1
5363,2013,전남,구례군,4673000000,초등학교,2013-04-01,여자,79,84,85,1,-6,-5,0.011904762,-0.070588235,-0.05952381
5364,2013,전남,구례군,4673000000,초등학교,2013-04-01,남자,83,96,97,1,-14,-13,0.010416667,-0.144329897,-0.135416667
5365,2013,전남,고흥군,4677000000,초등학교,2013-04-01,전체,350,383,365,-18,-15,-33,-0.046997389,-0.04109589,-0.08616188
5366,2013,전남,고흥군,4677000000,초등학교,2013-04-01,여자,171,189,183,-6,-12,-18,-0.031746032,-0.06557377,-0.095238095
5367,2013,전남,고흥군,4677000000,초등학교,2013-04-01,남자,179,194,182,-12,-3,-15,-0.06185567,-0.016483516,-0.077319588
5368,2013,전남,보성군,4678000000,초등학교,2013-04-01,전체,252,344,309,-35,-57,-92,-0.101744186,-0.184466019,-0.26744186
5369,2013,전남,보성군,4678000000,초등학교,2013-04-01,여자,116,168,139,-29,-23,-52,-0.172619048,-0.165467626,-0.30952381
5370,2013,전남,보성군,4678000000,초등학교,2013-04-01,남자,136,176,170,-6,-34,-40,-0.034090909,-0.2,-0.227272727
5371,2013,전남,화순군,4679000000,초등학교,2013-04-01,전체,513,597,568,-29,-55,-84,-0.048576214,-0.096830986,-0.140703518
5372,2013,전남,화순군,4679000000,초등학교,2013-04-01,여자,244,282,268,-14,-24,-38,-0.04964539,-0.089552239,-0.134751773
5373,2013,전남,화순군,4679000000,초등학교,2013-04-01,남자,269,315,300,-15,-31,-46,-0.047619048,-0.103333333,-0.146031746
5374,2013,전남,장흥군,4680000000,초등학교,2013-04-01,전체,246,258,253,-5,-7,-12,-0.019379845,-0.027667984,-0.046511628
5375,2013,전남,장흥군,4680000000,초등학교,2013-04-01,여자,99,117,114,-3,-15,-18,-0.025641026,-0.131578947,-0.153846154
5376,2013,전남,장흥군,4680000000,초등학교,2013-04-01,남자,147,141,139,-2,8,6,-0.014184397,0.057553957,0.042553191
5377,2013,전남,강진군,4681000000,초등학교,2013-04-01,전체,223,313,299,-14,-76,-90,-0.044728435,-0.254180602,-0.287539936
5378,2013,전남,강진군,4681000000,초등학교,2013-04-01,여자,106,170,156,-14,-50,-64,-0.082352941,-0.320512821,-0.376470588
5379,2013,전남,강진군,4681000000,초등학교,2013-04-01,남자,117,143,143,0,-26,-26,0,-0.181818182,-0.181818182
5380,2013,전남,해남군,4682000000,초등학교,2013-04-01,전체,495,497,506,9,-11,-2,0.018108652,-0.02173913,-0.004024145
5381,2013,전남,해남군,4682000000,초등학교,2013-04-01,여자,240,238,242,4,-2,2,0.016806723,-0.008264463,0.008403361
5382,2013,전남,해남군,4682000000,초등학교,2013-04-01,남자,255,259,264,5,-9,-4,0.019305019,-0.034090909,-0.015444015
5383,2013,전남,영암군,4683000000,초등학교,2013-04-01,전체,471,539,525,-14,-54,-68,-0.025974026,-0.102857143,-0.126159555
5384,2013,전남,영암군,4683000000,초등학교,2013-04-01,여자,219,259,248,-11,-29,-40,-0.042471042,-0.116935484,-0.154440154
5385,2013,전남,영암군,4683000000,초등학교,2013-04-01,남자,252,280,277,-3,-25,-28,-0.010714286,-0.090252708,-0.1
5386,2013,전남,무안군,4684000000,초등학교,2013-04-01,전체,577,658,686,28,-109,-81,0.042553191,-0.158892128,-0.123100304
5387,2013,전남,무안군,4684000000,초등학교,2013-04-01,여자,284,336,345,9,-61,-52,0.026785714,-0.176811594,-0.154761905
5388,2013,전남,무안군,4684000000,초등학교,2013-04-01,남자,293,322,341,19,-48,-29,0.059006211,-0.140762463,-0.090062112
5389,2013,전남,함평군,4686000000,초등학교,2013-04-01,전체,165,215,208,-7,-43,-50,-0.03255814,-0.206730769,-0.23255814
5390,2013,전남,함평군,4686000000,초등학교,2013-04-01,여자,88,107,102,-5,-14,-19,-0.046728972,-0.137254902,-0.177570093
5391,2013,전남,함평군,4686000000,초등학교,2013-04-01,남자,77,108,106,-2,-29,-31,-0.018518519,-0.273584906,-0.287037037
5392,2013,전남,영광군,4687000000,초등학교,2013-04-01,전체,373,404,400,-4,-27,-31,-0.00990099,-0.0675,-0.076732673
5393,2013,전남,영광군,4687000000,초등학교,2013-04-01,여자,190,201,196,-5,-6,-11,-0.024875622,-0.030612245,-0.054726368
5394,2013,전남,영광군,4687000000,초등학교,2013-04-01,남자,183,203,204,1,-21,-20,0.004926108,-0.102941176,-0.098522167
5395,2013,전남,장성군,4688000000,초등학교,2013-04-01,전체,343,335,335,0,8,8,0,0.023880597,0.023880597
5396,2013,전남,장성군,4688000000,초등학교,2013-04-01,여자,168,158,156,-2,12,10,-0.012658228,0.076923077,0.063291139
5397,2013,전남,장성군,4688000000,초등학교,2013-04-01,남자,175,177,179,2,-4,-2,0.011299435,-0.022346369,-0.011299435
5398,2013,전남,완도군,4689000000,초등학교,2013-04-01,전체,369,367,373,6,-4,2,0.016348774,-0.010723861,0.005449591
5399,2013,전남,완도군,4689000000,초등학교,2013-04-01,여자,169,169,167,-2,2,0,-0.01183432,0.011976048,0
5400,2013,전남,완도군,4689000000,초등학교,2013-04-01,남자,200,198,206,8,-6,2,0.04040404,-0.029126214,0.01010101
5401,2013,전남,진도군,4690000000,초등학교,2013-04-01,전체,201,250,250,0,-49,-49,0,-0.196,-0.196
5402,2013,전남,진도군,4690000000,초등학교,2013-04-01,여자,90,110,110,0,-20,-20,0,-0.181818182,-0.181818182
5403,2013,전남,진도군,4690000000,초등학교,2013-04-01,남자,111,140,140,0,-29,-29,0,-0.207142857,-0.207142857
5404,2013,전남,신안군,4691000000,초등학교,2013-04-01,전체,145,206,196,-10,-51,-61,-0.048543689,-0.260204082,-0.296116505
5405,2013,전남,신안군,4691000000,초등학교,2013-04-01,여자,83,108,102,-6,-19,-25,-0.055555556,-0.18627451,-0.231481481
5406,2013,전남,신안군,4691000000,초등학교,2013-04-01,남자,62,98,94,-4,-32,-36,-0.040816327,-0.340425532,-0.367346939
5407,2013,경북,포항시,4711000000,초등학교,2013-04-01,전체,4337,4375,4440,65,-103,-38,0.014857143,-0.023198198,-0.008685714
5408,2013,경북,포항시,4711000000,초등학교,2013-04-01,여자,2066,2118,2156,38,-90,-52,0.017941454,-0.04174397,-0.024551464
5409,2013,경북,포항시,4711000000,초등학교,2013-04-01,남자,2271,2257,2284,27,-13,14,0.011962782,-0.005691769,0.006202924
5410,2013,경북,경주시,4713000000,초등학교,2013-04-01,전체,2046,2188,2173,-15,-127,-142,-0.006855576,-0.058444547,-0.064899452
5411,2013,경북,경주시,4713000000,초등학교,2013-04-01,여자,985,1088,1073,-15,-88,-103,-0.013786765,-0.082013048,-0.094669118
5412,2013,경북,경주시,4713000000,초등학교,2013-04-01,남자,1061,1100,1100,0,-39,-39,0,-0.035454545,-0.035454545
5413,2013,경북,김천시,4715000000,초등학교,2013-04-01,전체,884,988,979,-9,-95,-104,-0.009109312,-0.097037794,-0.105263158
5414,2013,경북,김천시,4715000000,초등학교,2013-04-01,여자,381,438,427,-11,-46,-57,-0.025114155,-0.107728337,-0.130136986
5415,2013,경북,김천시,4715000000,초등학교,2013-04-01,남자,503,550,552,2,-49,-47,0.003636364,-0.088768116,-0.085454545
5416,2013,경북,안동시,4717000000,초등학교,2013-04-01,전체,1244,1314,1292,-22,-48,-70,-0.01674277,-0.037151703,-0.053272451
5417,2013,경북,안동시,4717000000,초등학교,2013-04-01,여자,609,637,628,-9,-19,-28,-0.014128728,-0.030254777,-0.043956044
5418,2013,경북,안동시,4717000000,초등학교,2013-04-01,남자,635,677,664,-13,-29,-42,-0.019202363,-0.043674699,-0.062038405
5419,2013,경북,구미시,4719000000,초등학교,2013-04-01,전체,4506,4636,4615,-21,-109,-130,-0.004529767,-0.023618635,-0.028041415
5420,2013,경북,구미시,4719000000,초등학교,2013-04-01,여자,2160,2188,2180,-8,-20,-28,-0.003656307,-0.009174312,-0.012797075
5421,2013,경북,구미시,4719000000,초등학교,2013-04-01,남자,2346,2448,2435,-13,-89,-102,-0.005310458,-0.036550308,-0.041666667
5422,2013,경북,영주시,4721000000,초등학교,2013-04-01,전체,826,822,812,-10,14,4,-0.01216545,0.017241379,0.00486618
5423,2013,경북,영주시,4721000000,초등학교,2013-04-01,여자,386,404,397,-7,-11,-18,-0.017326733,-0.027707809,-0.044554455
5424,2013,경북,영주시,4721000000,초등학교,2013-04-01,남자,440,418,415,-3,25,22,-0.007177033,0.060240964,0.052631579
5425,2013,경북,영천시,4723000000,초등학교,2013-04-01,전체,568,685,667,-18,-99,-117,-0.026277372,-0.148425787,-0.17080292
5426,2013,경북,영천시,4723000000,초등학교,2013-04-01,여자,276,337,332,-5,-56,-61,-0.014836795,-0.168674699,-0.181008902
5427,2013,경북,영천시,4723000000,초등학교,2013-04-01,남자,292,348,335,-13,-43,-56,-0.037356322,-0.128358209,-0.16091954
5428,2013,경북,상주시,4725000000,초등학교,2013-04-01,전체,619,654,655,1,-36,-35,0.001529052,-0.054961832,-0.05351682
5429,2013,경북,상주시,4725000000,초등학교,2013-04-01,여자,288,309,303,-6,-15,-21,-0.019417476,-0.04950495,-0.067961165
5430,2013,경북,상주시,4725000000,초등학교,2013-04-01,남자,331,345,352,7,-21,-14,0.020289855,-0.059659091,-0.04057971
5431,2013,경북,문경시,4728000000,초등학교,2013-04-01,전체,464,469,481,12,-17,-5,0.025586354,-0.035343035,-0.010660981
5432,2013,경북,문경시,4728000000,초등학교,2013-04-01,여자,207,213,220,7,-13,-6,0.03286385,-0.059090909,-0.028169014
5433,2013,경북,문경시,4728000000,초등학교,2013-04-01,남자,257,256,261,5,-4,1,0.01953125,-0.01532567,0.00390625
5434,2013,경북,경산시,4729000000,초등학교,2013-04-01,전체,2128,2275,2227,-48,-99,-147,-0.021098901,-0.044454423,-0.064615385
5435,2013,경북,경산시,4729000000,초등학교,2013-04-01,여자,989,1062,1041,-21,-52,-73,-0.019774011,-0.049951969,-0.06873823
5436,2013,경북,경산시,4729000000,초등학교,2013-04-01,남자,1139,1213,1186,-27,-47,-74,-0.022258862,-0.039629005,-0.061005771
5437,2013,경북,군위군,4772000000,초등학교,2013-04-01,전체,77,103,96,-7,-19,-26,-0.067961165,-0.197916667,-0.252427184
5438,2013,경북,군위군,4772000000,초등학교,2013-04-01,여자,40,53,48,-5,-8,-13,-0.094339623,-0.166666667,-0.245283019
5439,2013,경북,군위군,4772000000,초등학교,2013-04-01,남자,37,50,48,-2,-11,-13,-0.04,-0.229166667,-0.26
5440,2013,경북,의성군,4773000000,초등학교,2013-04-01,전체,217,225,226,1,-9,-8,0.004444444,-0.039823009,-0.035555556
5441,2013,경북,의성군,4773000000,초등학교,2013-04-01,여자,107,125,125,0,-18,-18,0,-0.144,-0.144
5442,2013,경북,의성군,4773000000,초등학교,2013-04-01,남자,110,100,101,1,9,10,0.01,0.089108911,0.1
5443,2013,경북,청송군,4775000000,초등학교,2013-04-01,전체,118,124,121,-3,-3,-6,-0.024193548,-0.024793388,-0.048387097
5444,2013,경북,청송군,4775000000,초등학교,2013-04-01,여자,60,64,62,-2,-2,-4,-0.03125,-0.032258065,-0.0625
5445,2013,경북,청송군,4775000000,초등학교,2013-04-01,남자,58,60,59,-1,-1,-2,-0.016666667,-0.016949153,-0.033333333
5446,2013,경북,영양군,4776000000,초등학교,2013-04-01,전체,87,94,105,11,-18,-7,0.117021277,-0.171428571,-0.074468085
5447,2013,경북,영양군,4776000000,초등학교,2013-04-01,여자,42,45,50,5,-8,-3,0.111111111,-0.16,-0.066666667
5448,2013,경북,영양군,4776000000,초등학교,2013-04-01,남자,45,49,55,6,-10,-4,0.12244898,-0.181818182,-0.081632653
5449,2013,경북,영덕군,4777000000,초등학교,2013-04-01,전체,205,230,227,-3,-22,-25,-0.013043478,-0.0969163,-0.108695652
5450,2013,경북,영덕군,4777000000,초등학교,2013-04-01,여자,106,106,101,-5,5,0,-0.047169811,0.04950495,0
5451,2013,경북,영덕군,4777000000,초등학교,2013-04-01,남자,99,124,126,2,-27,-25,0.016129032,-0.214285714,-0.201612903
5452,2013,경북,청도군,4782000000,초등학교,2013-04-01,전체,184,206,207,1,-23,-22,0.004854369,-0.111111111,-0.106796117
5453,2013,경북,청도군,4782000000,초등학교,2013-04-01,여자,86,111,111,0,-25,-25,0,-0.225225225,-0.225225225
5454,2013,경북,청도군,4782000000,초등학교,2013-04-01,남자,98,95,96,1,2,3,0.010526316,0.020833333,0.031578947
5455,2013,경북,고령군,4783000000,초등학교,2013-04-01,전체,230,249,252,3,-22,-19,0.012048193,-0.087301587,-0.076305221
5456,2013,경북,고령군,4783000000,초등학교,2013-04-01,여자,118,118,115,-3,3,0,-0.025423729,0.026086957,0
5457,2013,경북,고령군,4783000000,초등학교,2013-04-01,남자,112,131,137,6,-25,-19,0.045801527,-0.182481752,-0.145038168
5458,2013,경북,성주군,4784000000,초등학교,2013-04-01,전체,207,212,209,-3,-2,-5,-0.014150943,-0.009569378,-0.023584906
5459,2013,경북,성주군,4784000000,초등학교,2013-04-01,여자,89,95,89,-6,0,-6,-0.063157895,0,-0.063157895
5460,2013,경북,성주군,4784000000,초등학교,2013-04-01,남자,118,117,120,3,-2,1,0.025641026,-0.016666667,0.008547009
5461,2013,경북,칠곡군,4785000000,초등학교,2013-04-01,전체,1214,1405,1340,-65,-126,-191,-0.046263345,-0.094029851,-0.13594306
5462,2013,경북,칠곡군,4785000000,초등학교,2013-04-01,여자,581,675,636,-39,-55,-94,-0.057777778,-0.086477987,-0.139259259
5463,2013,경북,칠곡군,4785000000,초등학교,2013-04-01,남자,633,730,704,-26,-71,-97,-0.035616438,-0.100852273,-0.132876712
5464,2013,경북,예천군,4790000000,초등학교,2013-04-01,전체,253,271,271,0,-18,-18,0,-0.066420664,-0.066420664
5465,2013,경북,예천군,4790000000,초등학교,2013-04-01,여자,114,126,127,1,-13,-12,0.007936508,-0.102362205,-0.095238095
5466,2013,경북,예천군,4790000000,초등학교,2013-04-01,남자,139,145,144,-1,-5,-6,-0.006896552,-0.034722222,-0.04137931
5467,2013,경북,봉화군,4792000000,초등학교,2013-04-01,전체,171,184,192,8,-21,-13,0.043478261,-0.109375,-0.070652174
5468,2013,경북,봉화군,4792000000,초등학교,2013-04-01,여자,83,92,98,6,-15,-9,0.065217391,-0.153061224,-0.097826087
5469,2013,경북,봉화군,4792000000,초등학교,2013-04-01,남자,88,92,94,2,-6,-4,0.02173913,-0.063829787,-0.043478261
5470,2013,경북,울진군,4793000000,초등학교,2013-04-01,전체,362,407,398,-9,-36,-45,-0.022113022,-0.090452261,-0.110565111
5471,2013,경북,울진군,4793000000,초등학교,2013-04-01,여자,166,177,175,-2,-9,-11,-0.011299435,-0.051428571,-0.062146893
5472,2013,경북,울진군,4793000000,초등학교,2013-04-01,남자,196,230,223,-7,-27,-34,-0.030434783,-0.121076233,-0.147826087
5473,2013,경북,울릉군,4794000000,초등학교,2013-04-01,전체,51,65,67,2,-16,-14,0.030769231,-0.23880597,-0.215384615
5474,2013,경북,울릉군,4794000000,초등학교,2013-04-01,여자,26,30,34,4,-8,-4,0.133333333,-0.235294118,-0.133333333
5475,2013,경북,울릉군,4794000000,초등학교,2013-04-01,남자,25,35,33,-2,-8,-10,-0.057142857,-0.242424242,-0.285714286
5476,2013,경남,진주시,4817000000,초등학교,2013-04-01,전체,3054,2967,3034,67,20,87,0.022581732,0.006591958,0.029322548
5477,2013,경남,진주시,4817000000,초등학교,2013-04-01,여자,1460,1417,1444,27,16,43,0.01905434,0.011080332,0.030345801
5478,2013,경남,진주시,4817000000,초등학교,2013-04-01,남자,1594,1550,1590,40,4,44,0.025806452,0.002515723,0.028387097
5479,2013,경남,통영시,4822000000,초등학교,2013-04-01,전체,1254,1311,1296,-15,-42,-57,-0.011441648,-0.032407407,-0.043478261
5480,2013,경남,통영시,4822000000,초등학교,2013-04-01,여자,617,626,620,-6,-3,-9,-0.009584665,-0.00483871,-0.014376997
5481,2013,경남,통영시,4822000000,초등학교,2013-04-01,남자,637,685,676,-9,-39,-48,-0.013138686,-0.057692308,-0.070072993
5482,2013,경남,사천시,4824000000,초등학교,2013-04-01,전체,1065,1081,1085,4,-20,-16,0.003700278,-0.01843318,-0.01480111
5483,2013,경남,사천시,4824000000,초등학교,2013-04-01,여자,510,532,530,-2,-20,-22,-0.003759398,-0.037735849,-0.041353383
5484,2013,경남,사천시,4824000000,초등학교,2013-04-01,남자,555,549,555,6,0,6,0.010928962,0,0.010928962
5485,2013,경남,김해시,4825000000,초등학교,2013-04-01,전체,5830,6015,5978,-37,-148,-185,-0.006151288,-0.024757444,-0.030756442
5486,2013,경남,김해시,4825000000,초등학교,2013-04-01,여자,2815,2944,2927,-17,-112,-129,-0.005774457,-0.038264435,-0.043817935
5487,2013,경남,김해시,4825000000,초등학교,2013-04-01,남자,3015,3071,3051,-20,-36,-56,-0.006512537,-0.01179941,-0.018235103
5488,2013,경남,밀양시,4827000000,초등학교,2013-04-01,전체,667,702,684,-18,-17,-35,-0.025641026,-0.024853801,-0.04985755
5489,2013,경남,밀양시,4827000000,초등학교,2013-04-01,여자,323,338,326,-12,-3,-15,-0.035502959,-0.009202454,-0.044378698
5490,2013,경남,밀양시,4827000000,초등학교,2013-04-01,남자,344,364,358,-6,-14,-20,-0.016483516,-0.039106145,-0.054945055
5491,2013,경남,거제시,4831000000,초등학교,2013-04-01,전체,2643,2763,2735,-28,-92,-120,-0.010133912,-0.033638026,-0.043431053
5492,2013,경남,거제시,4831000000,초등학교,2013-04-01,여자,1294,1314,1307,-7,-13,-20,-0.005327245,-0.009946442,-0.0152207
5493,2013,경남,거제시,4831000000,초등학교,2013-04-01,남자,1349,1449,1428,-21,-79,-100,-0.014492754,-0.055322129,-0.069013112
5494,2013,경남,양산시,4833000000,초등학교,2013-04-01,전체,2741,2843,2846,3,-105,-102,0.001055223,-0.036893886,-0.035877594
5495,2013,경남,양산시,4833000000,초등학교,2013-04-01,여자,1347,1377,1368,-9,-21,-30,-0.006535948,-0.015350877,-0.021786492
5496,2013,경남,양산시,4833000000,초등학교,2013-04-01,남자,1394,1466,1478,12,-84,-72,0.008185539,-0.056833559,-0.049113233
5497,2013,경남,의령군,4872000000,초등학교,2013-04-01,전체,129,148,143,-5,-14,-19,-0.033783784,-0.097902098,-0.128378378
5498,2013,경남,의령군,4872000000,초등학교,2013-04-01,여자,63,74,74,0,-11,-11,0,-0.148648649,-0.148648649
5499,2013,경남,의령군,4872000000,초등학교,2013-04-01,남자,66,74,69,-5,-3,-8,-0.067567568,-0.043478261,-0.108108108
5500,2013,경남,함안군,4873000000,초등학교,2013-04-01,전체,547,616,600,-16,-53,-69,-0.025974026,-0.088333333,-0.112012987
5501,2013,경남,함안군,4873000000,초등학교,2013-04-01,여자,254,307,302,-5,-48,-53,-0.016286645,-0.158940397,-0.172638436
5502,2013,경남,함안군,4873000000,초등학교,2013-04-01,남자,293,309,298,-11,-5,-16,-0.035598706,-0.016778523,-0.051779935
5503,2013,경남,창녕군,4874000000,초등학교,2013-04-01,전체,369,326,356,30,13,43,0.09202454,0.036516854,0.13190184
5504,2013,경남,창녕군,4874000000,초등학교,2013-04-01,여자,172,154,174,20,-2,18,0.12987013,-0.011494253,0.116883117
5505,2013,경남,창녕군,4874000000,초등학교,2013-04-01,남자,197,172,182,10,15,25,0.058139535,0.082417582,0.145348837
5506,2013,경남,고성군,4882000000,초등학교,2013-04-01,전체,374,368,391,23,-17,6,0.0625,-0.043478261,0.016304348
5507,2013,경남,고성군,4882000000,초등학교,2013-04-01,여자,181,171,173,2,8,10,0.011695906,0.046242775,0.058479532
5508,2013,경남,고성군,4882000000,초등학교,2013-04-01,남자,193,197,218,21,-25,-4,0.106598985,-0.114678899,-0.020304569
5509,2013,경남,남해군,4884000000,초등학교,2013-04-01,전체,218,234,234,0,-16,-16,0,-0.068376068,-0.068376068
5510,2013,경남,남해군,4884000000,초등학교,2013-04-01,여자,98,110,114,4,-16,-12,0.036363636,-0.140350877,-0.109090909
5511,2013,경남,남해군,4884000000,초등학교,2013-04-01,남자,120,124,120,-4,0,-4,-0.032258065,0,-0.032258065
5512,2013,경남,하동군,4885000000,초등학교,2013-04-01,전체,261,313,300,-13,-39,-52,-0.041533546,-0.13,-0.166134185
5513,2013,경남,하동군,4885000000,초등학교,2013-04-01,여자,131,160,152,-8,-21,-29,-0.05,-0.138157895,-0.18125
5514,2013,경남,하동군,4885000000,초등학교,2013-04-01,남자,130,153,148,-5,-18,-23,-0.032679739,-0.121621622,-0.150326797
5515,2013,경남,산청군,4886000000,초등학교,2013-04-01,전체,181,225,208,-17,-27,-44,-0.075555556,-0.129807692,-0.195555556
5516,2013,경남,산청군,4886000000,초등학교,2013-04-01,여자,89,110,103,-7,-14,-21,-0.063636364,-0.13592233,-0.190909091
5517,2013,경남,산청군,4886000000,초등학교,2013-04-01,남자,92,115,105,-10,-13,-23,-0.086956522,-0.123809524,-0.2
5518,2013,경남,함양군,4887000000,초등학교,2013-04-01,전체,283,288,284,-4,-1,-5,-0.013888889,-0.003521127,-0.017361111
5519,2013,경남,함양군,4887000000,초등학교,2013-04-01,여자,134,134,131,-3,3,0,-0.02238806,0.022900763,0
5520,2013,경남,함양군,4887000000,초등학교,2013-04-01,남자,149,154,153,-1,-4,-5,-0.006493506,-0.026143791,-0.032467532
5521,2013,경남,거창군,4888000000,초등학교,2013-04-01,전체,428,469,479,10,-51,-41,0.021321962,-0.106471816,-0.087420043
5522,2013,경남,거창군,4888000000,초등학교,2013-04-01,여자,212,225,227,2,-15,-13,0.008888889,-0.066079295,-0.057777778
5523,2013,경남,거창군,4888000000,초등학교,2013-04-01,남자,216,244,252,8,-36,-28,0.032786885,-0.142857143,-0.114754098
5524,2013,경남,합천군,4889000000,초등학교,2013-04-01,전체,205,280,273,-7,-68,-75,-0.025,-0.249084249,-0.267857143
5525,2013,경남,합천군,4889000000,초등학교,2013-04-01,여자,98,132,127,-5,-29,-34,-0.037878788,-0.228346457,-0.257575758
5526,2013,경남,합천군,4889000000,초등학교,2013-04-01,남자,107,148,146,-2,-39,-41,-0.013513514,-0.267123288,-0.277027027
5527,2013,제주,제주시,5011000000,초등학교,2013-04-01,전체,4623,4592,4678,86,-55,31,0.018728223,-0.011757161,0.006750871
5528,2013,제주,제주시,5011000000,초등학교,2013-04-01,여자,2220,2218,2253,35,-33,2,0.015779982,-0.014647137,0.000901713
5529,2013,제주,제주시,5011000000,초등학교,2013-04-01,남자,2403,2374,2425,51,-22,29,0.02148273,-0.009072165,0.01221567
5530,2013,제주,서귀포시,5013000000,초등학교,2013-04-01,전체,1314,1452,1447,-5,-133,-138,-0.003443526,-0.091914305,-0.095041322
5531,2013,제주,서귀포시,5013000000,초등학교,2013-04-01,여자,611,678,687,9,-76,-67,0.013274336,-0.11062591,-0.098820059
5532,2013,제주,서귀포시,5013000000,초등학교,2013-04-01,남자,703,774,760,-14,-57,-71,-0.018087855,-0.075,-0.091731266
5533,2014,서울,종로구,1111000000,초등학교,2014-04-01,전체,1009,1085,1069,-16,-60,-76,-0.014746544,-0.056127222,-0.070046083
5534,2014,서울,종로구,1111000000,초등학교,2014-04-01,여자,489,513,512,-1,-23,-24,-0.001949318,-0.044921875,-0.046783626
5535,2014,서울,종로구,1111000000,초등학교,2014-04-01,남자,520,572,557,-15,-37,-52,-0.026223776,-0.066427289,-0.090909091
5536,2014,서울,중구,1114000000,초등학교,2014-04-01,전체,1089,1112,1031,-81,58,-23,-0.072841727,0.056256062,-0.020683453
5537,2014,서울,중구,1114000000,초등학교,2014-04-01,여자,558,549,519,-30,39,9,-0.054644809,0.075144509,0.016393443
5538,2014,서울,중구,1114000000,초등학교,2014-04-01,남자,531,563,512,-51,19,-32,-0.090586146,0.037109375,-0.056838366
5539,2014,서울,용산구,1117000000,초등학교,2014-04-01,전체,1593,1977,1925,-52,-332,-384,-0.026302479,-0.172467532,-0.194233687
5540,2014,서울,용산구,1117000000,초등학교,2014-04-01,여자,816,996,978,-18,-162,-180,-0.018072289,-0.165644172,-0.180722892
5541,2014,서울,용산구,1117000000,초등학교,2014-04-01,남자,777,981,947,-34,-170,-204,-0.034658512,-0.179514256,-0.20795107
5542,2014,서울,성동구,1120000000,초등학교,2014-04-01,전체,2396,2720,2659,-61,-263,-324,-0.022426471,-0.098909364,-0.119117647
5543,2014,서울,성동구,1120000000,초등학교,2014-04-01,여자,1210,1325,1300,-25,-90,-115,-0.018867925,-0.069230769,-0.086792453
5544,2014,서울,성동구,1120000000,초등학교,2014-04-01,남자,1186,1395,1359,-36,-173,-209,-0.025806452,-0.127299485,-0.149820789
5545,2014,서울,광진구,1121500000,초등학교,2014-04-01,전체,2817,2968,2920,-48,-103,-151,-0.016172507,-0.035273973,-0.050876011
5546,2014,서울,광진구,1121500000,초등학교,2014-04-01,여자,1401,1402,1386,-16,15,-1,-0.011412268,0.010822511,-0.000713267
5547,2014,서울,광진구,1121500000,초등학교,2014-04-01,남자,1416,1566,1534,-32,-118,-150,-0.020434227,-0.076923077,-0.095785441
5548,2014,서울,동대문구,1123000000,초등학교,2014-04-01,전체,2693,2974,2878,-96,-185,-281,-0.032279758,-0.064280751,-0.094485541
5549,2014,서울,동대문구,1123000000,초등학교,2014-04-01,여자,1263,1408,1357,-51,-94,-145,-0.036221591,-0.06927045,-0.102982955
5550,2014,서울,동대문구,1123000000,초등학교,2014-04-01,남자,1430,1566,1521,-45,-91,-136,-0.028735632,-0.05982906,-0.086845466
5551,2014,서울,중랑구,1126000000,초등학교,2014-04-01,전체,2883,3287,3163,-124,-280,-404,-0.037724369,-0.088523554,-0.122908427
5552,2014,서울,중랑구,1126000000,초등학교,2014-04-01,여자,1402,1619,1543,-76,-141,-217,-0.046942557,-0.091380428,-0.134033354
5553,2014,서울,중랑구,1126000000,초등학교,2014-04-01,남자,1481,1668,1620,-48,-139,-187,-0.028776978,-0.085802469,-0.112110312
5554,2014,서울,성북구,1129000000,초등학교,2014-04-01,전체,4256,4487,4361,-126,-105,-231,-0.028081123,-0.024077047,-0.051482059
5555,2014,서울,성북구,1129000000,초등학교,2014-04-01,여자,2085,2188,2105,-83,-20,-103,-0.037934186,-0.009501188,-0.047074954
5556,2014,서울,성북구,1129000000,초등학교,2014-04-01,남자,2171,2299,2256,-43,-85,-128,-0.018703784,-0.037677305,-0.055676381
5557,2014,서울,강북구,1130500000,초등학교,2014-04-01,전체,2041,2660,2575,-85,-534,-619,-0.031954887,-0.207378641,-0.232706767
5558,2014,서울,강북구,1130500000,초등학교,2014-04-01,여자,979,1278,1234,-44,-255,-299,-0.034428795,-0.206645057,-0.233959311
5559,2014,서울,강북구,1130500000,초등학교,2014-04-01,남자,1062,1382,1341,-41,-279,-320,-0.029667149,-0.208053691,-0.23154848
5560,2014,서울,도봉구,1132000000,초등학교,2014-04-01,전체,3151,2909,2889,-20,262,242,-0.006875215,0.09068882,0.0831901
5561,2014,서울,도봉구,1132000000,초등학교,2014-04-01,여자,1532,1366,1347,-19,185,166,-0.013909224,0.137342242,0.121522694
5562,2014,서울,도봉구,1132000000,초등학교,2014-04-01,남자,1619,1543,1542,-1,77,76,-0.000648088,0.049935149,0.049254699
5563,2014,서울,노원구,1135000000,초등학교,2014-04-01,전체,5183,5271,5201,-70,-18,-88,-0.013280212,-0.003460873,-0.016695124
5564,2014,서울,노원구,1135000000,초등학교,2014-04-01,여자,2519,2525,2493,-32,26,-6,-0.012673267,0.010429202,-0.002376238
5565,2014,서울,노원구,1135000000,초등학교,2014-04-01,남자,2664,2746,2708,-38,-44,-82,-0.01383831,-0.016248154,-0.029861617
5566,2014,서울,은평구,1138000000,초등학교,2014-04-01,전체,4359,4509,4487,-22,-128,-150,-0.004879131,-0.028526855,-0.0332668
5567,2014,서울,은평구,1138000000,초등학교,2014-04-01,여자,2089,2177,2163,-14,-74,-88,-0.006430868,-0.034211743,-0.0404226
5568,2014,서울,은평구,1138000000,초등학교,2014-04-01,남자,2270,2332,2324,-8,-54,-62,-0.003430532,-0.0232358,-0.026586621
5569,2014,서울,서대문구,1141000000,초등학교,2014-04-01,전체,2204,2344,2326,-18,-122,-140,-0.007679181,-0.052450559,-0.059726962
5570,2014,서울,서대문구,1141000000,초등학교,2014-04-01,여자,1102,1133,1129,-4,-27,-31,-0.00353045,-0.023914969,-0.027360989
5571,2014,서울,서대문구,1141000000,초등학교,2014-04-01,남자,1102,1211,1197,-14,-95,-109,-0.011560694,-0.079365079,-0.090008258
5572,2014,서울,마포구,1144000000,초등학교,2014-04-01,전체,3100,3594,3489,-105,-389,-494,-0.029215359,-0.111493265,-0.137451308
5573,2014,서울,마포구,1144000000,초등학교,2014-04-01,여자,1517,1732,1671,-61,-154,-215,-0.0352194,-0.092160383,-0.124133949
5574,2014,서울,마포구,1144000000,초등학교,2014-04-01,남자,1583,1862,1818,-44,-235,-279,-0.023630505,-0.129262926,-0.149838883
5575,2014,서울,양천구,1147000000,초등학교,2014-04-01,전체,4100,4275,4362,87,-262,-175,0.020350877,-0.060064191,-0.040935673
5576,2014,서울,양천구,1147000000,초등학교,2014-04-01,여자,1989,2038,2067,29,-78,-49,0.014229637,-0.037735849,-0.02404318
5577,2014,서울,양천구,1147000000,초등학교,2014-04-01,남자,2111,2237,2295,58,-184,-126,0.025927582,-0.080174292,-0.056325436
5578,2014,서울,강서구,1150000000,초등학교,2014-04-01,전체,4807,5253,5118,-135,-311,-446,-0.0256996,-0.060765924,-0.084903864
5579,2014,서울,강서구,1150000000,초등학교,2014-04-01,여자,2365,2565,2530,-35,-165,-200,-0.013645224,-0.065217391,-0.07797271
5580,2014,서울,강서구,1150000000,초등학교,2014-04-01,남자,2442,2688,2588,-100,-146,-246,-0.037202381,-0.056414219,-0.091517857
5581,2014,서울,구로구,1153000000,초등학교,2014-04-01,전체,3665,4229,4085,-144,-420,-564,-0.034050603,-0.102815177,-0.133364862
5582,2014,서울,구로구,1153000000,초등학교,2014-04-01,여자,1798,2068,1984,-84,-186,-270,-0.040618956,-0.09375,-0.130560928
5583,2014,서울,구로구,1153000000,초등학교,2014-04-01,남자,1867,2161,2101,-60,-234,-294,-0.027764924,-0.111375535,-0.136048126
5584,2014,서울,금천구,1154500000,초등학교,2014-04-01,전체,1715,1849,1752,-97,-37,-134,-0.05246079,-0.021118721,-0.072471606
5585,2014,서울,금천구,1154500000,초등학교,2014-04-01,여자,855,931,878,-53,-23,-76,-0.056928034,-0.0261959,-0.081632653
5586,2014,서울,금천구,1154500000,초등학교,2014-04-01,남자,860,918,874,-44,-14,-58,-0.047930283,-0.016018307,-0.063180828
5587,2014,서울,영등포구,1156000000,초등학교,2014-04-01,전체,2848,3631,3398,-233,-550,-783,-0.06416965,-0.161859918,-0.215643074
5588,2014,서울,영등포구,1156000000,초등학교,2014-04-01,여자,1350,1738,1621,-117,-271,-388,-0.067318757,-0.167180753,-0.223245109
5589,2014,서울,영등포구,1156000000,초등학교,2014-04-01,남자,1498,1893,1777,-116,-279,-395,-0.061278394,-0.15700619,-0.208663497
5590,2014,서울,동작구,1159000000,초등학교,2014-04-01,전체,3176,3387,3337,-50,-161,-211,-0.014762327,-0.048246928,-0.062297018
5591,2014,서울,동작구,1159000000,초등학교,2014-04-01,여자,1458,1607,1566,-41,-108,-149,-0.025513379,-0.068965517,-0.092719353
5592,2014,서울,동작구,1159000000,초등학교,2014-04-01,남자,1718,1780,1771,-9,-53,-62,-0.00505618,-0.029926595,-0.034831461
5593,2014,서울,관악구,1162000000,초등학교,2014-04-01,전체,3225,3989,3802,-187,-577,-764,-0.046878917,-0.15176223,-0.191526698
5594,2014,서울,관악구,1162000000,초등학교,2014-04-01,여자,1602,1985,1898,-87,-296,-383,-0.043828715,-0.155953635,-0.192947103
5595,2014,서울,관악구,1162000000,초등학교,2014-04-01,남자,1623,2004,1904,-100,-281,-381,-0.0499002,-0.147584034,-0.19011976
5596,2014,서울,서초구,1165000000,초등학교,2014-04-01,전체,3840,3952,4150,198,-310,-112,0.050101215,-0.074698795,-0.028340081
5597,2014,서울,서초구,1165000000,초등학교,2014-04-01,여자,1858,1913,2015,102,-157,-55,0.053319394,-0.077915633,-0.028750653
5598,2014,서울,서초구,1165000000,초등학교,2014-04-01,남자,1982,2039,2135,96,-153,-57,0.047081903,-0.071662763,-0.02795488
5599,2014,서울,강남구,1168000000,초등학교,2014-04-01,전체,3846,4332,4375,43,-529,-486,0.009926131,-0.120914286,-0.112188366
5600,2014,서울,강남구,1168000000,초등학교,2014-04-01,여자,1843,2145,2159,14,-316,-302,0.006526807,-0.146364057,-0.140792541
5601,2014,서울,강남구,1168000000,초등학교,2014-04-01,남자,2003,2187,2216,29,-213,-184,0.013260174,-0.096119134,-0.084133516
5602,2014,서울,송파구,1171000000,초등학교,2014-04-01,전체,5697,6043,5965,-78,-268,-346,-0.012907496,-0.044928751,-0.05725633
5603,2014,서울,송파구,1171000000,초등학교,2014-04-01,여자,2755,2919,2907,-12,-152,-164,-0.004110997,-0.052287582,-0.056183625
5604,2014,서울,송파구,1171000000,초등학교,2014-04-01,남자,2942,3124,3058,-66,-116,-182,-0.021126761,-0.03793329,-0.058258643
5605,2014,서울,강동구,1174000000,초등학교,2014-04-01,전체,3845,4356,4223,-133,-378,-511,-0.030532599,-0.089509827,-0.117309458
5606,2014,서울,강동구,1174000000,초등학교,2014-04-01,여자,1813,2017,1964,-53,-151,-204,-0.026276648,-0.07688391,-0.101140307
5607,2014,서울,강동구,1174000000,초등학교,2014-04-01,남자,2032,2339,2259,-80,-227,-307,-0.034202651,-0.100486941,-0.131252672
5608,2014,부산,중구,2611000000,초등학교,2014-04-01,전체,280,266,271,5,9,14,0.018796992,0.033210332,0.052631579
5609,2014,부산,중구,2611000000,초등학교,2014-04-01,여자,145,145,147,2,-2,0,0.013793103,-0.013605442,0
5610,2014,부산,중구,2611000000,초등학교,2014-04-01,남자,135,121,124,3,11,14,0.024793388,0.088709677,0.115702479
5611,2014,부산,서구,2614000000,초등학교,2014-04-01,전체,688,698,667,-31,21,-10,-0.044412607,0.031484258,-0.014326648
5612,2014,부산,서구,2614000000,초등학교,2014-04-01,여자,334,345,322,-23,12,-11,-0.066666667,0.037267081,-0.031884058
5613,2014,부산,서구,2614000000,초등학교,2014-04-01,남자,354,353,345,-8,9,1,-0.02266289,0.026086957,0.002832861
5614,2014,부산,동구,2617000000,초등학교,2014-04-01,전체,507,594,569,-25,-62,-87,-0.042087542,-0.108963093,-0.146464646
5615,2014,부산,동구,2617000000,초등학교,2014-04-01,여자,251,294,275,-19,-24,-43,-0.06462585,-0.087272727,-0.146258503
5616,2014,부산,동구,2617000000,초등학교,2014-04-01,남자,256,300,294,-6,-38,-44,-0.02,-0.129251701,-0.146666667
5617,2014,부산,영도구,2620000000,초등학교,2014-04-01,전체,776,867,848,-19,-72,-91,-0.021914648,-0.08490566,-0.104959631
5618,2014,부산,영도구,2620000000,초등학교,2014-04-01,여자,372,437,429,-8,-57,-65,-0.018306636,-0.132867133,-0.148741419
5619,2014,부산,영도구,2620000000,초등학교,2014-04-01,남자,404,430,419,-11,-15,-26,-0.025581395,-0.035799523,-0.060465116
5620,2014,부산,부산진구,2623000000,초등학교,2014-04-01,전체,2900,2955,2910,-45,-10,-55,-0.015228426,-0.003436426,-0.018612521
5621,2014,부산,부산진구,2623000000,초등학교,2014-04-01,여자,1446,1458,1438,-20,8,-12,-0.013717421,0.005563282,-0.008230453
5622,2014,부산,부산진구,2623000000,초등학교,2014-04-01,남자,1454,1497,1472,-25,-18,-43,-0.016700067,-0.012228261,-0.028724115
5623,2014,부산,동래구,2626000000,초등학교,2014-04-01,전체,2140,2143,2127,-16,13,-3,-0.007466169,0.006111895,-0.001399907
5624,2014,부산,동래구,2626000000,초등학교,2014-04-01,여자,1001,993,1005,12,-4,8,0.012084592,-0.0039801,0.008056395
5625,2014,부산,동래구,2626000000,초등학교,2014-04-01,남자,1139,1150,1122,-28,17,-11,-0.024347826,0.015151515,-0.009565217
5626,2014,부산,남구,2629000000,초등학교,2014-04-01,전체,2222,2332,2305,-27,-83,-110,-0.011578045,-0.036008677,-0.047169811
5627,2014,부산,남구,2629000000,초등학교,2014-04-01,여자,1039,1121,1100,-21,-61,-82,-0.018733274,-0.055454545,-0.073148974
5628,2014,부산,남구,2629000000,초등학교,2014-04-01,남자,1183,1211,1205,-6,-22,-28,-0.004954583,-0.018257261,-0.023121387
5629,2014,부산,북구,2632000000,초등학교,2014-04-01,전체,2304,2385,2470,85,-166,-81,0.035639413,-0.067206478,-0.033962264
5630,2014,부산,북구,2632000000,초등학교,2014-04-01,여자,1120,1178,1226,48,-106,-58,0.040747029,-0.086460033,-0.049235993
5631,2014,부산,북구,2632000000,초등학교,2014-04-01,남자,1184,1207,1244,37,-60,-23,0.030654515,-0.048231511,-0.01905551
5632,2014,부산,해운대구,2635000000,초등학교,2014-04-01,전체,3694,3897,3965,68,-271,-203,0.01744932,-0.068348045,-0.052091352
5633,2014,부산,해운대구,2635000000,초등학교,2014-04-01,여자,1820,1938,1964,26,-144,-118,0.013415893,-0.073319756,-0.060887513
5634,2014,부산,해운대구,2635000000,초등학교,2014-04-01,남자,1874,1959,2001,42,-127,-85,0.02143951,-0.063468266,-0.043389484
5635,2014,부산,사하구,2638000000,초등학교,2014-04-01,전체,2714,2992,2951,-41,-237,-278,-0.013703209,-0.080311759,-0.092914439
5636,2014,부산,사하구,2638000000,초등학교,2014-04-01,여자,1294,1447,1434,-13,-140,-153,-0.008984105,-0.09762901,-0.105736006
5637,2014,부산,사하구,2638000000,초등학교,2014-04-01,남자,1420,1545,1517,-28,-97,-125,-0.018122977,-0.063941991,-0.080906149
5638,2014,부산,금정구,2641000000,초등학교,2014-04-01,전체,1782,1675,1780,105,2,107,0.062686567,0.001123596,0.063880597
5639,2014,부산,금정구,2641000000,초등학교,2014-04-01,여자,859,810,846,36,13,49,0.044444444,0.01536643,0.060493827
5640,2014,부산,금정구,2641000000,초등학교,2014-04-01,남자,923,865,934,69,-11,58,0.079768786,-0.011777302,0.067052023
5641,2014,부산,강서구,2644000000,초등학교,2014-04-01,전체,692,648,661,13,31,44,0.020061728,0.046898638,0.067901235
5642,2014,부산,강서구,2644000000,초등학교,2014-04-01,여자,336,314,321,7,15,22,0.022292994,0.046728972,0.070063694
5643,2014,부산,강서구,2644000000,초등학교,2014-04-01,남자,356,334,340,6,16,22,0.017964072,0.047058824,0.065868263
5644,2014,부산,연제구,2647000000,초등학교,2014-04-01,전체,1657,1751,1702,-49,-45,-94,-0.027984009,-0.026439483,-0.053683609
5645,2014,부산,연제구,2647000000,초등학교,2014-04-01,여자,775,848,824,-24,-49,-73,-0.028301887,-0.059466019,-0.086084906
5646,2014,부산,연제구,2647000000,초등학교,2014-04-01,남자,882,903,878,-25,4,-21,-0.027685493,0.004555809,-0.023255814
5647,2014,부산,수영구,2650000000,초등학교,2014-04-01,전체,1098,1283,1262,-21,-164,-185,-0.016367888,-0.129952456,-0.144193297
5648,2014,부산,수영구,2650000000,초등학교,2014-04-01,여자,548,637,636,-1,-88,-89,-0.001569859,-0.13836478,-0.139717425
5649,2014,부산,수영구,2650000000,초등학교,2014-04-01,남자,550,646,626,-20,-76,-96,-0.030959752,-0.121405751,-0.148606811
5650,2014,부산,사상구,2653000000,초등학교,2014-04-01,전체,1660,1963,1902,-61,-242,-303,-0.031074885,-0.12723449,-0.154355578
5651,2014,부산,사상구,2653000000,초등학교,2014-04-01,여자,783,936,912,-24,-129,-153,-0.025641026,-0.141447368,-0.163461538
5652,2014,부산,사상구,2653000000,초등학교,2014-04-01,남자,877,1027,990,-37,-113,-150,-0.036027264,-0.114141414,-0.146056475
5653,2014,부산,기장군,2671000000,초등학교,2014-04-01,전체,1702,1265,1454,189,248,437,0.149407115,0.170563961,0.345454545
5654,2014,부산,기장군,2671000000,초등학교,2014-04-01,여자,814,618,704,86,110,196,0.139158576,0.15625,0.317152104
5655,2014,부산,기장군,2671000000,초등학교,2014-04-01,남자,888,647,750,103,138,241,0.159196291,0.184,0.372488408
5656,2014,대구,중구,2711000000,초등학교,2014-04-01,전체,735,499,486,-13,249,236,-0.026052104,0.512345679,0.472945892
5657,2014,대구,중구,2711000000,초등학교,2014-04-01,여자,344,215,216,1,128,129,0.004651163,0.592592593,0.6
5658,2014,대구,중구,2711000000,초등학교,2014-04-01,남자,391,284,270,-14,121,107,-0.049295775,0.448148148,0.376760563
5659,2014,대구,동구,2714000000,초등학교,2014-04-01,전체,3072,3069,3071,2,1,3,0.000651678,0.000325627,0.000977517
5660,2014,대구,동구,2714000000,초등학교,2014-04-01,여자,1548,1521,1530,9,18,27,0.00591716,0.011764706,0.017751479
5661,2014,대구,동구,2714000000,초등학교,2014-04-01,남자,1524,1548,1541,-7,-17,-24,-0.004521964,-0.011031798,-0.015503876
5662,2014,대구,서구,2717000000,초등학교,2014-04-01,전체,1204,1378,1336,-42,-132,-174,-0.030478955,-0.098802395,-0.126269956
5663,2014,대구,서구,2717000000,초등학교,2014-04-01,여자,604,664,644,-20,-40,-60,-0.030120482,-0.062111801,-0.090361446
5664,2014,대구,서구,2717000000,초등학교,2014-04-01,남자,600,714,692,-22,-92,-114,-0.030812325,-0.132947977,-0.159663866
5665,2014,대구,남구,2720000000,초등학교,2014-04-01,전체,938,1087,1098,11,-160,-149,0.010119595,-0.14571949,-0.137074517
5666,2014,대구,남구,2720000000,초등학교,2014-04-01,여자,443,548,539,-9,-96,-105,-0.016423358,-0.178107607,-0.191605839
5667,2014,대구,남구,2720000000,초등학교,2014-04-01,남자,495,539,559,20,-64,-44,0.037105751,-0.114490161,-0.081632653
5668,2014,대구,북구,2723000000,초등학교,2014-04-01,전체,4452,4876,4817,-59,-365,-424,-0.012100082,-0.075773303,-0.086956522
5669,2014,대구,북구,2723000000,초등학교,2014-04-01,여자,2149,2340,2301,-39,-152,-191,-0.016666667,-0.066058236,-0.081623932
5670,2014,대구,북구,2723000000,초등학교,2014-04-01,남자,2303,2536,2516,-20,-213,-233,-0.007886435,-0.084658188,-0.091876972
5671,2014,대구,수성구,2726000000,초등학교,2014-04-01,전체,4119,3904,4118,214,1,215,0.054815574,0.000242836,0.055071721
5672,2014,대구,수성구,2726000000,초등학교,2014-04-01,여자,1973,1937,2034,97,-61,36,0.050077439,-0.029990167,0.018585441
5673,2014,대구,수성구,2726000000,초등학교,2014-04-01,남자,2146,1967,2084,117,62,179,0.059481444,0.02975048,0.091001525
5674,2014,대구,달서구,2729000000,초등학교,2014-04-01,전체,5906,5655,5688,33,218,251,0.005835544,0.038326301,0.0443855
5675,2014,대구,달서구,2729000000,초등학교,2014-04-01,여자,2928,2734,2756,22,172,194,0.008046818,0.062409289,0.070958303
5676,2014,대구,달서구,2729000000,초등학교,2014-04-01,남자,2978,2921,2932,11,46,57,0.003765834,0.01568895,0.019513865
5677,2014,대구,달성군,2771000000,초등학교,2014-04-01,전체,1921,2086,2059,-27,-138,-165,-0.012943432,-0.067022827,-0.079098754
5678,2014,대구,달성군,2771000000,초등학교,2014-04-01,여자,935,1005,1000,-5,-65,-70,-0.004975124,-0.065,-0.069651741
5679,2014,대구,달성군,2771000000,초등학교,2014-04-01,남자,986,1081,1059,-22,-73,-95,-0.020351526,-0.068932956,-0.087881591
5680,2014,인천,중구,2811000000,초등학교,2014-04-01,전체,1343,971,1131,160,212,372,0.164778579,0.187444739,0.383110196
5681,2014,인천,중구,2811000000,초등학교,2014-04-01,여자,675,473,549,76,126,202,0.160676533,0.229508197,0.427061311
5682,2014,인천,중구,2811000000,초등학교,2014-04-01,남자,668,498,582,84,86,170,0.168674699,0.147766323,0.341365462
5683,2014,인천,동구,2814000000,초등학교,2014-04-01,전체,839,804,753,-51,86,35,-0.063432836,0.114209827,0.043532338
5684,2014,인천,동구,2814000000,초등학교,2014-04-01,여자,424,401,378,-23,46,23,-0.057356608,0.121693122,0.057356608
5685,2014,인천,동구,2814000000,초등학교,2014-04-01,남자,415,403,375,-28,40,12,-0.069478908,0.106666667,0.029776675
5686,2014,인천,미추홀구,2817700000,초등학교,2014-04-01,전체,3190,3765,3663,-102,-473,-575,-0.027091633,-0.129129129,-0.152722444
5687,2014,인천,미추홀구,2817700000,초등학교,2014-04-01,여자,1478,1824,1765,-59,-287,-346,-0.032346491,-0.162606232,-0.189692982
5688,2014,인천,미추홀구,2817700000,초등학교,2014-04-01,남자,1712,1941,1898,-43,-186,-229,-0.022153529,-0.097997893,-0.117980422
5689,2014,인천,연수구,2818500000,초등학교,2014-04-01,전체,3203,2811,3004,193,199,392,0.06865884,0.066245007,0.139452152
5690,2014,인천,연수구,2818500000,초등학교,2014-04-01,여자,1530,1373,1477,104,53,157,0.07574654,0.035883548,0.114348143
5691,2014,인천,연수구,2818500000,초등학교,2014-04-01,남자,1673,1438,1527,89,146,235,0.061891516,0.095612312,0.163421419
5692,2014,인천,남동구,2820000000,초등학교,2014-04-01,전체,5134,5430,5415,-15,-281,-296,-0.002762431,-0.05189289,-0.054511971
5693,2014,인천,남동구,2820000000,초등학교,2014-04-01,여자,2510,2686,2654,-32,-144,-176,-0.011913626,-0.054257724,-0.065524944
5694,2014,인천,남동구,2820000000,초등학교,2014-04-01,남자,2624,2744,2761,17,-137,-120,0.006195335,-0.049619703,-0.043731778
5695,2014,인천,부평구,2823700000,초등학교,2014-04-01,전체,5006,5332,5182,-150,-176,-326,-0.028132033,-0.033963721,-0.061140285
5696,2014,인천,부평구,2823700000,초등학교,2014-04-01,여자,2416,2550,2480,-70,-64,-134,-0.02745098,-0.025806452,-0.05254902
5697,2014,인천,부평구,2823700000,초등학교,2014-04-01,남자,2590,2782,2702,-80,-112,-192,-0.02875629,-0.041450777,-0.069015097
5698,2014,인천,계양구,2824500000,초등학교,2014-04-01,전체,3228,3461,3359,-102,-131,-233,-0.029471251,-0.038999702,-0.067321583
5699,2014,인천,계양구,2824500000,초등학교,2014-04-01,여자,1582,1668,1637,-31,-55,-86,-0.018585132,-0.033598045,-0.051558753
5700,2014,인천,계양구,2824500000,초등학교,2014-04-01,남자,1646,1793,1722,-71,-76,-147,-0.039598438,-0.044134727,-0.081985499
5701,2014,인천,서구,2826000000,초등학교,2014-04-01,전체,5649,5354,5753,399,-104,295,0.074523721,-0.018077525,0.055098991
5702,2014,인천,서구,2826000000,초등학교,2014-04-01,여자,2795,2618,2819,201,-24,177,0.076776165,-0.008513657,0.067608862
5703,2014,인천,서구,2826000000,초등학교,2014-04-01,남자,2854,2736,2934,198,-80,118,0.072368421,-0.02726653,0.043128655
5704,2014,인천,강화군,2871000000,초등학교,2014-04-01,전체,422,447,438,-9,-16,-25,-0.020134228,-0.03652968,-0.055928412
5705,2014,인천,강화군,2871000000,초등학교,2014-04-01,여자,205,227,220,-7,-15,-22,-0.030837004,-0.068181818,-0.0969163
5706,2014,인천,강화군,2871000000,초등학교,2014-04-01,남자,217,220,218,-2,-1,-3,-0.009090909,-0.004587156,-0.013636364
5707,2014,인천,옹진군,2872000000,초등학교,2014-04-01,전체,118,134,132,-2,-14,-16,-0.014925373,-0.106060606,-0.119402985
5708,2014,인천,옹진군,2872000000,초등학교,2014-04-01,여자,68,74,75,1,-7,-6,0.013513514,-0.093333333,-0.081081081
5709,2014,인천,옹진군,2872000000,초등학교,2014-04-01,남자,50,60,57,-3,-7,-10,-0.05,-0.122807018,-0.166666667
5710,2014,광주,동구,2911000000,초등학교,2014-04-01,전체,608,682,670,-12,-62,-74,-0.017595308,-0.092537313,-0.108504399
5711,2014,광주,동구,2911000000,초등학교,2014-04-01,여자,305,327,318,-9,-13,-22,-0.027522936,-0.040880503,-0.067278287
5712,2014,광주,동구,2911000000,초등학교,2014-04-01,남자,303,355,352,-3,-49,-52,-0.008450704,-0.139204545,-0.146478873
5713,2014,광주,서구,2914000000,초등학교,2014-04-01,전체,3174,3215,3219,4,-45,-41,0.001244168,-0.013979497,-0.012752722
5714,2014,광주,서구,2914000000,초등학교,2014-04-01,여자,1509,1525,1529,4,-20,-16,0.002622951,-0.013080445,-0.010491803
5715,2014,광주,서구,2914000000,초등학교,2014-04-01,남자,1665,1690,1690,0,-25,-25,0,-0.014792899,-0.014792899
5716,2014,광주,남구,2915500000,초등학교,2014-04-01,전체,2074,1905,1941,36,133,169,0.018897638,0.068521381,0.088713911
5717,2014,광주,남구,2915500000,초등학교,2014-04-01,여자,1020,912,942,30,78,108,0.032894737,0.082802548,0.118421053
5718,2014,광주,남구,2915500000,초등학교,2014-04-01,남자,1054,993,999,6,55,61,0.006042296,0.055055055,0.06143001
5719,2014,광주,북구,2917000000,초등학교,2014-04-01,전체,4308,4305,4290,-15,18,3,-0.003484321,0.004195804,0.000696864
5720,2014,광주,북구,2917000000,초등학교,2014-04-01,여자,2003,2026,2013,-13,-10,-23,-0.006416584,-0.00496771,-0.011352419
5721,2014,광주,북구,2917000000,초등학교,2014-04-01,남자,2305,2279,2277,-2,28,26,-0.000877578,0.012296882,0.011408513
5722,2014,광주,광산구,2920000000,초등학교,2014-04-01,전체,5817,5677,5758,81,59,140,0.014268099,0.010246613,0.024660912
5723,2014,광주,광산구,2920000000,초등학교,2014-04-01,여자,2778,2719,2758,39,20,59,0.014343509,0.007251632,0.021699154
5724,2014,광주,광산구,2920000000,초등학교,2014-04-01,남자,3039,2958,3000,42,39,81,0.014198783,0.013,0.027383367
5725,2014,대전,동구,3011000000,초등학교,2014-04-01,전체,2378,2619,2606,-13,-228,-241,-0.004963727,-0.087490407,-0.092019855
5726,2014,대전,동구,3011000000,초등학교,2014-04-01,여자,1154,1272,1266,-6,-112,-118,-0.004716981,-0.088467615,-0.092767296
5727,2014,대전,동구,3011000000,초등학교,2014-04-01,남자,1224,1347,1340,-7,-116,-123,-0.005196733,-0.086567164,-0.091314031
5728,2014,대전,중구,3014000000,초등학교,2014-04-01,전체,2546,2606,2620,14,-74,-60,0.005372218,-0.028244275,-0.023023791
5729,2014,대전,중구,3014000000,초등학교,2014-04-01,여자,1217,1274,1278,4,-61,-57,0.003139717,-0.047730829,-0.044740973
5730,2014,대전,중구,3014000000,초등학교,2014-04-01,남자,1329,1332,1342,10,-13,-3,0.007507508,-0.009687034,-0.002252252
5731,2014,대전,서구,3017000000,초등학교,2014-04-01,전체,4873,4845,4888,43,-15,28,0.008875129,-0.00306874,0.005779154
5732,2014,대전,서구,3017000000,초등학교,2014-04-01,여자,2445,2404,2430,26,15,41,0.010815308,0.00617284,0.017054908
5733,2014,대전,서구,3017000000,초등학교,2014-04-01,남자,2428,2441,2458,17,-30,-13,0.006964359,-0.012205045,-0.005325686
5734,2014,대전,유성구,3020000000,초등학교,2014-04-01,전체,4268,4088,4215,127,53,180,0.031066536,0.01257414,0.044031311
5735,2014,대전,유성구,3020000000,초등학교,2014-04-01,여자,2075,1953,1998,45,77,122,0.023041475,0.038538539,0.062467998
5736,2014,대전,유성구,3020000000,초등학교,2014-04-01,남자,2193,2135,2217,82,-24,58,0.038407494,-0.01082544,0.027166276
5737,2014,대전,대덕구,3023000000,초등학교,2014-04-01,전체,1929,1975,1950,-25,-21,-46,-0.012658228,-0.010769231,-0.023291139
5738,2014,대전,대덕구,3023000000,초등학교,2014-04-01,여자,932,974,963,-11,-31,-42,-0.011293634,-0.03219107,-0.04312115
5739,2014,대전,대덕구,3023000000,초등학교,2014-04-01,남자,997,1001,987,-14,10,-4,-0.013986014,0.010131712,-0.003996004
5740,2014,울산,중구,3111000000,초등학교,2014-04-01,전체,2023,1974,1988,14,35,49,0.007092199,0.017605634,0.024822695
5741,2014,울산,중구,3111000000,초등학교,2014-04-01,여자,975,956,954,-2,21,19,-0.00209205,0.022012579,0.019874477
5742,2014,울산,중구,3111000000,초등학교,2014-04-01,남자,1048,1018,1034,16,14,30,0.015717092,0.013539652,0.029469548
5743,2014,울산,남구,3114000000,초등학교,2014-04-01,전체,2968,3094,3144,50,-176,-126,0.01616031,-0.055979644,-0.040723982
5744,2014,울산,남구,3114000000,초등학교,2014-04-01,여자,1405,1471,1489,18,-84,-66,0.012236574,-0.0564137,-0.044867437
5745,2014,울산,남구,3114000000,초등학교,2014-04-01,남자,1563,1623,1655,32,-92,-60,0.019716574,-0.055589124,-0.036968577
5746,2014,울산,동구,3117000000,초등학교,2014-04-01,전체,1879,1923,1954,31,-75,-44,0.016120645,-0.038382805,-0.022880915
5747,2014,울산,동구,3117000000,초등학교,2014-04-01,여자,929,940,956,16,-27,-11,0.017021277,-0.028242678,-0.011702128
5748,2014,울산,동구,3117000000,초등학교,2014-04-01,남자,950,983,998,15,-48,-33,0.01525941,-0.048096192,-0.033570702
5749,2014,울산,북구,3120000000,초등학교,2014-04-01,전체,2526,2584,2540,-44,-14,-58,-0.017027864,-0.005511811,-0.02244582
5750,2014,울산,북구,3120000000,초등학교,2014-04-01,여자,1242,1281,1260,-21,-18,-39,-0.016393443,-0.014285714,-0.030444965
5751,2014,울산,북구,3120000000,초등학교,2014-04-01,남자,1284,1303,1280,-23,4,-19,-0.017651573,0.003125,-0.014581734
5752,2014,울산,울주군,3171000000,초등학교,2014-04-01,전체,2461,2430,2396,-34,65,31,-0.01399177,0.027128548,0.012757202
5753,2014,울산,울주군,3171000000,초등학교,2014-04-01,여자,1218,1155,1144,-11,74,63,-0.00952381,0.064685315,0.054545455
5754,2014,울산,울주군,3171000000,초등학교,2014-04-01,남자,1243,1275,1252,-23,-9,-32,-0.018039216,-0.007188498,-0.025098039
5755,2014,경기,수원시,4111000000,초등학교,2014-04-01,전체,12350,11862,12181,319,169,488,0.026892598,0.013874066,0.041139774
5756,2014,경기,수원시,4111000000,초등학교,2014-04-01,여자,5934,5731,5874,143,60,203,0.024952015,0.010214505,0.035421392
5757,2014,경기,수원시,4111000000,초등학교,2014-04-01,남자,6416,6131,6307,176,109,285,0.028706573,0.017282385,0.046485076
5758,2014,경기,성남시,4113000000,초등학교,2014-04-01,전체,8606,9084,9018,-66,-412,-478,-0.007265522,-0.045686405,-0.052619991
5759,2014,경기,성남시,4113000000,초등학교,2014-04-01,여자,4179,4398,4387,-11,-208,-219,-0.002501137,-0.047412811,-0.049795362
5760,2014,경기,성남시,4113000000,초등학교,2014-04-01,남자,4427,4686,4631,-55,-204,-259,-0.011737089,-0.044050961,-0.05527102
5761,2014,경기,부천시,4119000000,초등학교,2014-04-01,전체,7777,8423,8235,-188,-458,-646,-0.022319839,-0.055616272,-0.076694764
5762,2014,경기,부천시,4119000000,초등학교,2014-04-01,여자,3798,4133,4032,-101,-234,-335,-0.024437455,-0.058035714,-0.081054924
5763,2014,경기,부천시,4119000000,초등학교,2014-04-01,남자,3979,4290,4203,-87,-224,-311,-0.02027972,-0.053295265,-0.072494172
5764,2014,경기,안양시,4117000000,초등학교,2014-04-01,전체,5378,5777,5792,15,-414,-399,0.002596503,-0.071477901,-0.06906699
5765,2014,경기,안양시,4117000000,초등학교,2014-04-01,여자,2533,2763,2763,0,-230,-230,0,-0.083242852,-0.083242852
5766,2014,경기,안양시,4117000000,초등학교,2014-04-01,남자,2845,3014,3029,15,-184,-169,0.004976775,-0.060746121,-0.056071666
5767,2014,경기,과천시,4129000000,초등학교,2014-04-01,전체,578,693,721,28,-143,-115,0.04040404,-0.198335645,-0.165945166
5768,2014,경기,과천시,4129000000,초등학교,2014-04-01,여자,274,319,336,17,-62,-45,0.053291536,-0.18452381,-0.141065831
5769,2014,경기,과천시,4129000000,초등학교,2014-04-01,남자,304,374,385,11,-81,-70,0.029411765,-0.21038961,-0.187165775
5770,2014,경기,안산시,4127000000,초등학교,2014-04-01,전체,7139,7519,7379,-140,-240,-380,-0.018619497,-0.032524732,-0.050538635
5771,2014,경기,안산시,4127000000,초등학교,2014-04-01,여자,3471,3625,3564,-61,-93,-154,-0.016827586,-0.026094276,-0.042482759
5772,2014,경기,안산시,4127000000,초등학교,2014-04-01,남자,3668,3894,3815,-79,-147,-226,-0.020287622,-0.03853211,-0.058038007
5773,2014,경기,용인시,4146000000,초등학교,2014-04-01,전체,12253,12530,12845,315,-592,-277,0.025139665,-0.046087972,-0.022106943
5774,2014,경기,용인시,4146000000,초등학교,2014-04-01,여자,6012,6058,6210,152,-198,-46,0.025090789,-0.031884058,-0.007593265
5775,2014,경기,용인시,4146000000,초등학교,2014-04-01,남자,6241,6472,6635,163,-394,-231,0.025185414,-0.059382065,-0.035692213
5776,2014,경기,군포시,4141000000,초등학교,2014-04-01,전체,2995,3236,3137,-99,-142,-241,-0.030593325,-0.045266178,-0.07447466
5777,2014,경기,군포시,4141000000,초등학교,2014-04-01,여자,1444,1575,1512,-63,-68,-131,-0.04,-0.044973545,-0.083174603
5778,2014,경기,군포시,4141000000,초등학교,2014-04-01,남자,1551,1661,1625,-36,-74,-110,-0.021673691,-0.045538462,-0.066225166
5779,2014,경기,의왕시,4143000000,초등학교,2014-04-01,전체,1503,1668,1732,64,-229,-165,0.038369305,-0.13221709,-0.098920863
5780,2014,경기,의왕시,4143000000,초등학교,2014-04-01,여자,736,805,852,47,-116,-69,0.058385093,-0.136150235,-0.085714286
5781,2014,경기,의왕시,4143000000,초등학교,2014-04-01,남자,767,863,880,17,-113,-96,0.019698725,-0.128409091,-0.111239861
5782,2014,경기,시흥시,4139000000,초등학교,2014-04-01,전체,4395,4667,4585,-82,-190,-272,-0.017570174,-0.041439477,-0.058281551
5783,2014,경기,시흥시,4139000000,초등학교,2014-04-01,여자,2196,2346,2279,-67,-83,-150,-0.02855925,-0.036419482,-0.063938619
5784,2014,경기,시흥시,4139000000,초등학교,2014-04-01,남자,2199,2321,2306,-15,-107,-122,-0.006462732,-0.046400694,-0.05256355
5785,2014,경기,평택시,4122000000,초등학교,2014-04-01,전체,4946,4912,4934,22,12,34,0.004478827,0.002432104,0.006921824
5786,2014,경기,평택시,4122000000,초등학교,2014-04-01,여자,2405,2387,2388,1,17,18,0.000418936,0.007118928,0.007540846
5787,2014,경기,평택시,4122000000,초등학교,2014-04-01,남자,2541,2525,2546,21,-5,16,0.008316832,-0.001963865,0.006336634
5788,2014,경기,화성시,4159000000,초등학교,2014-04-01,전체,8041,8571,8436,-135,-395,-530,-0.015750788,-0.046823139,-0.061836425
5789,2014,경기,화성시,4159000000,초등학교,2014-04-01,여자,3977,4240,4155,-85,-178,-263,-0.02004717,-0.042839952,-0.062028302
5790,2014,경기,화성시,4159000000,초등학교,2014-04-01,남자,4064,4331,4281,-50,-217,-267,-0.011544678,-0.050689091,-0.06164858
5791,2014,경기,오산시,4137000000,초등학교,2014-04-01,전체,2993,3128,3102,-26,-109,-135,-0.00831202,-0.03513862,-0.043158568
5792,2014,경기,오산시,4137000000,초등학교,2014-04-01,여자,1439,1509,1484,-25,-45,-70,-0.016567263,-0.03032345,-0.046388337
5793,2014,경기,오산시,4137000000,초등학교,2014-04-01,남자,1554,1619,1618,-1,-64,-65,-0.000617665,-0.039555006,-0.04014824
5794,2014,경기,광명시,4121000000,초등학교,2014-04-01,전체,3800,4106,4005,-101,-205,-306,-0.024598149,-0.051186017,-0.074525085
5795,2014,경기,광명시,4121000000,초등학교,2014-04-01,여자,1923,2038,1984,-54,-61,-115,-0.026496565,-0.030745968,-0.05642787
5796,2014,경기,광명시,4121000000,초등학교,2014-04-01,남자,1877,2068,2021,-47,-144,-191,-0.022727273,-0.071251856,-0.092359768
5797,2014,경기,광주시,4161000000,초등학교,2014-04-01,전체,3122,3259,3335,76,-213,-137,0.023320037,-0.063868066,-0.042037435
5798,2014,경기,광주시,4161000000,초등학교,2014-04-01,여자,1587,1690,1742,52,-155,-103,0.030769231,-0.088978186,-0.060946746
5799,2014,경기,광주시,4161000000,초등학교,2014-04-01,남자,1535,1569,1593,24,-58,-34,0.015296367,-0.036409291,-0.021669853
5800,2014,경기,하남시,4145000000,초등학교,2014-04-01,전체,1328,1527,1462,-65,-134,-199,-0.042567125,-0.091655267,-0.130320891
5801,2014,경기,하남시,4145000000,초등학교,2014-04-01,여자,629,715,691,-24,-62,-86,-0.033566434,-0.089725036,-0.12027972
5802,2014,경기,하남시,4145000000,초등학교,2014-04-01,남자,699,812,771,-41,-72,-113,-0.050492611,-0.093385214,-0.139162562
5803,2014,경기,김포시,4157000000,초등학교,2014-04-01,전체,3827,3094,3630,536,197,733,0.173238526,0.054269972,0.236910149
5804,2014,경기,김포시,4157000000,초등학교,2014-04-01,여자,1889,1503,1753,250,136,386,0.166333999,0.077581289,0.256819694
5805,2014,경기,김포시,4157000000,초등학교,2014-04-01,남자,1938,1591,1877,286,61,347,0.179761157,0.032498668,0.218101823
5806,2014,경기,이천시,4150000000,초등학교,2014-04-01,전체,2377,2484,2464,-20,-87,-107,-0.00805153,-0.035308442,-0.043075684
5807,2014,경기,이천시,4150000000,초등학교,2014-04-01,여자,1167,1231,1226,-5,-59,-64,-0.004061738,-0.04812398,-0.051990252
5808,2014,경기,이천시,4150000000,초등학교,2014-04-01,남자,1210,1253,1238,-15,-28,-43,-0.011971269,-0.022617124,-0.034317638
5809,2014,경기,안성시,4155000000,초등학교,2014-04-01,전체,2031,2122,2089,-33,-58,-91,-0.015551367,-0.027764481,-0.042884072
5810,2014,경기,안성시,4155000000,초등학교,2014-04-01,여자,987,1036,1026,-10,-39,-49,-0.00965251,-0.038011696,-0.047297297
5811,2014,경기,안성시,4155000000,초등학교,2014-04-01,남자,1044,1086,1063,-23,-19,-42,-0.021178637,-0.017873942,-0.038674033
5812,2014,경기,여주시,4167000000,초등학교,2014-04-01,전체,1014,1029,1002,-27,12,-15,-0.026239067,0.011976048,-0.014577259
5813,2014,경기,여주시,4167000000,초등학교,2014-04-01,여자,503,483,480,-3,23,20,-0.00621118,0.047916667,0.041407867
5814,2014,경기,여주시,4167000000,초등학교,2014-04-01,남자,511,546,522,-24,-11,-35,-0.043956044,-0.021072797,-0.064102564
5815,2014,경기,양평군,4183000000,초등학교,2014-04-01,전체,847,786,830,44,17,61,0.055979644,0.020481928,0.077608142
5816,2014,경기,양평군,4183000000,초등학교,2014-04-01,여자,425,381,406,25,19,44,0.065616798,0.04679803,0.115485564
5817,2014,경기,양평군,4183000000,초등학교,2014-04-01,남자,422,405,424,19,-2,17,0.04691358,-0.004716981,0.041975309
5818,2014,경기,고양시,4128000000,초등학교,2014-04-01,전체,9425,9606,9770,164,-345,-181,0.017072663,-0.03531218,-0.01884239
5819,2014,경기,고양시,4128000000,초등학교,2014-04-01,여자,4555,4584,4682,98,-127,-29,0.021378709,-0.02712516,-0.006326353
5820,2014,경기,고양시,4128000000,초등학교,2014-04-01,남자,4870,5022,5088,66,-218,-152,0.013142174,-0.042845912,-0.030266826
5821,2014,경기,남양주시,4136000000,초등학교,2014-04-01,전체,7590,7555,7768,213,-178,35,0.02819325,-0.022914521,0.004632694
5822,2014,경기,남양주시,4136000000,초등학교,2014-04-01,여자,3672,3616,3725,109,-53,56,0.030143805,-0.014228188,0.015486726
5823,2014,경기,남양주시,4136000000,초등학교,2014-04-01,남자,3918,3939,4043,104,-125,-21,0.02640264,-0.030917635,-0.005331302
5824,2014,경기,구리시,4131000000,초등학교,2014-04-01,전체,1802,2034,1985,-49,-183,-232,-0.024090462,-0.092191436,-0.114060964
5825,2014,경기,구리시,4131000000,초등학교,2014-04-01,여자,848,983,964,-19,-116,-135,-0.019328586,-0.12033195,-0.13733469
5826,2014,경기,구리시,4131000000,초등학교,2014-04-01,남자,954,1051,1021,-30,-67,-97,-0.028544244,-0.065621939,-0.092293054
5827,2014,경기,의정부시,4115000000,초등학교,2014-04-01,전체,4073,4275,4270,-5,-197,-202,-0.001169591,-0.046135831,-0.047251462
5828,2014,경기,의정부시,4115000000,초등학교,2014-04-01,여자,1929,2028,2041,13,-112,-99,0.006410256,-0.054875061,-0.048816568
5829,2014,경기,의정부시,4115000000,초등학교,2014-04-01,남자,2144,2247,2229,-18,-85,-103,-0.008010681,-0.038133692,-0.045838896
5830,2014,경기,파주시,4148000000,초등학교,2014-04-01,전체,4943,4962,5118,156,-175,-19,0.031438936,-0.034193044,-0.003829101
5831,2014,경기,파주시,4148000000,초등학교,2014-04-01,여자,2431,2395,2476,81,-45,36,0.033820459,-0.018174475,0.015031315
5832,2014,경기,파주시,4148000000,초등학교,2014-04-01,남자,2512,2567,2642,75,-130,-55,0.029216985,-0.049205148,-0.021425789
5833,2014,경기,동두천시,4125000000,초등학교,2014-04-01,전체,983,990,999,9,-16,-7,0.009090909,-0.016016016,-0.007070707
5834,2014,경기,동두천시,4125000000,초등학교,2014-04-01,여자,492,508,513,5,-21,-16,0.00984252,-0.040935673,-0.031496063
5835,2014,경기,동두천시,4125000000,초등학교,2014-04-01,남자,491,482,486,4,5,9,0.008298755,0.010288066,0.018672199
5836,2014,경기,양주시,4163000000,초등학교,2014-04-01,전체,2361,2524,2487,-37,-126,-163,-0.014659271,-0.05066345,-0.064580032
5837,2014,경기,양주시,4163000000,초등학교,2014-04-01,여자,1141,1222,1191,-31,-50,-81,-0.025368249,-0.041981528,-0.066284779
5838,2014,경기,양주시,4163000000,초등학교,2014-04-01,남자,1220,1302,1296,-6,-76,-82,-0.004608295,-0.058641975,-0.062980031
5839,2014,경기,포천시,4165000000,초등학교,2014-04-01,전체,1335,1431,1391,-40,-56,-96,-0.027952481,-0.040258807,-0.067085954
5840,2014,경기,포천시,4165000000,초등학교,2014-04-01,여자,602,668,640,-28,-38,-66,-0.041916168,-0.059375,-0.098802395
5841,2014,경기,포천시,4165000000,초등학교,2014-04-01,남자,733,763,751,-12,-18,-30,-0.015727392,-0.023968043,-0.03931848
5842,2014,경기,가평군,4182000000,초등학교,2014-04-01,전체,450,466,471,5,-21,-16,0.010729614,-0.044585987,-0.034334764
5843,2014,경기,가평군,4182000000,초등학교,2014-04-01,여자,216,216,219,3,-3,0,0.013888889,-0.01369863,0
5844,2014,경기,가평군,4182000000,초등학교,2014-04-01,남자,234,250,252,2,-18,-16,0.008,-0.071428571,-0.064
5845,2014,경기,연천군,4180000000,초등학교,2014-04-01,전체,312,365,350,-15,-38,-53,-0.04109589,-0.108571429,-0.145205479
5846,2014,경기,연천군,4180000000,초등학교,2014-04-01,여자,142,173,166,-7,-24,-31,-0.040462428,-0.144578313,-0.179190751
5847,2014,경기,연천군,4180000000,초등학교,2014-04-01,남자,170,192,184,-8,-14,-22,-0.041666667,-0.076086957,-0.114583333
5848,2014,강원,춘천시,4211000000,초등학교,2014-04-01,전체,2517,2489,2522,33,-5,28,0.013258337,-0.001982554,0.011249498
5849,2014,강원,춘천시,4211000000,초등학교,2014-04-01,여자,1228,1230,1248,18,-20,-2,0.014634146,-0.016025641,-0.001626016
5850,2014,강원,춘천시,4211000000,초등학교,2014-04-01,남자,1289,1259,1274,15,15,30,0.011914218,0.01177394,0.023828435
5851,2014,강원,원주시,4213000000,초등학교,2014-04-01,전체,3415,3331,3372,41,43,84,0.012308616,0.012752076,0.025217652
5852,2014,강원,원주시,4213000000,초등학교,2014-04-01,여자,1651,1626,1643,17,8,25,0.010455105,0.004869142,0.015375154
5853,2014,강원,원주시,4213000000,초등학교,2014-04-01,남자,1764,1705,1729,24,35,59,0.014076246,0.020242915,0.034604106
5854,2014,강원,강릉시,4215000000,초등학교,2014-04-01,전체,1839,1852,1849,-3,-10,-13,-0.00161987,-0.005408329,-0.007019438
5855,2014,강원,강릉시,4215000000,초등학교,2014-04-01,여자,840,895,889,-6,-49,-55,-0.006703911,-0.05511811,-0.061452514
5856,2014,강원,강릉시,4215000000,초등학교,2014-04-01,남자,999,957,960,3,39,42,0.003134796,0.040625,0.043887147
5857,2014,강원,동해시,4217000000,초등학교,2014-04-01,전체,928,865,887,22,41,63,0.025433526,0.046223224,0.07283237
5858,2014,강원,동해시,4217000000,초등학교,2014-04-01,여자,444,410,420,10,24,34,0.024390244,0.057142857,0.082926829
5859,2014,강원,동해시,4217000000,초등학교,2014-04-01,남자,484,455,467,12,17,29,0.026373626,0.03640257,0.063736264
5860,2014,강원,태백시,4219000000,초등학교,2014-04-01,전체,449,467,449,-18,0,-18,-0.038543897,0,-0.038543897
5861,2014,강원,태백시,4219000000,초등학교,2014-04-01,여자,205,209,206,-3,-1,-4,-0.014354067,-0.004854369,-0.019138756
5862,2014,강원,태백시,4219000000,초등학교,2014-04-01,남자,244,258,243,-15,1,-14,-0.058139535,0.004115226,-0.054263566
5863,2014,강원,속초시,4221000000,초등학교,2014-04-01,전체,712,687,694,7,18,25,0.010189229,0.025936599,0.036390102
5864,2014,강원,속초시,4221000000,초등학교,2014-04-01,여자,313,320,322,2,-9,-7,0.00625,-0.027950311,-0.021875
5865,2014,강원,속초시,4221000000,초등학교,2014-04-01,남자,399,367,372,5,27,32,0.013623978,0.072580645,0.08719346
5866,2014,강원,삼척시,4223000000,초등학교,2014-04-01,전체,500,494,492,-2,8,6,-0.004048583,0.016260163,0.012145749
5867,2014,강원,삼척시,4223000000,초등학교,2014-04-01,여자,234,239,237,-2,-3,-5,-0.008368201,-0.012658228,-0.020920502
5868,2014,강원,삼척시,4223000000,초등학교,2014-04-01,남자,266,255,255,0,11,11,0,0.043137255,0.043137255
5869,2014,강원,홍천군,4272000000,초등학교,2014-04-01,전체,569,596,603,7,-34,-27,0.011744966,-0.056384743,-0.045302013
5870,2014,강원,홍천군,4272000000,초등학교,2014-04-01,여자,282,313,314,1,-32,-31,0.003194888,-0.101910828,-0.099041534
5871,2014,강원,홍천군,4272000000,초등학교,2014-04-01,남자,287,283,289,6,-2,4,0.021201413,-0.006920415,0.014134276
5872,2014,강원,횡성군,4273000000,초등학교,2014-04-01,전체,314,307,311,4,3,7,0.013029316,0.009646302,0.022801303
5873,2014,강원,횡성군,4273000000,초등학교,2014-04-01,여자,155,150,141,-9,14,5,-0.06,0.09929078,0.033333333
5874,2014,강원,횡성군,4273000000,초등학교,2014-04-01,남자,159,157,170,13,-11,2,0.082802548,-0.064705882,0.012738854
5875,2014,강원,영월군,4275000000,초등학교,2014-04-01,전체,254,270,283,13,-29,-16,0.048148148,-0.102473498,-0.059259259
5876,2014,강원,영월군,4275000000,초등학교,2014-04-01,여자,118,126,132,6,-14,-8,0.047619048,-0.106060606,-0.063492063
5877,2014,강원,영월군,4275000000,초등학교,2014-04-01,남자,136,144,151,7,-15,-8,0.048611111,-0.099337748,-0.055555556
5878,2014,강원,평창군,4276000000,초등학교,2014-04-01,전체,313,344,336,-8,-23,-31,-0.023255814,-0.068452381,-0.090116279
5879,2014,강원,평창군,4276000000,초등학교,2014-04-01,여자,150,168,166,-2,-16,-18,-0.011904762,-0.096385542,-0.107142857
5880,2014,강원,평창군,4276000000,초등학교,2014-04-01,남자,163,176,170,-6,-7,-13,-0.034090909,-0.041176471,-0.073863636
5881,2014,강원,정선군,4277000000,초등학교,2014-04-01,전체,289,268,272,4,17,21,0.014925373,0.0625,0.078358209
5882,2014,강원,정선군,4277000000,초등학교,2014-04-01,여자,141,135,135,0,6,6,0,0.044444444,0.044444444
5883,2014,강원,정선군,4277000000,초등학교,2014-04-01,남자,148,133,137,4,11,15,0.030075188,0.080291971,0.112781955
5884,2014,강원,철원군,4278000000,초등학교,2014-04-01,전체,427,441,444,3,-17,-14,0.006802721,-0.038288288,-0.031746032
5885,2014,강원,철원군,4278000000,초등학교,2014-04-01,여자,211,208,216,8,-5,3,0.038461538,-0.023148148,0.014423077
5886,2014,강원,철원군,4278000000,초등학교,2014-04-01,남자,216,233,228,-5,-12,-17,-0.021459227,-0.052631579,-0.072961373
5887,2014,강원,화천군,4279000000,초등학교,2014-04-01,전체,243,272,269,-3,-26,-29,-0.011029412,-0.096654275,-0.106617647
5888,2014,강원,화천군,4279000000,초등학교,2014-04-01,여자,126,125,130,5,-4,1,0.04,-0.030769231,0.008
5889,2014,강원,화천군,4279000000,초등학교,2014-04-01,남자,117,147,139,-8,-22,-30,-0.054421769,-0.158273381,-0.204081633
5890,2014,강원,양구군,4280000000,초등학교,2014-04-01,전체,209,221,204,-17,5,-12,-0.076923077,0.024509804,-0.054298643
5891,2014,강원,양구군,4280000000,초등학교,2014-04-01,여자,94,109,90,-19,4,-15,-0.174311927,0.044444444,-0.137614679
5892,2014,강원,양구군,4280000000,초등학교,2014-04-01,남자,115,112,114,2,1,3,0.017857143,0.00877193,0.026785714
5893,2014,강원,인제군,4281000000,초등학교,2014-04-01,전체,310,310,311,1,-1,0,0.003225806,-0.003215434,0
5894,2014,강원,인제군,4281000000,초등학교,2014-04-01,여자,151,147,158,11,-7,4,0.074829932,-0.044303797,0.027210884
5895,2014,강원,인제군,4281000000,초등학교,2014-04-01,남자,159,163,153,-10,6,-4,-0.061349693,0.039215686,-0.024539877
5896,2014,강원,고성군,4282000000,초등학교,2014-04-01,전체,162,176,168,-8,-6,-14,-0.045454545,-0.035714286,-0.079545455
5897,2014,강원,고성군,4282000000,초등학교,2014-04-01,여자,71,74,70,-4,1,-3,-0.054054054,0.014285714,-0.040540541
5898,2014,강원,고성군,4282000000,초등학교,2014-04-01,남자,91,102,98,-4,-7,-11,-0.039215686,-0.071428571,-0.107843137
5899,2014,강원,양양군,4283000000,초등학교,2014-04-01,전체,175,170,178,8,-3,5,0.047058824,-0.016853933,0.029411765
5900,2014,강원,양양군,4283000000,초등학교,2014-04-01,여자,86,81,83,2,3,5,0.024691358,0.036144578,0.061728395
5901,2014,강원,양양군,4283000000,초등학교,2014-04-01,남자,89,89,95,6,-6,0,0.06741573,-0.063157895,0
5902,2014,충북,청주시,4311000000,초등학교,2014-04-01,전체,7226,7229,7280,51,-54,-3,0.007054918,-0.007417582,-0.000414995
5903,2014,충북,청주시,4311000000,초등학교,2014-04-01,여자,3485,3502,3516,14,-31,-17,0.003997716,-0.008816837,-0.004854369
5904,2014,충북,청주시,4311000000,초등학교,2014-04-01,남자,3741,3727,3764,37,-23,14,0.009927556,-0.006110521,0.003756372
5905,2014,충북,충주시,4313000000,초등학교,2014-04-01,전체,1837,1897,1933,36,-96,-60,0.018977333,-0.049663735,-0.031628888
5906,2014,충북,충주시,4313000000,초등학교,2014-04-01,여자,880,901,929,28,-49,-21,0.031076582,-0.052744887,-0.023307436
5907,2014,충북,충주시,4313000000,초등학교,2014-04-01,남자,957,996,1004,8,-47,-39,0.008032129,-0.046812749,-0.039156627
5908,2014,충북,제천시,4315000000,초등학교,2014-04-01,전체,1105,1167,1160,-7,-55,-62,-0.005998286,-0.047413793,-0.053127678
5909,2014,충북,제천시,4315000000,초등학교,2014-04-01,여자,537,553,552,-1,-15,-16,-0.001808318,-0.027173913,-0.028933092
5910,2014,충북,제천시,4315000000,초등학교,2014-04-01,남자,568,614,608,-6,-40,-46,-0.009771987,-0.065789474,-0.074918567
5911,2014,충북,청주시,4311000000,초등학교,2014-04-01,전체,1759,2005,1905,-100,-146,-246,-0.049875312,-0.07664042,-0.122693267
5912,2014,충북,청주시,4311000000,초등학교,2014-04-01,여자,837,978,930,-48,-93,-141,-0.049079755,-0.1,-0.144171779
5913,2014,충북,청주시,4311000000,초등학교,2014-04-01,남자,922,1027,975,-52,-53,-105,-0.050632911,-0.054358974,-0.102239533
5914,2014,충북,보은군,4372000000,초등학교,2014-04-01,전체,191,192,195,3,-4,-1,0.015625,-0.020512821,-0.005208333
5915,2014,충북,보은군,4372000000,초등학교,2014-04-01,여자,76,99,98,-1,-22,-23,-0.01010101,-0.224489796,-0.232323232
5916,2014,충북,보은군,4372000000,초등학교,2014-04-01,남자,115,93,97,4,18,22,0.043010753,0.18556701,0.23655914
5917,2014,충북,옥천군,4373000000,초등학교,2014-04-01,전체,396,436,426,-10,-30,-40,-0.02293578,-0.070422535,-0.091743119
5918,2014,충북,옥천군,4373000000,초등학교,2014-04-01,여자,196,203,198,-5,-2,-7,-0.024630542,-0.01010101,-0.034482759
5919,2014,충북,옥천군,4373000000,초등학교,2014-04-01,남자,200,233,228,-5,-28,-33,-0.021459227,-0.122807018,-0.141630901
5920,2014,충북,영동군,4374000000,초등학교,2014-04-01,전체,343,322,335,13,8,21,0.040372671,0.023880597,0.065217391
5921,2014,충북,영동군,4374000000,초등학교,2014-04-01,여자,165,145,149,4,16,20,0.027586207,0.10738255,0.137931034
5922,2014,충북,영동군,4374000000,초등학교,2014-04-01,남자,178,177,186,9,-8,1,0.050847458,-0.043010753,0.005649718
5923,2014,충북,진천군,4375000000,초등학교,2014-04-01,전체,698,683,688,5,10,15,0.007320644,0.014534884,0.021961933
5924,2014,충북,진천군,4375000000,초등학교,2014-04-01,여자,343,334,338,4,5,9,0.011976048,0.014792899,0.026946108
5925,2014,충북,진천군,4375000000,초등학교,2014-04-01,남자,355,349,350,1,5,6,0.00286533,0.014285714,0.017191977
5926,2014,충북,괴산군,4376000000,초등학교,2014-04-01,전체,191,195,201,6,-10,-4,0.030769231,-0.049751244,-0.020512821
5927,2014,충북,괴산군,4376000000,초등학교,2014-04-01,여자,101,103,105,2,-4,-2,0.019417476,-0.038095238,-0.019417476
5928,2014,충북,괴산군,4376000000,초등학교,2014-04-01,남자,90,92,96,4,-6,-2,0.043478261,-0.0625,-0.02173913
5929,2014,충북,음성군,4377000000,초등학교,2014-04-01,전체,836,888,895,7,-59,-52,0.007882883,-0.065921788,-0.058558559
5930,2014,충북,음성군,4377000000,초등학교,2014-04-01,여자,400,427,436,9,-36,-27,0.021077283,-0.082568807,-0.06323185
5931,2014,충북,음성군,4377000000,초등학교,2014-04-01,남자,436,461,459,-2,-23,-25,-0.004338395,-0.050108932,-0.054229935
5932,2014,충북,단양군,4380000000,초등학교,2014-04-01,전체,211,207,204,-3,7,4,-0.014492754,0.034313725,0.019323671
5933,2014,충북,단양군,4380000000,초등학교,2014-04-01,여자,103,100,98,-2,5,3,-0.02,0.051020408,0.03
5934,2014,충북,단양군,4380000000,초등학교,2014-04-01,남자,108,107,106,-1,2,1,-0.009345794,0.018867925,0.009345794
5935,2014,충북,증평군,4374500000,초등학교,2014-04-01,전체,367,394,405,11,-38,-27,0.027918782,-0.09382716,-0.068527919
5936,2014,충북,증평군,4374500000,초등학교,2014-04-01,여자,175,187,197,10,-22,-12,0.053475936,-0.111675127,-0.064171123
5937,2014,충북,증평군,4374500000,초등학교,2014-04-01,남자,192,207,208,1,-16,-15,0.004830918,-0.076923077,-0.072463768
5938,2014,충남,천안시,4413000000,초등학교,2014-04-01,전체,6797,6873,6839,-34,-42,-76,-0.004946894,-0.006141249,-0.011057762
5939,2014,충남,천안시,4413000000,초등학교,2014-04-01,여자,3291,3323,3303,-20,-12,-32,-0.006018658,-0.003633061,-0.009629853
5940,2014,충남,천안시,4413000000,초등학교,2014-04-01,남자,3506,3550,3536,-14,-30,-44,-0.003943662,-0.008484163,-0.012394366
5941,2014,충남,공주시,4415000000,초등학교,2014-04-01,전체,871,983,932,-51,-61,-112,-0.051881994,-0.065450644,-0.113936928
5942,2014,충남,공주시,4415000000,초등학교,2014-04-01,여자,405,479,448,-31,-43,-74,-0.064718163,-0.095982143,-0.154488518
5943,2014,충남,공주시,4415000000,초등학교,2014-04-01,남자,466,504,484,-20,-18,-38,-0.03968254,-0.037190083,-0.075396825
5944,2014,충남,보령시,4418000000,초등학교,2014-04-01,전체,828,914,914,0,-86,-86,0,-0.094091904,-0.094091904
5945,2014,충남,보령시,4418000000,초등학교,2014-04-01,여자,406,460,460,0,-54,-54,0,-0.117391304,-0.117391304
5946,2014,충남,보령시,4418000000,초등학교,2014-04-01,남자,422,454,454,0,-32,-32,0,-0.070484581,-0.070484581
5947,2014,충남,아산시,4420000000,초등학교,2014-04-01,전체,3701,3879,3892,13,-191,-178,0.003351379,-0.049075026,-0.045888115
5948,2014,충남,아산시,4420000000,초등학교,2014-04-01,여자,1767,1864,1859,-5,-92,-97,-0.002682403,-0.049488973,-0.052038627
5949,2014,충남,아산시,4420000000,초등학교,2014-04-01,남자,1934,2015,2033,18,-99,-81,0.008933002,-0.048696508,-0.040198511
5950,2014,충남,서산시,4421000000,초등학교,2014-04-01,전체,1873,1864,1887,23,-14,9,0.012339056,-0.007419184,0.004828326
5951,2014,충남,서산시,4421000000,초등학교,2014-04-01,여자,906,891,904,13,2,15,0.014590348,0.002212389,0.016835017
5952,2014,충남,서산시,4421000000,초등학교,2014-04-01,남자,967,973,983,10,-16,-6,0.010277492,-0.016276704,-0.006166495
5953,2014,충남,논산시,4423000000,초등학교,2014-04-01,전체,1065,1028,1023,-5,42,37,-0.004863813,0.041055718,0.035992218
5954,2014,충남,논산시,4423000000,초등학교,2014-04-01,여자,501,499,506,7,-5,2,0.014028056,-0.009881423,0.004008016
5955,2014,충남,논산시,4423000000,초등학교,2014-04-01,남자,564,529,517,-12,47,35,-0.02268431,0.090909091,0.066162571
5956,2014,충남,계룡시,4425000000,초등학교,2014-04-01,전체,484,566,557,-9,-73,-82,-0.01590106,-0.131059246,-0.144876325
5957,2014,충남,계룡시,4425000000,초등학교,2014-04-01,여자,241,287,274,-13,-33,-46,-0.045296167,-0.120437956,-0.160278746
5958,2014,충남,계룡시,4425000000,초등학교,2014-04-01,남자,243,279,283,4,-40,-36,0.014336918,-0.141342756,-0.129032258
5959,2014,충남,금산군,4471000000,초등학교,2014-04-01,전체,454,439,436,-3,18,15,-0.006833713,0.041284404,0.034168565
5960,2014,충남,금산군,4471000000,초등학교,2014-04-01,여자,233,210,212,2,21,23,0.00952381,0.099056604,0.10952381
5961,2014,충남,금산군,4471000000,초등학교,2014-04-01,남자,221,229,224,-5,-3,-8,-0.021834061,-0.013392857,-0.034934498
5962,2014,충남,부여군,4476000000,초등학교,2014-04-01,전체,442,453,443,-10,-1,-11,-0.022075055,-0.002257336,-0.024282561
5963,2014,충남,부여군,4476000000,초등학교,2014-04-01,여자,212,219,214,-5,-2,-7,-0.02283105,-0.009345794,-0.03196347
5964,2014,충남,부여군,4476000000,초등학교,2014-04-01,남자,230,234,229,-5,1,-4,-0.021367521,0.004366812,-0.017094017
5965,2014,충남,서천군,4477000000,초등학교,2014-04-01,전체,328,355,347,-8,-19,-27,-0.022535211,-0.054755043,-0.076056338
5966,2014,충남,서천군,4477000000,초등학교,2014-04-01,여자,162,177,175,-2,-13,-15,-0.011299435,-0.074285714,-0.084745763
5967,2014,충남,서천군,4477000000,초등학교,2014-04-01,남자,166,178,172,-6,-6,-12,-0.033707865,-0.034883721,-0.06741573
5968,2014,충남,청양군,4479000000,초등학교,2014-04-01,전체,162,185,191,6,-29,-23,0.032432432,-0.151832461,-0.124324324
5969,2014,충남,청양군,4479000000,초등학교,2014-04-01,여자,86,90,92,2,-6,-4,0.022222222,-0.065217391,-0.044444444
5970,2014,충남,청양군,4479000000,초등학교,2014-04-01,남자,76,95,99,4,-23,-19,0.042105263,-0.232323232,-0.2
5971,2014,충남,홍성군,4480000000,초등학교,2014-04-01,전체,773,697,725,28,48,76,0.040172166,0.066206897,0.109038737
5972,2014,충남,홍성군,4480000000,초등학교,2014-04-01,여자,377,359,371,12,6,18,0.033426184,0.016172507,0.050139276
5973,2014,충남,홍성군,4480000000,초등학교,2014-04-01,남자,396,338,354,16,42,58,0.047337278,0.118644068,0.171597633
5974,2014,충남,예산군,4481000000,초등학교,2014-04-01,전체,614,610,608,-2,6,4,-0.003278689,0.009868421,0.006557377
5975,2014,충남,예산군,4481000000,초등학교,2014-04-01,여자,276,282,281,-1,-5,-6,-0.003546099,-0.017793594,-0.021276596
5976,2014,충남,예산군,4481000000,초등학교,2014-04-01,남자,338,328,327,-1,11,10,-0.00304878,0.033639144,0.030487805
5977,2014,충남,태안군,4482500000,초등학교,2014-04-01,전체,438,432,431,-1,7,6,-0.002314815,0.016241299,0.013888889
5978,2014,충남,태안군,4482500000,초등학교,2014-04-01,여자,203,200,203,3,0,3,0.015,0,0.015
5979,2014,충남,태안군,4482500000,초등학교,2014-04-01,남자,235,232,228,-4,7,3,-0.017241379,0.030701754,0.012931034
5980,2014,충남,당진시,4427000000,초등학교,2014-04-01,전체,1773,1773,1831,58,-58,0,0.032712916,-0.031676679,0
5981,2014,충남,당진시,4427000000,초등학교,2014-04-01,여자,850,871,882,11,-32,-21,0.012629162,-0.036281179,-0.024110218
5982,2014,충남,당진시,4427000000,초등학교,2014-04-01,남자,923,902,949,47,-26,21,0.05210643,-0.02739726,0.023281596
5983,2014,전북,전주시,4511000000,초등학교,2014-04-01,전체,6669,6572,6612,40,57,97,0.006086427,0.00862069,0.014759586
5984,2014,전북,전주시,4511000000,초등학교,2014-04-01,여자,3159,3139,3162,23,-3,20,0.007327174,-0.000948767,0.006371456
5985,2014,전북,전주시,4511000000,초등학교,2014-04-01,남자,3510,3433,3450,17,60,77,0.004951937,0.017391304,0.022429362
5986,2014,전북,군산시,4513000000,초등학교,2014-04-01,전체,2801,2851,2860,9,-59,-50,0.003156787,-0.020629371,-0.017537706
5987,2014,전북,군산시,4513000000,초등학교,2014-04-01,여자,1384,1375,1362,-13,22,9,-0.009454545,0.016152717,0.006545455
5988,2014,전북,군산시,4513000000,초등학교,2014-04-01,남자,1417,1476,1498,22,-81,-59,0.014905149,-0.054072096,-0.0399729
5989,2014,전북,익산시,4514000000,초등학교,2014-04-01,전체,2933,2957,2972,15,-39,-24,0.005072709,-0.013122476,-0.008116334
5990,2014,전북,익산시,4514000000,초등학교,2014-04-01,여자,1441,1460,1453,-7,-12,-19,-0.004794521,-0.008258775,-0.013013699
5991,2014,전북,익산시,4514000000,초등학교,2014-04-01,남자,1492,1497,1519,22,-27,-5,0.014696059,-0.017774852,-0.003340013
5992,2014,전북,정읍시,4518000000,초등학교,2014-04-01,전체,963,938,930,-8,33,25,-0.008528785,0.035483871,0.026652452
5993,2014,전북,정읍시,4518000000,초등학교,2014-04-01,여자,475,437,435,-2,40,38,-0.004576659,0.091954023,0.086956522
5994,2014,전북,정읍시,4518000000,초등학교,2014-04-01,남자,488,501,495,-6,-7,-13,-0.011976048,-0.014141414,-0.025948104
5995,2014,전북,남원시,4519000000,초등학교,2014-04-01,전체,729,699,712,13,17,30,0.018597997,0.023876404,0.042918455
5996,2014,전북,남원시,4519000000,초등학교,2014-04-01,여자,364,342,349,7,15,22,0.020467836,0.042979943,0.064327485
5997,2014,전북,남원시,4519000000,초등학교,2014-04-01,남자,365,357,363,6,2,8,0.016806723,0.005509642,0.022408964
5998,2014,전북,김제시,4521000000,초등학교,2014-04-01,전체,669,675,675,0,-6,-6,0,-0.008888889,-0.008888889
5999,2014,전북,김제시,4521000000,초등학교,2014-04-01,여자,334,361,359,-2,-25,-27,-0.005540166,-0.069637883,-0.074792244
6000,2014,전북,김제시,4521000000,초등학교,2014-04-01,남자,335,314,316,2,19,21,0.006369427,0.060126582,0.066878981
6001,2014,전북,완주군,4571000000,초등학교,2014-04-01,전체,916,883,921,38,-5,33,0.043035108,-0.005428882,0.037372593
6002,2014,전북,완주군,4571000000,초등학교,2014-04-01,여자,441,436,455,19,-14,5,0.043577982,-0.030769231,0.01146789
6003,2014,전북,완주군,4571000000,초등학교,2014-04-01,남자,475,447,466,19,9,28,0.042505593,0.019313305,0.062639821
6004,2014,전북,진안군,4572000000,초등학교,2014-04-01,전체,163,202,187,-15,-24,-39,-0.074257426,-0.128342246,-0.193069307
6005,2014,전북,진안군,4572000000,초등학교,2014-04-01,여자,82,95,94,-1,-12,-13,-0.010526316,-0.127659574,-0.136842105
6006,2014,전북,진안군,4572000000,초등학교,2014-04-01,남자,81,107,93,-14,-12,-26,-0.130841121,-0.129032258,-0.242990654
6007,2014,전북,무주군,4573000000,초등학교,2014-04-01,전체,210,217,215,-2,-5,-7,-0.00921659,-0.023255814,-0.032258065
6008,2014,전북,무주군,4573000000,초등학교,2014-04-01,여자,110,102,105,3,5,8,0.029411765,0.047619048,0.078431373
6009,2014,전북,무주군,4573000000,초등학교,2014-04-01,남자,100,115,110,-5,-10,-15,-0.043478261,-0.090909091,-0.130434783
6010,2014,전북,장수군,4574000000,초등학교,2014-04-01,전체,179,196,192,-4,-13,-17,-0.020408163,-0.067708333,-0.086734694
6011,2014,전북,장수군,4574000000,초등학교,2014-04-01,여자,103,103,98,-5,5,0,-0.048543689,0.051020408,0
6012,2014,전북,장수군,4574000000,초등학교,2014-04-01,남자,76,93,94,1,-18,-17,0.010752688,-0.191489362,-0.182795699
6013,2014,전북,임실군,4575000000,초등학교,2014-04-01,전체,163,177,172,-5,-9,-14,-0.028248588,-0.052325581,-0.079096045
6014,2014,전북,임실군,4575000000,초등학교,2014-04-01,여자,79,88,91,3,-12,-9,0.034090909,-0.131868132,-0.102272727
6015,2014,전북,임실군,4575000000,초등학교,2014-04-01,남자,84,89,81,-8,3,-5,-0.08988764,0.037037037,-0.056179775
6016,2014,전북,순창군,4577000000,초등학교,2014-04-01,전체,208,237,221,-16,-13,-29,-0.067510549,-0.058823529,-0.122362869
6017,2014,전북,순창군,4577000000,초등학교,2014-04-01,여자,97,117,108,-9,-11,-20,-0.076923077,-0.101851852,-0.170940171
6018,2014,전북,순창군,4577000000,초등학교,2014-04-01,남자,111,120,113,-7,-2,-9,-0.058333333,-0.017699115,-0.075
6019,2014,전북,고창군,4579000000,초등학교,2014-04-01,전체,394,393,396,3,-2,1,0.007633588,-0.005050505,0.002544529
6020,2014,전북,고창군,4579000000,초등학교,2014-04-01,여자,189,186,193,7,-4,3,0.037634409,-0.020725389,0.016129032
6021,2014,전북,고창군,4579000000,초등학교,2014-04-01,남자,205,207,203,-4,2,-2,-0.019323671,0.009852217,-0.009661836
6022,2014,전북,부안군,4580000000,초등학교,2014-04-01,전체,353,392,392,0,-39,-39,0,-0.099489796,-0.099489796
6023,2014,전북,부안군,4580000000,초등학교,2014-04-01,여자,176,191,194,3,-18,-15,0.015706806,-0.092783505,-0.078534031
6024,2014,전북,부안군,4580000000,초등학교,2014-04-01,남자,177,201,198,-3,-21,-24,-0.014925373,-0.106060606,-0.119402985
6025,2014,전남,목포시,4611000000,초등학교,2014-04-01,전체,2741,2653,2629,-24,112,88,-0.009046363,0.04260175,0.033169996
6026,2014,전남,목포시,4611000000,초등학교,2014-04-01,여자,1317,1291,1272,-19,45,26,-0.014717273,0.035377358,0.020139427
6027,2014,전남,목포시,4611000000,초등학교,2014-04-01,남자,1424,1362,1357,-5,67,62,-0.003671072,0.049373618,0.045521292
6028,2014,전남,여수시,4613000000,초등학교,2014-04-01,전체,2677,2775,2767,-8,-90,-98,-0.002882883,-0.032526202,-0.035315315
6029,2014,전남,여수시,4613000000,초등학교,2014-04-01,여자,1338,1372,1375,3,-37,-34,0.002186589,-0.026909091,-0.024781341
6030,2014,전남,여수시,4613000000,초등학교,2014-04-01,남자,1339,1403,1392,-11,-53,-64,-0.007840342,-0.038074713,-0.045616536
6031,2014,전남,순천시,4615000000,초등학교,2014-04-01,전체,2872,2651,2748,97,124,221,0.036589966,0.045123726,0.083364768
6032,2014,전남,순천시,4615000000,초등학교,2014-04-01,여자,1348,1278,1321,43,27,70,0.033646322,0.020439061,0.054773083
6033,2014,전남,순천시,4615000000,초등학교,2014-04-01,남자,1524,1373,1427,54,97,151,0.039329934,0.067974772,0.10997815
6034,2014,전남,나주시,4617000000,초등학교,2014-04-01,전체,597,638,643,5,-46,-41,0.007836991,-0.071539658,-0.064263323
6035,2014,전남,나주시,4617000000,초등학교,2014-04-01,여자,282,294,293,-1,-11,-12,-0.003401361,-0.037542662,-0.040816327
6036,2014,전남,나주시,4617000000,초등학교,2014-04-01,남자,315,344,350,6,-35,-29,0.01744186,-0.1,-0.084302326
6037,2014,전남,광양시,4623000000,초등학교,2014-04-01,전체,1610,1724,1690,-34,-80,-114,-0.019721578,-0.047337278,-0.06612529
6038,2014,전남,광양시,4623000000,초등학교,2014-04-01,여자,765,808,802,-6,-37,-43,-0.007425743,-0.046134663,-0.053217822
6039,2014,전남,광양시,4623000000,초등학교,2014-04-01,남자,845,916,888,-28,-43,-71,-0.030567686,-0.048423423,-0.077510917
6040,2014,전남,담양군,4671000000,초등학교,2014-04-01,전체,233,288,286,-2,-53,-55,-0.006944444,-0.185314685,-0.190972222
6041,2014,전남,담양군,4671000000,초등학교,2014-04-01,여자,116,145,137,-8,-21,-29,-0.055172414,-0.153284672,-0.2
6042,2014,전남,담양군,4671000000,초등학교,2014-04-01,남자,117,143,149,6,-32,-26,0.041958042,-0.214765101,-0.181818182
6043,2014,전남,곡성군,4672000000,초등학교,2014-04-01,전체,154,177,172,-5,-18,-23,-0.028248588,-0.104651163,-0.129943503
6044,2014,전남,곡성군,4672000000,초등학교,2014-04-01,여자,74,89,89,0,-15,-15,0,-0.168539326,-0.168539326
6045,2014,전남,곡성군,4672000000,초등학교,2014-04-01,남자,80,88,83,-5,-3,-8,-0.056818182,-0.036144578,-0.090909091
6046,2014,전남,구례군,4673000000,초등학교,2014-04-01,전체,184,183,180,-3,4,1,-0.016393443,0.022222222,0.005464481
6047,2014,전남,구례군,4673000000,초등학교,2014-04-01,여자,86,73,80,7,6,13,0.095890411,0.075,0.178082192
6048,2014,전남,구례군,4673000000,초등학교,2014-04-01,남자,98,110,100,-10,-2,-12,-0.090909091,-0.02,-0.109090909
6049,2014,전남,고흥군,4677000000,초등학교,2014-04-01,전체,388,405,403,-2,-15,-17,-0.004938272,-0.037220844,-0.041975309
6050,2014,전남,고흥군,4677000000,초등학교,2014-04-01,여자,185,192,187,-5,-2,-7,-0.026041667,-0.010695187,-0.036458333
6051,2014,전남,고흥군,4677000000,초등학교,2014-04-01,남자,203,213,216,3,-13,-10,0.014084507,-0.060185185,-0.046948357
6052,2014,전남,보성군,4678000000,초등학교,2014-04-01,전체,256,354,320,-34,-64,-98,-0.096045198,-0.2,-0.276836158
6053,2014,전남,보성군,4678000000,초등학교,2014-04-01,여자,129,169,151,-18,-22,-40,-0.106508876,-0.145695364,-0.236686391
6054,2014,전남,보성군,4678000000,초등학교,2014-04-01,남자,127,185,169,-16,-42,-58,-0.086486486,-0.24852071,-0.313513514
6055,2014,전남,화순군,4679000000,초등학교,2014-04-01,전체,611,653,641,-12,-30,-42,-0.018376723,-0.046801872,-0.06431853
6056,2014,전남,화순군,4679000000,초등학교,2014-04-01,여자,313,322,312,-10,1,-9,-0.031055901,0.003205128,-0.027950311
6057,2014,전남,화순군,4679000000,초등학교,2014-04-01,남자,298,331,329,-2,-31,-33,-0.006042296,-0.094224924,-0.099697885
6058,2014,전남,장흥군,4680000000,초등학교,2014-04-01,전체,258,250,249,-1,9,8,-0.004,0.036144578,0.032
6059,2014,전남,장흥군,4680000000,초등학교,2014-04-01,여자,125,121,124,3,1,4,0.024793388,0.008064516,0.033057851
6060,2014,전남,장흥군,4680000000,초등학교,2014-04-01,남자,133,129,125,-4,8,4,-0.031007752,0.064,0.031007752
6061,2014,전남,강진군,4681000000,초등학교,2014-04-01,전체,249,308,287,-21,-38,-59,-0.068181818,-0.132404181,-0.191558442
6062,2014,전남,강진군,4681000000,초등학교,2014-04-01,여자,130,160,146,-14,-16,-30,-0.0875,-0.109589041,-0.1875
6063,2014,전남,강진군,4681000000,초등학교,2014-04-01,남자,119,148,141,-7,-22,-29,-0.047297297,-0.156028369,-0.195945946
6064,2014,전남,해남군,4682000000,초등학교,2014-04-01,전체,499,564,561,-3,-62,-65,-0.005319149,-0.110516934,-0.115248227
6065,2014,전남,해남군,4682000000,초등학교,2014-04-01,여자,260,271,271,0,-11,-11,0,-0.040590406,-0.040590406
6066,2014,전남,해남군,4682000000,초등학교,2014-04-01,남자,239,293,290,-3,-51,-54,-0.010238908,-0.175862069,-0.184300341
6067,2014,전남,영암군,4683000000,초등학교,2014-04-01,전체,497,602,583,-19,-86,-105,-0.031561462,-0.147512864,-0.174418605
6068,2014,전남,영암군,4683000000,초등학교,2014-04-01,여자,258,321,313,-8,-55,-63,-0.024922118,-0.17571885,-0.196261682
6069,2014,전남,영암군,4683000000,초등학교,2014-04-01,남자,239,281,270,-11,-31,-42,-0.039145907,-0.114814815,-0.149466192
6070,2014,전남,무안군,4684000000,초등학교,2014-04-01,전체,775,777,802,25,-27,-2,0.032175032,-0.033665835,-0.002574003
6071,2014,전남,무안군,4684000000,초등학교,2014-04-01,여자,381,367,379,12,2,14,0.032697548,0.005277045,0.038147139
6072,2014,전남,무안군,4684000000,초등학교,2014-04-01,남자,394,410,423,13,-29,-16,0.031707317,-0.06855792,-0.03902439
6073,2014,전남,함평군,4686000000,초등학교,2014-04-01,전체,192,217,204,-13,-12,-25,-0.059907834,-0.058823529,-0.115207373
6074,2014,전남,함평군,4686000000,초등학교,2014-04-01,여자,95,112,100,-12,-5,-17,-0.107142857,-0.05,-0.151785714
6075,2014,전남,함평군,4686000000,초등학교,2014-04-01,남자,97,105,104,-1,-7,-8,-0.00952381,-0.067307692,-0.076190476
6076,2014,전남,영광군,4687000000,초등학교,2014-04-01,전체,425,474,463,-11,-38,-49,-0.023206751,-0.082073434,-0.103375527
6077,2014,전남,영광군,4687000000,초등학교,2014-04-01,여자,206,245,243,-2,-37,-39,-0.008163265,-0.152263374,-0.159183673
6078,2014,전남,영광군,4687000000,초등학교,2014-04-01,남자,219,229,220,-9,-1,-10,-0.03930131,-0.004545455,-0.043668122
6079,2014,전남,장성군,4688000000,초등학교,2014-04-01,전체,340,336,331,-5,9,4,-0.014880952,0.027190332,0.011904762
6080,2014,전남,장성군,4688000000,초등학교,2014-04-01,여자,156,159,158,-1,-2,-3,-0.006289308,-0.012658228,-0.018867925
6081,2014,전남,장성군,4688000000,초등학교,2014-04-01,남자,184,177,173,-4,11,7,-0.02259887,0.063583815,0.039548023
6082,2014,전남,완도군,4689000000,초등학교,2014-04-01,전체,376,382,383,1,-7,-6,0.002617801,-0.018276762,-0.015706806
6083,2014,전남,완도군,4689000000,초등학교,2014-04-01,여자,190,199,200,1,-10,-9,0.005025126,-0.05,-0.045226131
6084,2014,전남,완도군,4689000000,초등학교,2014-04-01,남자,186,183,183,0,3,3,0,0.016393443,0.016393443
6085,2014,전남,진도군,4690000000,초등학교,2014-04-01,전체,241,237,238,1,3,4,0.004219409,0.012605042,0.016877637
6086,2014,전남,진도군,4690000000,초등학교,2014-04-01,여자,128,124,124,0,4,4,0,0.032258065,0.032258065
6087,2014,전남,진도군,4690000000,초등학교,2014-04-01,남자,113,113,114,1,-1,0,0.008849558,-0.00877193,0
6088,2014,전남,신안군,4691000000,초등학교,2014-04-01,전체,174,238,234,-4,-60,-64,-0.016806723,-0.256410256,-0.268907563
6089,2014,전남,신안군,4691000000,초등학교,2014-04-01,여자,76,106,106,0,-30,-30,0,-0.283018868,-0.283018868
6090,2014,전남,신안군,4691000000,초등학교,2014-04-01,남자,98,132,128,-4,-30,-34,-0.03030303,-0.234375,-0.257575758
6091,2014,경북,포항시,4711000000,초등학교,2014-04-01,전체,4684,4704,4736,32,-52,-20,0.006802721,-0.01097973,-0.004251701
6092,2014,경북,포항시,4711000000,초등학교,2014-04-01,여자,2256,2306,2321,15,-65,-50,0.00650477,-0.02800517,-0.021682567
6093,2014,경북,포항시,4711000000,초등학교,2014-04-01,남자,2428,2398,2415,17,13,30,0.007089241,0.005383023,0.012510425
6094,2014,경북,경주시,4713000000,초등학교,2014-04-01,전체,2153,2220,2197,-23,-44,-67,-0.01036036,-0.02002731,-0.03018018
6095,2014,경북,경주시,4713000000,초등학교,2014-04-01,여자,1044,1049,1049,0,-5,-5,0,-0.004766444,-0.004766444
6096,2014,경북,경주시,4713000000,초등학교,2014-04-01,남자,1109,1171,1148,-23,-39,-62,-0.019641332,-0.033972125,-0.0529462
6097,2014,경북,김천시,4715000000,초등학교,2014-04-01,전체,1028,1126,1121,-5,-93,-98,-0.004440497,-0.082961641,-0.087033748
6098,2014,경북,김천시,4715000000,초등학교,2014-04-01,여자,490,517,512,-5,-22,-27,-0.00967118,-0.04296875,-0.052224371
6099,2014,경북,김천시,4715000000,초등학교,2014-04-01,남자,538,609,609,0,-71,-71,0,-0.116584565,-0.116584565
6100,2014,경북,안동시,4717000000,초등학교,2014-04-01,전체,1391,1449,1423,-26,-32,-58,-0.017943409,-0.022487702,-0.040027605
6101,2014,경북,안동시,4717000000,초등학교,2014-04-01,여자,665,695,689,-6,-24,-30,-0.008633094,-0.034833091,-0.043165468
6102,2014,경북,안동시,4717000000,초등학교,2014-04-01,남자,726,754,734,-20,-8,-28,-0.026525199,-0.010899183,-0.037135279
6103,2014,경북,구미시,4719000000,초등학교,2014-04-01,전체,4962,5105,5059,-46,-97,-143,-0.009010774,-0.01917375,-0.028011753
6104,2014,경북,구미시,4719000000,초등학교,2014-04-01,여자,2380,2508,2479,-29,-99,-128,-0.011562998,-0.039935458,-0.051036683
6105,2014,경북,구미시,4719000000,초등학교,2014-04-01,남자,2582,2597,2580,-17,2,-15,-0.006546015,0.000775194,-0.005775895
6106,2014,경북,영주시,4721000000,초등학교,2014-04-01,전체,840,866,869,3,-29,-26,0.003464203,-0.033371692,-0.030023095
6107,2014,경북,영주시,4721000000,초등학교,2014-04-01,여자,421,448,458,10,-37,-27,0.022321429,-0.080786026,-0.060267857
6108,2014,경북,영주시,4721000000,초등학교,2014-04-01,남자,419,418,411,-7,8,1,-0.016746411,0.01946472,0.002392344
6109,2014,경북,영천시,4723000000,초등학교,2014-04-01,전체,644,685,655,-30,-11,-41,-0.04379562,-0.016793893,-0.059854015
6110,2014,경북,영천시,4723000000,초등학교,2014-04-01,여자,296,322,296,-26,0,-26,-0.080745342,0,-0.080745342
6111,2014,경북,영천시,4723000000,초등학교,2014-04-01,남자,348,363,359,-4,-11,-15,-0.011019284,-0.030640669,-0.041322314
6112,2014,경북,상주시,4725000000,초등학교,2014-04-01,전체,703,735,738,3,-35,-32,0.004081633,-0.047425474,-0.043537415
6113,2014,경북,상주시,4725000000,초등학교,2014-04-01,여자,324,307,312,5,12,17,0.016286645,0.038461538,0.055374593
6114,2014,경북,상주시,4725000000,초등학교,2014-04-01,남자,379,428,426,-2,-47,-49,-0.004672897,-0.110328638,-0.114485981
6115,2014,경북,문경시,4728000000,초등학교,2014-04-01,전체,507,500,505,5,2,7,0.01,0.003960396,0.014
6116,2014,경북,문경시,4728000000,초등학교,2014-04-01,여자,228,218,218,0,10,10,0,0.04587156,0.04587156
6117,2014,경북,문경시,4728000000,초등학교,2014-04-01,남자,279,282,287,5,-8,-3,0.017730496,-0.027874564,-0.010638298
6118,2014,경북,경산시,4729000000,초등학교,2014-04-01,전체,2386,2545,2553,8,-167,-159,0.003143418,-0.065413239,-0.062475442
6119,2014,경북,경산시,4729000000,초등학교,2014-04-01,여자,1159,1227,1233,6,-74,-68,0.004889976,-0.060016221,-0.055419723
6120,2014,경북,경산시,4729000000,초등학교,2014-04-01,남자,1227,1318,1320,2,-93,-91,0.001517451,-0.070454545,-0.069044006
6121,2014,경북,군위군,4772000000,초등학교,2014-04-01,전체,80,104,102,-2,-22,-24,-0.019230769,-0.215686275,-0.230769231
6122,2014,경북,군위군,4772000000,초등학교,2014-04-01,여자,37,46,46,0,-9,-9,0,-0.195652174,-0.195652174
6123,2014,경북,군위군,4772000000,초등학교,2014-04-01,남자,43,58,56,-2,-13,-15,-0.034482759,-0.232142857,-0.25862069
6124,2014,경북,의성군,4773000000,초등학교,2014-04-01,전체,225,263,263,0,-38,-38,0,-0.144486692,-0.144486692
6125,2014,경북,의성군,4773000000,초등학교,2014-04-01,여자,120,130,125,-5,-5,-10,-0.038461538,-0.04,-0.076923077
6126,2014,경북,의성군,4773000000,초등학교,2014-04-01,남자,105,133,138,5,-33,-28,0.037593985,-0.239130435,-0.210526316
6127,2014,경북,청송군,4775000000,초등학교,2014-04-01,전체,125,138,138,0,-13,-13,0,-0.094202899,-0.094202899
6128,2014,경북,청송군,4775000000,초등학교,2014-04-01,여자,62,70,67,-3,-5,-8,-0.042857143,-0.074626866,-0.114285714
6129,2014,경북,청송군,4775000000,초등학교,2014-04-01,남자,63,68,71,3,-8,-5,0.044117647,-0.112676056,-0.073529412
6130,2014,경북,영양군,4776000000,초등학교,2014-04-01,전체,107,118,123,5,-16,-11,0.042372881,-0.130081301,-0.093220339
6131,2014,경북,영양군,4776000000,초등학교,2014-04-01,여자,51,63,69,6,-18,-12,0.095238095,-0.260869565,-0.19047619
6132,2014,경북,영양군,4776000000,초등학교,2014-04-01,남자,56,55,54,-1,2,1,-0.018181818,0.037037037,0.018181818
6133,2014,경북,영덕군,4777000000,초등학교,2014-04-01,전체,216,225,227,2,-11,-9,0.008888889,-0.04845815,-0.04
6134,2014,경북,영덕군,4777000000,초등학교,2014-04-01,여자,98,109,114,5,-16,-11,0.04587156,-0.140350877,-0.100917431
6135,2014,경북,영덕군,4777000000,초등학교,2014-04-01,남자,118,116,113,-3,5,2,-0.025862069,0.044247788,0.017241379
6136,2014,경북,청도군,4782000000,초등학교,2014-04-01,전체,216,226,220,-6,-4,-10,-0.026548673,-0.018181818,-0.044247788
6137,2014,경북,청도군,4782000000,초등학교,2014-04-01,여자,114,118,116,-2,-2,-4,-0.016949153,-0.017241379,-0.033898305
6138,2014,경북,청도군,4782000000,초등학교,2014-04-01,남자,102,108,104,-4,-2,-6,-0.037037037,-0.019230769,-0.055555556
6139,2014,경북,고령군,4783000000,초등학교,2014-04-01,전체,247,268,266,-2,-19,-21,-0.007462687,-0.071428571,-0.078358209
6140,2014,경북,고령군,4783000000,초등학교,2014-04-01,여자,119,123,124,1,-5,-4,0.008130081,-0.040322581,-0.032520325
6141,2014,경북,고령군,4783000000,초등학교,2014-04-01,남자,128,145,142,-3,-14,-17,-0.020689655,-0.098591549,-0.117241379
6142,2014,경북,성주군,4784000000,초등학교,2014-04-01,전체,203,237,242,5,-39,-34,0.021097046,-0.161157025,-0.143459916
6143,2014,경북,성주군,4784000000,초등학교,2014-04-01,여자,96,123,118,-5,-22,-27,-0.040650407,-0.186440678,-0.219512195
6144,2014,경북,성주군,4784000000,초등학교,2014-04-01,남자,107,114,124,10,-17,-7,0.087719298,-0.137096774,-0.061403509
6145,2014,경북,칠곡군,4785000000,초등학교,2014-04-01,전체,1316,1479,1429,-50,-113,-163,-0.033806626,-0.079076277,-0.110209601
6146,2014,경북,칠곡군,4785000000,초등학교,2014-04-01,여자,607,706,691,-15,-84,-99,-0.021246459,-0.121562952,-0.140226629
6147,2014,경북,칠곡군,4785000000,초등학교,2014-04-01,남자,709,773,738,-35,-29,-64,-0.045278137,-0.039295393,-0.082794308
6148,2014,경북,예천군,4790000000,초등학교,2014-04-01,전체,248,284,281,-3,-33,-36,-0.01056338,-0.117437722,-0.126760563
6149,2014,경북,예천군,4790000000,초등학교,2014-04-01,여자,107,128,127,-1,-20,-21,-0.0078125,-0.157480315,-0.1640625
6150,2014,경북,예천군,4790000000,초등학교,2014-04-01,남자,141,156,154,-2,-13,-15,-0.012820513,-0.084415584,-0.096153846
6151,2014,경북,봉화군,4792000000,초등학교,2014-04-01,전체,186,220,218,-2,-32,-34,-0.009090909,-0.146788991,-0.154545455
6152,2014,경북,봉화군,4792000000,초등학교,2014-04-01,여자,106,125,122,-3,-16,-19,-0.024,-0.131147541,-0.152
6153,2014,경북,봉화군,4792000000,초등학교,2014-04-01,남자,80,95,96,1,-16,-15,0.010526316,-0.166666667,-0.157894737
6154,2014,경북,울진군,4793000000,초등학교,2014-04-01,전체,400,400,389,-11,11,0,-0.0275,0.028277635,0
6155,2014,경북,울진군,4793000000,초등학교,2014-04-01,여자,180,182,179,-3,1,-2,-0.016483516,0.005586592,-0.010989011
6156,2014,경북,울진군,4793000000,초등학교,2014-04-01,남자,220,218,210,-8,10,2,-0.036697248,0.047619048,0.009174312
6157,2014,경북,울릉군,4794000000,초등학교,2014-04-01,전체,54,61,56,-5,-2,-7,-0.081967213,-0.035714286,-0.114754098
6158,2014,경북,울릉군,4794000000,초등학교,2014-04-01,여자,35,34,32,-2,3,1,-0.058823529,0.09375,0.029411765
6159,2014,경북,울릉군,4794000000,초등학교,2014-04-01,남자,19,27,24,-3,-5,-8,-0.111111111,-0.208333333,-0.296296296
6160,2014,경남,진주시,4817000000,초등학교,2014-04-01,전체,3364,3346,3376,30,-12,18,0.008965929,-0.003554502,0.005379558
6161,2014,경남,진주시,4817000000,초등학교,2014-04-01,여자,1648,1624,1650,26,-2,24,0.016009852,-0.001212121,0.014778325
6162,2014,경남,진주시,4817000000,초등학교,2014-04-01,남자,1716,1722,1726,4,-10,-6,0.00232288,-0.005793743,-0.003484321
6163,2014,경남,통영시,4822000000,초등학교,2014-04-01,전체,1483,1572,1554,-18,-71,-89,-0.011450382,-0.045688546,-0.056615776
6164,2014,경남,통영시,4822000000,초등학교,2014-04-01,여자,729,797,792,-5,-63,-68,-0.006273526,-0.079545455,-0.08531995
6165,2014,경남,통영시,4822000000,초등학교,2014-04-01,남자,754,775,762,-13,-8,-21,-0.016774194,-0.010498688,-0.027096774
6166,2014,경남,사천시,4824000000,초등학교,2014-04-01,전체,1172,1210,1224,14,-52,-38,0.011570248,-0.04248366,-0.031404959
6167,2014,경남,사천시,4824000000,초등학교,2014-04-01,여자,585,586,594,8,-9,-1,0.013651877,-0.015151515,-0.001706485
6168,2014,경남,사천시,4824000000,초등학교,2014-04-01,남자,587,624,630,6,-43,-37,0.009615385,-0.068253968,-0.059294872
6169,2014,경남,김해시,4825000000,초등학교,2014-04-01,전체,6507,6500,6510,10,-3,7,0.001538462,-0.000460829,0.001076923
6170,2014,경남,김해시,4825000000,초등학교,2014-04-01,여자,3195,3150,3155,5,40,45,0.001587302,0.012678288,0.014285714
6171,2014,경남,김해시,4825000000,초등학교,2014-04-01,남자,3312,3350,3355,5,-43,-38,0.001492537,-0.012816692,-0.011343284
6172,2014,경남,밀양시,4827000000,초등학교,2014-04-01,전체,782,786,787,1,-5,-4,0.001272265,-0.00635324,-0.005089059
6173,2014,경남,밀양시,4827000000,초등학교,2014-04-01,여자,380,399,397,-2,-17,-19,-0.005012531,-0.042821159,-0.047619048
6174,2014,경남,밀양시,4827000000,초등학교,2014-04-01,남자,402,387,390,3,12,15,0.007751938,0.030769231,0.03875969
6175,2014,경남,거제시,4831000000,초등학교,2014-04-01,전체,3060,3195,3177,-18,-117,-135,-0.005633803,-0.036827195,-0.042253521
6176,2014,경남,거제시,4831000000,초등학교,2014-04-01,여자,1466,1586,1582,-4,-116,-120,-0.002522068,-0.073324905,-0.075662043
6177,2014,경남,거제시,4831000000,초등학교,2014-04-01,남자,1594,1609,1595,-14,-1,-15,-0.008701057,-0.000626959,-0.009322561
6178,2014,경남,양산시,4833000000,초등학교,2014-04-01,전체,3194,3171,3159,-12,35,23,-0.003784295,0.011079456,0.007253232
6179,2014,경남,양산시,4833000000,초등학교,2014-04-01,여자,1582,1504,1507,3,75,78,0.001994681,0.04976775,0.051861702
6180,2014,경남,양산시,4833000000,초등학교,2014-04-01,남자,1612,1667,1652,-15,-40,-55,-0.0089982,-0.024213075,-0.032993401
6181,2014,경남,의령군,4872000000,초등학교,2014-04-01,전체,142,198,193,-5,-51,-56,-0.025252525,-0.264248705,-0.282828283
6182,2014,경남,의령군,4872000000,초등학교,2014-04-01,여자,73,102,101,-1,-28,-29,-0.009803922,-0.277227723,-0.284313725
6183,2014,경남,의령군,4872000000,초등학교,2014-04-01,남자,69,96,92,-4,-23,-27,-0.041666667,-0.25,-0.28125
6184,2014,경남,함안군,4873000000,초등학교,2014-04-01,전체,630,676,672,-4,-42,-46,-0.00591716,-0.0625,-0.068047337
6185,2014,경남,함안군,4873000000,초등학교,2014-04-01,여자,305,315,314,-1,-9,-10,-0.003174603,-0.02866242,-0.031746032
6186,2014,경남,함안군,4873000000,초등학교,2014-04-01,남자,325,361,358,-3,-33,-36,-0.008310249,-0.092178771,-0.099722992
6187,2014,경남,창녕군,4874000000,초등학교,2014-04-01,전체,399,389,402,13,-3,10,0.033419023,-0.007462687,0.025706941
6188,2014,경남,창녕군,4874000000,초등학교,2014-04-01,여자,179,184,187,3,-8,-5,0.016304348,-0.042780749,-0.027173913
6189,2014,경남,창녕군,4874000000,초등학교,2014-04-01,남자,220,205,215,10,5,15,0.048780488,0.023255814,0.073170732
6190,2014,경남,고성군,4882000000,초등학교,2014-04-01,전체,382,418,425,7,-43,-36,0.016746411,-0.101176471,-0.086124402
6191,2014,경남,고성군,4882000000,초등학교,2014-04-01,여자,172,186,189,3,-17,-14,0.016129032,-0.08994709,-0.075268817
6192,2014,경남,고성군,4882000000,초등학교,2014-04-01,남자,210,232,236,4,-26,-22,0.017241379,-0.110169492,-0.094827586
6193,2014,경남,남해군,4884000000,초등학교,2014-04-01,전체,245,280,271,-9,-26,-35,-0.032142857,-0.095940959,-0.125
6194,2014,경남,남해군,4884000000,초등학교,2014-04-01,여자,124,133,128,-5,-4,-9,-0.037593985,-0.03125,-0.067669173
6195,2014,경남,남해군,4884000000,초등학교,2014-04-01,남자,121,147,143,-4,-22,-26,-0.027210884,-0.153846154,-0.176870748
6196,2014,경남,하동군,4885000000,초등학교,2014-04-01,전체,296,304,301,-3,-5,-8,-0.009868421,-0.016611296,-0.026315789
6197,2014,경남,하동군,4885000000,초등학교,2014-04-01,여자,133,143,141,-2,-8,-10,-0.013986014,-0.056737589,-0.06993007
6198,2014,경남,하동군,4885000000,초등학교,2014-04-01,남자,163,161,160,-1,3,2,-0.00621118,0.01875,0.01242236
6199,2014,경남,산청군,4886000000,초등학교,2014-04-01,전체,215,249,242,-7,-27,-34,-0.02811245,-0.111570248,-0.136546185
6200,2014,경남,산청군,4886000000,초등학교,2014-04-01,여자,105,113,102,-11,3,-8,-0.097345133,0.029411765,-0.07079646
6201,2014,경남,산청군,4886000000,초등학교,2014-04-01,남자,110,136,140,4,-30,-26,0.029411765,-0.214285714,-0.191176471
6202,2014,경남,함양군,4887000000,초등학교,2014-04-01,전체,283,328,317,-11,-34,-45,-0.033536585,-0.107255521,-0.137195122
6203,2014,경남,함양군,4887000000,초등학교,2014-04-01,여자,128,152,141,-11,-13,-24,-0.072368421,-0.092198582,-0.157894737
6204,2014,경남,함양군,4887000000,초등학교,2014-04-01,남자,155,176,176,0,-21,-21,0,-0.119318182,-0.119318182
6205,2014,경남,거창군,4888000000,초등학교,2014-04-01,전체,495,495,506,11,-11,0,0.022222222,-0.02173913,0
6206,2014,경남,거창군,4888000000,초등학교,2014-04-01,여자,249,236,243,7,6,13,0.029661017,0.024691358,0.055084746
6207,2014,경남,거창군,4888000000,초등학교,2014-04-01,남자,246,259,263,4,-17,-13,0.015444015,-0.064638783,-0.05019305
6208,2014,경남,합천군,4889000000,초등학교,2014-04-01,전체,273,315,328,13,-55,-42,0.041269841,-0.167682927,-0.133333333
6209,2014,경남,합천군,4889000000,초등학교,2014-04-01,여자,127,153,160,7,-33,-26,0.045751634,-0.20625,-0.169934641
6210,2014,경남,합천군,4889000000,초등학교,2014-04-01,남자,146,162,168,6,-22,-16,0.037037037,-0.130952381,-0.098765432
6211,2014,제주,제주시,5011000000,초등학교,2014-04-01,전체,5147,4778,4924,146,223,369,0.030556718,0.045288383,0.077228966
6212,2014,제주,제주시,5011000000,초등학교,2014-04-01,여자,2492,2308,2390,82,102,184,0.035528596,0.042677824,0.079722704
6213,2014,제주,제주시,5011000000,초등학교,2014-04-01,남자,2655,2470,2534,64,121,185,0.025910931,0.047750592,0.074898785
6214,2014,제주,서귀포시,5013000000,초등학교,2014-04-01,전체,1431,1472,1480,8,-49,-41,0.005434783,-0.033108108,-0.027853261
6215,2014,제주,서귀포시,5013000000,초등학교,2014-04-01,여자,711,745,754,9,-43,-34,0.012080537,-0.057029178,-0.045637584
6216,2014,제주,서귀포시,5013000000,초등학교,2014-04-01,남자,720,727,726,-1,-6,-7,-0.001375516,-0.008264463,-0.009628611
