"","연도","시도","행정구역","학제","date.x","성별","학생수","인구수_2년전_4세","인구수_1년전_5세","4세대비5세변동치","5세대비1학년변동치","4세대비1학년변동치","4세대비5세변동률","5세대비1학년변동률","4세대비1학년변동률"
"1","2021","서울","종로구","초등학교",2021-04-01,"전체",799,865,841,-24,-42,-66,-0.0277456647398844,-0.0499405469678954,-0.0763005780346821
"2","2021","서울","종로구","초등학교",2021-04-01,"여자",407,417,406,-11,1,-10,-0.026378896882494,0.00246305418719212,-0.0239808153477218
"3","2021","서울","종로구","초등학교",2021-04-01,"남자",392,448,435,-13,-43,-56,-0.0290178571428571,-0.0988505747126437,-0.125
"4","2021","서울","중구","초등학교",2021-04-01,"전체",786,777,733,-44,53,9,-0.0566280566280566,0.0723055934515689,0.0115830115830116
"5","2021","서울","중구","초등학교",2021-04-01,"여자",393,378,355,-23,38,15,-0.0608465608465608,0.107042253521127,0.0396825396825397
"6","2021","서울","중구","초등학교",2021-04-01,"남자",393,399,378,-21,15,-6,-0.0526315789473684,0.0396825396825397,-0.0150375939849624
"7","2021","서울","용산구","초등학교",2021-04-01,"전체",1107,1494,1443,-51,-336,-387,-0.034136546184739,-0.232848232848233,-0.259036144578313
"8","2021","서울","용산구","초등학교",2021-04-01,"여자",550,726,707,-19,-157,-176,-0.0261707988980716,-0.222065063649222,-0.242424242424242
"9","2021","서울","용산구","초등학교",2021-04-01,"남자",557,768,736,-32,-179,-211,-0.0416666666666667,-0.24320652173913,-0.274739583333333
"10","2021","서울","성동구","초등학교",2021-04-01,"전체",1866,2477,2333,-144,-467,-611,-0.0581348405329027,-0.200171453064724,-0.246669358094469
"11","2021","서울","성동구","초등학교",2021-04-01,"여자",913,1212,1152,-60,-239,-299,-0.0495049504950495,-0.207465277777778,-0.246699669966997
"12","2021","서울","성동구","초등학교",2021-04-01,"남자",953,1265,1181,-84,-228,-312,-0.066403162055336,-0.193056731583404,-0.246640316205534
"13","2021","서울","광진구","초등학교",2021-04-01,"전체",2146,2355,2233,-122,-87,-209,-0.0518046709129512,-0.038961038961039,-0.0887473460721868
"14","2021","서울","광진구","초등학교",2021-04-01,"여자",1028,1146,1095,-51,-67,-118,-0.0445026178010471,-0.0611872146118721,-0.102966841186736
"15","2021","서울","광진구","초등학교",2021-04-01,"남자",1118,1209,1138,-71,-20,-91,-0.0587262200165426,-0.0175746924428823,-0.0752688172043011
"16","2021","서울","동대문구","초등학교",2021-04-01,"전체",2147,2368,2321,-47,-174,-221,-0.019847972972973,-0.0749676863420939,-0.0933277027027027
"17","2021","서울","동대문구","초등학교",2021-04-01,"여자",1052,1158,1147,-11,-95,-106,-0.00949913644214162,-0.0828247602441151,-0.0915371329879102
"18","2021","서울","동대문구","초등학교",2021-04-01,"남자",1095,1210,1174,-36,-79,-115,-0.0297520661157025,-0.0672913117546848,-0.0950413223140496
"19","2021","서울","중랑구","초등학교",2021-04-01,"전체",2185,2636,2467,-169,-282,-451,-0.0641122913505311,-0.11430887717876,-0.171092564491654
"20","2021","서울","중랑구","초등학교",2021-04-01,"여자",1071,1276,1180,-96,-109,-205,-0.0752351097178683,-0.0923728813559322,-0.160658307210031
"21","2021","서울","중랑구","초등학교",2021-04-01,"남자",1114,1360,1287,-73,-173,-246,-0.0536764705882353,-0.134421134421134,-0.180882352941176
"22","2021","서울","성북구","초등학교",2021-04-01,"전체",3134,3176,3198,22,-64,-42,0.00692695214105793,-0.0200125078173859,-0.0132241813602015
"23","2021","서울","성북구","초등학교",2021-04-01,"여자",1533,1527,1556,29,-23,6,0.0189914865749836,-0.0147814910025707,0.00392927308447937
"24","2021","서울","성북구","초등학교",2021-04-01,"남자",1601,1649,1642,-7,-41,-48,-0.00424499696785931,-0.0249695493300853,-0.0291085506367495
"25","2021","서울","강북구","초등학교",2021-04-01,"전체",1389,1877,1778,-99,-389,-488,-0.0527437400106553,-0.218785151856018,-0.259989344698988
"26","2021","서울","강북구","초등학교",2021-04-01,"여자",682,872,815,-57,-133,-190,-0.0653669724770642,-0.16319018404908,-0.217889908256881
"27","2021","서울","강북구","초등학교",2021-04-01,"남자",707,1005,963,-42,-256,-298,-0.0417910447761194,-0.265835929387331,-0.296517412935323
"28","2021","서울","도봉구","초등학교",2021-04-01,"전체",2248,2297,2200,-97,48,-49,-0.0422289943404441,0.0218181818181818,-0.021332172398781
"29","2021","서울","도봉구","초등학교",2021-04-01,"여자",1109,1097,1050,-47,59,12,-0.0428441203281677,0.0561904761904762,0.0109389243391067
"30","2021","서울","도봉구","초등학교",2021-04-01,"남자",1139,1200,1150,-50,-11,-61,-0.0416666666666667,-0.00956521739130435,-0.0508333333333333
"31","2021","서울","노원구","초등학교",2021-04-01,"전체",3743,3806,3770,-36,-27,-63,-0.00945874934314241,-0.00716180371352785,-0.0165528113504992
"32","2021","서울","노원구","초등학교",2021-04-01,"여자",1823,1881,1878,-3,-55,-58,-0.00159489633173844,-0.0292864749733759,-0.0308346624136098
"33","2021","서울","노원구","초등학교",2021-04-01,"남자",1920,1925,1892,-33,28,-5,-0.0171428571428571,0.0147991543340381,-0.0025974025974026
"34","2021","서울","은평구","초등학교",2021-04-01,"전체",3041,3549,3398,-151,-357,-508,-0.0425471963933502,-0.105061801059447,-0.143138912369682
"35","2021","서울","은평구","초등학교",2021-04-01,"여자",1458,1738,1640,-98,-182,-280,-0.0563866513233602,-0.110975609756098,-0.161104718066743
"36","2021","서울","은평구","초등학교",2021-04-01,"남자",1583,1811,1758,-53,-175,-228,-0.0292655991165102,-0.0995449374288965,-0.125897294312535
"37","2021","서울","서대문구","초등학교",2021-04-01,"전체",2203,2248,2254,6,-51,-45,0.00266903914590747,-0.0226264418811003,-0.0200177935943061
"38","2021","서울","서대문구","초등학교",2021-04-01,"여자",1117,1114,1127,13,-10,3,0.0116696588868941,-0.00887311446317657,0.00269299820466786
"39","2021","서울","서대문구","초등학교",2021-04-01,"남자",1086,1134,1127,-7,-41,-48,-0.00617283950617284,-0.036379769299024,-0.0423280423280423
"40","2021","서울","마포구","초등학교",2021-04-01,"전체",2272,2779,2707,-72,-435,-507,-0.025908600215905,-0.160694495751755,-0.182439726520331
"41","2021","서울","마포구","초등학교",2021-04-01,"여자",1141,1358,1318,-40,-177,-217,-0.0294550810014728,-0.134294385432473,-0.15979381443299
"42","2021","서울","마포구","초등학교",2021-04-01,"남자",1131,1421,1389,-32,-258,-290,-0.0225193525686137,-0.185745140388769,-0.204081632653061
"43","2021","서울","양천구","초등학교",2021-04-01,"전체",3397,3370,3443,73,-46,27,0.0216617210682493,-0.0133604414754575,0.00801186943620178
"44","2021","서울","양천구","초등학교",2021-04-01,"여자",1668,1630,1676,46,-8,38,0.0282208588957055,-0.00477326968973747,0.0233128834355828
"45","2021","서울","양천구","초등학교",2021-04-01,"남자",1729,1740,1767,27,-38,-11,0.0155172413793103,-0.021505376344086,-0.00632183908045977
"46","2021","서울","강서구","초등학교",2021-04-01,"전체",4031,4738,4437,-301,-406,-707,-0.0635289151540735,-0.0915032679738562,-0.149219079780498
"47","2021","서울","강서구","초등학교",2021-04-01,"여자",2039,2402,2239,-163,-200,-363,-0.0678601165695254,-0.0893255917820455,-0.151124063280599
"48","2021","서울","강서구","초등학교",2021-04-01,"남자",1992,2336,2198,-138,-206,-344,-0.0590753424657534,-0.0937215650591447,-0.147260273972603
"49","2021","서울","구로구","초등학교",2021-04-01,"전체",2777,3166,3143,-23,-366,-389,-0.00726468730259002,-0.116449252306713,-0.122867972204675
"50","2021","서울","구로구","초등학교",2021-04-01,"여자",1370,1563,1546,-17,-176,-193,-0.0108765195137556,-0.113842173350582,-0.123480486244402
"51","2021","서울","구로구","초등학교",2021-04-01,"남자",1407,1603,1597,-6,-190,-196,-0.00374298190892077,-0.118973074514715,-0.122270742358079
"52","2021","서울","금천구","초등학교",2021-04-01,"전체",1308,1516,1409,-107,-101,-208,-0.0705804749340369,-0.0716820440028389,-0.137203166226913
"53","2021","서울","금천구","초등학교",2021-04-01,"여자",637,772,711,-61,-74,-135,-0.0790155440414508,-0.10407876230661,-0.174870466321244
"54","2021","서울","금천구","초등학교",2021-04-01,"남자",671,744,698,-46,-27,-73,-0.0618279569892473,-0.0386819484240688,-0.0981182795698925
"55","2021","서울","영등포구","초등학교",2021-04-01,"전체",2427,2806,2691,-115,-264,-379,-0.040983606557377,-0.0981047937569677,-0.135067712045617
"56","2021","서울","영등포구","초등학교",2021-04-01,"여자",1137,1352,1305,-47,-168,-215,-0.0347633136094675,-0.128735632183908,-0.159023668639053
"57","2021","서울","영등포구","초등학교",2021-04-01,"남자",1290,1454,1386,-68,-96,-164,-0.046767537826685,-0.0692640692640693,-0.112792297111417
"58","2021","서울","동작구","초등학교",2021-04-01,"전체",2523,3003,2871,-132,-348,-480,-0.043956043956044,-0.121212121212121,-0.15984015984016
"59","2021","서울","동작구","초등학교",2021-04-01,"여자",1217,1466,1394,-72,-177,-249,-0.0491132332878581,-0.126972740315638,-0.169849931787176
"60","2021","서울","동작구","초등학교",2021-04-01,"남자",1306,1537,1477,-60,-171,-231,-0.0390370852309694,-0.115775220040623,-0.150292778139232
"61","2021","서울","관악구","초등학교",2021-04-01,"전체",2158,2801,2608,-193,-450,-643,-0.0689039628704034,-0.172546012269939,-0.229560871117458
"62","2021","서울","관악구","초등학교",2021-04-01,"여자",1038,1346,1252,-94,-214,-308,-0.0698365527488856,-0.170926517571885,-0.228826151560178
"63","2021","서울","관악구","초등학교",2021-04-01,"남자",1120,1455,1356,-99,-236,-335,-0.0680412371134021,-0.174041297935103,-0.230240549828179
"64","2021","서울","서초구","초등학교",2021-04-01,"전체",3399,3623,3723,100,-324,-224,0.0276014352746343,-0.0870265914585012,-0.0618272150151808
"65","2021","서울","서초구","초등학교",2021-04-01,"여자",1643,1727,1782,55,-139,-84,0.0318471337579618,-0.0780022446689113,-0.0486392588303416
"66","2021","서울","서초구","초등학교",2021-04-01,"남자",1756,1896,1941,45,-185,-140,0.0237341772151899,-0.095311695002576,-0.0738396624472574
"67","2021","서울","강남구","초등학교",2021-04-01,"전체",3604,3784,3945,161,-341,-180,0.0425475687103594,-0.0864385297845374,-0.047568710359408
"68","2021","서울","강남구","초등학교",2021-04-01,"여자",1721,1842,1906,64,-185,-121,0.0347448425624321,-0.0970619097586569,-0.0656894679695983
"69","2021","서울","강남구","초등학교",2021-04-01,"남자",1883,1942,2039,97,-156,-59,0.0499485066941298,-0.0765080922020598,-0.0303810504634398
"70","2021","서울","송파구","초등학교",2021-04-01,"전체",4988,5682,5576,-106,-588,-694,-0.0186554030271031,-0.10545193687231,-0.122140091517071
"71","2021","서울","송파구","초등학교",2021-04-01,"여자",2426,2742,2698,-44,-272,-316,-0.0160466812545587,-0.100815418828762,-0.115244347191831
"72","2021","서울","송파구","초등학교",2021-04-01,"남자",2562,2940,2878,-62,-316,-378,-0.0210884353741497,-0.109798471160528,-0.128571428571429
"73","2021","서울","강동구","초등학교",2021-04-01,"전체",3752,3280,3831,551,-79,472,0.167987804878049,-0.020621247716001,0.14390243902439
"74","2021","서울","강동구","초등학교",2021-04-01,"여자",1827,1603,1858,255,-31,224,0.159076731129133,-0.0166846071044133,0.139737991266376
"75","2021","서울","강동구","초등학교",2021-04-01,"남자",1925,1677,1973,296,-48,248,0.176505664877758,-0.0243284338570705,0.147883124627311
"76","2021","부산","중구","초등학교",2021-04-01,"전체",217,189,175,-14,42,28,-0.0740740740740741,0.24,0.148148148148148
"77","2021","부산","중구","초등학교",2021-04-01,"여자",104,92,87,-5,17,12,-0.0543478260869565,0.195402298850575,0.130434782608696
"78","2021","부산","중구","초등학교",2021-04-01,"남자",113,97,88,-9,25,16,-0.0927835051546392,0.284090909090909,0.164948453608247
"79","2021","부산","서구","초등학교",2021-04-01,"전체",606,598,607,9,-1,8,0.0150501672240803,-0.00164744645799012,0.0133779264214047
"80","2021","부산","서구","초등학교",2021-04-01,"여자",298,284,286,2,12,14,0.00704225352112676,0.041958041958042,0.0492957746478873
"81","2021","부산","서구","초등학교",2021-04-01,"남자",308,314,321,7,-13,-6,0.0222929936305732,-0.0404984423676012,-0.0191082802547771
"82","2021","부산","동구","초등학교",2021-04-01,"전체",387,433,453,20,-66,-46,0.046189376443418,-0.145695364238411,-0.106235565819861
"83","2021","부산","동구","초등학교",2021-04-01,"여자",188,214,218,4,-30,-26,0.0186915887850467,-0.137614678899083,-0.121495327102804
"84","2021","부산","동구","초등학교",2021-04-01,"남자",199,219,235,16,-36,-20,0.0730593607305936,-0.153191489361702,-0.091324200913242
"85","2021","부산","영도구","초등학교",2021-04-01,"전체",533,583,570,-13,-37,-50,-0.0222984562607204,-0.0649122807017544,-0.0857632933104631
"86","2021","부산","영도구","초등학교",2021-04-01,"여자",258,280,271,-9,-13,-22,-0.0321428571428571,-0.0479704797047971,-0.0785714285714286
"87","2021","부산","영도구","초등학교",2021-04-01,"남자",275,303,299,-4,-24,-28,-0.0132013201320132,-0.0802675585284281,-0.0924092409240924
"88","2021","부산","부산진구","초등학교",2021-04-01,"전체",2573,2428,2389,-39,184,145,-0.0160626029654036,0.077019673503558,0.0597199341021417
"89","2021","부산","부산진구","초등학교",2021-04-01,"여자",1273,1174,1159,-15,114,99,-0.0127768313458262,0.0983606557377049,0.0843270868824531
"90","2021","부산","부산진구","초등학교",2021-04-01,"남자",1300,1254,1230,-24,70,46,-0.0191387559808612,0.0569105691056911,0.0366826156299841
"91","2021","부산","동래구","초등학교",2021-04-01,"전체",2086,2044,2269,225,-183,42,0.110078277886497,-0.0806522697223446,0.0205479452054795
"92","2021","부산","동래구","초등학교",2021-04-01,"여자",990,979,1094,115,-104,11,0.117466802860061,-0.0950639853747715,0.0112359550561798
"93","2021","부산","동래구","초등학교",2021-04-01,"남자",1096,1065,1175,110,-79,31,0.103286384976526,-0.0672340425531915,0.0291079812206573
"94","2021","부산","남구","초등학교",2021-04-01,"전체",1927,2117,2087,-30,-160,-190,-0.0141709966934341,-0.0766650694777192,-0.0897496457250827
"95","2021","부산","남구","초등학교",2021-04-01,"여자",930,1012,996,-16,-66,-82,-0.0158102766798419,-0.0662650602409639,-0.0810276679841897
"96","2021","부산","남구","초등학교",2021-04-01,"남자",997,1105,1091,-14,-94,-108,-0.0126696832579186,-0.0861594867094409,-0.097737556561086
"97","2021","부산","북구","초등학교",2021-04-01,"전체",2002,2217,2169,-48,-167,-215,-0.0216508795669824,-0.0769940064545874,-0.096977898060442
"98","2021","부산","북구","초등학교",2021-04-01,"여자",984,1091,1087,-4,-103,-107,-0.00366636113657195,-0.0947562097516099,-0.0980751604032997
"99","2021","부산","북구","초등학교",2021-04-01,"남자",1018,1126,1082,-44,-64,-108,-0.0390763765541741,-0.0591497227356747,-0.0959147424511545
"100","2021","부산","해운대구","초등학교",2021-04-01,"전체",3032,3167,3180,13,-148,-135,0.00410483107041364,-0.0465408805031447,-0.0426270918850647
"101","2021","부산","해운대구","초등학교",2021-04-01,"여자",1455,1549,1568,19,-113,-94,0.0122659780503551,-0.0720663265306122,-0.0606843124596514
"102","2021","부산","해운대구","초등학교",2021-04-01,"남자",1577,1618,1612,-6,-35,-41,-0.00370828182941904,-0.021712158808933,-0.0253399258343634
"103","2021","부산","사하구","초등학교",2021-04-01,"전체",2090,2389,2313,-76,-223,-299,-0.0318124738384261,-0.0964115866839602,-0.125156969443282
"104","2021","부산","사하구","초등학교",2021-04-01,"여자",980,1187,1148,-39,-168,-207,-0.0328559393428812,-0.146341463414634,-0.174389216512216
"105","2021","부산","사하구","초등학교",2021-04-01,"남자",1110,1202,1165,-37,-55,-92,-0.0307820299500832,-0.0472103004291846,-0.0765391014975042
"106","2021","부산","금정구","초등학교",2021-04-01,"전체",1528,1588,1574,-14,-46,-60,-0.00881612090680101,-0.0292249047013977,-0.0377833753148615
"107","2021","부산","금정구","초등학교",2021-04-01,"여자",727,771,766,-5,-39,-44,-0.00648508430609598,-0.0509138381201044,-0.0570687418936446
"108","2021","부산","금정구","초등학교",2021-04-01,"남자",801,817,808,-9,-7,-16,-0.011015911872705,-0.00866336633663366,-0.0195838433292534
"109","2021","부산","강서구","초등학교",2021-04-01,"전체",2197,2140,2188,48,9,57,0.0224299065420561,0.00411334552102377,0.0266355140186916
"110","2021","부산","강서구","초등학교",2021-04-01,"여자",1072,1036,1054,18,18,36,0.0173745173745174,0.0170777988614801,0.0347490347490347
"111","2021","부산","강서구","초등학교",2021-04-01,"남자",1125,1104,1134,30,-9,21,0.0271739130434783,-0.00793650793650794,0.0190217391304348
"112","2021","부산","연제구","초등학교",2021-04-01,"전체",1556,1665,1662,-3,-106,-109,-0.0018018018018018,-0.0637785800240674,-0.0654654654654655
"113","2021","부산","연제구","초등학교",2021-04-01,"여자",777,825,826,1,-49,-48,0.00121212121212121,-0.0593220338983051,-0.0581818181818182
"114","2021","부산","연제구","초등학교",2021-04-01,"남자",779,840,836,-4,-57,-61,-0.00476190476190476,-0.0681818181818182,-0.0726190476190476
"115","2021","부산","수영구","초등학교",2021-04-01,"전체",1017,1117,1153,36,-136,-100,0.0322291853178156,-0.117953165654814,-0.0895255147717099
"116","2021","부산","수영구","초등학교",2021-04-01,"여자",494,561,567,6,-73,-67,0.0106951871657754,-0.128747795414462,-0.119429590017825
"117","2021","부산","수영구","초등학교",2021-04-01,"남자",523,556,586,30,-63,-33,0.0539568345323741,-0.107508532423208,-0.0593525179856115
"118","2021","부산","사상구","초등학교",2021-04-01,"전체",1166,1519,1440,-79,-274,-353,-0.0520078999341672,-0.190277777777778,-0.232389730085583
"119","2021","부산","사상구","초등학교",2021-04-01,"여자",573,772,729,-43,-156,-199,-0.055699481865285,-0.213991769547325,-0.257772020725389
"120","2021","부산","사상구","초등학교",2021-04-01,"남자",593,747,711,-36,-118,-154,-0.0481927710843374,-0.165963431786217,-0.20615796519411
"121","2021","부산","기장군","초등학교",2021-04-01,"전체",2256,2185,2217,32,39,71,0.0146453089244851,0.0175913396481732,0.0324942791762014
"122","2021","부산","기장군","초등학교",2021-04-01,"여자",1091,1038,1064,26,27,53,0.0250481695568401,0.0253759398496241,0.0510597302504817
"123","2021","부산","기장군","초등학교",2021-04-01,"남자",1165,1147,1153,6,12,18,0.00523103748910201,0.01040763226366,0.015693112467306
"124","2021","대구","중구","초등학교",2021-04-01,"전체",762,608,580,-28,182,154,-0.0460526315789474,0.313793103448276,0.253289473684211
"125","2021","대구","중구","초등학교",2021-04-01,"여자",377,316,300,-16,77,61,-0.0506329113924051,0.256666666666667,0.193037974683544
"126","2021","대구","중구","초등학교",2021-04-01,"남자",385,292,280,-12,105,93,-0.0410958904109589,0.375,0.318493150684932
"127","2021","대구","동구","초등학교",2021-04-01,"전체",2792,3085,2947,-138,-155,-293,-0.0447325769854133,-0.0525958601968103,-0.0949756888168558
"128","2021","대구","동구","초등학교",2021-04-01,"여자",1381,1489,1421,-68,-40,-108,-0.0456682337139019,-0.0281491907107671,-0.0725319006044325
"129","2021","대구","동구","초등학교",2021-04-01,"남자",1411,1596,1526,-70,-115,-185,-0.043859649122807,-0.0753604193971166,-0.115914786967419
"130","2021","대구","서구","초등학교",2021-04-01,"전체",804,900,844,-56,-40,-96,-0.0622222222222222,-0.0473933649289099,-0.106666666666667
"131","2021","대구","서구","초등학교",2021-04-01,"여자",386,453,430,-23,-44,-67,-0.0507726269315673,-0.102325581395349,-0.147902869757174
"132","2021","대구","서구","초등학교",2021-04-01,"남자",418,447,414,-33,4,-29,-0.0738255033557047,0.00966183574879227,-0.0648769574944072
"133","2021","대구","남구","초등학교",2021-04-01,"전체",657,740,759,19,-102,-83,0.0256756756756757,-0.134387351778656,-0.112162162162162
"134","2021","대구","남구","초등학교",2021-04-01,"여자",322,361,367,6,-45,-39,0.0166204986149584,-0.122615803814714,-0.10803324099723
"135","2021","대구","남구","초등학교",2021-04-01,"남자",335,379,392,13,-57,-44,0.0343007915567282,-0.145408163265306,-0.116094986807388
"136","2021","대구","북구","초등학교",2021-04-01,"전체",3524,3795,3831,36,-307,-271,0.00948616600790514,-0.0801357347950927,-0.0714097496706192
"137","2021","대구","북구","초등학교",2021-04-01,"여자",1729,1819,1841,22,-112,-90,0.0120945574491479,-0.0608365019011407,-0.0494777350192413
"138","2021","대구","북구","초등학교",2021-04-01,"남자",1795,1976,1990,14,-195,-181,0.00708502024291498,-0.0979899497487437,-0.0915991902834008
"139","2021","대구","수성구","초등학교",2021-04-01,"전체",3367,3064,3285,221,82,303,0.0721279373368146,0.0249619482496195,0.0988903394255875
"140","2021","대구","수성구","초등학교",2021-04-01,"여자",1642,1522,1627,105,15,120,0.068988173455979,0.00921942224953903,0.0788436268068331
"141","2021","대구","수성구","초등학교",2021-04-01,"남자",1725,1542,1658,116,67,183,0.0752269779507134,0.0404101326899879,0.118677042801556
"142","2021","대구","달서구","초등학교",2021-04-01,"전체",4623,4772,4772,0,-149,-149,0,-0.0312238055322716,-0.0312238055322716
"143","2021","대구","달서구","초등학교",2021-04-01,"여자",2263,2349,2341,-8,-78,-86,-0.00340570455512984,-0.0333190944041008,-0.0366113239676458
"144","2021","대구","달서구","초등학교",2021-04-01,"남자",2360,2423,2431,8,-71,-63,0.00330169211721007,-0.0292060880296174,-0.0260008254230293
"145","2021","대구","달성군","초등학교",2021-04-01,"전체",3089,3275,3244,-31,-155,-186,-0.00946564885496183,-0.0477805178791615,-0.056793893129771
"146","2021","대구","달성군","초등학교",2021-04-01,"여자",1526,1625,1612,-13,-86,-99,-0.008,-0.0533498759305211,-0.0609230769230769
"147","2021","대구","달성군","초등학교",2021-04-01,"남자",1563,1650,1632,-18,-69,-87,-0.0109090909090909,-0.0422794117647059,-0.0527272727272727
"148","2021","인천","중구","초등학교",2021-04-01,"전체",1426,1193,1290,97,136,233,0.0813076278290025,0.105426356589147,0.195305951383068
"149","2021","인천","중구","초등학교",2021-04-01,"여자",726,586,625,39,101,140,0.0665529010238908,0.1616,0.238907849829352
"150","2021","인천","중구","초등학교",2021-04-01,"남자",700,607,665,58,35,93,0.0955518945634267,0.0526315789473684,0.153212520593081
"151","2021","인천","동구","초등학교",2021-04-01,"전체",564,469,472,3,92,95,0.00639658848614072,0.194915254237288,0.202558635394456
"152","2021","인천","동구","초등학교",2021-04-01,"여자",257,216,217,1,40,41,0.00462962962962963,0.184331797235023,0.189814814814815
"153","2021","인천","동구","초등학교",2021-04-01,"남자",307,253,255,2,52,54,0.00790513833992095,0.203921568627451,0.213438735177866
"154","2021","인천","연수구","초등학교",2021-04-01,"전체",4278,3678,4021,343,257,600,0.0932572050027189,0.0639144491420045,0.163132137030995
"155","2021","인천","연수구","초등학교",2021-04-01,"여자",2068,1765,1944,179,124,303,0.101416430594901,0.0637860082304527,0.171671388101983
"156","2021","인천","연수구","초등학교",2021-04-01,"남자",2210,1913,2077,164,133,297,0.0857292211186618,0.0640346653827636,0.155253528489284
"157","2021","인천","미추홀구","초등학교",2021-04-01,"전체",2700,3288,3113,-175,-413,-588,-0.0532238442822384,-0.132669450690652,-0.178832116788321
"158","2021","인천","미추홀구","초등학교",2021-04-01,"여자",1333,1624,1551,-73,-218,-291,-0.0449507389162562,-0.140554480980013,-0.179187192118227
"159","2021","인천","미추홀구","초등학교",2021-04-01,"남자",1367,1664,1562,-102,-195,-297,-0.0612980769230769,-0.124839948783611,-0.178485576923077
"160","2021","인천","남동구","초등학교",2021-04-01,"전체",4447,5051,4932,-119,-485,-604,-0.0235596911502673,-0.0983373884833739,-0.119580281132449
"161","2021","인천","남동구","초등학교",2021-04-01,"여자",2169,2514,2439,-75,-270,-345,-0.0298329355608592,-0.11070110701107,-0.137231503579952
"162","2021","인천","남동구","초등학교",2021-04-01,"남자",2278,2537,2493,-44,-215,-259,-0.0173433188805676,-0.0862414761331729,-0.102089081592432
"163","2021","인천","부평구","초등학교",2021-04-01,"전체",3663,4026,3818,-208,-155,-363,-0.0516641828117238,-0.0405971712938711,-0.0901639344262295
"164","2021","인천","부평구","초등학교",2021-04-01,"여자",1798,1970,1883,-87,-85,-172,-0.0441624365482233,-0.0451407328730749,-0.0873096446700508
"165","2021","인천","부평구","초등학교",2021-04-01,"남자",1865,2056,1935,-121,-70,-191,-0.058852140077821,-0.0361757105943152,-0.0928988326848249
"166","2021","인천","계양구","초등학교",2021-04-01,"전체",2099,2208,2128,-80,-29,-109,-0.036231884057971,-0.0136278195488722,-0.0493659420289855
"167","2021","인천","계양구","초등학교",2021-04-01,"여자",1034,1072,1028,-44,6,-38,-0.041044776119403,0.00583657587548638,-0.0354477611940298
"168","2021","인천","계양구","초등학교",2021-04-01,"남자",1065,1136,1100,-36,-35,-71,-0.0316901408450704,-0.0318181818181818,-0.0625
"169","2021","인천","서구","초등학교",2021-04-01,"전체",5137,5720,5675,-45,-538,-583,-0.00786713286713287,-0.0948017621145374,-0.101923076923077
"170","2021","인천","서구","초등학교",2021-04-01,"여자",2488,2747,2738,-9,-250,-259,-0.00327630141973062,-0.0913075237399562,-0.0942846741900255
"171","2021","인천","서구","초등학교",2021-04-01,"남자",2649,2973,2937,-36,-288,-324,-0.012108980827447,-0.0980592441266599,-0.108980827447023
"172","2021","인천","강화군","초등학교",2021-04-01,"전체",340,329,338,9,2,11,0.027355623100304,0.00591715976331361,0.033434650455927
"173","2021","인천","강화군","초등학교",2021-04-01,"여자",158,171,174,3,-16,-13,0.0175438596491228,-0.0919540229885057,-0.0760233918128655
"174","2021","인천","강화군","초등학교",2021-04-01,"남자",182,158,164,6,18,24,0.0379746835443038,0.109756097560976,0.151898734177215
"175","2021","인천","옹진군","초등학교",2021-04-01,"전체",76,103,92,-11,-16,-27,-0.106796116504854,-0.173913043478261,-0.262135922330097
"176","2021","인천","옹진군","초등학교",2021-04-01,"여자",38,62,51,-11,-13,-24,-0.17741935483871,-0.254901960784314,-0.387096774193548
"177","2021","인천","옹진군","초등학교",2021-04-01,"남자",38,41,41,0,-3,-3,0,-0.0731707317073171,-0.0731707317073171
"178","2021","광주","동구","초등학교",2021-04-01,"전체",624,705,778,73,-154,-81,0.10354609929078,-0.197943444730077,-0.114893617021277
"179","2021","광주","동구","초등학교",2021-04-01,"여자",288,322,359,37,-71,-34,0.114906832298137,-0.197771587743733,-0.105590062111801
"180","2021","광주","동구","초등학교",2021-04-01,"남자",336,383,419,36,-83,-47,0.0939947780678851,-0.198090692124105,-0.122715404699739
"181","2021","광주","서구","초등학교",2021-04-01,"전체",2372,2396,2399,3,-27,-24,0.00125208681135225,-0.0112546894539391,-0.010016694490818
"182","2021","광주","서구","초등학교",2021-04-01,"여자",1145,1183,1177,-6,-32,-38,-0.00507185122569738,-0.0271877655055225,-0.0321217244294167
"183","2021","광주","서구","초등학교",2021-04-01,"남자",1227,1213,1222,9,5,14,0.00741962077493817,0.00409165302782324,0.0115416323165705
"184","2021","광주","남구","초등학교",2021-04-01,"전체",2243,1919,2012,93,231,324,0.0484627410109432,0.114811133200795,0.168837936425221
"185","2021","광주","남구","초등학교",2021-04-01,"여자",1128,915,960,45,168,213,0.0491803278688525,0.175,0.232786885245902
"186","2021","광주","남구","초등학교",2021-04-01,"남자",1115,1004,1052,48,63,111,0.047808764940239,0.0598859315589354,0.110557768924303
"187","2021","광주","북구","초등학교",2021-04-01,"전체",3694,3739,3684,-55,10,-45,-0.0147098154586788,0.00271444082519001,-0.0120353035571008
"188","2021","광주","북구","초등학교",2021-04-01,"여자",1819,1839,1797,-42,22,-20,-0.0228384991843393,0.0122426265998887,-0.0108754758020663
"189","2021","광주","북구","초등학교",2021-04-01,"남자",1875,1900,1887,-13,-12,-25,-0.0068421052631579,-0.00635930047694754,-0.0131578947368421
"190","2021","광주","광산구","초등학교",2021-04-01,"전체",4412,4563,4599,36,-187,-151,0.00788954635108481,-0.040661013263753,-0.0330922638614946
"191","2021","광주","광산구","초등학교",2021-04-01,"여자",2128,2200,2228,28,-100,-72,0.0127272727272727,-0.0448833034111311,-0.0327272727272727
"192","2021","광주","광산구","초등학교",2021-04-01,"남자",2284,2363,2371,8,-87,-79,0.00338552687261955,-0.0366933783213834,-0.0334320778671181
"193","2021","대전","동구","초등학교",2021-04-01,"전체",1659,1783,1717,-66,-58,-124,-0.037016264722378,-0.0337798485730926,-0.0695457094784072
"194","2021","대전","동구","초등학교",2021-04-01,"여자",777,846,814,-32,-37,-69,-0.0378250591016548,-0.0454545454545455,-0.0815602836879433
"195","2021","대전","동구","초등학교",2021-04-01,"남자",882,937,903,-34,-21,-55,-0.0362860192102455,-0.0232558139534884,-0.0586979722518677
"196","2021","대전","중구","초등학교",2021-04-01,"전체",1654,1789,1715,-74,-61,-135,-0.0413638904415875,-0.0355685131195335,-0.0754611514812745
"197","2021","대전","중구","초등학교",2021-04-01,"여자",834,867,831,-36,3,-33,-0.041522491349481,0.0036101083032491,-0.0380622837370242
"198","2021","대전","중구","초등학교",2021-04-01,"남자",820,922,884,-38,-64,-102,-0.0412147505422994,-0.0723981900452489,-0.110629067245119
"199","2021","대전","서구","초등학교",2021-04-01,"전체",4014,4260,4309,49,-295,-246,0.0115023474178404,-0.0684613599443026,-0.0577464788732394
"200","2021","대전","서구","초등학교",2021-04-01,"여자",1935,2082,2087,5,-152,-147,0.00240153698366955,-0.0728318160038332,-0.0706051873198847
"201","2021","대전","서구","초등학교",2021-04-01,"남자",2079,2178,2222,44,-143,-99,0.0202020202020202,-0.0643564356435644,-0.0454545454545455
"202","2021","대전","유성구","초등학교",2021-04-01,"전체",3774,4027,3970,-57,-196,-253,-0.0141544574124659,-0.0493702770780856,-0.0628259250062081
"203","2021","대전","유성구","초등학교",2021-04-01,"여자",1811,1928,1921,-7,-110,-117,-0.00363070539419087,-0.0572618427902134,-0.0606846473029046
"204","2021","대전","유성구","초등학교",2021-04-01,"남자",1963,2099,2049,-50,-86,-136,-0.0238208670795617,-0.0419716935090288,-0.0647927584564078
"205","2021","대전","대덕구","초등학교",2021-04-01,"전체",1211,1261,1202,-59,9,-50,-0.0467882632831086,0.00748752079866889,-0.0396510705789056
"206","2021","대전","대덕구","초등학교",2021-04-01,"여자",559,588,552,-36,7,-29,-0.0612244897959184,0.0126811594202899,-0.0493197278911565
"207","2021","대전","대덕구","초등학교",2021-04-01,"남자",652,673,650,-23,2,-21,-0.0341753343239227,0.00307692307692308,-0.0312035661218425
"208","2021","울산","중구","초등학교",2021-04-01,"전체",1858,1965,1912,-53,-54,-107,-0.0269720101781171,-0.0282426778242678,-0.0544529262086514
"209","2021","울산","중구","초등학교",2021-04-01,"여자",917,962,937,-25,-20,-45,-0.025987525987526,-0.0213447171824973,-0.0467775467775468
"210","2021","울산","중구","초등학교",2021-04-01,"남자",941,1003,975,-28,-34,-62,-0.0279162512462612,-0.0348717948717949,-0.061814556331007
"211","2021","울산","남구","초등학교",2021-04-01,"전체",2587,2725,2708,-17,-121,-138,-0.00623853211009174,-0.0446824224519941,-0.0506422018348624
"212","2021","울산","남구","초등학교",2021-04-01,"여자",1242,1304,1302,-2,-60,-62,-0.00153374233128834,-0.0460829493087558,-0.0475460122699387
"213","2021","울산","남구","초등학교",2021-04-01,"남자",1345,1421,1406,-15,-61,-76,-0.0105559465165376,-0.0433854907539118,-0.0534834623504574
"214","2021","울산","동구","초등학교",2021-04-01,"전체",1769,1862,1793,-69,-24,-93,-0.0370569280343716,-0.0133853876185165,-0.0499462943071966
"215","2021","울산","동구","초등학교",2021-04-01,"여자",864,918,875,-43,-11,-54,-0.0468409586056645,-0.0125714285714286,-0.0588235294117647
"216","2021","울산","동구","초등학교",2021-04-01,"남자",905,944,918,-26,-13,-39,-0.0275423728813559,-0.014161220043573,-0.0413135593220339
"217","2021","울산","북구","초등학교",2021-04-01,"전체",2733,2792,2867,75,-134,-59,0.0268624641833811,-0.0467387513079874,-0.0211318051575931
"218","2021","울산","북구","초등학교",2021-04-01,"여자",1324,1373,1399,26,-75,-49,0.0189366351056082,-0.0536097212294496,-0.0356882738528769
"219","2021","울산","북구","초등학교",2021-04-01,"남자",1409,1419,1468,49,-59,-10,0.0345313601127555,-0.0401907356948229,-0.00704721634954193
"220","2021","울산","울주군","초등학교",2021-04-01,"전체",2026,2012,2011,-1,15,14,-0.000497017892644135,0.00745897563401293,0.00695825049701789
"221","2021","울산","울주군","초등학교",2021-04-01,"여자",962,936,934,-2,28,26,-0.00213675213675214,0.0299785867237687,0.0277777777777778
"222","2021","울산","울주군","초등학교",2021-04-01,"남자",1064,1076,1077,1,-13,-12,0.000929368029739777,-0.0120705663881151,-0.0111524163568773
"223","2021","세종","세종시","초등학교",2021-04-01,"전체",5088,4639,5040,401,48,449,0.0864410433283035,0.00952380952380952,0.0967881008838112
"224","2021","세종","세종시","초등학교",2021-04-01,"전체",5088,4639,5040,401,48,449,0.0864410433283035,0.00952380952380952,0.0967881008838112
"225","2021","세종","세종시","초등학교",2021-04-01,"전체",5088,4639,5040,401,48,449,0.0864410433283035,0.00952380952380952,0.0967881008838112
"226","2021","세종","세종시","초등학교",2021-04-01,"전체",5088,4639,5040,401,48,449,0.0864410433283035,0.00952380952380952,0.0967881008838112
"227","2021","세종","세종시","초등학교",2021-04-01,"여자",2447,2252,2428,176,19,195,0.0781527531083481,0.00782537067545305,0.0865896980461812
"228","2021","세종","세종시","초등학교",2021-04-01,"여자",2447,2252,2428,176,19,195,0.0781527531083481,0.00782537067545305,0.0865896980461812
"229","2021","세종","세종시","초등학교",2021-04-01,"여자",2447,2252,2428,176,19,195,0.0781527531083481,0.00782537067545305,0.0865896980461812
"230","2021","세종","세종시","초등학교",2021-04-01,"여자",2447,2252,2428,176,19,195,0.0781527531083481,0.00782537067545305,0.0865896980461812
"231","2021","세종","세종시","초등학교",2021-04-01,"남자",2641,2387,2612,225,29,254,0.0942605781315459,0.0111026033690658,0.106409719312945
"232","2021","세종","세종시","초등학교",2021-04-01,"남자",2641,2387,2612,225,29,254,0.0942605781315459,0.0111026033690658,0.106409719312945
"233","2021","세종","세종시","초등학교",2021-04-01,"남자",2641,2387,2612,225,29,254,0.0942605781315459,0.0111026033690658,0.106409719312945
"234","2021","세종","세종시","초등학교",2021-04-01,"남자",2641,2387,2612,225,29,254,0.0942605781315459,0.0111026033690658,0.106409719312945
"235","2021","경기","수원시","초등학교",2021-04-01,"전체",10618,11351,11169,-182,-551,-733,-0.0160338296185358,-0.0493329751992121,-0.0645758082988283
"236","2021","경기","수원시","초등학교",2021-04-01,"여자",5126,5472,5396,-76,-270,-346,-0.0138888888888889,-0.0500370644922165,-0.0632309941520468
"237","2021","경기","수원시","초등학교",2021-04-01,"남자",5492,5879,5773,-106,-281,-387,-0.0180302772580371,-0.0486748657543738,-0.0658275216873618
"238","2021","경기","성남시","초등학교",2021-04-01,"전체",7180,7673,7688,15,-508,-493,0.00195490681610843,-0.0660770031217482,-0.0642512706894305
"239","2021","경기","성남시","초등학교",2021-04-01,"여자",3539,3844,3837,-7,-298,-305,-0.0018210197710718,-0.0776648423247329,-0.0793444328824141
"240","2021","경기","성남시","초등학교",2021-04-01,"남자",3641,3829,3851,22,-210,-188,0.00574562548968399,-0.0545312905738769,-0.0490989814572996
"241","2021","경기","부천시","초등학교",2021-04-01,"전체",6281,6812,6567,-245,-286,-531,-0.0359659424544921,-0.0435510887772194,-0.0779506752789196
"242","2021","경기","부천시","초등학교",2021-04-01,"여자",3088,3312,3206,-106,-118,-224,-0.0320048309178744,-0.0368059887710543,-0.0676328502415459
"243","2021","경기","부천시","초등학교",2021-04-01,"남자",3193,3500,3361,-139,-168,-307,-0.0397142857142857,-0.0499851234751562,-0.0877142857142857
"244","2021","경기","안양시","초등학교",2021-04-01,"전체",4229,4469,4342,-127,-113,-240,-0.0284179906019244,-0.0260248733302626,-0.0537032893264712
"245","2021","경기","안양시","초등학교",2021-04-01,"여자",2066,2232,2160,-72,-94,-166,-0.032258064516129,-0.0435185185185185,-0.0743727598566308
"246","2021","경기","안양시","초등학교",2021-04-01,"남자",2163,2237,2182,-55,-19,-74,-0.0245864997764864,-0.00870760769935839,-0.0330800178810907
"247","2021","경기","과천시","초등학교",2021-04-01,"전체",647,434,480,46,167,213,0.105990783410138,0.347916666666667,0.490783410138249
"248","2021","경기","과천시","초등학교",2021-04-01,"여자",315,213,234,21,81,102,0.0985915492957746,0.346153846153846,0.47887323943662
"249","2021","경기","과천시","초등학교",2021-04-01,"남자",332,221,246,25,86,111,0.113122171945701,0.349593495934959,0.502262443438914
"250","2021","경기","안산시","초등학교",2021-04-01,"전체",5078,4993,4897,-96,181,85,-0.0192269176847587,0.0369614049418011,0.0170238333667134
"251","2021","경기","안산시","초등학교",2021-04-01,"여자",2507,2522,2460,-62,47,-15,-0.0245836637589215,0.0191056910569106,-0.00594766058683584
"252","2021","경기","안산시","초등학교",2021-04-01,"남자",2571,2471,2437,-34,134,100,-0.0137596114933225,0.0549856380796061,0.0404694455685957
"253","2021","경기","용인시","초등학교",2021-04-01,"전체",11033,11102,11410,308,-377,-69,0.0277427490542245,-0.0330411919368975,-0.00621509637903081
"254","2021","경기","용인시","초등학교",2021-04-01,"여자",5432,5341,5487,146,-55,91,0.0273357049241715,-0.0100236923637689,0.0170380078636959
"255","2021","경기","용인시","초등학교",2021-04-01,"남자",5601,5761,5923,162,-322,-160,0.0281201180350634,-0.0543643423940571,-0.0277729560840132
"256","2021","경기","군포시","초등학교",2021-04-01,"전체",2187,2379,2304,-75,-117,-192,-0.0315258511979823,-0.05078125,-0.0807061790668348
"257","2021","경기","군포시","초등학교",2021-04-01,"여자",1056,1168,1115,-53,-59,-112,-0.0453767123287671,-0.052914798206278,-0.0958904109589041
"258","2021","경기","군포시","초등학교",2021-04-01,"남자",1131,1211,1189,-22,-58,-80,-0.0181668042939719,-0.0487804878048781,-0.0660611065235343
"259","2021","경기","의왕시","초등학교",2021-04-01,"전체",1240,1387,1501,114,-261,-147,0.0821917808219178,-0.173884077281812,-0.105984138428262
"260","2021","경기","의왕시","초등학교",2021-04-01,"여자",582,667,714,47,-132,-85,0.0704647676161919,-0.184873949579832,-0.12743628185907
"261","2021","경기","의왕시","초등학교",2021-04-01,"남자",658,720,787,67,-129,-62,0.0930555555555556,-0.163913595933926,-0.0861111111111111
"262","2021","경기","시흥시","초등학교",2021-04-01,"전체",5478,4901,5166,265,312,577,0.0540705978371761,0.0603948896631823,0.117731075290757
"263","2021","경기","시흥시","초등학교",2021-04-01,"여자",2700,2363,2500,137,200,337,0.0579771476936098,0.08,0.142615319509099
"264","2021","경기","시흥시","초등학교",2021-04-01,"남자",2778,2538,2666,128,112,240,0.0504334121355398,0.0420105026256564,0.0945626477541371
"265","2021","경기","평택시","초등학교",2021-04-01,"전체",5362,4974,5189,215,173,388,0.0432247687977483,0.0333397571786471,0.0780056292722155
"266","2021","경기","평택시","초등학교",2021-04-01,"여자",2615,2443,2527,84,88,172,0.0343839541547278,0.0348239018599129,0.0704052394596807
"267","2021","경기","평택시","초등학교",2021-04-01,"남자",2747,2531,2662,131,85,216,0.0517581983405768,0.0319308790383171,0.0853417621493481
"268","2021","경기","화성시","초등학교",2021-04-01,"전체",11404,11009,11573,564,-169,395,0.0512308111545099,-0.0146029551542383,0.0358797347624671
"269","2021","경기","화성시","초등학교",2021-04-01,"여자",5690,5373,5686,313,4,317,0.0582542341336311,0.000703482237073514,0.058998697189652
"270","2021","경기","화성시","초등학교",2021-04-01,"남자",5714,5636,5887,251,-173,78,0.0445351312987935,-0.0293867844402922,0.0138396025550035
"271","2021","경기","오산시","초등학교",2021-04-01,"전체",2681,2682,2725,43,-44,-1,0.0160328113348248,-0.0161467889908257,-0.000372856077554064
"272","2021","경기","오산시","초등학교",2021-04-01,"여자",1352,1317,1350,33,2,35,0.0250569476082005,0.00148148148148148,0.0265755504935459
"273","2021","경기","오산시","초등학교",2021-04-01,"남자",1329,1365,1375,10,-46,-36,0.00732600732600733,-0.0334545454545455,-0.0263736263736264
"274","2021","경기","광명시","초등학교",2021-04-01,"전체",2528,2787,2748,-39,-220,-259,-0.0139935414424112,-0.0800582241630277,-0.0929314675278077
"275","2021","경기","광명시","초등학교",2021-04-01,"여자",1244,1362,1344,-18,-100,-118,-0.013215859030837,-0.0744047619047619,-0.0866372980910426
"276","2021","경기","광명시","초등학교",2021-04-01,"남자",1284,1425,1404,-21,-120,-141,-0.0147368421052632,-0.0854700854700855,-0.0989473684210526
"277","2021","경기","광주시","초등학교",2021-04-01,"전체",3656,3963,3945,-18,-289,-307,-0.00454201362604088,-0.0732572877059569,-0.0774665657330305
"278","2021","경기","광주시","초등학교",2021-04-01,"여자",1765,1903,1892,-11,-127,-138,-0.00578034682080925,-0.0671247357293869,-0.0725170782974251
"279","2021","경기","광주시","초등학교",2021-04-01,"남자",1891,2060,2053,-7,-162,-169,-0.00339805825242718,-0.0789089137847053,-0.0820388349514563
"280","2021","경기","하남시","초등학교",2021-04-01,"전체",3373,3193,3394,201,-21,180,0.0629502035703101,-0.00618738951090159,0.0563733166301284
"281","2021","경기","하남시","초등학교",2021-04-01,"여자",1655,1607,1705,98,-50,48,0.0609831985065339,-0.0293255131964809,0.029869321717486
"282","2021","경기","하남시","초등학교",2021-04-01,"남자",1718,1586,1689,103,29,132,0.0649432534678436,0.0171699230313795,0.0832282471626734
"283","2021","경기","김포시","초등학교",2021-04-01,"전체",6216,5716,5883,167,333,500,0.0292162351294612,0.0566037735849057,0.0874737578726382
"284","2021","경기","김포시","초등학교",2021-04-01,"여자",3086,2763,2850,87,236,323,0.0314875135722041,0.0828070175438596,0.11690191820485
"285","2021","경기","김포시","초등학교",2021-04-01,"남자",3130,2953,3033,80,97,177,0.0270910938029123,0.031981536432575,0.0599390450389434
"286","2021","경기","이천시","초등학교",2021-04-01,"전체",2037,2226,2181,-45,-144,-189,-0.0202156334231806,-0.0660247592847318,-0.0849056603773585
"287","2021","경기","이천시","초등학교",2021-04-01,"여자",945,1065,1051,-14,-106,-120,-0.0131455399061033,-0.100856327307326,-0.112676056338028
"288","2021","경기","이천시","초등학교",2021-04-01,"남자",1092,1161,1130,-31,-38,-69,-0.0267011197243755,-0.0336283185840708,-0.0594315245478036
"289","2021","경기","안성시","초등학교",2021-04-01,"전체",1547,1572,1560,-12,-13,-25,-0.00763358778625954,-0.00833333333333333,-0.0159033078880407
"290","2021","경기","안성시","초등학교",2021-04-01,"여자",768,757,747,-10,21,11,-0.0132100396301189,0.0281124497991968,0.0145310435931308
"291","2021","경기","안성시","초등학교",2021-04-01,"남자",779,815,813,-2,-34,-36,-0.00245398773006135,-0.041820418204182,-0.0441717791411043
"292","2021","경기","여주시","초등학교",2021-04-01,"전체",766,801,807,6,-41,-35,0.00749063670411985,-0.0508054522924411,-0.0436953807740325
"293","2021","경기","여주시","초등학교",2021-04-01,"여자",370,367,368,1,2,3,0.00272479564032698,0.00543478260869565,0.00817438692098093
"294","2021","경기","여주시","초등학교",2021-04-01,"남자",396,434,439,5,-43,-38,0.0115207373271889,-0.0979498861047836,-0.0875576036866359
"295","2021","경기","양평군","초등학교",2021-04-01,"전체",783,781,797,16,-14,2,0.0204865556978233,-0.0175658720200753,0.00256081946222791
"296","2021","경기","양평군","초등학교",2021-04-01,"여자",364,378,384,6,-20,-14,0.0158730158730159,-0.0520833333333333,-0.037037037037037
"297","2021","경기","양평군","초등학교",2021-04-01,"남자",419,403,413,10,6,16,0.0248138957816377,0.0145278450363196,0.0397022332506203
"298","2021","경기","고양시","초등학교",2021-04-01,"전체",8568,8709,9111,402,-543,-141,0.0461591457113331,-0.0595982877839974,-0.0161901481226318
"299","2021","경기","고양시","초등학교",2021-04-01,"여자",4163,4240,4431,191,-268,-77,0.0450471698113208,-0.0604829609568946,-0.0181603773584906
"300","2021","경기","고양시","초등학교",2021-04-01,"남자",4405,4469,4680,211,-275,-64,0.0472141418661893,-0.0587606837606838,-0.0143208771537257
"301","2021","경기","남양주시","초등학교",2021-04-01,"전체",7088,7010,7297,287,-209,78,0.0409415121255349,-0.0286419076332739,0.0111269614835949
"302","2021","경기","남양주시","초등학교",2021-04-01,"여자",3469,3358,3515,157,-46,111,0.0467540202501489,-0.0130867709815078,0.0330553901131626
"303","2021","경기","남양주시","초등학교",2021-04-01,"남자",3619,3652,3782,130,-163,-33,0.0355969331872946,-0.0430988894764675,-0.00903614457831325
"304","2021","경기","구리시","초등학교",2021-04-01,"전체",1556,1858,1797,-61,-241,-302,-0.0328310010764263,-0.134112409571508,-0.16254036598493
"305","2021","경기","구리시","초등학교",2021-04-01,"여자",742,917,876,-41,-134,-175,-0.044711014176663,-0.15296803652968,-0.190839694656489
"306","2021","경기","구리시","초등학교",2021-04-01,"남자",814,941,921,-20,-107,-127,-0.0212539851222104,-0.116178067318132,-0.134962805526036
"307","2021","경기","의정부시","초등학교",2021-04-01,"전체",3562,3746,3757,11,-195,-184,0.00293646556326749,-0.0519031141868512,-0.0491190603310198
"308","2021","경기","의정부시","초등학교",2021-04-01,"여자",1742,1842,1849,7,-107,-100,0.00380021715526602,-0.0578691184424013,-0.0542888165038002
"309","2021","경기","의정부시","초등학교",2021-04-01,"남자",1820,1904,1908,4,-88,-84,0.00210084033613445,-0.0461215932914046,-0.0441176470588235
"310","2021","경기","파주시","초등학교",2021-04-01,"전체",4954,5030,4998,-32,-44,-76,-0.00636182902584493,-0.00880352140856343,-0.0151093439363817
"311","2021","경기","파주시","초등학교",2021-04-01,"여자",2436,2479,2477,-2,-41,-43,-0.000806776926179911,-0.0165522809850626,-0.0173457039128681
"312","2021","경기","파주시","초등학교",2021-04-01,"남자",2518,2551,2521,-30,-3,-33,-0.0117600940807526,-0.00119000396667989,-0.0129361034888279
"313","2021","경기","동두천시","초등학교",2021-04-01,"전체",725,746,719,-27,6,-21,-0.0361930294906166,0.00834492350486787,-0.0281501340482574
"314","2021","경기","동두천시","초등학교",2021-04-01,"여자",326,340,329,-11,-3,-14,-0.0323529411764706,-0.00911854103343465,-0.0411764705882353
"315","2021","경기","동두천시","초등학교",2021-04-01,"남자",399,406,390,-16,9,-7,-0.0394088669950739,0.0230769230769231,-0.0172413793103448
"316","2021","경기","양주시","초등학교",2021-04-01,"전체",2209,1990,2062,72,147,219,0.0361809045226131,0.071290009699321,0.110050251256281
"317","2021","경기","양주시","초등학교",2021-04-01,"여자",1054,973,1006,33,48,81,0.0339157245632066,0.047713717693837,0.0832476875642343
"318","2021","경기","양주시","초등학교",2021-04-01,"남자",1155,1017,1056,39,99,138,0.0383480825958702,0.09375,0.135693215339233
"319","2021","경기","포천시","초등학교",2021-04-01,"전체",887,1007,976,-31,-89,-120,-0.0307845084409136,-0.0911885245901639,-0.119165839126117
"320","2021","경기","포천시","초등학교",2021-04-01,"여자",449,506,494,-12,-45,-57,-0.0237154150197628,-0.0910931174089069,-0.112648221343874
"321","2021","경기","포천시","초등학교",2021-04-01,"남자",438,501,482,-19,-44,-63,-0.0379241516966068,-0.0912863070539419,-0.125748502994012
"322","2021","경기","가평군","초등학교",2021-04-01,"전체",330,361,343,-18,-13,-31,-0.0498614958448753,-0.0379008746355685,-0.0858725761772853
"323","2021","경기","가평군","초등학교",2021-04-01,"여자",149,170,167,-3,-18,-21,-0.0176470588235294,-0.107784431137725,-0.123529411764706
"324","2021","경기","가평군","초등학교",2021-04-01,"남자",181,191,176,-15,5,-10,-0.0785340314136126,0.0284090909090909,-0.0523560209424084
"325","2021","경기","연천군","초등학교",2021-04-01,"전체",264,303,294,-9,-30,-39,-0.0297029702970297,-0.102040816326531,-0.128712871287129
"326","2021","경기","연천군","초등학교",2021-04-01,"여자",136,159,142,-17,-6,-23,-0.106918238993711,-0.0422535211267606,-0.144654088050314
"327","2021","경기","연천군","초등학교",2021-04-01,"남자",128,144,152,8,-24,-16,0.0555555555555556,-0.157894736842105,-0.111111111111111
"328","2021","강원","춘천시","초등학교",2021-04-01,"전체",2319,2268,2335,67,-16,51,0.0295414462081129,-0.00685224839400428,0.0224867724867725
"329","2021","강원","춘천시","초등학교",2021-04-01,"여자",1117,1123,1148,25,-31,-6,0.0222617987533393,-0.0270034843205575,-0.00534283170080142
"330","2021","강원","춘천시","초등학교",2021-04-01,"남자",1202,1145,1187,42,15,57,0.0366812227074236,0.012636899747262,0.0497816593886463
"331","2021","강원","원주시","초등학교",2021-04-01,"전체",2924,2905,2981,76,-57,19,0.0261617900172117,-0.0191211003019121,0.00654044750430293
"332","2021","강원","원주시","초등학교",2021-04-01,"여자",1441,1433,1462,29,-21,8,0.0202372644801117,-0.0143638850889193,0.00558269364968597
"333","2021","강원","원주시","초등학교",2021-04-01,"남자",1483,1472,1519,47,-36,11,0.031929347826087,-0.0236998025016458,0.00747282608695652
"334","2021","강원","강릉시","초등학교",2021-04-01,"전체",1383,1410,1438,28,-55,-27,0.0198581560283688,-0.0382475660639777,-0.0191489361702128
"335","2021","강원","강릉시","초등학교",2021-04-01,"여자",682,722,737,15,-55,-40,0.0207756232686981,-0.0746268656716418,-0.0554016620498615
"336","2021","강원","강릉시","초등학교",2021-04-01,"남자",701,688,701,13,0,13,0.0188953488372093,0,0.0188953488372093
"337","2021","강원","동해시","초등학교",2021-04-01,"전체",747,695,703,8,44,52,0.0115107913669065,0.0625889046941678,0.0748201438848921
"338","2021","강원","동해시","초등학교",2021-04-01,"여자",364,313,319,6,45,51,0.0191693290734824,0.141065830721003,0.162939297124601
"339","2021","강원","동해시","초등학교",2021-04-01,"남자",383,382,384,2,-1,1,0.00523560209424084,-0.00260416666666667,0.00261780104712042
"340","2021","강원","태백시","초등학교",2021-04-01,"전체",290,296,295,-1,-5,-6,-0.00337837837837838,-0.0169491525423729,-0.0202702702702703
"341","2021","강원","태백시","초등학교",2021-04-01,"여자",137,152,149,-3,-12,-15,-0.0197368421052632,-0.0805369127516778,-0.0986842105263158
"342","2021","강원","태백시","초등학교",2021-04-01,"남자",153,144,146,2,7,9,0.0138888888888889,0.0479452054794521,0.0625
"343","2021","강원","속초시","초등학교",2021-04-01,"전체",627,674,696,22,-69,-47,0.0326409495548961,-0.0991379310344828,-0.0697329376854599
"344","2021","강원","속초시","초등학교",2021-04-01,"여자",306,333,335,2,-29,-27,0.00600600600600601,-0.0865671641791045,-0.0810810810810811
"345","2021","강원","속초시","초등학교",2021-04-01,"남자",321,341,361,20,-40,-20,0.0586510263929619,-0.110803324099723,-0.0586510263929619
"346","2021","강원","삼척시","초등학교",2021-04-01,"전체",382,423,409,-14,-27,-41,-0.033096926713948,-0.0660146699266504,-0.0969267139479905
"347","2021","강원","삼척시","초등학교",2021-04-01,"여자",182,211,200,-11,-18,-29,-0.0521327014218009,-0.09,-0.137440758293839
"348","2021","강원","삼척시","초등학교",2021-04-01,"남자",200,212,209,-3,-9,-12,-0.0141509433962264,-0.0430622009569378,-0.0566037735849057
"349","2021","강원","홍천군","초등학교",2021-04-01,"전체",332,392,374,-18,-42,-60,-0.0459183673469388,-0.112299465240642,-0.153061224489796
"350","2021","강원","홍천군","초등학교",2021-04-01,"여자",178,189,177,-12,1,-11,-0.0634920634920635,0.00564971751412429,-0.0582010582010582
"351","2021","강원","홍천군","초등학교",2021-04-01,"남자",154,203,197,-6,-43,-49,-0.0295566502463054,-0.218274111675127,-0.241379310344828
"352","2021","강원","횡성군","초등학교",2021-04-01,"전체",226,251,243,-8,-17,-25,-0.0318725099601594,-0.0699588477366255,-0.099601593625498
"353","2021","강원","횡성군","초등학교",2021-04-01,"여자",112,136,130,-6,-18,-24,-0.0441176470588235,-0.138461538461538,-0.176470588235294
"354","2021","강원","횡성군","초등학교",2021-04-01,"남자",114,115,113,-2,1,-1,-0.0173913043478261,0.00884955752212389,-0.00869565217391304
"355","2021","강원","영월군","초등학교",2021-04-01,"전체",179,197,189,-8,-10,-18,-0.0406091370558376,-0.0529100529100529,-0.0913705583756345
"356","2021","강원","영월군","초등학교",2021-04-01,"여자",77,91,88,-3,-11,-14,-0.032967032967033,-0.125,-0.153846153846154
"357","2021","강원","영월군","초등학교",2021-04-01,"남자",102,106,101,-5,1,-4,-0.0471698113207547,0.0099009900990099,-0.0377358490566038
"358","2021","강원","평창군","초등학교",2021-04-01,"전체",178,203,204,1,-26,-25,0.00492610837438424,-0.127450980392157,-0.123152709359606
"359","2021","강원","평창군","초등학교",2021-04-01,"여자",101,116,117,1,-16,-15,0.00862068965517241,-0.136752136752137,-0.129310344827586
"360","2021","강원","평창군","초등학교",2021-04-01,"남자",77,87,87,0,-10,-10,0,-0.114942528735632,-0.114942528735632
"361","2021","강원","정선군","초등학교",2021-04-01,"전체",211,190,189,-1,22,21,-0.00526315789473684,0.116402116402116,0.110526315789474
"362","2021","강원","정선군","초등학교",2021-04-01,"여자",105,91,93,2,12,14,0.021978021978022,0.129032258064516,0.153846153846154
"363","2021","강원","정선군","초등학교",2021-04-01,"남자",106,99,96,-3,10,7,-0.0303030303030303,0.104166666666667,0.0707070707070707
"364","2021","강원","철원군","초등학교",2021-04-01,"전체",352,360,354,-6,-2,-8,-0.0166666666666667,-0.00564971751412429,-0.0222222222222222
"365","2021","강원","철원군","초등학교",2021-04-01,"여자",169,172,172,0,-3,-3,0,-0.0174418604651163,-0.0174418604651163
"366","2021","강원","철원군","초등학교",2021-04-01,"남자",183,188,182,-6,1,-5,-0.0319148936170213,0.00549450549450549,-0.0265957446808511
"367","2021","강원","화천군","초등학교",2021-04-01,"전체",176,213,211,-2,-35,-37,-0.00938967136150235,-0.165876777251185,-0.173708920187793
"368","2021","강원","화천군","초등학교",2021-04-01,"여자",73,100,100,0,-27,-27,0,-0.27,-0.27
"369","2021","강원","화천군","초등학교",2021-04-01,"남자",103,113,111,-2,-8,-10,-0.0176991150442478,-0.0720720720720721,-0.0884955752212389
"370","2021","강원","양구군","초등학교",2021-04-01,"전체",155,192,180,-12,-25,-37,-0.0625,-0.138888888888889,-0.192708333333333
"371","2021","강원","양구군","초등학교",2021-04-01,"여자",69,102,97,-5,-28,-33,-0.0490196078431373,-0.288659793814433,-0.323529411764706
"372","2021","강원","양구군","초등학교",2021-04-01,"남자",86,90,83,-7,3,-4,-0.0777777777777778,0.036144578313253,-0.0444444444444444
"373","2021","강원","인제군","초등학교",2021-04-01,"전체",220,254,244,-10,-24,-34,-0.0393700787401575,-0.0983606557377049,-0.133858267716535
"374","2021","강원","인제군","초등학교",2021-04-01,"여자",109,119,116,-3,-7,-10,-0.0252100840336134,-0.0603448275862069,-0.0840336134453782
"375","2021","강원","인제군","초등학교",2021-04-01,"남자",111,135,128,-7,-17,-24,-0.0518518518518519,-0.1328125,-0.177777777777778
"376","2021","강원","고성군","초등학교",2021-04-01,"전체",167,136,122,-14,45,31,-0.102941176470588,0.368852459016393,0.227941176470588
"377","2021","강원","고성군","초등학교",2021-04-01,"여자",80,67,61,-6,19,13,-0.0895522388059701,0.311475409836066,0.194029850746269
"378","2021","강원","고성군","초등학교",2021-04-01,"남자",87,69,61,-8,26,18,-0.115942028985507,0.426229508196721,0.260869565217391
"379","2021","강원","양양군","초등학교",2021-04-01,"전체",142,153,163,10,-21,-11,0.065359477124183,-0.128834355828221,-0.0718954248366013
"380","2021","강원","양양군","초등학교",2021-04-01,"여자",74,71,81,10,-7,3,0.140845070422535,-0.0864197530864197,0.0422535211267606
"381","2021","강원","양양군","초등학교",2021-04-01,"남자",68,82,82,0,-14,-14,0,-0.170731707317073,-0.170731707317073
"382","2021","충북","청주시","초등학교",2021-04-01,"전체",7889,8030,8031,1,-142,-141,0.00012453300124533,-0.0176814842485369,-0.0175591531755915
"383","2021","충북","청주시","초등학교",2021-04-01,"여자",3919,4019,4034,15,-115,-100,0.00373227170938044,-0.0285076846802181,-0.0248818113958696
"384","2021","충북","청주시","초등학교",2021-04-01,"남자",3970,4011,3997,-14,-27,-41,-0.00349040139616056,-0.00675506629972479,-0.0102218898030416
"385","2021","충북","충주시","초등학교",2021-04-01,"전체",1525,1537,1543,6,-18,-12,0.00390370852309694,-0.0116655865197667,-0.00780741704619388
"386","2021","충북","충주시","초등학교",2021-04-01,"여자",781,777,785,8,-4,4,0.0102960102960103,-0.00509554140127389,0.00514800514800515
"387","2021","충북","충주시","초등학교",2021-04-01,"남자",744,760,758,-2,-14,-16,-0.00263157894736842,-0.0184696569920844,-0.0210526315789474
"388","2021","충북","제천시","초등학교",2021-04-01,"전체",952,973,969,-4,-17,-21,-0.00411099691675231,-0.0175438596491228,-0.0215827338129496
"389","2021","충북","제천시","초등학교",2021-04-01,"여자",483,479,472,-7,11,4,-0.0146137787056367,0.0233050847457627,0.00835073068893528
"390","2021","충북","제천시","초등학교",2021-04-01,"남자",469,494,497,3,-28,-25,0.00607287449392713,-0.0563380281690141,-0.0506072874493927
"391","2021","충북","보은군","초등학교",2021-04-01,"전체",148,154,146,-8,2,-6,-0.051948051948052,0.0136986301369863,-0.038961038961039
"392","2021","충북","보은군","초등학교",2021-04-01,"여자",70,72,67,-5,3,-2,-0.0694444444444444,0.0447761194029851,-0.0277777777777778
"393","2021","충북","보은군","초등학교",2021-04-01,"남자",78,82,79,-3,-1,-4,-0.0365853658536585,-0.0126582278481013,-0.0487804878048781
"394","2021","충북","옥천군","초등학교",2021-04-01,"전체",298,291,287,-4,11,7,-0.013745704467354,0.0383275261324042,0.0240549828178694
"395","2021","충북","옥천군","초등학교",2021-04-01,"여자",152,138,137,-1,15,14,-0.0072463768115942,0.109489051094891,0.101449275362319
"396","2021","충북","옥천군","초등학교",2021-04-01,"남자",146,153,150,-3,-4,-7,-0.0196078431372549,-0.0266666666666667,-0.0457516339869281
"397","2021","충북","영동군","초등학교",2021-04-01,"전체",227,230,233,3,-6,-3,0.0130434782608696,-0.0257510729613734,-0.0130434782608696
"398","2021","충북","영동군","초등학교",2021-04-01,"여자",120,115,120,5,0,5,0.0434782608695652,0,0.0434782608695652
"399","2021","충북","영동군","초등학교",2021-04-01,"남자",107,115,113,-2,-6,-8,-0.0173913043478261,-0.0530973451327434,-0.0695652173913043
"400","2021","충북","진천군","초등학교",2021-04-01,"전체",866,813,825,12,41,53,0.014760147601476,0.0496969696969697,0.0651906519065191
"401","2021","충북","진천군","초등학교",2021-04-01,"여자",412,392,401,9,11,20,0.0229591836734694,0.027431421446384,0.0510204081632653
"402","2021","충북","진천군","초등학교",2021-04-01,"남자",454,421,424,3,30,33,0.00712589073634204,0.0707547169811321,0.0783847980997625
"403","2021","충북","괴산군","초등학교",2021-04-01,"전체",166,134,143,9,23,32,0.0671641791044776,0.160839160839161,0.238805970149254
"404","2021","충북","괴산군","초등학교",2021-04-01,"여자",79,63,65,2,14,16,0.0317460317460317,0.215384615384615,0.253968253968254
"405","2021","충북","괴산군","초등학교",2021-04-01,"남자",87,71,78,7,9,16,0.0985915492957746,0.115384615384615,0.225352112676056
"406","2021","충북","음성군","초등학교",2021-04-01,"전체",633,694,673,-21,-40,-61,-0.0302593659942363,-0.0594353640416048,-0.0878962536023055
"407","2021","충북","음성군","초등학교",2021-04-01,"여자",294,342,319,-23,-25,-48,-0.0672514619883041,-0.0783699059561129,-0.140350877192982
"408","2021","충북","음성군","초등학교",2021-04-01,"남자",339,352,354,2,-15,-13,0.00568181818181818,-0.0423728813559322,-0.0369318181818182
"409","2021","충북","단양군","초등학교",2021-04-01,"전체",119,137,132,-5,-13,-18,-0.0364963503649635,-0.0984848484848485,-0.131386861313869
"410","2021","충북","단양군","초등학교",2021-04-01,"여자",52,60,59,-1,-7,-8,-0.0166666666666667,-0.11864406779661,-0.133333333333333
"411","2021","충북","단양군","초등학교",2021-04-01,"남자",67,77,73,-4,-6,-10,-0.051948051948052,-0.0821917808219178,-0.12987012987013
"412","2021","충북","증평군","초등학교",2021-04-01,"전체",331,380,369,-11,-38,-49,-0.0289473684210526,-0.102981029810298,-0.128947368421053
"413","2021","충북","증평군","초등학교",2021-04-01,"여자",186,206,201,-5,-15,-20,-0.0242718446601942,-0.0746268656716418,-0.0970873786407767
"414","2021","충북","증평군","초등학교",2021-04-01,"남자",145,174,168,-6,-23,-29,-0.0344827586206897,-0.136904761904762,-0.166666666666667
"415","2021","충남","천안시","초등학교",2021-04-01,"전체",6716,6833,6806,-27,-90,-117,-0.00395141226401288,-0.0132236262121657,-0.0171227864773891
"416","2021","충남","천안시","초등학교",2021-04-01,"여자",3287,3391,3375,-16,-88,-104,-0.00471837216160425,-0.0260740740740741,-0.0306694190504276
"417","2021","충남","천안시","초등학교",2021-04-01,"남자",3429,3442,3431,-11,-2,-13,-0.0031958163858222,-0.000582920431361119,-0.00377687391051714
"418","2021","충남","공주시","초등학교",2021-04-01,"전체",617,641,643,2,-26,-24,0.0031201248049922,-0.0404354587869362,-0.0374414976599064
"419","2021","충남","공주시","초등학교",2021-04-01,"여자",279,309,314,5,-35,-30,0.0161812297734628,-0.111464968152866,-0.0970873786407767
"420","2021","충남","공주시","초등학교",2021-04-01,"남자",338,332,329,-3,9,6,-0.00903614457831325,0.027355623100304,0.0180722891566265
"421","2021","충남","보령시","초등학교",2021-04-01,"전체",670,702,708,6,-38,-32,0.00854700854700855,-0.0536723163841808,-0.0455840455840456
"422","2021","충남","보령시","초등학교",2021-04-01,"여자",363,367,377,10,-14,-4,0.0272479564032698,-0.0371352785145889,-0.0108991825613079
"423","2021","충남","보령시","초등학교",2021-04-01,"남자",307,335,331,-4,-24,-28,-0.0119402985074627,-0.0725075528700906,-0.0835820895522388
"424","2021","충남","아산시","초등학교",2021-04-01,"전체",3511,3714,3657,-57,-146,-203,-0.0153473344103393,-0.0399234345091605,-0.0546580506192784
"425","2021","충남","아산시","초등학교",2021-04-01,"여자",1717,1825,1793,-32,-76,-108,-0.0175342465753425,-0.0423870607919688,-0.0591780821917808
"426","2021","충남","아산시","초등학교",2021-04-01,"남자",1794,1889,1864,-25,-70,-95,-0.0132345156167284,-0.0375536480686695,-0.050291159343568
"427","2021","충남","서산시","초등학교",2021-04-01,"전체",1721,1714,1710,-4,11,7,-0.00233372228704784,0.0064327485380117,0.00408401400233372
"428","2021","충남","서산시","초등학교",2021-04-01,"여자",825,836,834,-2,-9,-11,-0.00239234449760766,-0.0107913669064748,-0.0131578947368421
"429","2021","충남","서산시","초등학교",2021-04-01,"남자",896,878,876,-2,20,18,-0.00227790432801822,0.0228310502283105,0.020501138952164
"430","2021","충남","논산시","초등학교",2021-04-01,"전체",845,834,825,-9,20,11,-0.0107913669064748,0.0242424242424242,0.013189448441247
"431","2021","충남","논산시","초등학교",2021-04-01,"여자",425,417,412,-5,13,8,-0.0119904076738609,0.0315533980582524,0.0191846522781775
"432","2021","충남","논산시","초등학교",2021-04-01,"남자",420,417,413,-4,7,3,-0.00959232613908873,0.0169491525423729,0.00719424460431655
"433","2021","충남","계룡시","초등학교",2021-04-01,"전체",431,430,436,6,-5,1,0.013953488372093,-0.0114678899082569,0.00232558139534884
"434","2021","충남","계룡시","초등학교",2021-04-01,"여자",217,227,227,0,-10,-10,0,-0.0440528634361234,-0.0440528634361234
"435","2021","충남","계룡시","초등학교",2021-04-01,"남자",214,203,209,6,5,11,0.0295566502463054,0.0239234449760766,0.0541871921182266
"436","2021","충남","금산군","초등학교",2021-04-01,"전체",256,246,248,2,8,10,0.00813008130081301,0.032258064516129,0.040650406504065
"437","2021","충남","금산군","초등학교",2021-04-01,"여자",120,119,118,-1,2,1,-0.00840336134453781,0.0169491525423729,0.00840336134453781
"438","2021","충남","금산군","초등학교",2021-04-01,"남자",136,127,130,3,6,9,0.0236220472440945,0.0461538461538462,0.0708661417322835
"439","2021","충남","부여군","초등학교",2021-04-01,"전체",334,356,359,3,-25,-22,0.00842696629213483,-0.0696378830083565,-0.0617977528089888
"440","2021","충남","부여군","초등학교",2021-04-01,"여자",156,162,159,-3,-3,-6,-0.0185185185185185,-0.0188679245283019,-0.037037037037037
"441","2021","충남","부여군","초등학교",2021-04-01,"남자",178,194,200,6,-22,-16,0.0309278350515464,-0.11,-0.0824742268041237
"442","2021","충남","서천군","초등학교",2021-04-01,"전체",266,272,267,-5,-1,-6,-0.0183823529411765,-0.00374531835205993,-0.0220588235294118
"443","2021","충남","서천군","초등학교",2021-04-01,"여자",128,133,129,-4,-1,-5,-0.0300751879699248,-0.00775193798449612,-0.037593984962406
"444","2021","충남","서천군","초등학교",2021-04-01,"남자",138,139,138,-1,0,-1,-0.00719424460431655,0,-0.00719424460431655
"445","2021","충남","청양군","초등학교",2021-04-01,"전체",123,132,133,1,-10,-9,0.00757575757575758,-0.075187969924812,-0.0681818181818182
"446","2021","충남","청양군","초등학교",2021-04-01,"여자",67,71,74,3,-7,-4,0.0422535211267606,-0.0945945945945946,-0.0563380281690141
"447","2021","충남","청양군","초등학교",2021-04-01,"남자",56,61,59,-2,-3,-5,-0.0327868852459016,-0.0508474576271186,-0.0819672131147541
"448","2021","충남","홍성군","초등학교",2021-04-01,"전체",832,868,873,5,-41,-36,0.00576036866359447,-0.0469644902634593,-0.0414746543778802
"449","2021","충남","홍성군","초등학교",2021-04-01,"여자",392,422,422,0,-30,-30,0,-0.0710900473933649,-0.0710900473933649
"450","2021","충남","홍성군","초등학교",2021-04-01,"남자",440,446,451,5,-11,-6,0.0112107623318386,-0.024390243902439,-0.0134529147982063
"451","2021","충남","예산군","초등학교",2021-04-01,"전체",413,371,370,-1,43,42,-0.00269541778975741,0.116216216216216,0.113207547169811
"452","2021","충남","예산군","초등학교",2021-04-01,"여자",200,168,166,-2,34,32,-0.0119047619047619,0.204819277108434,0.19047619047619
"453","2021","충남","예산군","초등학교",2021-04-01,"남자",213,203,204,1,9,10,0.00492610837438424,0.0441176470588235,0.0492610837438424
"454","2021","충남","태안군","초등학교",2021-04-01,"전체",322,327,320,-7,2,-5,-0.0214067278287462,0.00625,-0.0152905198776758
"455","2021","충남","태안군","초등학교",2021-04-01,"여자",165,169,155,-14,10,-4,-0.0828402366863905,0.0645161290322581,-0.0236686390532544
"456","2021","충남","태안군","초등학교",2021-04-01,"남자",157,158,165,7,-8,-1,0.0443037974683544,-0.0484848484848485,-0.00632911392405063
"457","2021","충남","당진시","초등학교",2021-04-01,"전체",1715,1752,1737,-15,-22,-37,-0.00856164383561644,-0.0126655152561888,-0.0211187214611872
"458","2021","충남","당진시","초등학교",2021-04-01,"여자",866,868,861,-7,5,-2,-0.00806451612903226,0.00580720092915215,-0.00230414746543779
"459","2021","충남","당진시","초등학교",2021-04-01,"남자",849,884,876,-8,-27,-35,-0.00904977375565611,-0.0308219178082192,-0.0395927601809955
"460","2021","전북","전주시","초등학교",2021-04-01,"전체",6132,5889,6046,157,86,243,0.0266598743419935,0.0142242805160437,0.0412633723892002
"461","2021","전북","전주시","초등학교",2021-04-01,"여자",2984,2873,2960,87,24,111,0.0302819352593108,0.00810810810810811,0.0386355725722242
"462","2021","전북","전주시","초등학교",2021-04-01,"남자",3148,3016,3086,70,62,132,0.023209549071618,0.0200907323395982,0.0437665782493369
"463","2021","전북","군산시","초등학교",2021-04-01,"전체",2388,2525,2470,-55,-82,-137,-0.0217821782178218,-0.0331983805668016,-0.0542574257425743
"464","2021","전북","군산시","초등학교",2021-04-01,"여자",1143,1243,1218,-25,-75,-100,-0.0201126307320998,-0.061576354679803,-0.080450522928399
"465","2021","전북","군산시","초등학교",2021-04-01,"남자",1245,1282,1252,-30,-7,-37,-0.0234009360374415,-0.00559105431309904,-0.0288611544461778
"466","2021","전북","익산시","초등학교",2021-04-01,"전체",2050,2202,2163,-39,-113,-152,-0.0177111716621253,-0.0522422561257513,-0.0690281562216167
"467","2021","전북","익산시","초등학교",2021-04-01,"여자",991,1012,987,-25,4,-21,-0.024703557312253,0.00405268490374873,-0.0207509881422925
"468","2021","전북","익산시","초등학교",2021-04-01,"남자",1059,1190,1176,-14,-117,-131,-0.0117647058823529,-0.0994897959183673,-0.110084033613445
"469","2021","전북","정읍시","초등학교",2021-04-01,"전체",721,743,739,-4,-18,-22,-0.0053835800807537,-0.0243572395128552,-0.0296096904441454
"470","2021","전북","정읍시","초등학교",2021-04-01,"여자",367,360,358,-2,9,7,-0.00555555555555556,0.0251396648044693,0.0194444444444444
"471","2021","전북","정읍시","초등학교",2021-04-01,"남자",354,383,381,-2,-27,-29,-0.00522193211488251,-0.0708661417322835,-0.0757180156657963
"472","2021","전북","남원시","초등학교",2021-04-01,"전체",521,546,547,1,-26,-25,0.00183150183150183,-0.0475319926873857,-0.0457875457875458
"473","2021","전북","남원시","초등학교",2021-04-01,"여자",243,252,253,1,-10,-9,0.00396825396825397,-0.0395256916996047,-0.0357142857142857
"474","2021","전북","남원시","초등학교",2021-04-01,"남자",278,294,294,0,-16,-16,0,-0.054421768707483,-0.054421768707483
"475","2021","전북","김제시","초등학교",2021-04-01,"전체",486,482,476,-6,10,4,-0.012448132780083,0.0210084033613445,0.00829875518672199
"476","2021","전북","김제시","초등학교",2021-04-01,"여자",226,233,232,-1,-6,-7,-0.00429184549356223,-0.0258620689655172,-0.0300429184549356
"477","2021","전북","김제시","초등학교",2021-04-01,"남자",260,249,244,-5,16,11,-0.0200803212851406,0.0655737704918033,0.0441767068273092
"478","2021","전북","완주군","초등학교",2021-04-01,"전체",664,842,820,-22,-156,-178,-0.0261282660332542,-0.190243902439024,-0.211401425178147
"479","2021","전북","완주군","초등학교",2021-04-01,"여자",334,427,410,-17,-76,-93,-0.0398126463700234,-0.185365853658537,-0.217798594847775
"480","2021","전북","완주군","초등학교",2021-04-01,"남자",330,415,410,-5,-80,-85,-0.0120481927710843,-0.195121951219512,-0.204819277108434
"481","2021","전북","진안군","초등학교",2021-04-01,"전체",107,133,120,-13,-13,-26,-0.0977443609022556,-0.108333333333333,-0.195488721804511
"482","2021","전북","진안군","초등학교",2021-04-01,"여자",56,73,63,-10,-7,-17,-0.136986301369863,-0.111111111111111,-0.232876712328767
"483","2021","전북","진안군","초등학교",2021-04-01,"남자",51,60,57,-3,-6,-9,-0.05,-0.105263157894737,-0.15
"484","2021","전북","무주군","초등학교",2021-04-01,"전체",142,135,134,-1,8,7,-0.00740740740740741,0.0597014925373134,0.0518518518518519
"485","2021","전북","무주군","초등학교",2021-04-01,"여자",54,44,45,1,9,10,0.0227272727272727,0.2,0.227272727272727
"486","2021","전북","무주군","초등학교",2021-04-01,"남자",88,91,89,-2,-1,-3,-0.021978021978022,-0.0112359550561798,-0.032967032967033
"487","2021","전북","장수군","초등학교",2021-04-01,"전체",127,137,131,-6,-4,-10,-0.0437956204379562,-0.0305343511450382,-0.072992700729927
"488","2021","전북","장수군","초등학교",2021-04-01,"여자",65,73,69,-4,-4,-8,-0.0547945205479452,-0.0579710144927536,-0.10958904109589
"489","2021","전북","장수군","초등학교",2021-04-01,"남자",62,64,62,-2,0,-2,-0.03125,0,-0.03125
"490","2021","전북","임실군","초등학교",2021-04-01,"전체",117,169,138,-31,-21,-52,-0.183431952662722,-0.152173913043478,-0.307692307692308
"491","2021","전북","임실군","초등학교",2021-04-01,"여자",58,72,63,-9,-5,-14,-0.125,-0.0793650793650794,-0.194444444444444
"492","2021","전북","임실군","초등학교",2021-04-01,"남자",59,97,75,-22,-16,-38,-0.22680412371134,-0.213333333333333,-0.391752577319588
"493","2021","전북","순창군","초등학교",2021-04-01,"전체",130,141,130,-11,0,-11,-0.0780141843971631,0,-0.0780141843971631
"494","2021","전북","순창군","초등학교",2021-04-01,"여자",57,67,61,-6,-4,-10,-0.0895522388059701,-0.0655737704918033,-0.149253731343284
"495","2021","전북","순창군","초등학교",2021-04-01,"남자",73,74,69,-5,4,-1,-0.0675675675675676,0.0579710144927536,-0.0135135135135135
"496","2021","전북","고창군","초등학교",2021-04-01,"전체",311,290,292,2,19,21,0.00689655172413793,0.0650684931506849,0.0724137931034483
"497","2021","전북","고창군","초등학교",2021-04-01,"여자",138,144,147,3,-9,-6,0.0208333333333333,-0.0612244897959184,-0.0416666666666667
"498","2021","전북","고창군","초등학교",2021-04-01,"남자",173,146,145,-1,28,27,-0.00684931506849315,0.193103448275862,0.184931506849315
"499","2021","전북","부안군","초등학교",2021-04-01,"전체",269,303,298,-5,-29,-34,-0.0165016501650165,-0.0973154362416107,-0.112211221122112
"500","2021","전북","부안군","초등학교",2021-04-01,"여자",131,151,146,-5,-15,-20,-0.033112582781457,-0.102739726027397,-0.132450331125828
"501","2021","전북","부안군","초등학교",2021-04-01,"남자",138,152,152,0,-14,-14,0,-0.0921052631578947,-0.0921052631578947
"502","2021","전남","목포시","초등학교",2021-04-01,"전체",2166,2131,2158,27,8,35,0.012670107930549,0.00370713623725672,0.0164242139840451
"503","2021","전남","목포시","초등학교",2021-04-01,"여자",1054,1009,1019,10,35,45,0.00991080277502478,0.0343473994111874,0.0445986124876115
"504","2021","전남","목포시","초등학교",2021-04-01,"남자",1112,1122,1139,17,-27,-10,0.0151515151515152,-0.0237050043898156,-0.0089126559714795
"505","2021","전남","여수시","초등학교",2021-04-01,"전체",2192,2359,2321,-38,-129,-167,-0.0161085205595591,-0.0555794915984489,-0.0707927087749046
"506","2021","전남","여수시","초등학교",2021-04-01,"여자",1069,1142,1122,-20,-53,-73,-0.0175131348511384,-0.0472370766488414,-0.063922942206655
"507","2021","전남","여수시","초등학교",2021-04-01,"남자",1123,1217,1199,-18,-76,-94,-0.0147904683648316,-0.0633861551292744,-0.0772391125718981
"508","2021","전남","순천시","초등학교",2021-04-01,"전체",2528,2528,2592,64,-64,0,0.0253164556962025,-0.0246913580246914,0
"509","2021","전남","순천시","초등학교",2021-04-01,"여자",1279,1261,1295,34,-16,18,0.0269627279936558,-0.0123552123552124,0.014274385408406
"510","2021","전남","순천시","초등학교",2021-04-01,"남자",1249,1267,1297,30,-48,-18,0.0236779794790845,-0.0370084811102544,-0.0142067876874507
"511","2021","전남","나주시","초등학교",2021-04-01,"전체",1056,1098,1050,-48,6,-42,-0.0437158469945355,0.00571428571428571,-0.0382513661202186
"512","2021","전남","나주시","초등학교",2021-04-01,"여자",504,526,505,-21,-1,-22,-0.0399239543726236,-0.00198019801980198,-0.0418250950570342
"513","2021","전남","나주시","초등학교",2021-04-01,"남자",552,572,545,-27,7,-20,-0.0472027972027972,0.0128440366972477,-0.034965034965035
"514","2021","전남","광양시","초등학교",2021-04-01,"전체",1357,1510,1493,-17,-136,-153,-0.0112582781456954,-0.0910917615539183,-0.101324503311258
"515","2021","전남","광양시","초등학교",2021-04-01,"여자",686,737,735,-2,-49,-51,-0.00271370420624152,-0.0666666666666667,-0.0691994572591588
"516","2021","전남","광양시","초등학교",2021-04-01,"남자",671,773,758,-15,-87,-102,-0.019404915912031,-0.114775725593668,-0.131953428201811
"517","2021","전남","담양군","초등학교",2021-04-01,"전체",237,258,242,-16,-5,-21,-0.062015503875969,-0.0206611570247934,-0.0813953488372093
"518","2021","전남","담양군","초등학교",2021-04-01,"여자",118,134,121,-13,-3,-16,-0.0970149253731343,-0.0247933884297521,-0.119402985074627
"519","2021","전남","담양군","초등학교",2021-04-01,"남자",119,124,121,-3,-2,-5,-0.0241935483870968,-0.0165289256198347,-0.0403225806451613
"520","2021","전남","곡성군","초등학교",2021-04-01,"전체",103,132,126,-6,-23,-29,-0.0454545454545455,-0.182539682539683,-0.21969696969697
"521","2021","전남","곡성군","초등학교",2021-04-01,"여자",48,62,59,-3,-11,-14,-0.0483870967741935,-0.186440677966102,-0.225806451612903
"522","2021","전남","곡성군","초등학교",2021-04-01,"남자",55,70,67,-3,-12,-15,-0.0428571428571429,-0.17910447761194,-0.214285714285714
"523","2021","전남","구례군","초등학교",2021-04-01,"전체",111,122,118,-4,-7,-11,-0.0327868852459016,-0.0593220338983051,-0.0901639344262295
"524","2021","전남","구례군","초등학교",2021-04-01,"여자",53,60,59,-1,-6,-7,-0.0166666666666667,-0.101694915254237,-0.116666666666667
"525","2021","전남","구례군","초등학교",2021-04-01,"남자",58,62,59,-3,-1,-4,-0.0483870967741935,-0.0169491525423729,-0.0645161290322581
"526","2021","전남","고흥군","초등학교",2021-04-01,"전체",248,262,270,8,-22,-14,0.0305343511450382,-0.0814814814814815,-0.0534351145038168
"527","2021","전남","고흥군","초등학교",2021-04-01,"여자",128,135,143,8,-15,-7,0.0592592592592593,-0.104895104895105,-0.0518518518518519
"528","2021","전남","고흥군","초등학교",2021-04-01,"남자",120,127,127,0,-7,-7,0,-0.0551181102362205,-0.0551181102362205
"529","2021","전남","보성군","초등학교",2021-04-01,"전체",163,208,190,-18,-27,-45,-0.0865384615384615,-0.142105263157895,-0.216346153846154
"530","2021","전남","보성군","초등학교",2021-04-01,"여자",74,98,89,-9,-15,-24,-0.0918367346938776,-0.168539325842697,-0.244897959183673
"531","2021","전남","보성군","초등학교",2021-04-01,"남자",89,110,101,-9,-12,-21,-0.0818181818181818,-0.118811881188119,-0.190909090909091
"532","2021","전남","화순군","초등학교",2021-04-01,"전체",357,357,364,7,-7,0,0.0196078431372549,-0.0192307692307692,0
"533","2021","전남","화순군","초등학교",2021-04-01,"여자",166,181,184,3,-18,-15,0.0165745856353591,-0.0978260869565217,-0.0828729281767956
"534","2021","전남","화순군","초등학교",2021-04-01,"남자",191,176,180,4,11,15,0.0227272727272727,0.0611111111111111,0.0852272727272727
"535","2021","전남","장흥군","초등학교",2021-04-01,"전체",213,227,215,-12,-2,-14,-0.052863436123348,-0.00930232558139535,-0.0616740088105727
"536","2021","전남","장흥군","초등학교",2021-04-01,"여자",107,119,115,-4,-8,-12,-0.0336134453781513,-0.0695652173913043,-0.100840336134454
"537","2021","전남","장흥군","초등학교",2021-04-01,"남자",106,108,100,-8,6,-2,-0.0740740740740741,0.06,-0.0185185185185185
"538","2021","전남","강진군","초등학교",2021-04-01,"전체",177,199,187,-12,-10,-22,-0.0603015075376884,-0.053475935828877,-0.110552763819095
"539","2021","전남","강진군","초등학교",2021-04-01,"여자",96,104,99,-5,-3,-8,-0.0480769230769231,-0.0303030303030303,-0.0769230769230769
"540","2021","전남","강진군","초등학교",2021-04-01,"남자",81,95,88,-7,-7,-14,-0.0736842105263158,-0.0795454545454545,-0.147368421052632
"541","2021","전남","해남군","초등학교",2021-04-01,"전체",374,418,382,-36,-8,-44,-0.0861244019138756,-0.0209424083769634,-0.105263157894737
"542","2021","전남","해남군","초등학교",2021-04-01,"여자",195,213,196,-17,-1,-18,-0.07981220657277,-0.00510204081632653,-0.0845070422535211
"543","2021","전남","해남군","초등학교",2021-04-01,"남자",179,205,186,-19,-7,-26,-0.0926829268292683,-0.0376344086021505,-0.126829268292683
"544","2021","전남","영암군","초등학교",2021-04-01,"전체",326,406,386,-20,-60,-80,-0.0492610837438424,-0.155440414507772,-0.197044334975369
"545","2021","전남","영암군","초등학교",2021-04-01,"여자",165,202,191,-11,-26,-37,-0.0544554455445545,-0.136125654450262,-0.183168316831683
"546","2021","전남","영암군","초등학교",2021-04-01,"남자",161,204,195,-9,-34,-43,-0.0441176470588235,-0.174358974358974,-0.21078431372549
"547","2021","전남","무안군","초등학교",2021-04-01,"전체",867,792,795,3,72,75,0.00378787878787879,0.0905660377358491,0.0946969696969697
"548","2021","전남","무안군","초등학교",2021-04-01,"여자",406,375,377,2,29,31,0.00533333333333333,0.0769230769230769,0.0826666666666667
"549","2021","전남","무안군","초등학교",2021-04-01,"남자",461,417,418,1,43,44,0.00239808153477218,0.102870813397129,0.105515587529976
"550","2021","전남","함평군","초등학교",2021-04-01,"전체",121,169,157,-12,-36,-48,-0.0710059171597633,-0.229299363057325,-0.284023668639053
"551","2021","전남","함평군","초등학교",2021-04-01,"여자",61,92,87,-5,-26,-31,-0.0543478260869565,-0.298850574712644,-0.33695652173913
"552","2021","전남","함평군","초등학교",2021-04-01,"남자",60,77,70,-7,-10,-17,-0.0909090909090909,-0.142857142857143,-0.220779220779221
"553","2021","전남","영광군","초등학교",2021-04-01,"전체",294,337,318,-19,-24,-43,-0.056379821958457,-0.0754716981132075,-0.127596439169139
"554","2021","전남","영광군","초등학교",2021-04-01,"여자",143,158,154,-4,-11,-15,-0.0253164556962025,-0.0714285714285714,-0.0949367088607595
"555","2021","전남","영광군","초등학교",2021-04-01,"남자",151,179,164,-15,-13,-28,-0.0837988826815642,-0.0792682926829268,-0.156424581005587
"556","2021","전남","장성군","초등학교",2021-04-01,"전체",307,311,305,-6,2,-4,-0.0192926045016077,0.00655737704918033,-0.0128617363344051
"557","2021","전남","장성군","초등학교",2021-04-01,"여자",138,161,160,-1,-22,-23,-0.0062111801242236,-0.1375,-0.142857142857143
"558","2021","전남","장성군","초등학교",2021-04-01,"남자",169,150,145,-5,24,19,-0.0333333333333333,0.16551724137931,0.126666666666667
"559","2021","전남","완도군","초등학교",2021-04-01,"전체",347,345,336,-9,11,2,-0.0260869565217391,0.0327380952380952,0.00579710144927536
"560","2021","전남","완도군","초등학교",2021-04-01,"여자",162,157,151,-6,11,5,-0.0382165605095541,0.0728476821192053,0.0318471337579618
"561","2021","전남","완도군","초등학교",2021-04-01,"남자",185,188,185,-3,0,-3,-0.0159574468085106,0,-0.0159574468085106
"562","2021","전남","진도군","초등학교",2021-04-01,"전체",168,185,181,-4,-13,-17,-0.0216216216216216,-0.0718232044198895,-0.0918918918918919
"563","2021","전남","진도군","초등학교",2021-04-01,"여자",76,82,80,-2,-4,-6,-0.024390243902439,-0.05,-0.0731707317073171
"564","2021","전남","진도군","초등학교",2021-04-01,"남자",92,103,101,-2,-9,-11,-0.0194174757281553,-0.0891089108910891,-0.106796116504854
"565","2021","전남","신안군","초등학교",2021-04-01,"전체",128,177,170,-7,-42,-49,-0.0395480225988701,-0.247058823529412,-0.27683615819209
"566","2021","전남","신안군","초등학교",2021-04-01,"여자",67,82,80,-2,-13,-15,-0.024390243902439,-0.1625,-0.182926829268293
"567","2021","전남","신안군","초등학교",2021-04-01,"남자",61,95,90,-5,-29,-34,-0.0526315789473684,-0.322222222222222,-0.357894736842105
"568","2021","경북","포항시","초등학교",2021-04-01,"전체",4408,4510,4536,26,-128,-102,0.0057649667405765,-0.0282186948853616,-0.0226164079822616
"569","2021","경북","포항시","초등학교",2021-04-01,"여자",2135,2172,2204,32,-69,-37,0.0147329650092081,-0.0313067150635209,-0.0170349907918969
"570","2021","경북","포항시","초등학교",2021-04-01,"남자",2273,2338,2332,-6,-59,-65,-0.00256629597946963,-0.0253001715265866,-0.0278015397775877
"571","2021","경북","경주시","초등학교",2021-04-01,"전체",1774,1741,1761,20,13,33,0.0114876507754164,0.00738216922203294,0.0189546237794371
"572","2021","경북","경주시","초등학교",2021-04-01,"여자",854,829,840,11,14,25,0.0132689987937274,0.0166666666666667,0.0301568154402895
"573","2021","경북","경주시","초등학교",2021-04-01,"남자",920,912,921,9,-1,8,0.00986842105263158,-0.001085776330076,0.0087719298245614
"574","2021","경북","김천시","초등학교",2021-04-01,"전체",1077,1141,1117,-24,-40,-64,-0.021034180543383,-0.035810205908684,-0.056091148115688
"575","2021","경북","김천시","초등학교",2021-04-01,"여자",530,553,547,-6,-17,-23,-0.0108499095840868,-0.0310786106032907,-0.0415913200723327
"576","2021","경북","김천시","초등학교",2021-04-01,"남자",547,588,570,-18,-23,-41,-0.0306122448979592,-0.0403508771929825,-0.0697278911564626
"577","2021","경북","안동시","초등학교",2021-04-01,"전체",1176,1128,1117,-11,59,48,-0.00975177304964539,0.0528200537153089,0.0425531914893617
"578","2021","경북","안동시","초등학교",2021-04-01,"여자",571,552,546,-6,25,19,-0.0108695652173913,0.0457875457875458,0.0344202898550725
"579","2021","경북","안동시","초등학교",2021-04-01,"남자",605,576,571,-5,34,29,-0.00868055555555556,0.0595446584938704,0.0503472222222222
"580","2021","경북","구미시","초등학교",2021-04-01,"전체",4685,4947,4906,-41,-221,-262,-0.00828785122296341,-0.0450468813697513,-0.0529613907418638
"581","2021","경북","구미시","초등학교",2021-04-01,"여자",2265,2413,2403,-10,-138,-148,-0.00414421881475342,-0.0574282147315855,-0.0613344384583506
"582","2021","경북","구미시","초등학교",2021-04-01,"남자",2420,2534,2503,-31,-83,-114,-0.0122336227308603,-0.0331602077506992,-0.0449881610102605
"583","2021","경북","영주시","초등학교",2021-04-01,"전체",665,673,671,-2,-6,-8,-0.00297176820208024,-0.00894187779433681,-0.011887072808321
"584","2021","경북","영주시","초등학교",2021-04-01,"여자",300,310,314,4,-14,-10,0.0129032258064516,-0.0445859872611465,-0.032258064516129
"585","2021","경북","영주시","초등학교",2021-04-01,"남자",365,363,357,-6,8,2,-0.0165289256198347,0.0224089635854342,0.00550964187327824
"586","2021","경북","영천시","초등학교",2021-04-01,"전체",511,600,578,-22,-67,-89,-0.0366666666666667,-0.115916955017301,-0.148333333333333
"587","2021","경북","영천시","초등학교",2021-04-01,"여자",235,308,296,-12,-61,-73,-0.038961038961039,-0.206081081081081,-0.237012987012987
"588","2021","경북","영천시","초등학교",2021-04-01,"남자",276,292,282,-10,-6,-16,-0.0342465753424658,-0.0212765957446809,-0.0547945205479452
"589","2021","경북","상주시","초등학교",2021-04-01,"전체",521,551,550,-1,-29,-30,-0.00181488203266788,-0.0527272727272727,-0.0544464609800363
"590","2021","경북","상주시","초등학교",2021-04-01,"여자",242,256,259,3,-17,-14,0.01171875,-0.0656370656370656,-0.0546875
"591","2021","경북","상주시","초등학교",2021-04-01,"남자",279,295,291,-4,-12,-16,-0.0135593220338983,-0.0412371134020619,-0.0542372881355932
"592","2021","경북","문경시","초등학교",2021-04-01,"전체",389,429,424,-5,-35,-40,-0.0116550116550117,-0.0825471698113208,-0.0932400932400932
"593","2021","경북","문경시","초등학교",2021-04-01,"여자",191,207,206,-1,-15,-16,-0.00483091787439614,-0.0728155339805825,-0.0772946859903382
"594","2021","경북","문경시","초등학교",2021-04-01,"남자",198,222,218,-4,-20,-24,-0.018018018018018,-0.0917431192660551,-0.108108108108108
"595","2021","경북","경산시","초등학교",2021-04-01,"전체",2210,2394,2376,-18,-166,-184,-0.0075187969924812,-0.0698653198653199,-0.076858813700919
"596","2021","경북","경산시","초등학교",2021-04-01,"여자",1112,1159,1150,-9,-38,-47,-0.00776531492666091,-0.0330434782608696,-0.0405522001725626
"597","2021","경북","경산시","초등학교",2021-04-01,"남자",1098,1235,1226,-9,-128,-137,-0.00728744939271255,-0.104404567699837,-0.110931174089069
"598","2021","경북","군위군","초등학교",2021-04-01,"전체",62,76,71,-5,-9,-14,-0.0657894736842105,-0.126760563380282,-0.184210526315789
"599","2021","경북","군위군","초등학교",2021-04-01,"여자",30,39,35,-4,-5,-9,-0.102564102564103,-0.142857142857143,-0.230769230769231
"600","2021","경북","군위군","초등학교",2021-04-01,"남자",32,37,36,-1,-4,-5,-0.027027027027027,-0.111111111111111,-0.135135135135135
"601","2021","경북","의성군","초등학교",2021-04-01,"전체",170,177,172,-5,-2,-7,-0.0282485875706215,-0.0116279069767442,-0.0395480225988701
"602","2021","경북","의성군","초등학교",2021-04-01,"여자",79,84,81,-3,-2,-5,-0.0357142857142857,-0.0246913580246914,-0.0595238095238095
"603","2021","경북","의성군","초등학교",2021-04-01,"남자",91,93,91,-2,0,-2,-0.021505376344086,0,-0.021505376344086
"604","2021","경북","청송군","초등학교",2021-04-01,"전체",97,122,116,-6,-19,-25,-0.0491803278688525,-0.163793103448276,-0.204918032786885
"605","2021","경북","청송군","초등학교",2021-04-01,"여자",55,65,62,-3,-7,-10,-0.0461538461538462,-0.112903225806452,-0.153846153846154
"606","2021","경북","청송군","초등학교",2021-04-01,"남자",42,57,54,-3,-12,-15,-0.0526315789473684,-0.222222222222222,-0.263157894736842
"607","2021","경북","영양군","초등학교",2021-04-01,"전체",71,95,89,-6,-18,-24,-0.0631578947368421,-0.202247191011236,-0.252631578947368
"608","2021","경북","영양군","초등학교",2021-04-01,"여자",44,58,52,-6,-8,-14,-0.103448275862069,-0.153846153846154,-0.241379310344828
"609","2021","경북","영양군","초등학교",2021-04-01,"남자",27,37,37,0,-10,-10,0,-0.27027027027027,-0.27027027027027
"610","2021","경북","영덕군","초등학교",2021-04-01,"전체",167,206,195,-11,-28,-39,-0.0533980582524272,-0.143589743589744,-0.189320388349515
"611","2021","경북","영덕군","초등학교",2021-04-01,"여자",81,95,90,-5,-9,-14,-0.0526315789473684,-0.1,-0.147368421052632
"612","2021","경북","영덕군","초등학교",2021-04-01,"남자",86,111,105,-6,-19,-25,-0.0540540540540541,-0.180952380952381,-0.225225225225225
"613","2021","경북","청도군","초등학교",2021-04-01,"전체",148,158,160,2,-12,-10,0.0126582278481013,-0.075,-0.0632911392405063
"614","2021","경북","청도군","초등학교",2021-04-01,"여자",73,74,75,1,-2,-1,0.0135135135135135,-0.0266666666666667,-0.0135135135135135
"615","2021","경북","청도군","초등학교",2021-04-01,"남자",75,84,85,1,-10,-9,0.0119047619047619,-0.117647058823529,-0.107142857142857
"616","2021","경북","고령군","초등학교",2021-04-01,"전체",157,170,158,-12,-1,-13,-0.0705882352941176,-0.00632911392405063,-0.0764705882352941
"617","2021","경북","고령군","초등학교",2021-04-01,"여자",70,77,68,-9,2,-7,-0.116883116883117,0.0294117647058824,-0.0909090909090909
"618","2021","경북","고령군","초등학교",2021-04-01,"남자",87,93,90,-3,-3,-6,-0.032258064516129,-0.0333333333333333,-0.0645161290322581
"619","2021","경북","성주군","초등학교",2021-04-01,"전체",147,215,191,-24,-44,-68,-0.111627906976744,-0.230366492146597,-0.316279069767442
"620","2021","경북","성주군","초등학교",2021-04-01,"여자",77,100,92,-8,-15,-23,-0.08,-0.16304347826087,-0.23
"621","2021","경북","성주군","초등학교",2021-04-01,"남자",70,115,99,-16,-29,-45,-0.139130434782609,-0.292929292929293,-0.391304347826087
"622","2021","경북","칠곡군","초등학교",2021-04-01,"전체",1016,1150,1102,-48,-86,-134,-0.0417391304347826,-0.0780399274047187,-0.116521739130435
"623","2021","경북","칠곡군","초등학교",2021-04-01,"여자",475,540,517,-23,-42,-65,-0.0425925925925926,-0.0812379110251451,-0.12037037037037
"624","2021","경북","칠곡군","초등학교",2021-04-01,"남자",541,610,585,-25,-44,-69,-0.040983606557377,-0.0752136752136752,-0.113114754098361
"625","2021","경북","예천군","초등학교",2021-04-01,"전체",361,458,484,26,-123,-97,0.0567685589519651,-0.254132231404959,-0.2117903930131
"626","2021","경북","예천군","초등학교",2021-04-01,"여자",163,218,222,4,-59,-55,0.018348623853211,-0.265765765765766,-0.252293577981651
"627","2021","경북","예천군","초등학교",2021-04-01,"남자",198,240,262,22,-64,-42,0.0916666666666667,-0.244274809160305,-0.175
"628","2021","경북","봉화군","초등학교",2021-04-01,"전체",127,180,157,-23,-30,-53,-0.127777777777778,-0.191082802547771,-0.294444444444444
"629","2021","경북","봉화군","초등학교",2021-04-01,"여자",56,74,66,-8,-10,-18,-0.108108108108108,-0.151515151515152,-0.243243243243243
"630","2021","경북","봉화군","초등학교",2021-04-01,"남자",71,106,91,-15,-20,-35,-0.141509433962264,-0.21978021978022,-0.330188679245283
"631","2021","경북","울진군","초등학교",2021-04-01,"전체",296,334,321,-13,-25,-38,-0.0389221556886228,-0.0778816199376947,-0.11377245508982
"632","2021","경북","울진군","초등학교",2021-04-01,"여자",157,164,162,-2,-5,-7,-0.0121951219512195,-0.0308641975308642,-0.0426829268292683
"633","2021","경북","울진군","초등학교",2021-04-01,"남자",139,170,159,-11,-20,-31,-0.0647058823529412,-0.125786163522013,-0.182352941176471
"634","2021","경북","울릉군","초등학교",2021-04-01,"전체",43,48,39,-9,4,-5,-0.1875,0.102564102564103,-0.104166666666667
"635","2021","경북","울릉군","초등학교",2021-04-01,"여자",24,24,20,-4,4,0,-0.166666666666667,0.2,0
"636","2021","경북","울릉군","초등학교",2021-04-01,"남자",19,24,19,-5,0,-5,-0.208333333333333,0,-0.208333333333333
"637","2021","경남","진주시","초등학교",2021-04-01,"전체",3329,3173,3211,38,118,156,0.0119760479041916,0.0367486764247898,0.0491648282382603
"638","2021","경남","진주시","초등학교",2021-04-01,"여자",1605,1581,1604,23,1,24,0.0145477545857052,0.000623441396508728,0.015180265654649
"639","2021","경남","진주시","초등학교",2021-04-01,"남자",1724,1592,1607,15,117,132,0.00942211055276382,0.0728064716863721,0.0829145728643216
"640","2021","경남","통영시","초등학교",2021-04-01,"전체",1168,1186,1166,-20,2,-18,-0.0168634064080944,0.00171526586620926,-0.015177065767285
"641","2021","경남","통영시","초등학교",2021-04-01,"여자",573,568,564,-4,9,5,-0.00704225352112676,0.0159574468085106,0.00880281690140845
"642","2021","경남","통영시","초등학교",2021-04-01,"남자",595,618,602,-16,-7,-23,-0.0258899676375405,-0.0116279069767442,-0.0372168284789644
"643","2021","경남","사천시","초등학교",2021-04-01,"전체",926,922,909,-13,17,4,-0.0140997830802603,0.0187018701870187,0.00433839479392625
"644","2021","경남","사천시","초등학교",2021-04-01,"여자",473,443,435,-8,38,30,-0.018058690744921,0.0873563218390805,0.0677200902934537
"645","2021","경남","사천시","초등학교",2021-04-01,"남자",453,479,474,-5,-21,-26,-0.0104384133611691,-0.0443037974683544,-0.0542797494780793
"646","2021","경남","김해시","초등학교",2021-04-01,"전체",5522,5511,5566,55,-44,11,0.00998003992015968,-0.00790513833992095,0.00199600798403194
"647","2021","경남","김해시","초등학교",2021-04-01,"여자",2668,2680,2689,9,-21,-12,0.00335820895522388,-0.00780959464484939,-0.00447761194029851
"648","2021","경남","김해시","초등학교",2021-04-01,"남자",2854,2831,2877,46,-23,23,0.0162486753797245,-0.00799443865137296,0.00812433768986224
"649","2021","경남","밀양시","초등학교",2021-04-01,"전체",610,594,601,7,9,16,0.0117845117845118,0.0149750415973378,0.0269360269360269
"650","2021","경남","밀양시","초등학교",2021-04-01,"여자",298,306,310,4,-12,-8,0.0130718954248366,-0.0387096774193548,-0.0261437908496732
"651","2021","경남","밀양시","초등학교",2021-04-01,"남자",312,288,291,3,21,24,0.0104166666666667,0.0721649484536082,0.0833333333333333
"652","2021","경남","거제시","초등학교",2021-04-01,"전체",3108,3360,3292,-68,-184,-252,-0.0202380952380952,-0.0558930741190765,-0.075
"653","2021","경남","거제시","초등학교",2021-04-01,"여자",1502,1674,1631,-43,-129,-172,-0.0256869772998805,-0.079092581238504,-0.102747909199522
"654","2021","경남","거제시","초등학교",2021-04-01,"남자",1606,1686,1661,-25,-55,-80,-0.0148279952550415,-0.033112582781457,-0.0474495848161329
"655","2021","경남","양산시","초등학교",2021-04-01,"전체",3867,4020,4004,-16,-137,-153,-0.00398009950248756,-0.0342157842157842,-0.0380597014925373
"656","2021","경남","양산시","초등학교",2021-04-01,"여자",1852,1940,1961,21,-109,-88,0.0108247422680412,-0.055583885772565,-0.045360824742268
"657","2021","경남","양산시","초등학교",2021-04-01,"남자",2015,2080,2043,-37,-28,-65,-0.0177884615384615,-0.0137053352912384,-0.03125
"658","2021","경남","의령군","초등학교",2021-04-01,"전체",103,126,123,-3,-20,-23,-0.0238095238095238,-0.16260162601626,-0.182539682539683
"659","2021","경남","의령군","초등학교",2021-04-01,"여자",41,41,39,-2,2,0,-0.0487804878048781,0.0512820512820513,0
"660","2021","경남","의령군","초등학교",2021-04-01,"남자",62,85,84,-1,-22,-23,-0.0117647058823529,-0.261904761904762,-0.270588235294118
"661","2021","경남","함안군","초등학교",2021-04-01,"전체",475,475,468,-7,7,0,-0.0147368421052632,0.014957264957265,0
"662","2021","경남","함안군","초등학교",2021-04-01,"여자",237,236,237,1,0,1,0.00423728813559322,0,0.00423728813559322
"663","2021","경남","함안군","초등학교",2021-04-01,"남자",238,239,231,-8,7,-1,-0.0334728033472803,0.0303030303030303,-0.00418410041841004
"664","2021","경남","창녕군","초등학교",2021-04-01,"전체",324,353,346,-7,-22,-29,-0.0198300283286119,-0.0635838150289017,-0.0821529745042493
"665","2021","경남","창녕군","초등학교",2021-04-01,"여자",151,176,174,-2,-23,-25,-0.0113636363636364,-0.132183908045977,-0.142045454545455
"666","2021","경남","창녕군","초등학교",2021-04-01,"남자",173,177,172,-5,1,-4,-0.0282485875706215,0.00581395348837209,-0.0225988700564972
"667","2021","경남","고성군","초등학교",2021-04-01,"전체",305,325,315,-10,-10,-20,-0.0307692307692308,-0.0317460317460317,-0.0615384615384615
"668","2021","경남","고성군","초등학교",2021-04-01,"여자",167,171,166,-5,1,-4,-0.0292397660818713,0.00602409638554217,-0.0233918128654971
"669","2021","경남","고성군","초등학교",2021-04-01,"남자",138,154,149,-5,-11,-16,-0.0324675324675325,-0.0738255033557047,-0.103896103896104
"670","2021","경남","남해군","초등학교",2021-04-01,"전체",188,186,188,2,0,2,0.010752688172043,0,0.010752688172043
"671","2021","경남","남해군","초등학교",2021-04-01,"여자",78,78,76,-2,2,0,-0.0256410256410256,0.0263157894736842,0
"672","2021","경남","남해군","초등학교",2021-04-01,"남자",110,108,112,4,-2,2,0.037037037037037,-0.0178571428571429,0.0185185185185185
"673","2021","경남","하동군","초등학교",2021-04-01,"전체",183,252,238,-14,-55,-69,-0.0555555555555556,-0.23109243697479,-0.273809523809524
"674","2021","경남","하동군","초등학교",2021-04-01,"여자",71,116,104,-12,-33,-45,-0.103448275862069,-0.317307692307692,-0.387931034482759
"675","2021","경남","하동군","초등학교",2021-04-01,"남자",112,136,134,-2,-22,-24,-0.0147058823529412,-0.164179104477612,-0.176470588235294
"676","2021","경남","산청군","초등학교",2021-04-01,"전체",112,155,141,-14,-29,-43,-0.0903225806451613,-0.205673758865248,-0.27741935483871
"677","2021","경남","산청군","초등학교",2021-04-01,"여자",50,78,71,-7,-21,-28,-0.0897435897435897,-0.295774647887324,-0.358974358974359
"678","2021","경남","산청군","초등학교",2021-04-01,"남자",62,77,70,-7,-8,-15,-0.0909090909090909,-0.114285714285714,-0.194805194805195
"679","2021","경남","함양군","초등학교",2021-04-01,"전체",210,211,207,-4,3,-1,-0.018957345971564,0.0144927536231884,-0.004739336492891
"680","2021","경남","함양군","초등학교",2021-04-01,"여자",101,108,107,-1,-6,-7,-0.00925925925925926,-0.0560747663551402,-0.0648148148148148
"681","2021","경남","함양군","초등학교",2021-04-01,"남자",109,103,100,-3,9,6,-0.029126213592233,0.09,0.058252427184466
"682","2021","경남","거창군","초등학교",2021-04-01,"전체",453,437,423,-14,30,16,-0.0320366132723112,0.0709219858156028,0.0366132723112128
"683","2021","경남","거창군","초등학교",2021-04-01,"여자",228,219,213,-6,15,9,-0.0273972602739726,0.0704225352112676,0.0410958904109589
"684","2021","경남","거창군","초등학교",2021-04-01,"남자",225,218,210,-8,15,7,-0.036697247706422,0.0714285714285714,0.0321100917431193
"685","2021","경남","합천군","초등학교",2021-04-01,"전체",155,174,176,2,-21,-19,0.0114942528735632,-0.119318181818182,-0.109195402298851
"686","2021","경남","합천군","초등학교",2021-04-01,"여자",77,82,85,3,-8,-5,0.0365853658536585,-0.0941176470588235,-0.0609756097560976
"687","2021","경남","합천군","초등학교",2021-04-01,"남자",78,92,91,-1,-13,-14,-0.0108695652173913,-0.142857142857143,-0.152173913043478
"688","2021","제주","제주시","초등학교",2021-04-01,"전체",5130,4905,4950,45,180,225,0.00917431192660551,0.0363636363636364,0.0458715596330275
"689","2021","제주","제주시","초등학교",2021-04-01,"여자",2501,2406,2454,48,47,95,0.0199501246882793,0.0191524042379788,0.0394846217788861
"690","2021","제주","제주시","초등학교",2021-04-01,"남자",2629,2499,2496,-3,133,130,-0.00120048019207683,0.0532852564102564,0.0520208083233293
"691","2021","제주","서귀포시","초등학교",2021-04-01,"전체",1495,1553,1595,42,-100,-58,0.0270444301352222,-0.0626959247648903,-0.0373470701867354
"692","2021","제주","서귀포시","초등학교",2021-04-01,"여자",747,769,774,5,-27,-22,0.00650195058517555,-0.0348837209302326,-0.0286085825747724
"693","2021","제주","서귀포시","초등학교",2021-04-01,"남자",748,784,821,37,-73,-36,0.0471938775510204,-0.0889159561510353,-0.0459183673469388
"694","2015","서울","종로구","초등학교",2015-04-01,"전체",976,1006,1009,3,-33,-30,0.00298210735586481,-0.0327056491575818,-0.0298210735586481
"695","2015","서울","종로구","초등학교",2015-04-01,"여자",472,488,488,0,-16,-16,0,-0.0327868852459016,-0.0327868852459016
"696","2015","서울","종로구","초등학교",2015-04-01,"남자",504,518,521,3,-17,-14,0.00579150579150579,-0.0326295585412668,-0.027027027027027
"697","2015","서울","중구","초등학교",2015-04-01,"전체",977,886,805,-81,172,91,-0.0914221218961625,0.213664596273292,0.102708803611738
"698","2015","서울","중구","초등학교",2015-04-01,"여자",496,445,398,-47,98,51,-0.10561797752809,0.246231155778894,0.114606741573034
"699","2015","서울","중구","초등학교",2015-04-01,"남자",481,441,407,-34,74,40,-0.0770975056689342,0.181818181818182,0.090702947845805
"700","2015","서울","용산구","초등학교",2015-04-01,"전체",1414,1858,1796,-62,-382,-444,-0.0333692142088267,-0.212694877505568,-0.238966630785791
"701","2015","서울","용산구","초등학교",2015-04-01,"여자",714,944,927,-17,-213,-230,-0.0180084745762712,-0.229773462783172,-0.24364406779661
"702","2015","서울","용산구","초등학교",2015-04-01,"남자",700,914,869,-45,-169,-214,-0.0492341356673961,-0.194476409666283,-0.234135667396061
"703","2015","서울","성동구","초등학교",2015-04-01,"전체",2147,2441,2362,-79,-215,-294,-0.0323637853338796,-0.0910245554614733,-0.120442441622286
"704","2015","서울","성동구","초등학교",2015-04-01,"여자",1040,1187,1150,-37,-110,-147,-0.0311710193765796,-0.0956521739130435,-0.123841617523168
"705","2015","서울","성동구","초등학교",2015-04-01,"남자",1107,1254,1212,-42,-105,-147,-0.0334928229665072,-0.0866336633663366,-0.117224880382775
"706","2015","서울","광진구","초등학교",2015-04-01,"전체",2601,2615,2532,-83,69,-14,-0.0317399617590822,0.0272511848341232,-0.00535372848948375
"707","2015","서울","광진구","초등학교",2015-04-01,"여자",1237,1265,1221,-44,16,-28,-0.0347826086956522,0.0131040131040131,-0.0221343873517787
"708","2015","서울","광진구","초등학교",2015-04-01,"남자",1364,1350,1311,-39,53,14,-0.0288888888888889,0.0404271548436308,0.0103703703703704
"709","2015","서울","동대문구","초등학교",2015-04-01,"전체",2596,2692,2644,-48,-48,-96,-0.0178306092124814,-0.0181543116490166,-0.0356612184249629
"710","2015","서울","동대문구","초등학교",2015-04-01,"여자",1267,1327,1298,-29,-31,-60,-0.0218538055764883,-0.0238828967642527,-0.0452147701582517
"711","2015","서울","동대문구","초등학교",2015-04-01,"남자",1329,1365,1346,-19,-17,-36,-0.0139194139194139,-0.012630014858841,-0.0263736263736264
"712","2015","서울","중랑구","초등학교",2015-04-01,"전체",2812,3082,3019,-63,-207,-270,-0.0204412719013628,-0.0685657502484266,-0.0876054510058404
"713","2015","서울","중랑구","초등학교",2015-04-01,"여자",1389,1505,1468,-37,-79,-116,-0.0245847176079734,-0.0538147138964578,-0.0770764119601329
"714","2015","서울","중랑구","초등학교",2015-04-01,"남자",1423,1577,1551,-26,-128,-154,-0.0164870006341154,-0.0825274016763378,-0.0976537729866836
"715","2015","서울","성북구","초등학교",2015-04-01,"전체",3876,4069,3973,-96,-97,-193,-0.0235930203981322,-0.0244147998993204,-0.0474318014254116
"716","2015","서울","성북구","초등학교",2015-04-01,"여자",1871,1978,1951,-27,-80,-107,-0.0136501516683519,-0.0410046130189646,-0.0540950455005056
"717","2015","서울","성북구","초등학교",2015-04-01,"남자",2005,2091,2022,-69,-17,-86,-0.0329985652797704,-0.00840751730959446,-0.0411286465805835
"718","2015","서울","강북구","초등학교",2015-04-01,"전체",1855,2540,2417,-123,-562,-685,-0.0484251968503937,-0.232519652461729,-0.269685039370079
"719","2015","서울","강북구","초등학교",2015-04-01,"여자",927,1282,1214,-68,-287,-355,-0.0530421216848674,-0.236408566721582,-0.276911076443058
"720","2015","서울","강북구","초등학교",2015-04-01,"남자",928,1258,1203,-55,-275,-330,-0.0437201907790143,-0.228595178719867,-0.262321144674086
"721","2015","서울","도봉구","초등학교",2015-04-01,"전체",2813,2687,2620,-67,193,126,-0.0249348716040194,0.0736641221374046,0.0468924451060662
"722","2015","서울","도봉구","초등학교",2015-04-01,"여자",1349,1307,1291,-16,58,42,-0.0122417750573833,0.0449264136328428,0.0321346595256312
"723","2015","서울","도봉구","초등학교",2015-04-01,"남자",1464,1380,1329,-51,135,84,-0.0369565217391304,0.101580135440181,0.0608695652173913
"724","2015","서울","노원구","초등학교",2015-04-01,"전체",4895,4832,4734,-98,161,63,-0.0202814569536424,0.0340092944655682,0.0130380794701987
"725","2015","서울","노원구","초등학교",2015-04-01,"여자",2388,2404,2341,-63,47,-16,-0.0262063227953411,0.0200768902178556,-0.00665557404326123
"726","2015","서울","노원구","초등학교",2015-04-01,"남자",2507,2428,2393,-35,114,79,-0.0144151565074135,0.0476389469285416,0.0325370675453048
"727","2015","서울","은평구","초등학교",2015-04-01,"전체",3960,4302,4167,-135,-207,-342,-0.0313807531380753,-0.0496760259179266,-0.0794979079497908
"728","2015","서울","은평구","초등학교",2015-04-01,"여자",1898,2059,1990,-69,-92,-161,-0.0335114133074308,-0.0462311557788945,-0.0781932977173385
"729","2015","서울","은평구","초등학교",2015-04-01,"남자",2062,2243,2177,-66,-115,-181,-0.0294248773963442,-0.0528249885163068,-0.0806954971020954
"730","2015","서울","서대문구","초등학교",2015-04-01,"전체",2109,2256,2196,-60,-87,-147,-0.0265957446808511,-0.0396174863387978,-0.0651595744680851
"731","2015","서울","서대문구","초등학교",2015-04-01,"여자",1029,1070,1057,-13,-28,-41,-0.0121495327102804,-0.0264900662251656,-0.0383177570093458
"732","2015","서울","서대문구","초등학교",2015-04-01,"남자",1080,1186,1139,-47,-59,-106,-0.0396290050590219,-0.0517998244073749,-0.0893760539629005
"733","2015","서울","마포구","초등학교",2015-04-01,"전체",2917,3262,3183,-79,-266,-345,-0.0242182709993869,-0.0835689601005341,-0.105763335377069
"734","2015","서울","마포구","초등학교",2015-04-01,"여자",1412,1559,1535,-24,-123,-147,-0.0153944836433611,-0.0801302931596091,-0.0942912123155869
"735","2015","서울","마포구","초등학교",2015-04-01,"남자",1505,1703,1648,-55,-143,-198,-0.0322959483264827,-0.0867718446601942,-0.116265413975338
"736","2015","서울","양천구","초등학교",2015-04-01,"전체",4071,3822,3914,92,157,249,0.0240711669283098,0.040112416964742,0.065149136577708
"737","2015","서울","양천구","초등학교",2015-04-01,"여자",1975,1859,1904,45,71,116,0.0242065626681011,0.0372899159663866,0.0623991393222162
"738","2015","서울","양천구","초등학교",2015-04-01,"남자",2096,1963,2010,47,86,133,0.0239429444727458,0.0427860696517413,0.0677534386143658
"739","2015","서울","강서구","초등학교",2015-04-01,"전체",4757,4663,4591,-72,166,94,-0.015440703409822,0.0361576998475278,0.0201586961183787
"740","2015","서울","강서구","초등학교",2015-04-01,"여자",2324,2279,2233,-46,91,45,-0.0201842913558578,0.0407523510971787,0.0197455024133392
"741","2015","서울","강서구","초등학교",2015-04-01,"남자",2433,2384,2358,-26,75,49,-0.0109060402684564,0.0318066157760814,0.0205536912751678
"742","2015","서울","구로구","초등학교",2015-04-01,"전체",3516,4034,3917,-117,-401,-518,-0.0290034705007437,-0.102374266019913,-0.128408527516113
"743","2015","서울","구로구","초등학교",2015-04-01,"여자",1728,1996,1950,-46,-222,-268,-0.0230460921843687,-0.113846153846154,-0.134268537074148
"744","2015","서울","구로구","초등학교",2015-04-01,"남자",1788,2038,1967,-71,-179,-250,-0.034838076545633,-0.0910015251652262,-0.122669283611384
"745","2015","서울","금천구","초등학교",2015-04-01,"전체",1550,1731,1636,-95,-86,-181,-0.0548815713460427,-0.0525672371638142,-0.104563835932987
"746","2015","서울","금천구","초등학교",2015-04-01,"여자",753,851,809,-42,-56,-98,-0.0493537015276146,-0.069221260815822,-0.115158636897767
"747","2015","서울","금천구","초등학교",2015-04-01,"남자",797,880,827,-53,-30,-83,-0.0602272727272727,-0.0362756952841596,-0.0943181818181818
"748","2015","서울","영등포구","초등학교",2015-04-01,"전체",2589,3099,2939,-160,-350,-510,-0.0516295579219103,-0.119088125212657,-0.164569215876089
"749","2015","서울","영등포구","초등학교",2015-04-01,"여자",1265,1560,1484,-76,-219,-295,-0.0487179487179487,-0.147574123989218,-0.189102564102564
"750","2015","서울","영등포구","초등학교",2015-04-01,"남자",1324,1539,1455,-84,-131,-215,-0.0545808966861598,-0.0900343642611684,-0.139701104613385
"751","2015","서울","동작구","초등학교",2015-04-01,"전체",2904,3239,3177,-62,-273,-335,-0.0191417104044458,-0.0859301227573182,-0.103426983636925
"752","2015","서울","동작구","초등학교",2015-04-01,"여자",1429,1607,1571,-36,-142,-178,-0.0224019912881145,-0.0903882877148313,-0.110765401369011
"753","2015","서울","동작구","초등학교",2015-04-01,"남자",1475,1632,1606,-26,-131,-157,-0.0159313725490196,-0.0815691158156912,-0.0962009803921569
"754","2015","서울","관악구","초등학교",2015-04-01,"전체",3014,3557,3354,-203,-340,-543,-0.0570705650829351,-0.101371496720334,-0.152656733202137
"755","2015","서울","관악구","초등학교",2015-04-01,"여자",1454,1697,1590,-107,-136,-243,-0.0630524454920448,-0.0855345911949685,-0.143193871538008
"756","2015","서울","관악구","초등학교",2015-04-01,"남자",1560,1860,1764,-96,-204,-300,-0.0516129032258065,-0.115646258503401,-0.161290322580645
"757","2015","서울","서초구","초등학교",2015-04-01,"전체",3926,3839,4001,162,-75,87,0.0421984891898932,-0.0187453136715821,0.0226621516019797
"758","2015","서울","서초구","초등학교",2015-04-01,"여자",1928,1881,1975,94,-47,47,0.049973418394471,-0.0237974683544304,0.0249867091972355
"759","2015","서울","서초구","초등학교",2015-04-01,"남자",1998,1958,2026,68,-28,40,0.034729315628192,-0.0138203356367226,0.0204290091930541
"760","2015","서울","강남구","초등학교",2015-04-01,"전체",3970,4050,4114,64,-144,-80,0.0158024691358025,-0.0350024307243559,-0.0197530864197531
"761","2015","서울","강남구","초등학교",2015-04-01,"여자",1881,1924,1954,30,-73,-43,0.0155925155925156,-0.0373592630501535,-0.0223492723492724
"762","2015","서울","강남구","초등학교",2015-04-01,"남자",2089,2126,2160,34,-71,-37,0.0159924741298213,-0.0328703703703704,-0.0174035747883349
"763","2015","서울","송파구","초등학교",2015-04-01,"전체",5204,5431,5633,202,-429,-227,0.0371938869453139,-0.0761583525652405,-0.0417970907751795
"764","2015","서울","송파구","초등학교",2015-04-01,"여자",2489,2626,2720,94,-231,-137,0.0357958872810358,-0.0849264705882353,-0.0521706016755522
"765","2015","서울","송파구","초등학교",2015-04-01,"남자",2715,2805,2913,108,-198,-90,0.0385026737967914,-0.0679711637487127,-0.0320855614973262
"766","2015","서울","강동구","초등학교",2015-04-01,"전체",3665,4091,3978,-113,-313,-426,-0.027621608408702,-0.0786827551533434,-0.104131019310682
"767","2015","서울","강동구","초등학교",2015-04-01,"여자",1741,2026,1949,-77,-208,-285,-0.0380059230009872,-0.106721395587481,-0.140671273445212
"768","2015","서울","강동구","초등학교",2015-04-01,"남자",1924,2065,2029,-36,-105,-141,-0.0174334140435835,-0.0517496303597831,-0.0682808716707022
"769","2015","부산","중구","초등학교",2015-04-01,"전체",250,217,214,-3,36,33,-0.0138248847926267,0.168224299065421,0.152073732718894
"770","2015","부산","중구","초등학교",2015-04-01,"여자",112,102,98,-4,14,10,-0.0392156862745098,0.142857142857143,0.0980392156862745
"771","2015","부산","중구","초등학교",2015-04-01,"남자",138,115,116,1,22,23,0.00869565217391304,0.189655172413793,0.2
"772","2015","부산","서구","초등학교",2015-04-01,"전체",599,641,622,-19,-23,-42,-0.0296411856474259,-0.0369774919614148,-0.0655226209048362
"773","2015","부산","서구","초등학교",2015-04-01,"여자",316,297,291,-6,25,19,-0.0202020202020202,0.0859106529209622,0.063973063973064
"774","2015","부산","서구","초등학교",2015-04-01,"남자",283,344,331,-13,-48,-61,-0.0377906976744186,-0.145015105740181,-0.177325581395349
"775","2015","부산","동구","초등학교",2015-04-01,"전체",428,508,497,-11,-69,-80,-0.0216535433070866,-0.138832997987928,-0.15748031496063
"776","2015","부산","동구","초등학교",2015-04-01,"여자",209,245,246,1,-37,-36,0.00408163265306122,-0.150406504065041,-0.146938775510204
"777","2015","부산","동구","초등학교",2015-04-01,"남자",219,263,251,-12,-32,-44,-0.0456273764258555,-0.127490039840637,-0.167300380228137
"778","2015","부산","영도구","초등학교",2015-04-01,"전체",731,813,766,-47,-35,-82,-0.0578105781057811,-0.0456919060052219,-0.100861008610086
"779","2015","부산","영도구","초등학교",2015-04-01,"여자",360,413,386,-27,-26,-53,-0.0653753026634383,-0.0673575129533679,-0.128329297820823
"780","2015","부산","영도구","초등학교",2015-04-01,"남자",371,400,380,-20,-9,-29,-0.05,-0.0236842105263158,-0.0725
"781","2015","부산","부산진구","초등학교",2015-04-01,"전체",2724,2796,2679,-117,45,-72,-0.0418454935622318,0.0167973124300112,-0.0257510729613734
"782","2015","부산","부산진구","초등학교",2015-04-01,"여자",1303,1356,1289,-67,14,-53,-0.0494100294985251,0.0108611326609775,-0.0390855457227139
"783","2015","부산","부산진구","초등학교",2015-04-01,"남자",1421,1440,1390,-50,31,-19,-0.0347222222222222,0.0223021582733813,-0.0131944444444444
"784","2015","부산","동래구","초등학교",2015-04-01,"전체",2021,1907,2033,126,-12,114,0.0660723649711589,-0.0059026069847516,0.0597797587834295
"785","2015","부산","동래구","초등학교",2015-04-01,"여자",967,933,972,39,-5,34,0.0418006430868167,-0.0051440329218107,0.0364415862808146
"786","2015","부산","동래구","초등학교",2015-04-01,"남자",1054,974,1061,87,-7,80,0.0893223819301848,-0.00659754948162111,0.082135523613963
"787","2015","부산","남구","초등학교",2015-04-01,"전체",2073,2037,2083,46,-10,36,0.0225822287677958,-0.00480076812289966,0.0176730486008837
"788","2015","부산","남구","초등학교",2015-04-01,"여자",1032,1017,1047,30,-15,15,0.0294985250737463,-0.0143266475644699,0.0147492625368732
"789","2015","부산","남구","초등학교",2015-04-01,"남자",1041,1020,1036,16,5,21,0.0156862745098039,0.00482625482625483,0.0205882352941176
"790","2015","부산","북구","초등학교",2015-04-01,"전체",2252,2361,2314,-47,-62,-109,-0.0199068191444303,-0.0267934312878133,-0.0461668784413384
"791","2015","부산","북구","초등학교",2015-04-01,"여자",1087,1126,1100,-26,-13,-39,-0.0230905861456483,-0.0118181818181818,-0.0346358792184725
"792","2015","부산","북구","초등학교",2015-04-01,"남자",1165,1235,1214,-21,-49,-70,-0.017004048582996,-0.0403624382207578,-0.0566801619433198
"793","2015","부산","해운대구","초등학교",2015-04-01,"전체",3424,3490,3450,-40,-26,-66,-0.0114613180515759,-0.00753623188405797,-0.0189111747851003
"794","2015","부산","해운대구","초등학교",2015-04-01,"여자",1650,1652,1636,-16,14,-2,-0.00968523002421308,0.00855745721271394,-0.00121065375302663
"795","2015","부산","해운대구","초등학교",2015-04-01,"남자",1774,1838,1814,-24,-40,-64,-0.0130576713819369,-0.0220507166482911,-0.0348204570184984
"796","2015","부산","사하구","초등학교",2015-04-01,"전체",2545,2833,2740,-93,-195,-288,-0.0328273914578186,-0.0711678832116788,-0.101659018708083
"797","2015","부산","사하구","초등학교",2015-04-01,"여자",1260,1394,1354,-40,-94,-134,-0.0286944045911047,-0.069423929098966,-0.0961262553802009
"798","2015","부산","사하구","초등학교",2015-04-01,"남자",1285,1439,1386,-53,-101,-154,-0.0368311327310632,-0.0728715728715729,-0.107018763029882
"799","2015","부산","금정구","초등학교",2015-04-01,"전체",1612,1574,1551,-23,61,38,-0.0146124523506989,0.0393294648613798,0.0241423125794155
"800","2015","부산","금정구","초등학교",2015-04-01,"여자",758,732,735,3,23,26,0.00409836065573771,0.0312925170068027,0.0355191256830601
"801","2015","부산","금정구","초등학교",2015-04-01,"남자",854,842,816,-26,38,12,-0.0308788598574822,0.0465686274509804,0.0142517814726841
"802","2015","부산","강서구","초등학교",2015-04-01,"전체",898,626,741,115,157,272,0.18370607028754,0.211875843454791,0.434504792332268
"803","2015","부산","강서구","초등학교",2015-04-01,"여자",460,316,372,56,88,144,0.177215189873418,0.236559139784946,0.455696202531646
"804","2015","부산","강서구","초등학교",2015-04-01,"남자",438,310,369,59,69,128,0.190322580645161,0.186991869918699,0.412903225806452
"805","2015","부산","연제구","초등학교",2015-04-01,"전체",1570,1547,1544,-3,26,23,-0.00193923723335488,0.016839378238342,0.0148674854557207
"806","2015","부산","연제구","초등학교",2015-04-01,"여자",764,745,734,-11,30,19,-0.0147651006711409,0.0408719346049046,0.025503355704698
"807","2015","부산","연제구","초등학교",2015-04-01,"남자",806,802,810,8,-4,4,0.00997506234413965,-0.00493827160493827,0.00498753117206983
"808","2015","부산","수영구","초등학교",2015-04-01,"전체",1102,1162,1118,-44,-16,-60,-0.0378657487091222,-0.0143112701252236,-0.0516351118760757
"809","2015","부산","수영구","초등학교",2015-04-01,"여자",545,580,557,-23,-12,-35,-0.0396551724137931,-0.0215439856373429,-0.0603448275862069
"810","2015","부산","수영구","초등학교",2015-04-01,"남자",557,582,561,-21,-4,-25,-0.0360824742268041,-0.0071301247771836,-0.0429553264604811
"811","2015","부산","사상구","초등학교",2015-04-01,"전체",1562,1773,1705,-68,-143,-211,-0.0383530738860688,-0.0838709677419355,-0.119007332205302
"812","2015","부산","사상구","초등학교",2015-04-01,"여자",771,887,853,-34,-82,-116,-0.0383314543404735,-0.0961313012895662,-0.130777903043968
"813","2015","부산","사상구","초등학교",2015-04-01,"남자",791,886,852,-34,-61,-95,-0.0383747178329571,-0.0715962441314554,-0.107223476297968
"814","2015","부산","기장군","초등학교",2015-04-01,"전체",1720,1380,1635,255,85,340,0.184782608695652,0.0519877675840979,0.246376811594203
"815","2015","부산","기장군","초등학교",2015-04-01,"여자",840,669,795,126,45,171,0.188340807174888,0.0566037735849057,0.255605381165919
"816","2015","부산","기장군","초등학교",2015-04-01,"남자",880,711,840,129,40,169,0.181434599156118,0.0476190476190476,0.237693389592124
"817","2015","대구","중구","초등학교",2015-04-01,"전체",725,508,479,-29,246,217,-0.0570866141732283,0.51356993736952,0.427165354330709
"818","2015","대구","중구","초등학교",2015-04-01,"여자",345,248,233,-15,112,97,-0.0604838709677419,0.48068669527897,0.391129032258065
"819","2015","대구","중구","초등학교",2015-04-01,"남자",380,260,246,-14,134,120,-0.0538461538461538,0.544715447154472,0.461538461538462
"820","2015","대구","동구","초등학교",2015-04-01,"전체",2929,2892,2910,18,19,37,0.00622406639004149,0.00652920962199313,0.0127939142461964
"821","2015","대구","동구","초등학교",2015-04-01,"여자",1444,1387,1406,19,38,57,0.0136986301369863,0.027027027027027,0.0410958904109589
"822","2015","대구","동구","초등학교",2015-04-01,"남자",1485,1505,1504,-1,-19,-20,-0.000664451827242525,-0.0126329787234043,-0.0132890365448505
"823","2015","대구","서구","초등학교",2015-04-01,"전체",1080,1278,1209,-69,-129,-198,-0.0539906103286385,-0.106699751861042,-0.154929577464789
"824","2015","대구","서구","초등학교",2015-04-01,"여자",532,644,616,-28,-84,-112,-0.0434782608695652,-0.136363636363636,-0.173913043478261
"825","2015","대구","서구","초등학교",2015-04-01,"남자",548,634,593,-41,-45,-86,-0.0646687697160883,-0.075885328836425,-0.135646687697161
"826","2015","대구","남구","초등학교",2015-04-01,"전체",832,1019,987,-32,-155,-187,-0.0314033366045142,-0.157041540020263,-0.18351324828263
"827","2015","대구","남구","초등학교",2015-04-01,"여자",387,475,457,-18,-70,-88,-0.0378947368421053,-0.153172866520788,-0.185263157894737
"828","2015","대구","남구","초등학교",2015-04-01,"남자",445,544,530,-14,-85,-99,-0.0257352941176471,-0.160377358490566,-0.181985294117647
"829","2015","대구","북구","초등학교",2015-04-01,"전체",4014,4258,4167,-91,-153,-244,-0.0213715359323626,-0.0367170626349892,-0.0573038985439173
"830","2015","대구","북구","초등학교",2015-04-01,"여자",1929,2038,2007,-31,-78,-109,-0.0152109911678116,-0.038863976083707,-0.0534838076545633
"831","2015","대구","북구","초등학교",2015-04-01,"남자",2085,2220,2160,-60,-75,-135,-0.027027027027027,-0.0347222222222222,-0.0608108108108108
"832","2015","대구","수성구","초등학교",2015-04-01,"전체",3821,3479,3766,287,55,342,0.0824949698189135,0.0146043547530536,0.098304110376545
"833","2015","대구","수성구","초등학교",2015-04-01,"여자",1831,1636,1765,129,66,195,0.0788508557457213,0.0373937677053824,0.11919315403423
"834","2015","대구","수성구","초등학교",2015-04-01,"남자",1990,1843,2001,158,-11,147,0.085729788388497,-0.00549725137431284,0.079761258817146
"835","2015","대구","달서구","초등학교",2015-04-01,"전체",5526,5186,5283,97,243,340,0.0187042036251446,0.0459965928449744,0.0655611261087543
"836","2015","대구","달서구","초등학교",2015-04-01,"여자",2620,2472,2497,25,123,148,0.0101132686084142,0.0492591109331197,0.0598705501618123
"837","2015","대구","달서구","초등학교",2015-04-01,"남자",2906,2714,2786,72,120,192,0.0265291083271923,0.0430725053840632,0.0707442888725129
"838","2015","대구","달성군","초등학교",2015-04-01,"전체",1896,2061,1994,-67,-98,-165,-0.0325084910237749,-0.0491474423269809,-0.0800582241630277
"839","2015","대구","달성군","초등학교",2015-04-01,"여자",910,973,950,-23,-40,-63,-0.0236382322713258,-0.0421052631578947,-0.0647482014388489
"840","2015","대구","달성군","초등학교",2015-04-01,"남자",986,1088,1044,-44,-58,-102,-0.0404411764705882,-0.0555555555555556,-0.09375
"841","2015","인천","중구","초등학교",2015-04-01,"전체",1244,992,1045,53,199,252,0.0534274193548387,0.190430622009569,0.254032258064516
"842","2015","인천","중구","초등학교",2015-04-01,"여자",621,507,524,17,97,114,0.0335305719921105,0.185114503816794,0.224852071005917
"843","2015","인천","중구","초등학교",2015-04-01,"남자",623,485,521,36,102,138,0.0742268041237113,0.195777351247601,0.284536082474227
"844","2015","인천","동구","초등학교",2015-04-01,"전체",754,678,647,-31,107,76,-0.0457227138643068,0.165378670788253,0.112094395280236
"845","2015","인천","동구","초등학교",2015-04-01,"여자",376,331,321,-10,55,45,-0.0302114803625378,0.171339563862928,0.13595166163142
"846","2015","인천","동구","초등학교",2015-04-01,"남자",378,347,326,-21,52,31,-0.0605187319884726,0.159509202453988,0.0893371757925072
"847","2015","인천","남구","초등학교",2015-04-01,"전체",2972,3460,3359,-101,-387,-488,-0.0291907514450867,-0.115212860970527,-0.141040462427746
"848","2015","인천","남구","초등학교",2015-04-01,"여자",1427,1659,1623,-36,-196,-232,-0.0216998191681736,-0.120764017252002,-0.139843279083785
"849","2015","인천","남구","초등학교",2015-04-01,"남자",1545,1801,1736,-65,-191,-256,-0.0360910605219323,-0.110023041474654,-0.142143253747918
"850","2015","인천","연수구","초등학교",2015-04-01,"전체",3134,2681,2961,280,173,453,0.10443864229765,0.0584262073623776,0.168966803431555
"851","2015","인천","연수구","초등학교",2015-04-01,"여자",1504,1218,1364,146,140,286,0.119868637110016,0.102639296187683,0.234811165845649
"852","2015","인천","연수구","초등학교",2015-04-01,"남자",1630,1463,1597,134,33,167,0.0915926179084074,0.0206637445209768,0.114149008885851
"853","2015","인천","남동구","초등학교",2015-04-01,"전체",4980,5186,5201,15,-221,-206,0.00289240262244504,-0.0424918284945203,-0.0397223293482453
"854","2015","인천","남동구","초등학교",2015-04-01,"여자",2472,2557,2565,8,-93,-85,0.00312866640594447,-0.0362573099415205,-0.03324208056316
"855","2015","인천","남동구","초등학교",2015-04-01,"남자",2508,2629,2636,7,-128,-121,0.00266260935717003,-0.0485584218512898,-0.0460251046025105
"856","2015","인천","부평구","초등학교",2015-04-01,"전체",4537,4920,4737,-183,-200,-383,-0.0371951219512195,-0.0422208148617268,-0.0778455284552846
"857","2015","인천","부평구","초등학교",2015-04-01,"여자",2179,2355,2273,-82,-94,-176,-0.0348195329087049,-0.0413550373955125,-0.0747346072186836
"858","2015","인천","부평구","초등학교",2015-04-01,"남자",2358,2565,2464,-101,-106,-207,-0.0393762183235867,-0.0430194805194805,-0.0807017543859649
"859","2015","인천","계양구","초등학교",2015-04-01,"전체",2964,3090,3055,-35,-91,-126,-0.0113268608414239,-0.0297872340425532,-0.0407766990291262
"860","2015","인천","계양구","초등학교",2015-04-01,"여자",1476,1521,1524,3,-48,-45,0.0019723865877712,-0.031496062992126,-0.029585798816568
"861","2015","인천","계양구","초등학교",2015-04-01,"남자",1488,1569,1531,-38,-43,-81,-0.024219247928617,-0.0280862181580666,-0.0516252390057361
"862","2015","인천","서구","초등학교",2015-04-01,"전체",5471,5414,5575,161,-104,57,0.0297377170299224,-0.0186547085201794,0.0105282600664943
"863","2015","인천","서구","초등학교",2015-04-01,"여자",2726,2621,2720,99,6,105,0.0377718428080885,0.00220588235294118,0.0400610454025181
"864","2015","인천","서구","초등학교",2015-04-01,"남자",2745,2793,2855,62,-110,-48,0.0221983530254207,-0.0385288966725044,-0.0171858216970999
"865","2015","인천","강화군","초등학교",2015-04-01,"전체",382,359,368,9,14,23,0.0250696378830084,0.0380434782608696,0.064066852367688
"866","2015","인천","강화군","초등학교",2015-04-01,"여자",196,175,182,7,14,21,0.04,0.0769230769230769,0.12
"867","2015","인천","강화군","초등학교",2015-04-01,"남자",186,184,186,2,0,2,0.0108695652173913,0,0.0108695652173913
"868","2015","인천","옹진군","초등학교",2015-04-01,"전체",107,149,162,13,-55,-42,0.087248322147651,-0.339506172839506,-0.281879194630872
"869","2015","인천","옹진군","초등학교",2015-04-01,"여자",52,74,76,2,-24,-22,0.027027027027027,-0.315789473684211,-0.297297297297297
"870","2015","인천","옹진군","초등학교",2015-04-01,"남자",55,75,86,11,-31,-20,0.146666666666667,-0.36046511627907,-0.266666666666667
"871","2015","광주","동구","초등학교",2015-04-01,"전체",530,647,624,-23,-94,-117,-0.035548686244204,-0.150641025641026,-0.180834621329212
"872","2015","광주","동구","초등학교",2015-04-01,"여자",260,306,295,-11,-35,-46,-0.0359477124183007,-0.11864406779661,-0.150326797385621
"873","2015","광주","동구","초등학교",2015-04-01,"남자",270,341,329,-12,-59,-71,-0.0351906158357771,-0.179331306990881,-0.208211143695015
"874","2015","광주","서구","초등학교",2015-04-01,"전체",2852,3046,2960,-86,-108,-194,-0.0282337491792515,-0.0364864864864865,-0.0636900853578464
"875","2015","광주","서구","초등학교",2015-04-01,"여자",1397,1483,1441,-42,-44,-86,-0.0283209710047202,-0.0305343511450382,-0.0579905596763318
"876","2015","광주","서구","초등학교",2015-04-01,"남자",1455,1563,1519,-44,-64,-108,-0.0281509916826615,-0.0421329822251481,-0.0690978886756238
"877","2015","광주","남구","초등학교",2015-04-01,"전체",2076,1786,1854,68,222,290,0.038073908174692,0.119741100323625,0.162374020156775
"878","2015","광주","남구","초등학교",2015-04-01,"여자",1000,884,916,32,84,116,0.0361990950226244,0.091703056768559,0.131221719457014
"879","2015","광주","남구","초등학교",2015-04-01,"남자",1076,902,938,36,138,174,0.0399113082039911,0.147121535181237,0.19290465631929
"880","2015","광주","북구","초등학교",2015-04-01,"전체",3986,3955,3979,24,7,31,0.00606826801517067,0.00175923598894195,0.00783817951959545
"881","2015","광주","북구","초등학교",2015-04-01,"여자",1935,1887,1921,34,14,48,0.018018018018018,0.00728787090057262,0.0254372019077901
"882","2015","광주","북구","초등학교",2015-04-01,"남자",2051,2068,2058,-10,-7,-17,-0.00483558994197292,-0.00340136054421769,-0.00822050290135396
"883","2015","광주","광산구","초등학교",2015-04-01,"전체",5397,5251,5352,101,45,146,0.0192344315368501,0.00840807174887892,0.0278042277661398
"884","2015","광주","광산구","초등학교",2015-04-01,"여자",2658,2651,2677,26,-19,7,0.00980761976612599,-0.00709749719835637,0.002640513013957
"885","2015","광주","광산구","초등학교",2015-04-01,"남자",2739,2600,2675,75,64,139,0.0288461538461538,0.0239252336448598,0.0534615384615385
"886","2015","대전","동구","초등학교",2015-04-01,"전체",2140,2430,2342,-88,-202,-290,-0.0362139917695473,-0.0862510674637062,-0.119341563786008
"887","2015","대전","동구","초등학교",2015-04-01,"여자",1035,1166,1126,-40,-91,-131,-0.0343053173241852,-0.0808170515097691,-0.112349914236707
"888","2015","대전","동구","초등학교",2015-04-01,"남자",1105,1264,1216,-48,-111,-159,-0.0379746835443038,-0.0912828947368421,-0.125791139240506
"889","2015","대전","중구","초등학교",2015-04-01,"전체",2374,2329,2343,14,31,45,0.0060111635895234,0.0132309005548442,0.0193215972520395
"890","2015","대전","중구","초등학교",2015-04-01,"여자",1119,1088,1111,23,8,31,0.0211397058823529,0.0072007200720072,0.0284926470588235
"891","2015","대전","중구","초등학교",2015-04-01,"남자",1255,1241,1232,-9,23,14,-0.0072522159548751,0.0186688311688312,0.0112812248186946
"892","2015","대전","서구","초등학교",2015-04-01,"전체",4476,4441,4485,44,-9,35,0.00990767845079937,-0.0020066889632107,0.00788110785859041
"893","2015","대전","서구","초등학교",2015-04-01,"여자",2160,2079,2104,25,56,81,0.012025012025012,0.026615969581749,0.038961038961039
"894","2015","대전","서구","초등학교",2015-04-01,"남자",2316,2362,2381,19,-65,-46,0.00804403048264183,-0.0272994540109198,-0.0194750211685013
"895","2015","대전","유성구","초등학교",2015-04-01,"전체",4122,3919,4030,111,92,203,0.0283235519265119,0.0228287841191067,0.0517989282980352
"896","2015","대전","유성구","초등학교",2015-04-01,"여자",1998,1878,1933,55,65,120,0.0292864749733759,0.0336264873254009,0.0638977635782748
"897","2015","대전","유성구","초등학교",2015-04-01,"남자",2124,2041,2097,56,27,83,0.027437530622244,0.0128755364806867,0.0406663400293974
"898","2015","대전","대덕구","초등학교",2015-04-01,"전체",1721,1821,1796,-25,-75,-100,-0.013728720483251,-0.0417594654788419,-0.0549148819330038
"899","2015","대전","대덕구","초등학교",2015-04-01,"여자",872,906,886,-20,-14,-34,-0.022075055187638,-0.0158013544018059,-0.0375275938189845
"900","2015","대전","대덕구","초등학교",2015-04-01,"남자",849,915,910,-5,-61,-66,-0.00546448087431694,-0.067032967032967,-0.0721311475409836
"901","2015","울산","중구","초등학교",2015-04-01,"전체",2063,1868,1943,75,120,195,0.0401498929336188,0.0617601646937725,0.104389721627409
"902","2015","울산","중구","초등학교",2015-04-01,"여자",1004,899,941,42,63,105,0.0467185761957731,0.0669500531349628,0.116796440489433
"903","2015","울산","중구","초등학교",2015-04-01,"남자",1059,969,1002,33,57,90,0.0340557275541796,0.0568862275449102,0.0928792569659443
"904","2015","울산","남구","초등학교",2015-04-01,"전체",2840,2985,3015,30,-175,-145,0.0100502512562814,-0.0580431177446103,-0.0485762144053601
"905","2015","울산","남구","초등학교",2015-04-01,"여자",1358,1435,1449,14,-91,-77,0.00975609756097561,-0.0628019323671498,-0.0536585365853659
"906","2015","울산","남구","초등학교",2015-04-01,"남자",1482,1550,1566,16,-84,-68,0.0103225806451613,-0.053639846743295,-0.0438709677419355
"907","2015","울산","동구","초등학교",2015-04-01,"전체",1775,1875,1854,-21,-79,-100,-0.0112,-0.0426105717367853,-0.0533333333333333
"908","2015","울산","동구","초등학교",2015-04-01,"여자",834,873,863,-10,-29,-39,-0.011454753722795,-0.033603707995365,-0.0446735395189003
"909","2015","울산","동구","초등학교",2015-04-01,"남자",941,1002,991,-11,-50,-61,-0.0109780439121756,-0.0504540867810293,-0.0608782435129741
"910","2015","울산","북구","초등학교",2015-04-01,"전체",2349,2426,2412,-14,-63,-77,-0.00577081615828524,-0.0261194029850746,-0.0317394888705688
"911","2015","울산","북구","초등학교",2015-04-01,"여자",1138,1143,1153,10,-15,-5,0.00874890638670166,-0.013009540329575,-0.00437445319335083
"912","2015","울산","북구","초등학교",2015-04-01,"남자",1211,1283,1259,-24,-48,-72,-0.0187061574434918,-0.0381254964257347,-0.0561184723304754
"913","2015","울산","울주군","초등학교",2015-04-01,"전체",2325,2213,2196,-17,129,112,-0.00768187980117488,0.0587431693989071,0.0506100316312698
"914","2015","울산","울주군","초등학교",2015-04-01,"여자",1103,1100,1082,-18,21,3,-0.0163636363636364,0.0194085027726433,0.00272727272727273
"915","2015","울산","울주군","초등학교",2015-04-01,"남자",1222,1113,1114,1,108,109,0.000898472596585804,0.0969479353680431,0.0979335130278527
"916","2015","세종","세종시","초등학교",2015-04-01,"전체",2578,1274,1518,244,1060,1304,0.191522762951334,0.69828722002635,1.02354788069074
"917","2015","세종","세종시","초등학교",2015-04-01,"전체",2578,1274,1518,244,1060,1304,0.191522762951334,0.69828722002635,1.02354788069074
"918","2015","세종","세종시","초등학교",2015-04-01,"전체",2578,1274,1518,244,1060,1304,0.191522762951334,0.69828722002635,1.02354788069074
"919","2015","세종","세종시","초등학교",2015-04-01,"전체",2578,1274,1518,244,1060,1304,0.191522762951334,0.69828722002635,1.02354788069074
"920","2015","세종","세종시","초등학교",2015-04-01,"여자",1291,624,752,128,539,667,0.205128205128205,0.716755319148936,1.06891025641026
"921","2015","세종","세종시","초등학교",2015-04-01,"여자",1291,624,752,128,539,667,0.205128205128205,0.716755319148936,1.06891025641026
"922","2015","세종","세종시","초등학교",2015-04-01,"여자",1291,624,752,128,539,667,0.205128205128205,0.716755319148936,1.06891025641026
"923","2015","세종","세종시","초등학교",2015-04-01,"여자",1291,624,752,128,539,667,0.205128205128205,0.716755319148936,1.06891025641026
"924","2015","세종","세종시","초등학교",2015-04-01,"남자",1287,650,766,116,521,637,0.178461538461538,0.680156657963446,0.98
"925","2015","세종","세종시","초등학교",2015-04-01,"남자",1287,650,766,116,521,637,0.178461538461538,0.680156657963446,0.98
"926","2015","세종","세종시","초등학교",2015-04-01,"남자",1287,650,766,116,521,637,0.178461538461538,0.680156657963446,0.98
"927","2015","세종","세종시","초등학교",2015-04-01,"남자",1287,650,766,116,521,637,0.178461538461538,0.680156657963446,0.98
"928","2015","경기","수원시","초등학교",2015-04-01,"전체",11849,11296,11691,395,158,553,0.0349681303116147,0.0135146694038149,0.0489553824362606
"929","2015","경기","수원시","초등학교",2015-04-01,"여자",5760,5439,5641,202,119,321,0.0371391799963229,0.0210955504343202,0.0590182018753447
"930","2015","경기","수원시","초등학교",2015-04-01,"남자",6089,5857,6050,193,39,232,0.0329520232200785,0.00644628099173554,0.0396107222127369
"931","2015","경기","성남시","초등학교",2015-04-01,"전체",7921,8378,8334,-44,-413,-457,-0.00525185008355216,-0.0495560355171586,-0.0545476247314395
"932","2015","경기","성남시","초등학교",2015-04-01,"여자",3854,4100,4072,-28,-218,-246,-0.00682926829268293,-0.0535363457760314,-0.06
"933","2015","경기","성남시","초등학교",2015-04-01,"남자",4067,4278,4262,-16,-195,-211,-0.0037400654511454,-0.0457531675269826,-0.0493221131369799
"934","2015","경기","부천시","초등학교",2015-04-01,"전체",7048,7493,7312,-181,-264,-445,-0.0241558788202322,-0.0361050328227571,-0.0593887628453223
"935","2015","경기","부천시","초등학교",2015-04-01,"여자",3439,3654,3562,-92,-123,-215,-0.0251778872468528,-0.0345311622683885,-0.058839627805145
"936","2015","경기","부천시","초등학교",2015-04-01,"남자",3609,3839,3750,-89,-141,-230,-0.023183120604324,-0.0376,-0.0599114352696015
"937","2015","경기","안양시","초등학교",2015-04-01,"전체",5127,5263,5172,-91,-45,-136,-0.0172905187155615,-0.00870069605568445,-0.0258407752232567
"938","2015","경기","안양시","초등학교",2015-04-01,"여자",2501,2523,2484,-39,17,-22,-0.0154577883472057,0.00684380032206119,-0.00871977804201348
"939","2015","경기","안양시","초등학교",2015-04-01,"남자",2626,2740,2688,-52,-62,-114,-0.018978102189781,-0.0230654761904762,-0.0416058394160584
"940","2015","경기","과천시","초등학교",2015-04-01,"전체",554,581,589,8,-35,-27,0.0137693631669535,-0.0594227504244482,-0.0464716006884682
"941","2015","경기","과천시","초등학교",2015-04-01,"여자",276,282,285,3,-9,-6,0.0106382978723404,-0.0315789473684211,-0.0212765957446809
"942","2015","경기","과천시","초등학교",2015-04-01,"남자",278,299,304,5,-26,-21,0.0167224080267559,-0.0855263157894737,-0.0702341137123746
"943","2015","경기","안산시","초등학교",2015-04-01,"전체",6508,6558,6478,-80,30,-50,-0.0121988411100945,0.00463105896881754,-0.00762427569380909
"944","2015","경기","안산시","초등학교",2015-04-01,"여자",3154,3228,3165,-63,-11,-74,-0.0195167286245353,-0.00347551342812006,-0.0229244114002478
"945","2015","경기","안산시","초등학교",2015-04-01,"남자",3354,3330,3313,-17,41,24,-0.0051051051051051,0.0123754904920012,0.00720720720720721
"946","2015","경기","용인시","초등학교",2015-04-01,"전체",11757,11736,12023,287,-266,21,0.0244546693933197,-0.0221242618314896,0.00178936605316973
"947","2015","경기","용인시","초등학교",2015-04-01,"여자",5680,5697,5859,162,-179,-17,0.028436018957346,-0.0305512886158047,-0.00298402668070915
"948","2015","경기","용인시","초등학교",2015-04-01,"남자",6077,6039,6164,125,-87,38,0.0206987911905945,-0.0141142115509409,0.00629243252194072
"949","2015","경기","군포시","초등학교",2015-04-01,"전체",2892,3029,2973,-56,-81,-137,-0.0184879498184219,-0.0272452068617558,-0.0452294486629251
"950","2015","경기","군포시","초등학교",2015-04-01,"여자",1385,1505,1463,-42,-78,-120,-0.027906976744186,-0.0533151059466849,-0.079734219269103
"951","2015","경기","군포시","초등학교",2015-04-01,"남자",1507,1524,1510,-14,-3,-17,-0.00918635170603675,-0.00198675496688742,-0.0111548556430446
"952","2015","경기","의왕시","초등학교",2015-04-01,"전체",1397,1651,1627,-24,-230,-254,-0.0145366444579043,-0.141364474492932,-0.153846153846154
"953","2015","경기","의왕시","초등학교",2015-04-01,"여자",668,792,782,-10,-114,-124,-0.0126262626262626,-0.145780051150895,-0.156565656565657
"954","2015","경기","의왕시","초등학교",2015-04-01,"남자",729,859,845,-14,-116,-130,-0.0162980209545984,-0.137278106508876,-0.151338766006985
"955","2015","경기","시흥시","초등학교",2015-04-01,"전체",4152,4309,4203,-106,-51,-157,-0.0245996750986308,-0.0121341898643826,-0.0364353678347644
"956","2015","경기","시흥시","초등학교",2015-04-01,"여자",1973,2051,1983,-68,-10,-78,-0.0331545587518284,-0.00504286434694907,-0.038030229156509
"957","2015","경기","시흥시","초등학교",2015-04-01,"남자",2179,2258,2220,-38,-41,-79,-0.016829052258636,-0.0184684684684685,-0.0349867139061116
"958","2015","경기","평택시","초등학교",2015-04-01,"전체",4718,4608,4690,82,28,110,0.0177951388888889,0.00597014925373134,0.0238715277777778
"959","2015","경기","평택시","초등학교",2015-04-01,"여자",2317,2255,2292,37,25,62,0.0164079822616408,0.0109075043630017,0.0274944567627494
"960","2015","경기","평택시","초등학교",2015-04-01,"남자",2401,2353,2398,45,3,48,0.0191245218869528,0.00125104253544621,0.0203994900127497
"961","2015","경기","화성시","초등학교",2015-04-01,"전체",8225,8226,8084,-142,141,-1,-0.0172623389253586,0.0174418604651163,-0.00012156576707999
"962","2015","경기","화성시","초등학교",2015-04-01,"여자",4014,3945,3892,-53,122,69,-0.0134347275031686,0.0313463514902364,0.0174904942965779
"963","2015","경기","화성시","초등학교",2015-04-01,"남자",4211,4281,4192,-89,19,-70,-0.0207895351553375,0.0045324427480916,-0.0163513197850969
"964","2015","경기","오산시","초등학교",2015-04-01,"전체",2971,2926,2986,60,-15,45,0.0205058099794942,-0.00502344273275285,0.0153793574846206
"965","2015","경기","오산시","초등학교",2015-04-01,"여자",1371,1368,1392,24,-21,3,0.0175438596491228,-0.0150862068965517,0.00219298245614035
"966","2015","경기","오산시","초등학교",2015-04-01,"남자",1600,1558,1594,36,6,42,0.0231065468549422,0.00376411543287327,0.0269576379974326
"967","2015","경기","광명시","초등학교",2015-04-01,"전체",3612,3879,3770,-109,-158,-267,-0.0281000257798402,-0.0419098143236074,-0.0688321732405259
"968","2015","경기","광명시","초등학교",2015-04-01,"여자",1790,1917,1847,-70,-57,-127,-0.0365153886280647,-0.0308608554412561,-0.0662493479394888
"969","2015","경기","광명시","초등학교",2015-04-01,"남자",1822,1962,1923,-39,-101,-140,-0.0198776758409786,-0.0525221008840354,-0.0713557594291539
"970","2015","경기","광주시","초등학교",2015-04-01,"전체",2939,3041,3064,23,-125,-102,0.00756330154554423,-0.0407963446475196,-0.0335415981585005
"971","2015","경기","광주시","초등학교",2015-04-01,"여자",1478,1471,1485,14,-7,7,0.00951733514615908,-0.00471380471380471,0.00475866757307954
"972","2015","경기","광주시","초등학교",2015-04-01,"남자",1461,1570,1579,9,-118,-109,0.00573248407643312,-0.0747308423052565,-0.0694267515923567
"973","2015","경기","하남시","초등학교",2015-04-01,"전체",1390,1310,1293,-17,97,80,-0.0129770992366412,0.0750193348801237,0.0610687022900763
"974","2015","경기","하남시","초등학교",2015-04-01,"여자",681,678,665,-13,16,3,-0.0191740412979351,0.0240601503759399,0.00442477876106195
"975","2015","경기","하남시","초등학교",2015-04-01,"남자",709,632,628,-4,81,77,-0.00632911392405063,0.128980891719745,0.121835443037975
"976","2015","경기","김포시","초등학교",2015-04-01,"전체",4265,3594,3936,342,329,671,0.0951585976627713,0.0835873983739837,0.186700055648303
"977","2015","경기","김포시","초등학교",2015-04-01,"여자",2107,1762,1919,157,188,345,0.0891032917139614,0.0979676915059927,0.195800227014756
"978","2015","경기","김포시","초등학교",2015-04-01,"남자",2158,1832,2017,185,141,326,0.100982532751092,0.0699058006941001,0.177947598253275
"979","2015","경기","이천시","초등학교",2015-04-01,"전체",2168,2220,2199,-21,-31,-52,-0.00945945945945946,-0.0140973169622556,-0.0234234234234234
"980","2015","경기","이천시","초등학교",2015-04-01,"여자",1027,1055,1045,-10,-18,-28,-0.00947867298578199,-0.0172248803827751,-0.0265402843601896
"981","2015","경기","이천시","초등학교",2015-04-01,"남자",1141,1165,1154,-11,-13,-24,-0.00944206008583691,-0.011265164644714,-0.0206008583690987
"982","2015","경기","안성시","초등학교",2015-04-01,"전체",1926,1975,1958,-17,-32,-49,-0.00860759493670886,-0.0163432073544433,-0.0248101265822785
"983","2015","경기","안성시","초등학교",2015-04-01,"여자",936,957,949,-8,-13,-21,-0.00835945663531871,-0.0136986301369863,-0.0219435736677116
"984","2015","경기","안성시","초등학교",2015-04-01,"남자",990,1018,1009,-9,-19,-28,-0.00884086444007859,-0.0188305252725471,-0.0275049115913556
"985","2015","경기","여주군","초등학교",2015-04-01,"전체",884,967,NA,NA,NA,-83,NA,NA,-0.0858324715615305
"986","2015","경기","여주군","초등학교",2015-04-01,"여자",409,459,NA,NA,NA,-50,NA,NA,-0.108932461873638
"987","2015","경기","여주군","초등학교",2015-04-01,"남자",475,508,NA,NA,NA,-33,NA,NA,-0.0649606299212598
"988","2015","경기","양평군","초등학교",2015-04-01,"전체",816,775,821,46,-5,41,0.0593548387096774,-0.00609013398294762,0.0529032258064516
"989","2015","경기","양평군","초등학교",2015-04-01,"여자",406,381,399,18,7,25,0.047244094488189,0.0175438596491228,0.0656167979002625
"990","2015","경기","양평군","초등학교",2015-04-01,"남자",410,394,422,28,-12,16,0.0710659898477157,-0.028436018957346,0.0406091370558376
"991","2015","경기","고양시","초등학교",2015-04-01,"전체",9234,8903,9281,378,-47,331,0.0424575985622824,-0.00506410947096218,0.0371784791643266
"992","2015","경기","고양시","초등학교",2015-04-01,"여자",4519,4423,4598,175,-79,96,0.0395659054940086,-0.0171813832100913,0.0217047252995704
"993","2015","경기","고양시","초등학교",2015-04-01,"남자",4715,4480,4683,203,32,235,0.0453125,0.00683322656416827,0.0524553571428571
"994","2015","경기","남양주시","초등학교",2015-04-01,"전체",7243,7370,7514,144,-271,-127,0.0195386702849389,-0.036066010114453,-0.0172320217096337
"995","2015","경기","남양주시","초등학교",2015-04-01,"여자",3468,3562,3629,67,-161,-94,0.0188096574957889,-0.0443648387985671,-0.0263896687254351
"996","2015","경기","남양주시","초등학교",2015-04-01,"남자",3775,3808,3885,77,-110,-33,0.0202205882352941,-0.0283140283140283,-0.00866596638655462
"997","2015","경기","구리시","초등학교",2015-04-01,"전체",1607,1798,1738,-60,-131,-191,-0.0333704115684093,-0.0753739930955121,-0.10622914349277
"998","2015","경기","구리시","초등학교",2015-04-01,"여자",823,887,858,-29,-35,-64,-0.0326944757609921,-0.0407925407925408,-0.0721533258173619
"999","2015","경기","구리시","초등학교",2015-04-01,"남자",784,911,880,-31,-96,-127,-0.0340285400658617,-0.109090909090909,-0.13940724478595
"1000","2015","경기","의정부시","초등학교",2015-04-01,"전체",3574,3914,3895,-19,-321,-340,-0.00485436893203883,-0.082413350449294,-0.0868676545733265
"1001","2015","경기","의정부시","초등학교",2015-04-01,"여자",1718,1949,1931,-18,-213,-231,-0.00923550538737814,-0.110305541170378,-0.118522319138019
"1002","2015","경기","의정부시","초등학교",2015-04-01,"남자",1856,1965,1964,-1,-108,-109,-0.000508905852417303,-0.054989816700611,-0.055470737913486
"1003","2015","경기","파주시","초등학교",2015-04-01,"전체",4757,4774,4758,-16,-1,-17,-0.00335148722245496,-0.000210172341319882,-0.0035609551738584
"1004","2015","경기","파주시","초등학교",2015-04-01,"여자",2301,2279,2288,9,13,22,0.00394910048266784,0.00568181818181818,0.00965335673541027
"1005","2015","경기","파주시","초등학교",2015-04-01,"남자",2456,2495,2470,-25,-14,-39,-0.0100200400801603,-0.00566801619433198,-0.0156312625250501
"1006","2015","경기","동두천시","초등학교",2015-04-01,"전체",866,927,901,-26,-35,-61,-0.0280474649406688,-0.0388457269700333,-0.0658036677454153
"1007","2015","경기","동두천시","초등학교",2015-04-01,"여자",452,494,487,-7,-35,-42,-0.01417004048583,-0.0718685831622177,-0.0850202429149798
"1008","2015","경기","동두천시","초등학교",2015-04-01,"남자",414,433,414,-19,0,-19,-0.0438799076212471,0,-0.0438799076212471
"1009","2015","경기","양주시","초등학교",2015-04-01,"전체",2212,2266,2218,-48,-6,-54,-0.0211827007943513,-0.00270513976555455,-0.0238305383936452
"1010","2015","경기","양주시","초등학교",2015-04-01,"여자",1101,1123,1103,-20,-2,-22,-0.0178094390026714,-0.00181323662737987,-0.0195903829029386
"1011","2015","경기","양주시","초등학교",2015-04-01,"남자",1111,1143,1115,-28,-4,-32,-0.0244969378827647,-0.00358744394618834,-0.0279965004374453
"1012","2015","경기","포천시","초등학교",2015-04-01,"전체",1240,1181,1183,2,57,59,0.00169348010160881,0.0481825866441251,0.0499576629974598
"1013","2015","경기","포천시","초등학교",2015-04-01,"여자",587,585,589,4,-2,2,0.00683760683760684,-0.0033955857385399,0.00341880341880342
"1014","2015","경기","포천시","초등학교",2015-04-01,"남자",653,596,594,-2,59,57,-0.00335570469798658,0.0993265993265993,0.0956375838926175
"1015","2015","경기","가평군","초등학교",2015-04-01,"전체",438,435,437,2,1,3,0.00459770114942529,0.0022883295194508,0.00689655172413793
"1016","2015","경기","가평군","초등학교",2015-04-01,"여자",214,206,209,3,5,8,0.0145631067961165,0.0239234449760766,0.0388349514563107
"1017","2015","경기","가평군","초등학교",2015-04-01,"남자",224,229,228,-1,-4,-5,-0.00436681222707424,-0.0175438596491228,-0.0218340611353712
"1018","2015","경기","연천군","초등학교",2015-04-01,"전체",300,317,309,-8,-9,-17,-0.0252365930599369,-0.029126213592233,-0.0536277602523659
"1019","2015","경기","연천군","초등학교",2015-04-01,"여자",143,152,147,-5,-4,-9,-0.0328947368421053,-0.0272108843537415,-0.0592105263157895
"1020","2015","경기","연천군","초등학교",2015-04-01,"남자",157,165,162,-3,-5,-8,-0.0181818181818182,-0.0308641975308642,-0.0484848484848485
"1021","2015","강원","춘천시","초등학교",2015-04-01,"전체",2436,2382,2384,2,52,54,0.000839630562552477,0.0218120805369128,0.0226700251889169
"1022","2015","강원","춘천시","초등학교",2015-04-01,"여자",1159,1115,1125,10,34,44,0.00896860986547085,0.0302222222222222,0.0394618834080717
"1023","2015","강원","춘천시","초등학교",2015-04-01,"남자",1277,1267,1259,-8,18,10,-0.00631412786108919,0.0142970611596505,0.00789265982636148
"1024","2015","강원","원주시","초등학교",2015-04-01,"전체",3085,3039,3083,44,2,46,0.0144784468575189,0.000648718780408693,0.0151365580783152
"1025","2015","강원","원주시","초등학교",2015-04-01,"여자",1516,1433,1456,23,60,83,0.0160502442428472,0.0412087912087912,0.057920446615492
"1026","2015","강원","원주시","초등학교",2015-04-01,"남자",1569,1606,1627,21,-58,-37,0.0130759651307597,-0.0356484326982176,-0.0230386052303861
"1027","2015","강원","강릉시","초등학교",2015-04-01,"전체",1627,1629,1641,12,-14,-2,0.00736648250460405,-0.00853138330286411,-0.00122774708410068
"1028","2015","강원","강릉시","초등학교",2015-04-01,"여자",777,801,810,9,-33,-24,0.0112359550561798,-0.0407407407407407,-0.0299625468164794
"1029","2015","강원","강릉시","초등학교",2015-04-01,"남자",850,828,831,3,19,22,0.0036231884057971,0.022864019253911,0.0265700483091787
"1030","2015","강원","동해시","초등학교",2015-04-01,"전체",836,815,816,1,20,21,0.00122699386503067,0.0245098039215686,0.0257668711656442
"1031","2015","강원","동해시","초등학교",2015-04-01,"여자",384,378,381,3,3,6,0.00793650793650794,0.0078740157480315,0.0158730158730159
"1032","2015","강원","동해시","초등학교",2015-04-01,"남자",452,437,435,-2,17,15,-0.0045766590389016,0.0390804597701149,0.034324942791762
"1033","2015","강원","태백시","초등학교",2015-04-01,"전체",399,425,410,-15,-11,-26,-0.0352941176470588,-0.0268292682926829,-0.0611764705882353
"1034","2015","강원","태백시","초등학교",2015-04-01,"여자",195,212,208,-4,-13,-17,-0.0188679245283019,-0.0625,-0.080188679245283
"1035","2015","강원","태백시","초등학교",2015-04-01,"남자",204,213,202,-11,2,-9,-0.0516431924882629,0.0099009900990099,-0.0422535211267606
"1036","2015","강원","속초시","초등학교",2015-04-01,"전체",644,632,642,10,2,12,0.0158227848101266,0.00311526479750779,0.0189873417721519
"1037","2015","강원","속초시","초등학교",2015-04-01,"여자",332,328,328,0,4,4,0,0.0121951219512195,0.0121951219512195
"1038","2015","강원","속초시","초등학교",2015-04-01,"남자",312,304,314,10,-2,8,0.0328947368421053,-0.00636942675159236,0.0263157894736842
"1039","2015","강원","삼척시","초등학교",2015-04-01,"전체",447,471,484,13,-37,-24,0.0276008492569002,-0.0764462809917355,-0.0509554140127389
"1040","2015","강원","삼척시","초등학교",2015-04-01,"여자",231,234,238,4,-7,-3,0.0170940170940171,-0.0294117647058824,-0.0128205128205128
"1041","2015","강원","삼척시","초등학교",2015-04-01,"남자",216,237,246,9,-30,-21,0.0379746835443038,-0.121951219512195,-0.0886075949367089
"1042","2015","강원","홍천군","초등학교",2015-04-01,"전체",494,507,512,5,-18,-13,0.00986193293885602,-0.03515625,-0.0256410256410256
"1043","2015","강원","홍천군","초등학교",2015-04-01,"여자",253,248,250,2,3,5,0.00806451612903226,0.012,0.0201612903225806
"1044","2015","강원","홍천군","초등학교",2015-04-01,"남자",241,259,262,3,-21,-18,0.0115830115830116,-0.0801526717557252,-0.0694980694980695
"1045","2015","강원","횡성군","초등학교",2015-04-01,"전체",293,298,299,1,-6,-5,0.00335570469798658,-0.020066889632107,-0.0167785234899329
"1046","2015","강원","횡성군","초등학교",2015-04-01,"여자",137,142,142,0,-5,-5,0,-0.0352112676056338,-0.0352112676056338
"1047","2015","강원","횡성군","초등학교",2015-04-01,"남자",156,156,157,1,-1,0,0.00641025641025641,-0.00636942675159236,0
"1048","2015","강원","영월군","초등학교",2015-04-01,"전체",232,233,229,-4,3,-1,-0.0171673819742489,0.0131004366812227,-0.00429184549356223
"1049","2015","강원","영월군","초등학교",2015-04-01,"여자",112,118,106,-12,6,-6,-0.101694915254237,0.0566037735849057,-0.0508474576271186
"1050","2015","강원","영월군","초등학교",2015-04-01,"남자",120,115,123,8,-3,5,0.0695652173913043,-0.024390243902439,0.0434782608695652
"1051","2015","강원","평창군","초등학교",2015-04-01,"전체",312,319,320,1,-8,-7,0.00313479623824451,-0.025,-0.0219435736677116
"1052","2015","강원","평창군","초등학교",2015-04-01,"여자",156,160,157,-3,-1,-4,-0.01875,-0.00636942675159236,-0.025
"1053","2015","강원","평창군","초등학교",2015-04-01,"남자",156,159,163,4,-7,-3,0.0251572327044025,-0.0429447852760736,-0.0188679245283019
"1054","2015","강원","정선군","초등학교",2015-04-01,"전체",238,270,267,-3,-29,-32,-0.0111111111111111,-0.108614232209738,-0.118518518518519
"1055","2015","강원","정선군","초등학교",2015-04-01,"여자",124,138,131,-7,-7,-14,-0.0507246376811594,-0.0534351145038168,-0.101449275362319
"1056","2015","강원","정선군","초등학교",2015-04-01,"남자",114,132,136,4,-22,-18,0.0303030303030303,-0.161764705882353,-0.136363636363636
"1057","2015","강원","철원군","초등학교",2015-04-01,"전체",418,455,437,-18,-19,-37,-0.0395604395604396,-0.0434782608695652,-0.0813186813186813
"1058","2015","강원","철원군","초등학교",2015-04-01,"여자",197,229,220,-9,-23,-32,-0.0393013100436681,-0.104545454545455,-0.139737991266376
"1059","2015","강원","철원군","초등학교",2015-04-01,"남자",221,226,217,-9,4,-5,-0.0398230088495575,0.0184331797235023,-0.0221238938053097
"1060","2015","강원","화천군","초등학교",2015-04-01,"전체",191,240,224,-16,-33,-49,-0.0666666666666667,-0.147321428571429,-0.204166666666667
"1061","2015","강원","화천군","초등학교",2015-04-01,"여자",92,106,101,-5,-9,-14,-0.0471698113207547,-0.0891089108910891,-0.132075471698113
"1062","2015","강원","화천군","초등학교",2015-04-01,"남자",99,134,123,-11,-24,-35,-0.082089552238806,-0.195121951219512,-0.261194029850746
"1063","2015","강원","양구군","초등학교",2015-04-01,"전체",197,198,195,-3,2,-1,-0.0151515151515152,0.0102564102564103,-0.00505050505050505
"1064","2015","강원","양구군","초등학교",2015-04-01,"여자",91,100,97,-3,-6,-9,-0.03,-0.0618556701030928,-0.09
"1065","2015","강원","양구군","초등학교",2015-04-01,"남자",106,98,98,0,8,8,0,0.0816326530612245,0.0816326530612245
"1066","2015","강원","인제군","초등학교",2015-04-01,"전체",282,312,306,-6,-24,-30,-0.0192307692307692,-0.0784313725490196,-0.0961538461538462
"1067","2015","강원","인제군","초등학교",2015-04-01,"여자",144,155,157,2,-13,-11,0.0129032258064516,-0.0828025477707006,-0.0709677419354839
"1068","2015","강원","인제군","초등학교",2015-04-01,"남자",138,157,149,-8,-11,-19,-0.0509554140127389,-0.0738255033557047,-0.121019108280255
"1069","2015","강원","고성군","초등학교",2015-04-01,"전체",160,144,148,4,12,16,0.0277777777777778,0.0810810810810811,0.111111111111111
"1070","2015","강원","고성군","초등학교",2015-04-01,"여자",66,69,74,5,-8,-3,0.072463768115942,-0.108108108108108,-0.0434782608695652
"1071","2015","강원","고성군","초등학교",2015-04-01,"남자",94,75,74,-1,20,19,-0.0133333333333333,0.27027027027027,0.253333333333333
"1072","2015","강원","양양군","초등학교",2015-04-01,"전체",150,170,165,-5,-15,-20,-0.0294117647058824,-0.0909090909090909,-0.117647058823529
"1073","2015","강원","양양군","초등학교",2015-04-01,"여자",63,79,79,0,-16,-16,0,-0.20253164556962,-0.20253164556962
"1074","2015","강원","양양군","초등학교",2015-04-01,"남자",87,91,86,-5,1,-4,-0.0549450549450549,0.0116279069767442,-0.043956043956044
"1075","2015","충북","청주시","초등학교",2015-04-01,"전체",8391,6833,6851,18,1540,1558,0.00263427484267525,0.224784702963071,0.22801112249378
"1076","2015","충북","청주시","초등학교",2015-04-01,"여자",4088,3325,3346,21,742,763,0.00631578947368421,0.221757322175732,0.229473684210526
"1077","2015","충북","청주시","초등학교",2015-04-01,"남자",4303,3508,3505,-3,798,795,-0.000855188141391106,0.227674750356633,0.226624857468643
"1078","2015","충북","충주시","초등학교",2015-04-01,"전체",1701,1616,1616,0,85,85,0,0.0525990099009901,0.0525990099009901
"1079","2015","충북","충주시","초등학교",2015-04-01,"여자",799,739,742,3,57,60,0.0040595399188092,0.0768194070080863,0.081190798376184
"1080","2015","충북","충주시","초등학교",2015-04-01,"남자",902,877,874,-3,28,25,-0.00342075256556442,0.0320366132723112,0.0285062713797035
"1081","2015","충북","제천시","초등학교",2015-04-01,"전체",1079,1076,1079,3,0,3,0.00278810408921933,0,0.00278810408921933
"1082","2015","충북","제천시","초등학교",2015-04-01,"여자",507,508,514,6,-7,-1,0.0118110236220472,-0.0136186770428016,-0.00196850393700787
"1083","2015","충북","제천시","초등학교",2015-04-01,"남자",572,568,565,-3,7,4,-0.00528169014084507,0.0123893805309735,0.00704225352112676
"1084","2015","충북","보은군","초등학교",2015-04-01,"전체",180,177,177,0,3,3,0,0.0169491525423729,0.0169491525423729
"1085","2015","충북","보은군","초등학교",2015-04-01,"여자",80,74,76,2,4,6,0.027027027027027,0.0526315789473684,0.0810810810810811
"1086","2015","충북","보은군","초등학교",2015-04-01,"남자",100,103,101,-2,-1,-3,-0.0194174757281553,-0.0099009900990099,-0.029126213592233
"1087","2015","충북","옥천군","초등학교",2015-04-01,"전체",357,350,353,3,4,7,0.00857142857142857,0.0113314447592068,0.02
"1088","2015","충북","옥천군","초등학교",2015-04-01,"여자",174,178,178,0,-4,-4,0,-0.0224719101123595,-0.0224719101123595
"1089","2015","충북","옥천군","초등학교",2015-04-01,"남자",183,172,175,3,8,11,0.0174418604651163,0.0457142857142857,0.063953488372093
"1090","2015","충북","영동군","초등학교",2015-04-01,"전체",294,311,316,5,-22,-17,0.0160771704180064,-0.069620253164557,-0.0546623794212219
"1091","2015","충북","영동군","초등학교",2015-04-01,"여자",135,146,150,4,-15,-11,0.0273972602739726,-0.1,-0.0753424657534247
"1092","2015","충북","영동군","초등학교",2015-04-01,"남자",159,165,166,1,-7,-6,0.00606060606060606,-0.0421686746987952,-0.0363636363636364
"1093","2015","충북","진천군","초등학교",2015-04-01,"전체",670,595,611,16,59,75,0.026890756302521,0.0965630114566285,0.126050420168067
"1094","2015","충북","진천군","초등학교",2015-04-01,"여자",301,263,266,3,35,38,0.0114068441064639,0.131578947368421,0.144486692015209
"1095","2015","충북","진천군","초등학교",2015-04-01,"남자",369,332,345,13,24,37,0.0391566265060241,0.0695652173913043,0.11144578313253
"1096","2015","충북","괴산군","초등학교",2015-04-01,"전체",189,208,218,10,-29,-19,0.0480769230769231,-0.13302752293578,-0.0913461538461538
"1097","2015","충북","괴산군","초등학교",2015-04-01,"여자",110,110,112,2,-2,0,0.0181818181818182,-0.0178571428571429,0
"1098","2015","충북","괴산군","초등학교",2015-04-01,"남자",79,98,106,8,-27,-19,0.0816326530612245,-0.254716981132075,-0.193877551020408
"1099","2015","충북","음성군","초등학교",2015-04-01,"전체",797,826,810,-16,-13,-29,-0.0193704600484262,-0.0160493827160494,-0.0351089588377724
"1100","2015","충북","음성군","초등학교",2015-04-01,"여자",384,381,369,-12,15,3,-0.031496062992126,0.040650406504065,0.0078740157480315
"1101","2015","충북","음성군","초등학교",2015-04-01,"남자",413,445,441,-4,-28,-32,-0.00898876404494382,-0.0634920634920635,-0.0719101123595506
"1102","2015","충북","단양군","초등학교",2015-04-01,"전체",182,183,186,3,-4,-1,0.0163934426229508,-0.021505376344086,-0.00546448087431694
"1103","2015","충북","단양군","초등학교",2015-04-01,"여자",96,87,87,0,9,9,0,0.103448275862069,0.103448275862069
"1104","2015","충북","단양군","초등학교",2015-04-01,"남자",86,96,99,3,-13,-10,0.03125,-0.131313131313131,-0.104166666666667
"1105","2015","충북","증평군","초등학교",2015-04-01,"전체",352,409,403,-6,-51,-57,-0.0146699266503667,-0.126550868486352,-0.139364303178484
"1106","2015","충북","증평군","초등학교",2015-04-01,"여자",169,186,186,0,-17,-17,0,-0.0913978494623656,-0.0913978494623656
"1107","2015","충북","증평군","초등학교",2015-04-01,"남자",183,223,217,-6,-34,-40,-0.0269058295964126,-0.15668202764977,-0.179372197309417
"1108","2015","충남","천안시","초등학교",2015-04-01,"전체",6599,6523,6503,-20,96,76,-0.00306607389238081,0.0147624173458404,0.0116510807910471
"1109","2015","충남","천안시","초등학교",2015-04-01,"여자",3174,3115,3102,-13,72,59,-0.00417335473515249,0.02321083172147,0.0189406099518459
"1110","2015","충남","천안시","초등학교",2015-04-01,"남자",3425,3408,3401,-7,24,17,-0.00205399061032864,0.00705674801528962,0.00498826291079812
"1111","2015","충남","공주시","초등학교",2015-04-01,"전체",797,834,836,2,-39,-37,0.00239808153477218,-0.0466507177033493,-0.0443645083932854
"1112","2015","충남","공주시","초등학교",2015-04-01,"여자",402,418,416,-2,-14,-16,-0.00478468899521531,-0.0336538461538462,-0.0382775119617225
"1113","2015","충남","공주시","초등학교",2015-04-01,"남자",395,416,420,4,-25,-21,0.00961538461538462,-0.0595238095238095,-0.0504807692307692
"1114","2015","충남","보령시","초등학교",2015-04-01,"전체",836,799,816,17,20,37,0.0212765957446809,0.0245098039215686,0.0463078848560701
"1115","2015","충남","보령시","초등학교",2015-04-01,"여자",412,399,395,-4,17,13,-0.0100250626566416,0.0430379746835443,0.0325814536340852
"1116","2015","충남","보령시","초등학교",2015-04-01,"남자",424,400,421,21,3,24,0.0525,0.00712589073634204,0.06
"1117","2015","충남","아산시","초등학교",2015-04-01,"전체",3494,3728,3734,6,-240,-234,0.00160944206008584,-0.0642742367434387,-0.0627682403433476
"1118","2015","충남","아산시","초등학교",2015-04-01,"여자",1712,1829,1817,-12,-105,-117,-0.00656096227446692,-0.0577875619152449,-0.0639693821760525
"1119","2015","충남","아산시","초등학교",2015-04-01,"남자",1782,1899,1917,18,-135,-117,0.00947867298578199,-0.0704225352112676,-0.0616113744075829
"1120","2015","충남","서산시","초등학교",2015-04-01,"전체",1724,1703,1726,23,-2,21,0.0135055783910746,-0.00115874855156431,0.0123311802701116
"1121","2015","충남","서산시","초등학교",2015-04-01,"여자",823,793,814,21,9,30,0.0264817150063052,0.0110565110565111,0.0378310214375788
"1122","2015","충남","서산시","초등학교",2015-04-01,"남자",901,910,912,2,-11,-9,0.0021978021978022,-0.0120614035087719,-0.00989010989010989
"1123","2015","충남","논산시","초등학교",2015-04-01,"전체",1009,955,951,-4,58,54,-0.00418848167539267,0.0609884332281809,0.056544502617801
"1124","2015","충남","논산시","초등학교",2015-04-01,"여자",497,487,478,-9,19,10,-0.0184804928131417,0.0397489539748954,0.0205338809034908
"1125","2015","충남","논산시","초등학교",2015-04-01,"남자",512,468,473,5,39,44,0.0106837606837607,0.0824524312896406,0.094017094017094
"1126","2015","충남","계룡시","초등학교",2015-04-01,"전체",441,468,472,4,-31,-27,0.00854700854700855,-0.0656779661016949,-0.0576923076923077
"1127","2015","충남","계룡시","초등학교",2015-04-01,"여자",212,220,207,-13,5,-8,-0.0590909090909091,0.0241545893719807,-0.0363636363636364
"1128","2015","충남","계룡시","초등학교",2015-04-01,"남자",229,248,265,17,-36,-19,0.0685483870967742,-0.135849056603774,-0.0766129032258065
"1129","2015","충남","금산군","초등학교",2015-04-01,"전체",378,385,385,0,-7,-7,0,-0.0181818181818182,-0.0181818181818182
"1130","2015","충남","금산군","초등학교",2015-04-01,"여자",178,191,191,0,-13,-13,0,-0.0680628272251309,-0.0680628272251309
"1131","2015","충남","금산군","초등학교",2015-04-01,"남자",200,194,194,0,6,6,0,0.0309278350515464,0.0309278350515464
"1132","2015","충남","부여군","초등학교",2015-04-01,"전체",408,422,421,-1,-13,-14,-0.0023696682464455,-0.0308788598574822,-0.033175355450237
"1133","2015","충남","부여군","초등학교",2015-04-01,"여자",198,199,200,1,-2,-1,0.0050251256281407,-0.01,-0.0050251256281407
"1134","2015","충남","부여군","초등학교",2015-04-01,"남자",210,223,221,-2,-11,-13,-0.00896860986547085,-0.0497737556561086,-0.0582959641255605
"1135","2015","충남","서천군","초등학교",2015-04-01,"전체",315,324,324,0,-9,-9,0,-0.0277777777777778,-0.0277777777777778
"1136","2015","충남","서천군","초등학교",2015-04-01,"여자",161,163,156,-7,5,-2,-0.0429447852760736,0.032051282051282,-0.0122699386503067
"1137","2015","충남","서천군","초등학교",2015-04-01,"남자",154,161,168,7,-14,-7,0.0434782608695652,-0.0833333333333333,-0.0434782608695652
"1138","2015","충남","청양군","초등학교",2015-04-01,"전체",171,171,171,0,0,0,0,0,0
"1139","2015","충남","청양군","초등학교",2015-04-01,"여자",72,79,78,-1,-6,-7,-0.0126582278481013,-0.0769230769230769,-0.0886075949367089
"1140","2015","충남","청양군","초등학교",2015-04-01,"남자",99,92,93,1,6,7,0.0108695652173913,0.0645161290322581,0.0760869565217391
"1141","2015","충남","홍성군","초등학교",2015-04-01,"전체",827,757,773,16,54,70,0.0211360634081902,0.0698576972833118,0.0924702774108322
"1142","2015","충남","홍성군","초등학교",2015-04-01,"여자",415,372,383,11,32,43,0.0295698924731183,0.0835509138381201,0.115591397849462
"1143","2015","충남","홍성군","초등학교",2015-04-01,"남자",412,385,390,5,22,27,0.012987012987013,0.0564102564102564,0.0701298701298701
"1144","2015","충남","예산군","초등학교",2015-04-01,"전체",512,537,531,-6,-19,-25,-0.0111731843575419,-0.0357815442561205,-0.0465549348230912
"1145","2015","충남","예산군","초등학교",2015-04-01,"여자",256,255,251,-4,5,1,-0.0156862745098039,0.0199203187250996,0.00392156862745098
"1146","2015","충남","예산군","초등학교",2015-04-01,"남자",256,282,280,-2,-24,-26,-0.00709219858156028,-0.0857142857142857,-0.0921985815602837
"1147","2015","충남","태안군","초등학교",2015-04-01,"전체",429,431,434,3,-5,-2,0.00696055684454756,-0.0115207373271889,-0.00464037122969838
"1148","2015","충남","태안군","초등학교",2015-04-01,"여자",212,204,207,3,5,8,0.0147058823529412,0.0241545893719807,0.0392156862745098
"1149","2015","충남","태안군","초등학교",2015-04-01,"남자",217,227,227,0,-10,-10,0,-0.0440528634361234,-0.0440528634361234
"1150","2015","충남","당진시","초등학교",2015-04-01,"전체",1734,1702,1745,43,-11,32,0.0252643948296122,-0.00630372492836676,0.0188014101057579
"1151","2015","충남","당진시","초등학교",2015-04-01,"여자",809,812,834,22,-25,-3,0.0270935960591133,-0.0299760191846523,-0.00369458128078818
"1152","2015","충남","당진시","초등학교",2015-04-01,"남자",925,890,911,21,14,35,0.0235955056179775,0.0153677277716795,0.0393258426966292
"1153","2015","전북","전주시","초등학교",2015-04-01,"전체",6339,6078,6224,146,115,261,0.0240210595590655,0.0184768637532134,0.0429417571569595
"1154","2015","전북","전주시","초등학교",2015-04-01,"여자",3098,2975,3033,58,65,123,0.0194957983193277,0.0214309264754369,0.0413445378151261
"1155","2015","전북","전주시","초등학교",2015-04-01,"남자",3241,3103,3191,88,50,138,0.0283596519497261,0.0156690692572861,0.044473090557525
"1156","2015","전북","군산시","초등학교",2015-04-01,"전체",2618,2651,2640,-11,-22,-33,-0.004149377593361,-0.00833333333333333,-0.012448132780083
"1157","2015","전북","군산시","초등학교",2015-04-01,"여자",1239,1282,1271,-11,-32,-43,-0.00858034321372855,-0.025177025963808,-0.0335413416536661
"1158","2015","전북","군산시","초등학교",2015-04-01,"남자",1379,1369,1369,0,10,10,0,0.00730460189919649,0.00730460189919649
"1159","2015","전북","익산시","초등학교",2015-04-01,"전체",2674,2619,2626,7,48,55,0.00267277586865216,0.0182787509520183,0.0210003818251241
"1160","2015","전북","익산시","초등학교",2015-04-01,"여자",1281,1254,1247,-7,34,27,-0.00558213716108453,0.0272654370489174,0.0215311004784689
"1161","2015","전북","익산시","초등학교",2015-04-01,"남자",1393,1365,1379,14,14,28,0.0102564102564103,0.0101522842639594,0.0205128205128205
"1162","2015","전북","정읍시","초등학교",2015-04-01,"전체",866,867,870,3,-4,-1,0.00346020761245675,-0.00459770114942529,-0.00115340253748558
"1163","2015","전북","정읍시","초등학교",2015-04-01,"여자",413,411,412,1,1,2,0.0024330900243309,0.00242718446601942,0.0048661800486618
"1164","2015","전북","정읍시","초등학교",2015-04-01,"남자",453,456,458,2,-5,-3,0.0043859649122807,-0.0109170305676856,-0.00657894736842105
"1165","2015","전북","남원시","초등학교",2015-04-01,"전체",729,722,732,10,-3,7,0.0138504155124654,-0.00409836065573771,0.00969529085872576
"1166","2015","전북","남원시","초등학교",2015-04-01,"여자",347,321,331,10,16,26,0.0311526479750779,0.0483383685800604,0.0809968847352025
"1167","2015","전북","남원시","초등학교",2015-04-01,"남자",382,401,401,0,-19,-19,0,-0.0473815461346633,-0.0473815461346633
"1168","2015","전북","김제시","초등학교",2015-04-01,"전체",606,607,602,-5,4,-1,-0.00823723228995058,0.00664451827242525,-0.00164744645799012
"1169","2015","전북","김제시","초등학교",2015-04-01,"여자",290,271,268,-3,22,19,-0.011070110701107,0.082089552238806,0.0701107011070111
"1170","2015","전북","김제시","초등학교",2015-04-01,"남자",316,336,334,-2,-18,-20,-0.00595238095238095,-0.0538922155688623,-0.0595238095238095
"1171","2015","전북","완주군","초등학교",2015-04-01,"전체",904,913,925,12,-21,-9,0.0131434830230011,-0.0227027027027027,-0.00985761226725082
"1172","2015","전북","완주군","초등학교",2015-04-01,"여자",427,429,432,3,-5,-2,0.00699300699300699,-0.0115740740740741,-0.00466200466200466
"1173","2015","전북","완주군","초등학교",2015-04-01,"남자",477,484,493,9,-16,-7,0.0185950413223141,-0.0324543610547667,-0.0144628099173554
"1174","2015","전북","진안군","초등학교",2015-04-01,"전체",135,184,171,-13,-36,-49,-0.0706521739130435,-0.210526315789474,-0.266304347826087
"1175","2015","전북","진안군","초등학교",2015-04-01,"여자",67,87,85,-2,-18,-20,-0.0229885057471264,-0.211764705882353,-0.229885057471264
"1176","2015","전북","진안군","초등학교",2015-04-01,"남자",68,97,86,-11,-18,-29,-0.11340206185567,-0.209302325581395,-0.298969072164948
"1177","2015","전북","무주군","초등학교",2015-04-01,"전체",167,199,194,-5,-27,-32,-0.0251256281407035,-0.139175257731959,-0.160804020100503
"1178","2015","전북","무주군","초등학교",2015-04-01,"여자",84,109,107,-2,-23,-25,-0.018348623853211,-0.214953271028037,-0.229357798165138
"1179","2015","전북","무주군","초등학교",2015-04-01,"남자",83,90,87,-3,-4,-7,-0.0333333333333333,-0.0459770114942529,-0.0777777777777778
"1180","2015","전북","장수군","초등학교",2015-04-01,"전체",187,164,166,2,21,23,0.0121951219512195,0.126506024096386,0.140243902439024
"1181","2015","전북","장수군","초등학교",2015-04-01,"여자",95,78,80,2,15,17,0.0256410256410256,0.1875,0.217948717948718
"1182","2015","전북","장수군","초등학교",2015-04-01,"남자",92,86,86,0,6,6,0,0.0697674418604651,0.0697674418604651
"1183","2015","전북","임실군","초등학교",2015-04-01,"전체",203,212,216,4,-13,-9,0.0188679245283019,-0.0601851851851852,-0.0424528301886792
"1184","2015","전북","임실군","초등학교",2015-04-01,"여자",100,99,104,5,-4,1,0.0505050505050505,-0.0384615384615385,0.0101010101010101
"1185","2015","전북","임실군","초등학교",2015-04-01,"남자",103,113,112,-1,-9,-10,-0.00884955752212389,-0.0803571428571429,-0.0884955752212389
"1186","2015","전북","순창군","초등학교",2015-04-01,"전체",187,199,206,7,-19,-12,0.0351758793969849,-0.0922330097087379,-0.0603015075376884
"1187","2015","전북","순창군","초등학교",2015-04-01,"여자",102,110,109,-1,-7,-8,-0.00909090909090909,-0.0642201834862385,-0.0727272727272727
"1188","2015","전북","순창군","초등학교",2015-04-01,"남자",85,89,97,8,-12,-4,0.0898876404494382,-0.123711340206186,-0.0449438202247191
"1189","2015","전북","고창군","초등학교",2015-04-01,"전체",351,380,388,8,-37,-29,0.0210526315789474,-0.095360824742268,-0.0763157894736842
"1190","2015","전북","고창군","초등학교",2015-04-01,"여자",174,190,190,0,-16,-16,0,-0.0842105263157895,-0.0842105263157895
"1191","2015","전북","고창군","초등학교",2015-04-01,"남자",177,190,198,8,-21,-13,0.0421052631578947,-0.106060606060606,-0.068421052631579
"1192","2015","전북","부안군","초등학교",2015-04-01,"전체",335,316,324,8,11,19,0.0253164556962025,0.0339506172839506,0.060126582278481
"1193","2015","전북","부안군","초등학교",2015-04-01,"여자",162,161,162,1,0,1,0.0062111801242236,0,0.0062111801242236
"1194","2015","전북","부안군","초등학교",2015-04-01,"남자",173,155,162,7,11,18,0.0451612903225806,0.0679012345679012,0.116129032258065
"1195","2015","전남","목포시","초등학교",2015-04-01,"전체",2631,2519,2436,-83,195,112,-0.0329495831679238,0.0800492610837438,0.0444620881302104
"1196","2015","전남","목포시","초등학교",2015-04-01,"여자",1273,1192,1164,-28,109,81,-0.023489932885906,0.0936426116838488,0.0679530201342282
"1197","2015","전남","목포시","초등학교",2015-04-01,"남자",1358,1327,1272,-55,86,31,-0.0414468726450641,0.0676100628930818,0.0233609645817634
"1198","2015","전남","여수시","초등학교",2015-04-01,"전체",2485,2514,2500,-14,-15,-29,-0.00556881463802705,-0.006,-0.0115354017501989
"1199","2015","전남","여수시","초등학교",2015-04-01,"여자",1193,1248,1227,-21,-34,-55,-0.0168269230769231,-0.0277098614506927,-0.0440705128205128
"1200","2015","전남","여수시","초등학교",2015-04-01,"남자",1292,1266,1273,7,19,26,0.00552922590837283,0.0149253731343284,0.0205371248025276
"1201","2015","전남","순천시","초등학교",2015-04-01,"전체",2710,2537,2647,110,63,173,0.043358297201419,0.0238005289006422,0.0681907765076862
"1202","2015","전남","순천시","초등학교",2015-04-01,"여자",1310,1214,1268,54,42,96,0.0444810543657331,0.0331230283911672,0.0790774299835255
"1203","2015","전남","순천시","초등학교",2015-04-01,"남자",1400,1323,1379,56,21,77,0.0423280423280423,0.0152284263959391,0.0582010582010582
"1204","2015","전남","나주시","초등학교",2015-04-01,"전체",630,557,562,5,68,73,0.00897666068222621,0.120996441281139,0.131059245960503
"1205","2015","전남","나주시","초등학교",2015-04-01,"여자",297,277,275,-2,22,20,-0.0072202166064982,0.08,0.0722021660649819
"1206","2015","전남","나주시","초등학교",2015-04-01,"남자",333,280,287,7,46,53,0.025,0.160278745644599,0.189285714285714
"1207","2015","전남","광양시","초등학교",2015-04-01,"전체",1533,1598,1583,-15,-50,-65,-0.00938673341677096,-0.0315855969677827,-0.0406758448060075
"1208","2015","전남","광양시","초등학교",2015-04-01,"여자",748,790,779,-11,-31,-42,-0.0139240506329114,-0.0397946084724005,-0.0531645569620253
"1209","2015","전남","광양시","초등학교",2015-04-01,"남자",785,808,804,-4,-19,-23,-0.00495049504950495,-0.0236318407960199,-0.0284653465346535
"1210","2015","전남","담양군","초등학교",2015-04-01,"전체",241,271,264,-7,-23,-30,-0.025830258302583,-0.0871212121212121,-0.11070110701107
"1211","2015","전남","담양군","초등학교",2015-04-01,"여자",105,110,113,3,-8,-5,0.0272727272727273,-0.0707964601769911,-0.0454545454545455
"1212","2015","전남","담양군","초등학교",2015-04-01,"남자",136,161,151,-10,-15,-25,-0.062111801242236,-0.0993377483443709,-0.15527950310559
"1213","2015","전남","곡성군","초등학교",2015-04-01,"전체",177,194,193,-1,-16,-17,-0.00515463917525773,-0.0829015544041451,-0.0876288659793814
"1214","2015","전남","곡성군","초등학교",2015-04-01,"여자",72,80,79,-1,-7,-8,-0.0125,-0.0886075949367089,-0.1
"1215","2015","전남","곡성군","초등학교",2015-04-01,"남자",105,114,114,0,-9,-9,0,-0.0789473684210526,-0.0789473684210526
"1216","2015","전남","구례군","초등학교",2015-04-01,"전체",170,172,167,-5,3,-2,-0.0290697674418605,0.0179640718562874,-0.0116279069767442
"1217","2015","전남","구례군","초등학교",2015-04-01,"여자",73,83,78,-5,-5,-10,-0.0602409638554217,-0.0641025641025641,-0.120481927710843
"1218","2015","전남","구례군","초등학교",2015-04-01,"남자",97,89,89,0,8,8,0,0.0898876404494382,0.0898876404494382
"1219","2015","전남","고흥군","초등학교",2015-04-01,"전체",312,326,318,-8,-6,-14,-0.0245398773006135,-0.0188679245283019,-0.0429447852760736
"1220","2015","전남","고흥군","초등학교",2015-04-01,"여자",155,173,171,-2,-16,-18,-0.0115606936416185,-0.0935672514619883,-0.104046242774566
"1221","2015","전남","고흥군","초등학교",2015-04-01,"남자",157,153,147,-6,10,4,-0.0392156862745098,0.0680272108843537,0.0261437908496732
"1222","2015","전남","보성군","초등학교",2015-04-01,"전체",222,290,258,-32,-36,-68,-0.110344827586207,-0.13953488372093,-0.23448275862069
"1223","2015","전남","보성군","초등학교",2015-04-01,"여자",117,158,138,-20,-21,-41,-0.126582278481013,-0.152173913043478,-0.259493670886076
"1224","2015","전남","보성군","초등학교",2015-04-01,"남자",105,132,120,-12,-15,-27,-0.0909090909090909,-0.125,-0.204545454545455
"1225","2015","전남","화순군","초등학교",2015-04-01,"전체",484,515,493,-22,-9,-31,-0.0427184466019417,-0.0182555780933063,-0.0601941747572816
"1226","2015","전남","화순군","초등학교",2015-04-01,"여자",242,251,239,-12,3,-9,-0.047808764940239,0.0125523012552301,-0.0358565737051793
"1227","2015","전남","화순군","초등학교",2015-04-01,"남자",242,264,254,-10,-12,-22,-0.0378787878787879,-0.047244094488189,-0.0833333333333333
"1228","2015","전남","장흥군","초등학교",2015-04-01,"전체",240,265,269,4,-29,-25,0.0150943396226415,-0.107806691449814,-0.0943396226415094
"1229","2015","전남","장흥군","초등학교",2015-04-01,"여자",124,137,135,-2,-11,-13,-0.0145985401459854,-0.0814814814814815,-0.0948905109489051
"1230","2015","전남","장흥군","초등학교",2015-04-01,"남자",116,128,134,6,-18,-12,0.046875,-0.134328358208955,-0.09375
"1231","2015","전남","강진군","초등학교",2015-04-01,"전체",239,297,280,-17,-41,-58,-0.0572390572390572,-0.146428571428571,-0.195286195286195
"1232","2015","전남","강진군","초등학교",2015-04-01,"여자",111,141,129,-12,-18,-30,-0.0851063829787234,-0.13953488372093,-0.212765957446809
"1233","2015","전남","강진군","초등학교",2015-04-01,"남자",128,156,151,-5,-23,-28,-0.032051282051282,-0.152317880794702,-0.179487179487179
"1234","2015","전남","해남군","초등학교",2015-04-01,"전체",517,527,526,-1,-9,-10,-0.00189753320683112,-0.0171102661596958,-0.0189753320683112
"1235","2015","전남","해남군","초등학교",2015-04-01,"여자",243,255,252,-3,-9,-12,-0.0117647058823529,-0.0357142857142857,-0.0470588235294118
"1236","2015","전남","해남군","초등학교",2015-04-01,"남자",274,272,274,2,0,2,0.00735294117647059,0,0.00735294117647059
"1237","2015","전남","영암군","초등학교",2015-04-01,"전체",445,542,493,-49,-48,-97,-0.0904059040590406,-0.0973630831643002,-0.178966789667897
"1238","2015","전남","영암군","초등학교",2015-04-01,"여자",202,240,224,-16,-22,-38,-0.0666666666666667,-0.0982142857142857,-0.158333333333333
"1239","2015","전남","영암군","초등학교",2015-04-01,"남자",243,302,269,-33,-26,-59,-0.109271523178808,-0.0966542750929368,-0.195364238410596
"1240","2015","전남","무안군","초등학교",2015-04-01,"전체",787,768,870,102,-83,19,0.1328125,-0.0954022988505747,0.0247395833333333
"1241","2015","전남","무안군","초등학교",2015-04-01,"여자",379,373,418,45,-39,6,0.120643431635389,-0.0933014354066986,0.0160857908847185
"1242","2015","전남","무안군","초등학교",2015-04-01,"남자",408,395,452,57,-44,13,0.144303797468354,-0.0973451327433628,0.0329113924050633
"1243","2015","전남","함평군","초등학교",2015-04-01,"전체",162,202,198,-4,-36,-40,-0.0198019801980198,-0.181818181818182,-0.198019801980198
"1244","2015","전남","함평군","초등학교",2015-04-01,"여자",75,102,100,-2,-25,-27,-0.0196078431372549,-0.25,-0.264705882352941
"1245","2015","전남","함평군","초등학교",2015-04-01,"남자",87,100,98,-2,-11,-13,-0.02,-0.112244897959184,-0.13
"1246","2015","전남","영광군","초등학교",2015-04-01,"전체",391,376,385,9,6,15,0.023936170212766,0.0155844155844156,0.0398936170212766
"1247","2015","전남","영광군","초등학교",2015-04-01,"여자",192,182,191,9,1,10,0.0494505494505494,0.00523560209424084,0.0549450549450549
"1248","2015","전남","영광군","초등학교",2015-04-01,"남자",199,194,194,0,5,5,0,0.0257731958762887,0.0257731958762887
"1249","2015","전남","장성군","초등학교",2015-04-01,"전체",346,349,354,5,-8,-3,0.0143266475644699,-0.0225988700564972,-0.00859598853868195
"1250","2015","전남","장성군","초등학교",2015-04-01,"여자",165,176,181,5,-16,-11,0.0284090909090909,-0.0883977900552486,-0.0625
"1251","2015","전남","장성군","초등학교",2015-04-01,"남자",181,173,173,0,8,8,0,0.046242774566474,0.046242774566474
"1252","2015","전남","완도군","초등학교",2015-04-01,"전체",308,314,311,-3,-3,-6,-0.00955414012738853,-0.00964630225080386,-0.0191082802547771
"1253","2015","전남","완도군","초등학교",2015-04-01,"여자",138,137,142,5,-4,1,0.0364963503649635,-0.028169014084507,0.0072992700729927
"1254","2015","전남","완도군","초등학교",2015-04-01,"남자",170,177,169,-8,1,-7,-0.0451977401129944,0.00591715976331361,-0.0395480225988701
"1255","2015","전남","진도군","초등학교",2015-04-01,"전체",183,230,229,-1,-46,-47,-0.00434782608695652,-0.200873362445415,-0.204347826086957
"1256","2015","전남","진도군","초등학교",2015-04-01,"여자",84,109,110,1,-26,-25,0.00917431192660551,-0.236363636363636,-0.229357798165138
"1257","2015","전남","진도군","초등학교",2015-04-01,"남자",99,121,119,-2,-20,-22,-0.0165289256198347,-0.168067226890756,-0.181818181818182
"1258","2015","전남","신안군","초등학교",2015-04-01,"전체",173,202,213,11,-40,-29,0.0544554455445545,-0.187793427230047,-0.143564356435644
"1259","2015","전남","신안군","초등학교",2015-04-01,"여자",86,100,101,1,-15,-14,0.01,-0.148514851485149,-0.14
"1260","2015","전남","신안군","초등학교",2015-04-01,"남자",87,102,112,10,-25,-15,0.0980392156862745,-0.223214285714286,-0.147058823529412
"1261","2015","경북","포항시","초등학교",2015-04-01,"전체",4423,4497,4507,10,-84,-74,0.0022237046920169,-0.0186376747282006,-0.0164554147209251
"1262","2015","경북","포항시","초등학교",2015-04-01,"여자",2161,2215,2211,-4,-50,-54,-0.0018058690744921,-0.0226142017186793,-0.0243792325056433
"1263","2015","경북","포항시","초등학교",2015-04-01,"남자",2262,2282,2296,14,-34,-20,0.00613496932515337,-0.014808362369338,-0.00876424189307625
"1264","2015","경북","경주시","초등학교",2015-04-01,"전체",1973,2027,2007,-20,-34,-54,-0.00986679822397632,-0.0169407075236672,-0.0266403552047361
"1265","2015","경북","경주시","초등학교",2015-04-01,"여자",966,993,985,-8,-19,-27,-0.0080563947633434,-0.0192893401015228,-0.027190332326284
"1266","2015","경북","경주시","초등학교",2015-04-01,"남자",1007,1034,1022,-12,-15,-27,-0.011605415860735,-0.0146771037181996,-0.0261121856866538
"1267","2015","경북","김천시","초등학교",2015-04-01,"전체",1077,1036,1035,-1,42,41,-0.000965250965250965,0.0405797101449275,0.0395752895752896
"1268","2015","경북","김천시","초등학교",2015-04-01,"여자",500,497,504,7,-4,3,0.0140845070422535,-0.00793650793650794,0.00603621730382294
"1269","2015","경북","김천시","초등학교",2015-04-01,"남자",577,539,531,-8,46,38,-0.0148423005565863,0.0866290018832392,0.0705009276437848
"1270","2015","경북","안동시","초등학교",2015-04-01,"전체",1318,1344,1336,-8,-18,-26,-0.00595238095238095,-0.0134730538922156,-0.0193452380952381
"1271","2015","경북","안동시","초등학교",2015-04-01,"여자",644,679,675,-4,-31,-35,-0.00589101620029455,-0.0459259259259259,-0.0515463917525773
"1272","2015","경북","안동시","초등학교",2015-04-01,"남자",674,665,661,-4,13,9,-0.00601503759398496,0.0196671709531014,0.0135338345864662
"1273","2015","경북","구미시","초등학교",2015-04-01,"전체",4723,4715,4652,-63,71,8,-0.0133616118769883,0.015262252794497,0.00169671261930011
"1274","2015","경북","구미시","초등학교",2015-04-01,"여자",2301,2250,2217,-33,84,51,-0.0146666666666667,0.0378890392422192,0.0226666666666667
"1275","2015","경북","구미시","초등학교",2015-04-01,"남자",2422,2465,2435,-30,-13,-43,-0.0121703853955375,-0.0053388090349076,-0.0174442190669371
"1276","2015","경북","영주시","초등학교",2015-04-01,"전체",816,775,778,3,38,41,0.00387096774193548,0.0488431876606684,0.0529032258064516
"1277","2015","경북","영주시","초등학교",2015-04-01,"여자",414,372,377,5,37,42,0.0134408602150538,0.0981432360742706,0.112903225806452
"1278","2015","경북","영주시","초등학교",2015-04-01,"남자",402,403,401,-2,1,-1,-0.00496277915632754,0.00249376558603491,-0.00248138957816377
"1279","2015","경북","영천시","초등학교",2015-04-01,"전체",578,595,583,-12,-5,-17,-0.0201680672268908,-0.00857632933104631,-0.0285714285714286
"1280","2015","경북","영천시","초등학교",2015-04-01,"여자",265,272,265,-7,0,-7,-0.0257352941176471,0,-0.0257352941176471
"1281","2015","경북","영천시","초등학교",2015-04-01,"남자",313,323,318,-5,-5,-10,-0.0154798761609907,-0.0157232704402516,-0.0309597523219814
"1282","2015","경북","상주시","초등학교",2015-04-01,"전체",712,656,663,7,49,56,0.0106707317073171,0.0739064856711916,0.0853658536585366
"1283","2015","경북","상주시","초등학교",2015-04-01,"여자",340,339,335,-4,5,1,-0.0117994100294985,0.0149253731343284,0.00294985250737463
"1284","2015","경북","상주시","초등학교",2015-04-01,"남자",372,317,328,11,44,55,0.0347003154574132,0.134146341463415,0.173501577287066
"1285","2015","경북","문경시","초등학교",2015-04-01,"전체",484,477,482,5,2,7,0.010482180293501,0.004149377593361,0.0146750524109015
"1286","2015","경북","문경시","초등학교",2015-04-01,"여자",228,221,229,8,-1,7,0.0361990950226244,-0.00436681222707424,0.0316742081447964
"1287","2015","경북","문경시","초등학교",2015-04-01,"남자",256,256,253,-3,3,0,-0.01171875,0.0118577075098814,0
"1288","2015","경북","경산시","초등학교",2015-04-01,"전체",2156,2287,2241,-46,-85,-131,-0.020113686051596,-0.0379294957608211,-0.0572802798425885
"1289","2015","경북","경산시","초등학교",2015-04-01,"여자",1024,1111,1094,-17,-70,-87,-0.0153015301530153,-0.0639853747714808,-0.0783078307830783
"1290","2015","경북","경산시","초등학교",2015-04-01,"남자",1132,1176,1147,-29,-15,-44,-0.0246598639455782,-0.013077593722755,-0.0374149659863946
"1291","2015","경북","군위군","초등학교",2015-04-01,"전체",93,88,89,1,4,5,0.0113636363636364,0.0449438202247191,0.0568181818181818
"1292","2015","경북","군위군","초등학교",2015-04-01,"여자",41,44,43,-1,-2,-3,-0.0227272727272727,-0.0465116279069767,-0.0681818181818182
"1293","2015","경북","군위군","초등학교",2015-04-01,"남자",52,44,46,2,6,8,0.0454545454545455,0.130434782608696,0.181818181818182
"1294","2015","경북","의성군","초등학교",2015-04-01,"전체",220,225,216,-9,4,-5,-0.04,0.0185185185185185,-0.0222222222222222
"1295","2015","경북","의성군","초등학교",2015-04-01,"여자",85,88,87,-1,-2,-3,-0.0113636363636364,-0.0229885057471264,-0.0340909090909091
"1296","2015","경북","의성군","초등학교",2015-04-01,"남자",135,137,129,-8,6,-2,-0.0583941605839416,0.0465116279069767,-0.0145985401459854
"1297","2015","경북","청송군","초등학교",2015-04-01,"전체",123,132,130,-2,-7,-9,-0.0151515151515152,-0.0538461538461538,-0.0681818181818182
"1298","2015","경북","청송군","초등학교",2015-04-01,"여자",49,55,54,-1,-5,-6,-0.0181818181818182,-0.0925925925925926,-0.109090909090909
"1299","2015","경북","청송군","초등학교",2015-04-01,"남자",74,77,76,-1,-2,-3,-0.012987012987013,-0.0263157894736842,-0.038961038961039
"1300","2015","경북","영양군","초등학교",2015-04-01,"전체",105,89,86,-3,19,16,-0.0337078651685393,0.22093023255814,0.179775280898876
"1301","2015","경북","영양군","초등학교",2015-04-01,"여자",51,39,37,-2,14,12,-0.0512820512820513,0.378378378378378,0.307692307692308
"1302","2015","경북","영양군","초등학교",2015-04-01,"남자",54,50,49,-1,5,4,-0.02,0.102040816326531,0.08
"1303","2015","경북","영덕군","초등학교",2015-04-01,"전체",168,186,186,0,-18,-18,0,-0.0967741935483871,-0.0967741935483871
"1304","2015","경북","영덕군","초등학교",2015-04-01,"여자",82,77,79,2,3,5,0.025974025974026,0.0379746835443038,0.0649350649350649
"1305","2015","경북","영덕군","초등학교",2015-04-01,"남자",86,109,107,-2,-21,-23,-0.018348623853211,-0.196261682242991,-0.211009174311927
"1306","2015","경북","청도군","초등학교",2015-04-01,"전체",176,165,174,9,2,11,0.0545454545454545,0.0114942528735632,0.0666666666666667
"1307","2015","경북","청도군","초등학교",2015-04-01,"여자",84,73,79,6,5,11,0.0821917808219178,0.0632911392405063,0.150684931506849
"1308","2015","경북","청도군","초등학교",2015-04-01,"남자",92,92,95,3,-3,0,0.0326086956521739,-0.0315789473684211,0
"1309","2015","경북","고령군","초등학교",2015-04-01,"전체",230,231,228,-3,2,-1,-0.012987012987013,0.0087719298245614,-0.00432900432900433
"1310","2015","경북","고령군","초등학교",2015-04-01,"여자",99,100,96,-4,3,-1,-0.04,0.03125,-0.01
"1311","2015","경북","고령군","초등학교",2015-04-01,"남자",131,131,132,1,-1,0,0.00763358778625954,-0.00757575757575758,0
"1312","2015","경북","성주군","초등학교",2015-04-01,"전체",207,227,226,-1,-19,-20,-0.00440528634361234,-0.084070796460177,-0.0881057268722467
"1313","2015","경북","성주군","초등학교",2015-04-01,"여자",93,119,116,-3,-23,-26,-0.0252100840336134,-0.198275862068966,-0.218487394957983
"1314","2015","경북","성주군","초등학교",2015-04-01,"남자",114,108,110,2,4,6,0.0185185185185185,0.0363636363636364,0.0555555555555556
"1315","2015","경북","칠곡군","초등학교",2015-04-01,"전체",1235,1311,1284,-27,-49,-76,-0.0205949656750572,-0.0381619937694704,-0.0579710144927536
"1316","2015","경북","칠곡군","초등학교",2015-04-01,"여자",600,615,595,-20,5,-15,-0.032520325203252,0.00840336134453781,-0.024390243902439
"1317","2015","경북","칠곡군","초등학교",2015-04-01,"남자",635,696,689,-7,-54,-61,-0.0100574712643678,-0.0783744557329463,-0.0876436781609195
"1318","2015","경북","예천군","초등학교",2015-04-01,"전체",243,284,276,-8,-33,-41,-0.028169014084507,-0.119565217391304,-0.144366197183099
"1319","2015","경북","예천군","초등학교",2015-04-01,"여자",99,125,120,-5,-21,-26,-0.04,-0.175,-0.208
"1320","2015","경북","예천군","초등학교",2015-04-01,"남자",144,159,156,-3,-12,-15,-0.0188679245283019,-0.0769230769230769,-0.0943396226415094
"1321","2015","경북","봉화군","초등학교",2015-04-01,"전체",175,218,208,-10,-33,-43,-0.0458715596330275,-0.158653846153846,-0.197247706422018
"1322","2015","경북","봉화군","초등학교",2015-04-01,"여자",73,89,88,-1,-15,-16,-0.0112359550561798,-0.170454545454545,-0.179775280898876
"1323","2015","경북","봉화군","초등학교",2015-04-01,"남자",102,129,120,-9,-18,-27,-0.0697674418604651,-0.15,-0.209302325581395
"1324","2015","경북","울진군","초등학교",2015-04-01,"전체",368,415,396,-19,-28,-47,-0.0457831325301205,-0.0707070707070707,-0.113253012048193
"1325","2015","경북","울진군","초등학교",2015-04-01,"여자",179,209,193,-16,-14,-30,-0.076555023923445,-0.0725388601036269,-0.143540669856459
"1326","2015","경북","울진군","초등학교",2015-04-01,"남자",189,206,203,-3,-14,-17,-0.0145631067961165,-0.0689655172413793,-0.0825242718446602
"1327","2015","경북","울릉군","초등학교",2015-04-01,"전체",57,53,59,6,-2,4,0.113207547169811,-0.0338983050847458,0.0754716981132075
"1328","2015","경북","울릉군","초등학교",2015-04-01,"여자",25,28,35,7,-10,-3,0.25,-0.285714285714286,-0.107142857142857
"1329","2015","경북","울릉군","초등학교",2015-04-01,"남자",32,25,24,-1,8,7,-0.04,0.333333333333333,0.28
"1330","2015","경남","진주시","초등학교",2015-04-01,"전체",3261,2919,2974,55,287,342,0.0188420692017814,0.0965030262273033,0.117163412127441
"1331","2015","경남","진주시","초등학교",2015-04-01,"여자",1582,1386,1421,35,161,196,0.0252525252525253,0.113300492610837,0.141414141414141
"1332","2015","경남","진주시","초등학교",2015-04-01,"남자",1679,1533,1553,20,126,146,0.0130463144161774,0.0811332904056665,0.0952380952380952
"1333","2015","경남","통영시","초등학교",2015-04-01,"전체",1439,1482,1489,7,-50,-43,0.00472334682860999,-0.0335795836131632,-0.0290148448043185
"1334","2015","경남","통영시","초등학교",2015-04-01,"여자",725,739,742,3,-17,-14,0.0040595399188092,-0.022911051212938,-0.0189445196211096
"1335","2015","경남","통영시","초등학교",2015-04-01,"남자",714,743,747,4,-33,-29,0.0053835800807537,-0.0441767068273092,-0.0390309555854643
"1336","2015","경남","사천시","초등학교",2015-04-01,"전체",1166,1203,1202,-1,-36,-37,-0.000831255195344971,-0.0299500831946755,-0.0307564422277639
"1337","2015","경남","사천시","초등학교",2015-04-01,"여자",564,563,574,11,-10,1,0.019538188277087,-0.0174216027874564,0.00177619893428064
"1338","2015","경남","사천시","초등학교",2015-04-01,"남자",602,640,628,-12,-26,-38,-0.01875,-0.0414012738853503,-0.059375
"1339","2015","경남","김해시","초등학교",2015-04-01,"전체",6072,5938,6117,179,-45,134,0.0301448299090603,-0.00735654732712114,0.0225665207140451
"1340","2015","경남","김해시","초등학교",2015-04-01,"여자",2945,2938,3033,95,-88,7,0.0323349217154527,-0.0290141773821299,0.00238257317903336
"1341","2015","경남","김해시","초등학교",2015-04-01,"남자",3127,3000,3084,84,43,127,0.028,0.0139429312581064,0.0423333333333333
"1342","2015","경남","밀양시","초등학교",2015-04-01,"전체",739,709,727,18,12,30,0.0253878702397743,0.0165061898211829,0.0423131170662905
"1343","2015","경남","밀양시","초등학교",2015-04-01,"여자",375,343,354,11,21,32,0.032069970845481,0.0593220338983051,0.0932944606413994
"1344","2015","경남","밀양시","초등학교",2015-04-01,"남자",364,366,373,7,-9,-2,0.0191256830601093,-0.0241286863270777,-0.00546448087431694
"1345","2015","경남","거제시","초등학교",2015-04-01,"전체",3028,3044,3041,-3,-13,-16,-0.000985545335085414,-0.00427490956922065,-0.00525624178712221
"1346","2015","경남","거제시","초등학교",2015-04-01,"여자",1482,1445,1441,-4,41,37,-0.0027681660899654,0.0284524635669674,0.0256055363321799
"1347","2015","경남","거제시","초등학교",2015-04-01,"남자",1546,1599,1600,1,-54,-53,0.000625390869293308,-0.03375,-0.0331457160725453
"1348","2015","경남","양산시","초등학교",2015-04-01,"전체",3213,2938,3060,122,153,275,0.0415248468345813,0.05,0.0936010891763104
"1349","2015","경남","양산시","초등학교",2015-04-01,"여자",1542,1400,1462,62,80,142,0.0442857142857143,0.0547195622435021,0.101428571428571
"1350","2015","경남","양산시","초등학교",2015-04-01,"남자",1671,1538,1598,60,73,133,0.0390117035110533,0.0456821026282854,0.0864759427828349
"1351","2015","경남","의령군","초등학교",2015-04-01,"전체",131,172,157,-15,-26,-41,-0.0872093023255814,-0.165605095541401,-0.238372093023256
"1352","2015","경남","의령군","초등학교",2015-04-01,"여자",66,84,70,-14,-4,-18,-0.166666666666667,-0.0571428571428571,-0.214285714285714
"1353","2015","경남","의령군","초등학교",2015-04-01,"남자",65,88,87,-1,-22,-23,-0.0113636363636364,-0.252873563218391,-0.261363636363636
"1354","2015","경남","함안군","초등학교",2015-04-01,"전체",686,636,637,1,49,50,0.00157232704402516,0.0769230769230769,0.0786163522012579
"1355","2015","경남","함안군","초등학교",2015-04-01,"여자",326,319,327,8,-1,7,0.0250783699059561,-0.00305810397553517,0.0219435736677116
"1356","2015","경남","함안군","초등학교",2015-04-01,"남자",360,317,310,-7,50,43,-0.0220820189274448,0.161290322580645,0.135646687697161
"1357","2015","경남","창녕군","초등학교",2015-04-01,"전체",379,415,415,0,-36,-36,0,-0.0867469879518072,-0.0867469879518072
"1358","2015","경남","창녕군","초등학교",2015-04-01,"여자",178,188,191,3,-13,-10,0.0159574468085106,-0.0680628272251309,-0.0531914893617021
"1359","2015","경남","창녕군","초등학교",2015-04-01,"남자",201,227,224,-3,-23,-26,-0.013215859030837,-0.102678571428571,-0.114537444933921
"1360","2015","경남","고성군","초등학교",2015-04-01,"전체",397,419,395,-24,2,-22,-0.0572792362768496,0.00506329113924051,-0.0525059665871122
"1361","2015","경남","고성군","초등학교",2015-04-01,"여자",190,206,191,-15,-1,-16,-0.0728155339805825,-0.00523560209424084,-0.0776699029126214
"1362","2015","경남","고성군","초등학교",2015-04-01,"남자",207,213,204,-9,3,-6,-0.0422535211267606,0.0147058823529412,-0.028169014084507
"1363","2015","경남","남해군","초등학교",2015-04-01,"전체",237,238,229,-9,8,-1,-0.0378151260504202,0.0349344978165939,-0.00420168067226891
"1364","2015","경남","남해군","초등학교",2015-04-01,"여자",106,113,105,-8,1,-7,-0.0707964601769911,0.00952380952380952,-0.0619469026548673
"1365","2015","경남","남해군","초등학교",2015-04-01,"남자",131,125,124,-1,7,6,-0.008,0.0564516129032258,0.048
"1366","2015","경남","하동군","초등학교",2015-04-01,"전체",268,286,284,-2,-16,-18,-0.00699300699300699,-0.0563380281690141,-0.0629370629370629
"1367","2015","경남","하동군","초등학교",2015-04-01,"여자",130,145,142,-3,-12,-15,-0.0206896551724138,-0.0845070422535211,-0.103448275862069
"1368","2015","경남","하동군","초등학교",2015-04-01,"남자",138,141,142,1,-4,-3,0.00709219858156028,-0.028169014084507,-0.0212765957446809
"1369","2015","경남","산청군","초등학교",2015-04-01,"전체",175,172,180,8,-5,3,0.0465116279069767,-0.0277777777777778,0.0174418604651163
"1370","2015","경남","산청군","초등학교",2015-04-01,"여자",68,78,84,6,-16,-10,0.0769230769230769,-0.19047619047619,-0.128205128205128
"1371","2015","경남","산청군","초등학교",2015-04-01,"남자",107,94,96,2,11,13,0.0212765957446809,0.114583333333333,0.138297872340426
"1372","2015","경남","함양군","초등학교",2015-04-01,"전체",283,290,292,2,-9,-7,0.00689655172413793,-0.0308219178082192,-0.0241379310344828
"1373","2015","경남","함양군","초등학교",2015-04-01,"여자",140,161,159,-2,-19,-21,-0.0124223602484472,-0.119496855345912,-0.130434782608696
"1374","2015","경남","함양군","초등학교",2015-04-01,"남자",143,129,133,4,10,14,0.0310077519379845,0.075187969924812,0.108527131782946
"1375","2015","경남","거창군","초등학교",2015-04-01,"전체",483,476,494,18,-11,7,0.0378151260504202,-0.0222672064777328,0.0147058823529412
"1376","2015","경남","거창군","초등학교",2015-04-01,"여자",231,233,244,11,-13,-2,0.0472103004291846,-0.0532786885245902,-0.00858369098712446
"1377","2015","경남","거창군","초등학교",2015-04-01,"남자",252,243,250,7,2,9,0.0288065843621399,0.008,0.037037037037037
"1378","2015","경남","합천군","초등학교",2015-04-01,"전체",226,265,262,-3,-36,-39,-0.0113207547169811,-0.137404580152672,-0.147169811320755
"1379","2015","경남","합천군","초등학교",2015-04-01,"여자",106,126,126,0,-20,-20,0,-0.158730158730159,-0.158730158730159
"1380","2015","경남","합천군","초등학교",2015-04-01,"남자",120,139,136,-3,-16,-19,-0.0215827338129496,-0.117647058823529,-0.136690647482014
"1381","2015","제주","제주시","초등학교",2015-04-01,"전체",4796,4566,4717,151,79,230,0.0330705212439772,0.016747933008268,0.0503723171265878
"1382","2015","제주","제주시","초등학교",2015-04-01,"여자",2329,2198,2262,64,67,131,0.0291173794358508,0.0296198054818744,0.0595996360327571
"1383","2015","제주","제주시","초등학교",2015-04-01,"남자",2467,2368,2455,87,12,99,0.0367398648648649,0.00488798370672098,0.0418074324324324
"1384","2015","제주","서귀포시","초등학교",2015-04-01,"전체",1407,1306,1372,66,35,101,0.0505359877488515,0.0255102040816327,0.0773353751914242
"1385","2015","제주","서귀포시","초등학교",2015-04-01,"여자",684,642,671,29,13,42,0.0451713395638629,0.0193740685543964,0.0654205607476635
"1386","2015","제주","서귀포시","초등학교",2015-04-01,"남자",723,664,701,37,22,59,0.0557228915662651,0.0313837375178317,0.088855421686747
"1387","2016","서울","종로구","초등학교",2016-04-01,"전체",876,891,840,-51,36,-15,-0.0572390572390572,0.0428571428571429,-0.0168350168350168
"1388","2016","서울","종로구","초등학교",2016-04-01,"여자",422,413,385,-28,37,9,-0.0677966101694915,0.0961038961038961,0.0217917675544794
"1389","2016","서울","종로구","초등학교",2016-04-01,"남자",454,478,455,-23,-1,-24,-0.0481171548117155,-0.0021978021978022,-0.0502092050209205
"1390","2016","서울","중구","초등학교",2016-04-01,"전체",883,848,803,-45,80,35,-0.0530660377358491,0.099626400996264,0.0412735849056604
"1391","2016","서울","중구","초등학교",2016-04-01,"여자",440,422,396,-26,44,18,-0.0616113744075829,0.111111111111111,0.042654028436019
"1392","2016","서울","중구","초등학교",2016-04-01,"남자",443,426,407,-19,36,17,-0.0446009389671361,0.0884520884520884,0.039906103286385
"1393","2016","서울","용산구","초등학교",2016-04-01,"전체",1286,1676,1586,-90,-300,-390,-0.0536992840095465,-0.189155107187894,-0.232696897374702
"1394","2016","서울","용산구","초등학교",2016-04-01,"여자",628,840,806,-34,-178,-212,-0.0404761904761905,-0.220843672456576,-0.252380952380952
"1395","2016","서울","용산구","초등학교",2016-04-01,"남자",658,836,780,-56,-122,-178,-0.0669856459330144,-0.156410256410256,-0.212918660287081
"1396","2016","서울","성동구","초등학교",2016-04-01,"전체",1995,2223,2113,-110,-118,-228,-0.0494826810616284,-0.0558447704685282,-0.102564102564103
"1397","2016","서울","성동구","초등학교",2016-04-01,"여자",989,1102,1044,-58,-55,-113,-0.0526315789473684,-0.0526819923371648,-0.102540834845735
"1398","2016","서울","성동구","초등학교",2016-04-01,"남자",1006,1121,1069,-52,-63,-115,-0.0463871543264942,-0.058933582787652,-0.102586975914362
"1399","2016","서울","광진구","초등학교",2016-04-01,"전체",2407,2509,2401,-108,6,-102,-0.0430450378636907,0.00249895876718034,-0.0406536468712635
"1400","2016","서울","광진구","초등학교",2016-04-01,"여자",1161,1182,1139,-43,22,-21,-0.0363790186125212,0.019315188762072,-0.0177664974619289
"1401","2016","서울","광진구","초등학교",2016-04-01,"남자",1246,1327,1262,-65,-16,-81,-0.0489826676714393,-0.0126782884310618,-0.0610399397136398
"1402","2016","서울","동대문구","초등학교",2016-04-01,"전체",2348,2637,2613,-24,-265,-289,-0.00910125142207053,-0.101415996938385,-0.109594235874099
"1403","2016","서울","동대문구","초등학교",2016-04-01,"여자",1130,1305,1283,-22,-153,-175,-0.0168582375478927,-0.11925175370226,-0.134099616858238
"1404","2016","서울","동대문구","초등학교",2016-04-01,"남자",1218,1332,1330,-2,-112,-114,-0.0015015015015015,-0.0842105263157895,-0.0855855855855856
"1405","2016","서울","중랑구","초등학교",2016-04-01,"전체",2563,2914,2843,-71,-280,-351,-0.0243651338366507,-0.0984875131902919,-0.120452985586822
"1406","2016","서울","중랑구","초등학교",2016-04-01,"여자",1282,1439,1388,-51,-106,-157,-0.0354412786657401,-0.0763688760806916,-0.109103544127867
"1407","2016","서울","중랑구","초등학교",2016-04-01,"남자",1281,1475,1455,-20,-174,-194,-0.0135593220338983,-0.119587628865979,-0.131525423728814
"1408","2016","서울","성북구","초등학교",2016-04-01,"전체",3592,3929,3791,-138,-199,-337,-0.035123441079155,-0.0524927459773147,-0.0857724611860524
"1409","2016","서울","성북구","초등학교",2016-04-01,"여자",1751,1932,1854,-78,-103,-181,-0.0403726708074534,-0.0555555555555556,-0.0936853002070393
"1410","2016","서울","성북구","초등학교",2016-04-01,"남자",1841,1997,1937,-60,-96,-156,-0.0300450676014021,-0.0495611770779556,-0.0781171757636455
"1411","2016","서울","강북구","초등학교",2016-04-01,"전체",1778,2317,2174,-143,-396,-539,-0.0617177384548986,-0.182152713891444,-0.232628398791541
"1412","2016","서울","강북구","초등학교",2016-04-01,"여자",880,1097,1043,-54,-163,-217,-0.0492251595259799,-0.156279961649089,-0.197812215132179
"1413","2016","서울","강북구","초등학교",2016-04-01,"남자",898,1220,1131,-89,-233,-322,-0.0729508196721311,-0.206012378426172,-0.263934426229508
"1414","2016","서울","도봉구","초등학교",2016-04-01,"전체",2684,2574,2545,-29,139,110,-0.0112665112665113,0.0546168958742633,0.0427350427350427
"1415","2016","서울","도봉구","초등학교",2016-04-01,"여자",1324,1250,1224,-26,100,74,-0.0208,0.0816993464052288,0.0592
"1416","2016","서울","도봉구","초등학교",2016-04-01,"남자",1360,1324,1321,-3,39,36,-0.00226586102719033,0.0295230885692657,0.027190332326284
"1417","2016","서울","노원구","초등학교",2016-04-01,"전체",4329,4350,4247,-103,82,-21,-0.0236781609195402,0.0193077466446904,-0.00482758620689655
"1418","2016","서울","노원구","초등학교",2016-04-01,"여자",2109,2142,2070,-72,39,-33,-0.0336134453781513,0.0188405797101449,-0.015406162464986
"1419","2016","서울","노원구","초등학교",2016-04-01,"남자",2220,2208,2177,-31,43,12,-0.0140398550724638,0.0197519522278365,0.00543478260869565
"1420","2016","서울","은평구","초등학교",2016-04-01,"전체",3737,4003,3954,-49,-217,-266,-0.0122408193854609,-0.0548811330298432,-0.0664501623782163
"1421","2016","서울","은평구","초등학교",2016-04-01,"여자",1813,1952,1935,-17,-122,-139,-0.00870901639344262,-0.0630490956072351,-0.0712090163934426
"1422","2016","서울","은평구","초등학교",2016-04-01,"남자",1924,2051,2019,-32,-95,-127,-0.0156021452949781,-0.0470529965329371,-0.0619210141394442
"1423","2016","서울","서대문구","초등학교",2016-04-01,"전체",2213,2173,2075,-98,138,40,-0.0450989415554533,0.0665060240963855,0.0184077312471238
"1424","2016","서울","서대문구","초등학교",2016-04-01,"여자",1103,1070,1023,-47,80,33,-0.0439252336448598,0.0782013685239492,0.0308411214953271
"1425","2016","서울","서대문구","초등학교",2016-04-01,"남자",1110,1103,1052,-51,58,7,-0.0462375339981868,0.0551330798479087,0.00634632819582956
"1426","2016","서울","마포구","초등학교",2016-04-01,"전체",2638,2994,3040,46,-402,-356,0.0153640614562458,-0.132236842105263,-0.118904475617902
"1427","2016","서울","마포구","초등학교",2016-04-01,"여자",1275,1417,1432,15,-157,-142,0.0105857445306987,-0.10963687150838,-0.100211714890614
"1428","2016","서울","마포구","초등학교",2016-04-01,"남자",1363,1577,1608,31,-245,-214,0.0196575776791376,-0.152363184079602,-0.13570069752695
"1429","2016","서울","양천구","초등학교",2016-04-01,"전체",3616,3693,3741,48,-125,-77,0.0129975629569456,-0.0334135257952419,-0.0208502572434335
"1430","2016","서울","양천구","초등학교",2016-04-01,"여자",1762,1790,1836,46,-74,-28,0.0256983240223464,-0.0403050108932462,-0.0156424581005587
"1431","2016","서울","양천구","초등학교",2016-04-01,"남자",1854,1903,1905,2,-51,-49,0.00105097214923805,-0.0267716535433071,-0.0257488176563321
"1432","2016","서울","강서구","초등학교",2016-04-01,"전체",4413,4430,4562,132,-149,-17,0.0297968397291196,-0.03266111354669,-0.00383747178329571
"1433","2016","서울","강서구","초등학교",2016-04-01,"여자",2124,2135,2204,69,-80,-11,0.0323185011709602,-0.0362976406533575,-0.00515222482435597
"1434","2016","서울","강서구","초등학교",2016-04-01,"남자",2289,2295,2358,63,-69,-6,0.0274509803921569,-0.0292620865139949,-0.00261437908496732
"1435","2016","서울","구로구","초등학교",2016-04-01,"전체",3329,3900,3720,-180,-391,-571,-0.0461538461538462,-0.10510752688172,-0.146410256410256
"1436","2016","서울","구로구","초등학교",2016-04-01,"여자",1640,1882,1792,-90,-152,-242,-0.0478214665249734,-0.0848214285714286,-0.128586609989373
"1437","2016","서울","구로구","초등학교",2016-04-01,"남자",1689,2018,1928,-90,-239,-329,-0.0445986124876115,-0.12396265560166,-0.163032705649158
"1438","2016","서울","금천구","초등학교",2016-04-01,"전체",1510,1600,1534,-66,-24,-90,-0.04125,-0.015645371577575,-0.05625
"1439","2016","서울","금천구","초등학교",2016-04-01,"여자",734,758,715,-43,19,-24,-0.0567282321899736,0.0265734265734266,-0.0316622691292876
"1440","2016","서울","금천구","초등학교",2016-04-01,"남자",776,842,819,-23,-43,-66,-0.0273159144893112,-0.0525030525030525,-0.0783847980997625
"1441","2016","서울","영등포구","초등학교",2016-04-01,"전체",2377,3069,2903,-166,-526,-692,-0.0540892798957315,-0.181191870478815,-0.225480612577387
"1442","2016","서울","영등포구","초등학교",2016-04-01,"여자",1166,1467,1416,-51,-250,-301,-0.0347648261758691,-0.176553672316384,-0.205180640763463
"1443","2016","서울","영등포구","초등학교",2016-04-01,"남자",1211,1602,1487,-115,-276,-391,-0.0717852684144819,-0.18560860793544,-0.244069912609238
"1444","2016","서울","동작구","초등학교",2016-04-01,"전체",2807,3154,3063,-91,-256,-347,-0.028852251109702,-0.0835781913157036,-0.11001902346227
"1445","2016","서울","동작구","초등학교",2016-04-01,"여자",1395,1546,1501,-45,-106,-151,-0.0291073738680466,-0.0706195869420386,-0.0976714100905563
"1446","2016","서울","동작구","초등학교",2016-04-01,"남자",1412,1608,1562,-46,-150,-196,-0.0286069651741294,-0.0960307298335467,-0.121890547263682
"1447","2016","서울","관악구","초등학교",2016-04-01,"전체",2732,3422,3225,-197,-493,-690,-0.0575686732904734,-0.152868217054264,-0.201636469900643
"1448","2016","서울","관악구","초등학교",2016-04-01,"여자",1310,1657,1578,-79,-268,-347,-0.0476765238382619,-0.169835234474018,-0.209414604707302
"1449","2016","서울","관악구","초등학교",2016-04-01,"남자",1422,1765,1647,-118,-225,-343,-0.0668555240793201,-0.136612021857924,-0.194334277620397
"1450","2016","서울","서초구","초등학교",2016-04-01,"전체",3662,3972,4189,217,-527,-310,0.0546324269889225,-0.125805681546909,-0.0780463242698892
"1451","2016","서울","서초구","초등학교",2016-04-01,"여자",1797,1980,2081,101,-284,-183,0.051010101010101,-0.136472849591543,-0.0924242424242424
"1452","2016","서울","서초구","초등학교",2016-04-01,"남자",1865,1992,2108,116,-243,-127,0.0582329317269076,-0.115275142314991,-0.0637550200803213
"1453","2016","서울","강남구","초등학교",2016-04-01,"전체",3703,3931,4148,217,-445,-228,0.0552022386161282,-0.107280617164899,-0.0580005087763928
"1454","2016","서울","강남구","초등학교",2016-04-01,"여자",1807,1918,2023,105,-216,-111,0.0547445255474453,-0.106772120612951,-0.0578727841501564
"1455","2016","서울","강남구","초등학교",2016-04-01,"남자",1896,2013,2125,112,-229,-117,0.0556383507203179,-0.107764705882353,-0.0581222056631893
"1456","2016","서울","송파구","초등학교",2016-04-01,"전체",5075,5627,5544,-83,-469,-552,-0.0147503110005331,-0.0845959595959596,-0.0980984538830638
"1457","2016","서울","송파구","초등학교",2016-04-01,"여자",2476,2738,2721,-17,-245,-262,-0.00620891161431702,-0.0900404263138552,-0.0956902848794741
"1458","2016","서울","송파구","초등학교",2016-04-01,"남자",2599,2889,2823,-66,-224,-290,-0.0228452751817238,-0.0793482111229189,-0.100380754586362
"1459","2016","서울","강동구","초등학교",2016-04-01,"전체",3229,3863,3736,-127,-507,-634,-0.032876003106394,-0.135706638115632,-0.164121149365778
"1460","2016","서울","강동구","초등학교",2016-04-01,"여자",1583,1859,1805,-54,-222,-276,-0.0290478752017214,-0.122991689750693,-0.148466917697687
"1461","2016","서울","강동구","초등학교",2016-04-01,"남자",1646,2004,1931,-73,-285,-358,-0.0364271457085828,-0.147591921284309,-0.178642714570858
"1462","2016","부산","중구","초등학교",2016-04-01,"전체",245,223,228,5,17,22,0.0224215246636771,0.0745614035087719,0.0986547085201794
"1463","2016","부산","중구","초등학교",2016-04-01,"여자",110,111,109,-2,1,-1,-0.018018018018018,0.00917431192660551,-0.00900900900900901
"1464","2016","부산","중구","초등학교",2016-04-01,"남자",135,112,119,7,16,23,0.0625,0.134453781512605,0.205357142857143
"1465","2016","부산","서구","초등학교",2016-04-01,"전체",572,598,600,2,-28,-26,0.00334448160535117,-0.0466666666666667,-0.0434782608695652
"1466","2016","부산","서구","초등학교",2016-04-01,"여자",268,281,284,3,-16,-13,0.0106761565836299,-0.0563380281690141,-0.0462633451957295
"1467","2016","부산","서구","초등학교",2016-04-01,"남자",304,317,316,-1,-12,-13,-0.00315457413249211,-0.0379746835443038,-0.0410094637223975
"1468","2016","부산","동구","초등학교",2016-04-01,"전체",388,536,492,-44,-104,-148,-0.082089552238806,-0.211382113821138,-0.276119402985075
"1469","2016","부산","동구","초등학교",2016-04-01,"여자",196,269,256,-13,-60,-73,-0.0483271375464684,-0.234375,-0.271375464684015
"1470","2016","부산","동구","초등학교",2016-04-01,"남자",192,267,236,-31,-44,-75,-0.116104868913858,-0.186440677966102,-0.280898876404494
"1471","2016","부산","영도구","초등학교",2016-04-01,"전체",617,724,700,-24,-83,-107,-0.0331491712707182,-0.118571428571429,-0.147790055248619
"1472","2016","부산","영도구","초등학교",2016-04-01,"여자",301,360,344,-16,-43,-59,-0.0444444444444444,-0.125,-0.163888888888889
"1473","2016","부산","영도구","초등학교",2016-04-01,"남자",316,364,356,-8,-40,-48,-0.021978021978022,-0.112359550561798,-0.131868131868132
"1474","2016","부산","부산진구","초등학교",2016-04-01,"전체",2550,2703,2649,-54,-99,-153,-0.0199778024417314,-0.0373725934314836,-0.0566037735849057
"1475","2016","부산","부산진구","초등학교",2016-04-01,"여자",1262,1320,1282,-38,-20,-58,-0.0287878787878788,-0.015600624024961,-0.0439393939393939
"1476","2016","부산","부산진구","초등학교",2016-04-01,"남자",1288,1383,1367,-16,-79,-95,-0.0115690527838033,-0.0577907827359181,-0.0686912509038323
"1477","2016","부산","동래구","초등학교",2016-04-01,"전체",1856,1829,1847,18,9,27,0.00984144341170038,0.00487276664861938,0.0147621651175506
"1478","2016","부산","동래구","초등학교",2016-04-01,"여자",886,906,907,1,-21,-20,0.0011037527593819,-0.0231532524807056,-0.022075055187638
"1479","2016","부산","동래구","초등학교",2016-04-01,"남자",970,923,940,17,30,47,0.0184182015167931,0.0319148936170213,0.0509209100758397
"1480","2016","부산","남구","초등학교",2016-04-01,"전체",1932,2188,2159,-29,-227,-256,-0.013254113345521,-0.105141269106068,-0.117001828153565
"1481","2016","부산","남구","초등학교",2016-04-01,"여자",961,1074,1067,-7,-106,-113,-0.00651769087523277,-0.0993439550140581,-0.105214152700186
"1482","2016","부산","남구","초등학교",2016-04-01,"남자",971,1114,1092,-22,-121,-143,-0.0197486535008977,-0.110805860805861,-0.128366247755835
"1483","2016","부산","북구","초등학교",2016-04-01,"전체",2203,2217,2197,-20,6,-14,-0.009021199819576,0.00273099681383705,-0.0063148398737032
"1484","2016","부산","북구","초등학교",2016-04-01,"여자",1107,1077,1072,-5,35,30,-0.00464252553389044,0.0326492537313433,0.0278551532033426
"1485","2016","부산","북구","초등학교",2016-04-01,"남자",1096,1140,1125,-15,-29,-44,-0.0131578947368421,-0.0257777777777778,-0.0385964912280702
"1486","2016","부산","해운대구","초등학교",2016-04-01,"전체",3149,3323,3389,66,-240,-174,0.0198615708696961,-0.0708173502508114,-0.052362323201926
"1487","2016","부산","해운대구","초등학교",2016-04-01,"여자",1534,1620,1648,28,-114,-86,0.0172839506172839,-0.0691747572815534,-0.0530864197530864
"1488","2016","부산","해운대구","초등학교",2016-04-01,"남자",1615,1703,1741,38,-126,-88,0.0223135642982971,-0.0723721998851235,-0.0516735173223723
"1489","2016","부산","사하구","초등학교",2016-04-01,"전체",2413,2638,2557,-81,-144,-225,-0.0307050796057619,-0.0563159953070004,-0.0852918877937832
"1490","2016","부산","사하구","초등학교",2016-04-01,"여자",1160,1270,1230,-40,-70,-110,-0.031496062992126,-0.0569105691056911,-0.0866141732283465
"1491","2016","부산","사하구","초등학교",2016-04-01,"남자",1253,1368,1327,-41,-74,-115,-0.0299707602339181,-0.0557648831951771,-0.0840643274853801
"1492","2016","부산","금정구","초등학교",2016-04-01,"전체",1534,1606,1589,-17,-55,-72,-0.0105853051058531,-0.0346129641283826,-0.0448318804483188
"1493","2016","부산","금정구","초등학교",2016-04-01,"여자",728,753,744,-9,-16,-25,-0.0119521912350598,-0.021505376344086,-0.0332005312084993
"1494","2016","부산","금정구","초등학교",2016-04-01,"남자",806,853,845,-8,-39,-47,-0.00937866354044549,-0.0461538461538462,-0.0550996483001172
"1495","2016","부산","강서구","초등학교",2016-04-01,"전체",1191,807,1025,218,166,384,0.270136307311029,0.161951219512195,0.475836431226766
"1496","2016","부산","강서구","초등학교",2016-04-01,"여자",568,384,500,116,68,184,0.302083333333333,0.136,0.479166666666667
"1497","2016","부산","강서구","초등학교",2016-04-01,"남자",623,423,525,102,98,200,0.24113475177305,0.186666666666667,0.472813238770686
"1498","2016","부산","연제구","초등학교",2016-04-01,"전체",1472,1469,1475,6,-3,3,0.00408441116405718,-0.00203389830508475,0.00204220558202859
"1499","2016","부산","연제구","초등학교",2016-04-01,"여자",689,690,702,12,-13,-1,0.0173913043478261,-0.0185185185185185,-0.00144927536231884
"1500","2016","부산","연제구","초등학교",2016-04-01,"남자",783,779,773,-6,10,4,-0.00770218228498074,0.0129366106080207,0.00513478818998716
"1501","2016","부산","수영구","초등학교",2016-04-01,"전체",1017,1082,1092,10,-75,-65,0.00924214417744917,-0.0686813186813187,-0.0600739371534196
"1502","2016","부산","수영구","초등학교",2016-04-01,"여자",485,508,506,-2,-21,-23,-0.00393700787401575,-0.041501976284585,-0.0452755905511811
"1503","2016","부산","수영구","초등학교",2016-04-01,"남자",532,574,586,12,-54,-42,0.0209059233449477,-0.0921501706484642,-0.0731707317073171
"1504","2016","부산","사상구","초등학교",2016-04-01,"전체",1394,1646,1594,-52,-200,-252,-0.031591737545565,-0.125470514429109,-0.153098420413123
"1505","2016","부산","사상구","초등학교",2016-04-01,"여자",668,776,757,-19,-89,-108,-0.0244845360824742,-0.117569352708058,-0.139175257731959
"1506","2016","부산","사상구","초등학교",2016-04-01,"남자",726,870,837,-33,-111,-144,-0.0379310344827586,-0.132616487455197,-0.16551724137931
"1507","2016","부산","기장군","초등학교",2016-04-01,"전체",1799,1683,1813,130,-14,116,0.077243018419489,-0.00772200772200772,0.0689245395127748
"1508","2016","부산","기장군","초등학교",2016-04-01,"여자",880,828,888,60,-8,52,0.072463768115942,-0.00900900900900901,0.0628019323671498
"1509","2016","부산","기장군","초등학교",2016-04-01,"남자",919,855,925,70,-6,64,0.0818713450292398,-0.00648648648648649,0.0748538011695906
"1510","2016","대구","중구","초등학교",2016-04-01,"전체",686,460,496,36,190,226,0.0782608695652174,0.383064516129032,0.491304347826087
"1511","2016","대구","중구","초등학교",2016-04-01,"여자",316,193,216,23,100,123,0.119170984455959,0.462962962962963,0.637305699481865
"1512","2016","대구","중구","초등학교",2016-04-01,"남자",370,267,280,13,90,103,0.048689138576779,0.321428571428571,0.385767790262172
"1513","2016","대구","동구","초등학교",2016-04-01,"전체",2890,3074,3053,-21,-163,-184,-0.00683148991541965,-0.0533901080904029,-0.0598568640208198
"1514","2016","대구","동구","초등학교",2016-04-01,"여자",1372,1451,1459,8,-87,-79,0.00551343900758098,-0.0596298834818369,-0.0544452101998622
"1515","2016","대구","동구","초등학교",2016-04-01,"남자",1518,1623,1594,-29,-76,-105,-0.0178681454097351,-0.0476787954830615,-0.0646950092421442
"1516","2016","대구","서구","초등학교",2016-04-01,"전체",1028,1116,1045,-71,-17,-88,-0.0636200716845878,-0.0162679425837321,-0.0788530465949821
"1517","2016","대구","서구","초등학교",2016-04-01,"여자",530,550,514,-36,16,-20,-0.0654545454545455,0.0311284046692607,-0.0363636363636364
"1518","2016","대구","서구","초등학교",2016-04-01,"남자",498,566,531,-35,-33,-68,-0.0618374558303887,-0.0621468926553672,-0.120141342756184
"1519","2016","대구","남구","초등학교",2016-04-01,"전체",779,868,846,-22,-67,-89,-0.0253456221198157,-0.0791962174940898,-0.102534562211982
"1520","2016","대구","남구","초등학교",2016-04-01,"여자",397,432,414,-18,-17,-35,-0.0416666666666667,-0.0410628019323672,-0.0810185185185185
"1521","2016","대구","남구","초등학교",2016-04-01,"남자",382,436,432,-4,-50,-54,-0.00917431192660551,-0.115740740740741,-0.123853211009174
"1522","2016","대구","북구","초등학교",2016-04-01,"전체",3662,3908,3874,-34,-212,-246,-0.00870010235414534,-0.0547237996902426,-0.0629477993858751
"1523","2016","대구","북구","초등학교",2016-04-01,"여자",1800,1864,1861,-3,-61,-64,-0.00160944206008584,-0.0327780763030629,-0.0343347639484979
"1524","2016","대구","북구","초등학교",2016-04-01,"남자",1862,2044,2013,-31,-151,-182,-0.0151663405088063,-0.0750124192747144,-0.089041095890411
"1525","2016","대구","수성구","초등학교",2016-04-01,"전체",3558,3346,3467,121,91,212,0.0361625821876868,0.0262474762042111,0.0633592349073521
"1526","2016","대구","수성구","초등학교",2016-04-01,"여자",1684,1605,1660,55,24,79,0.0342679127725857,0.0144578313253012,0.0492211838006231
"1527","2016","대구","수성구","초등학교",2016-04-01,"남자",1874,1741,1807,66,67,133,0.0379092475588742,0.0370780298837853,0.0763928776565192
"1528","2016","대구","달서구","초등학교",2016-04-01,"전체",5193,5221,5265,44,-72,-28,0.00842750430951925,-0.0136752136752137,-0.00536295728787589
"1529","2016","대구","달서구","초등학교",2016-04-01,"여자",2451,2519,2541,22,-90,-68,0.00873362445414847,-0.0354191263282172,-0.0269948392219135
"1530","2016","대구","달서구","초등학교",2016-04-01,"남자",2742,2702,2724,22,18,40,0.00814211695040711,0.0066079295154185,0.0148038490007402
"1531","2016","대구","달성군","초등학교",2016-04-01,"전체",1916,1922,1915,-7,1,-6,-0.0036420395421436,0.000522193211488251,-0.00312174817898023
"1532","2016","대구","달성군","초등학교",2016-04-01,"여자",961,950,940,-10,21,11,-0.0105263157894737,0.0223404255319149,0.0115789473684211
"1533","2016","대구","달성군","초등학교",2016-04-01,"남자",955,972,975,3,-20,-17,0.00308641975308642,-0.0205128205128205,-0.0174897119341564
"1534","2016","인천","중구","초등학교",2016-04-01,"전체",1201,1070,1115,45,86,131,0.0420560747663551,0.0771300448430493,0.122429906542056
"1535","2016","인천","중구","초등학교",2016-04-01,"여자",589,546,559,13,30,43,0.0238095238095238,0.0536672629695885,0.0787545787545788
"1536","2016","인천","중구","초등학교",2016-04-01,"남자",612,524,556,32,56,88,0.0610687022900763,0.100719424460432,0.16793893129771
"1537","2016","인천","동구","초등학교",2016-04-01,"전체",704,638,631,-7,73,66,-0.0109717868338558,0.115689381933439,0.103448275862069
"1538","2016","인천","동구","초등학교",2016-04-01,"여자",372,311,312,1,60,61,0.00321543408360129,0.192307692307692,0.196141479099678
"1539","2016","인천","동구","초등학교",2016-04-01,"남자",332,327,319,-8,13,5,-0.0244648318042813,0.0407523510971787,0.0152905198776758
"1540","2016","인천","남구","초등학교",2016-04-01,"전체",2826,3252,3170,-82,-344,-426,-0.0252152521525215,-0.108517350157729,-0.1309963099631
"1541","2016","인천","남구","초등학교",2016-04-01,"여자",1403,1636,1602,-34,-199,-233,-0.0207823960880196,-0.124219725343321,-0.142420537897311
"1542","2016","인천","남구","초등학교",2016-04-01,"남자",1423,1616,1568,-48,-145,-193,-0.0297029702970297,-0.0924744897959184,-0.119430693069307
"1543","2016","인천","연수구","초등학교",2016-04-01,"전체",3226,2813,2965,152,261,413,0.0540348382509776,0.088026981450253,0.146818343405617
"1544","2016","인천","연수구","초등학교",2016-04-01,"여자",1540,1368,1432,64,108,172,0.0467836257309941,0.0754189944134078,0.125730994152047
"1545","2016","인천","연수구","초등학교",2016-04-01,"남자",1686,1445,1533,88,153,241,0.0608996539792388,0.0998043052837573,0.166782006920415
"1546","2016","인천","남동구","초등학교",2016-04-01,"전체",5079,5100,5109,9,-30,-21,0.00176470588235294,-0.00587199060481503,-0.00411764705882353
"1547","2016","인천","남동구","초등학교",2016-04-01,"여자",2480,2462,2486,24,-6,18,0.00974817221770918,-0.00241351568785197,0.00731112916328188
"1548","2016","인천","남동구","초등학교",2016-04-01,"남자",2599,2638,2623,-15,-24,-39,-0.00568612585291888,-0.00914982844071674,-0.0147839272175891
"1549","2016","인천","부평구","초등학교",2016-04-01,"전체",4474,4622,4558,-64,-84,-148,-0.0138468195586326,-0.0184291355857832,-0.0320207702293379
"1550","2016","인천","부평구","초등학교",2016-04-01,"여자",2169,2267,2224,-43,-55,-98,-0.0189677988531098,-0.0247302158273381,-0.043228936921041
"1551","2016","인천","부평구","초등학교",2016-04-01,"남자",2305,2355,2334,-21,-29,-50,-0.0089171974522293,-0.0124250214224507,-0.0212314225053079
"1552","2016","인천","계양구","초등학교",2016-04-01,"전체",2720,3021,2923,-98,-203,-301,-0.0324395895398875,-0.0694491960314745,-0.0996358821582257
"1553","2016","인천","계양구","초등학교",2016-04-01,"여자",1294,1465,1420,-45,-126,-171,-0.0307167235494881,-0.0887323943661972,-0.116723549488055
"1554","2016","인천","계양구","초등학교",2016-04-01,"남자",1426,1556,1503,-53,-77,-130,-0.0340616966580977,-0.051230871590153,-0.083547557840617
"1555","2016","인천","서구","초등학교",2016-04-01,"전체",5111,5461,5455,-6,-344,-350,-0.00109869987181835,-0.0630614115490376,-0.0640908258560703
"1556","2016","인천","서구","초등학교",2016-04-01,"여자",2454,2640,2637,-3,-183,-186,-0.00113636363636364,-0.0693970420932878,-0.0704545454545455
"1557","2016","인천","서구","초등학교",2016-04-01,"남자",2657,2821,2818,-3,-161,-164,-0.0010634526763559,-0.0571327182398864,-0.0581354129741227
"1558","2016","인천","강화군","초등학교",2016-04-01,"전체",394,389,399,10,-5,5,0.025706940874036,-0.012531328320802,0.012853470437018
"1559","2016","인천","강화군","초등학교",2016-04-01,"여자",184,201,201,0,-17,-17,0,-0.0845771144278607,-0.0845771144278607
"1560","2016","인천","강화군","초등학교",2016-04-01,"남자",210,188,198,10,12,22,0.0531914893617021,0.0606060606060606,0.117021276595745
"1561","2016","인천","옹진군","초등학교",2016-04-01,"전체",114,126,120,-6,-6,-12,-0.0476190476190476,-0.05,-0.0952380952380952
"1562","2016","인천","옹진군","초등학교",2016-04-01,"여자",52,67,56,-11,-4,-15,-0.164179104477612,-0.0714285714285714,-0.223880597014925
"1563","2016","인천","옹진군","초등학교",2016-04-01,"남자",62,59,64,5,-2,3,0.0847457627118644,-0.03125,0.0508474576271186
"1564","2016","광주","동구","초등학교",2016-04-01,"전체",496,594,577,-17,-81,-98,-0.0286195286195286,-0.140381282495667,-0.164983164983165
"1565","2016","광주","동구","초등학교",2016-04-01,"여자",233,297,291,-6,-58,-64,-0.0202020202020202,-0.199312714776632,-0.215488215488215
"1566","2016","광주","동구","초등학교",2016-04-01,"남자",263,297,286,-11,-23,-34,-0.037037037037037,-0.0804195804195804,-0.114478114478114
"1567","2016","광주","서구","초등학교",2016-04-01,"전체",2724,2810,2747,-63,-23,-86,-0.0224199288256228,-0.00837277029486713,-0.0306049822064057
"1568","2016","광주","서구","초등학교",2016-04-01,"여자",1337,1322,1287,-35,50,15,-0.0264750378214826,0.0388500388500388,0.0113464447806354
"1569","2016","광주","서구","초등학교",2016-04-01,"남자",1387,1488,1460,-28,-73,-101,-0.0188172043010753,-0.05,-0.0678763440860215
"1570","2016","광주","남구","초등학교",2016-04-01,"전체",1985,1720,1858,138,127,265,0.0802325581395349,0.0683530678148547,0.15406976744186
"1571","2016","광주","남구","초등학교",2016-04-01,"여자",955,842,894,52,61,113,0.0617577197149644,0.0682326621923937,0.134204275534442
"1572","2016","광주","남구","초등학교",2016-04-01,"남자",1030,878,964,86,66,152,0.0979498861047836,0.0684647302904564,0.173120728929385
"1573","2016","광주","북구","초등학교",2016-04-01,"전체",3883,3873,3927,54,-44,10,0.0139426800929512,-0.0112044817927171,0.00258197779499096
"1574","2016","광주","북구","초등학교",2016-04-01,"여자",1807,1810,1832,22,-25,-3,0.0121546961325967,-0.013646288209607,-0.00165745856353591
"1575","2016","광주","북구","초등학교",2016-04-01,"남자",2076,2063,2095,32,-19,13,0.0155113911778963,-0.00906921241050119,0.00630150266602036
"1576","2016","광주","광산구","초등학교",2016-04-01,"전체",5163,5194,5212,18,-49,-31,0.00346553715825953,-0.00940138142747506,-0.00596842510589141
"1577","2016","광주","광산구","초등학교",2016-04-01,"여자",2557,2526,2545,19,12,31,0.00752177355502771,0.00471512770137525,0.0122723673792557
"1578","2016","광주","광산구","초등학교",2016-04-01,"남자",2606,2668,2667,-1,-61,-62,-0.000374812593703148,-0.0228721409823772,-0.0232383808095952
"1579","2016","대전","동구","초등학교",2016-04-01,"전체",1971,2296,2132,-164,-161,-325,-0.0714285714285714,-0.075515947467167,-0.141550522648084
"1580","2016","대전","동구","초등학교",2016-04-01,"여자",936,1110,1030,-80,-94,-174,-0.0720720720720721,-0.0912621359223301,-0.156756756756757
"1581","2016","대전","동구","초등학교",2016-04-01,"남자",1035,1186,1102,-84,-67,-151,-0.0708263069139966,-0.0607985480943739,-0.127318718381113
"1582","2016","대전","중구","초등학교",2016-04-01,"전체",2067,2286,2156,-130,-89,-219,-0.0568678915135608,-0.0412801484230056,-0.0958005249343832
"1583","2016","대전","중구","초등학교",2016-04-01,"여자",1014,1124,1060,-64,-46,-110,-0.0569395017793594,-0.0433962264150943,-0.097864768683274
"1584","2016","대전","중구","초등학교",2016-04-01,"남자",1053,1162,1096,-66,-43,-109,-0.0567986230636833,-0.0392335766423358,-0.0938037865748709
"1585","2016","대전","서구","초등학교",2016-04-01,"전체",4253,4399,4426,27,-173,-146,0.00613775858149579,-0.0390872119295075,-0.0331893612184587
"1586","2016","대전","서구","초등학교",2016-04-01,"여자",2043,2209,2210,1,-167,-166,0.000452693526482571,-0.0755656108597285,-0.0751471253961068
"1587","2016","대전","서구","초등학교",2016-04-01,"남자",2210,2190,2216,26,-6,20,0.0118721461187215,-0.00270758122743682,0.0091324200913242
"1588","2016","대전","유성구","초등학교",2016-04-01,"전체",3830,3898,3957,59,-127,-68,0.0151359671626475,-0.0320950214809199,-0.017444843509492
"1589","2016","대전","유성구","초등학교",2016-04-01,"여자",1900,1872,1940,68,-40,28,0.0363247863247863,-0.0206185567010309,0.014957264957265
"1590","2016","대전","유성구","초등학교",2016-04-01,"남자",1930,2026,2017,-9,-87,-96,-0.00444225074037512,-0.0431333663857214,-0.0473840078973346
"1591","2016","대전","대덕구","초등학교",2016-04-01,"전체",1575,1741,1692,-49,-117,-166,-0.0281447443997702,-0.0691489361702128,-0.0953475014359563
"1592","2016","대전","대덕구","초등학교",2016-04-01,"여자",741,826,803,-23,-62,-85,-0.0278450363196126,-0.0772104607721046,-0.102905569007264
"1593","2016","대전","대덕구","초등학교",2016-04-01,"남자",834,915,889,-26,-55,-81,-0.0284153005464481,-0.061867266591676,-0.0885245901639344
"1594","2016","울산","중구","초등학교",2016-04-01,"전체",2079,1942,2079,137,0,137,0.0705458290422245,0,0.0705458290422245
"1595","2016","울산","중구","초등학교",2016-04-01,"여자",966,910,960,50,6,56,0.0549450549450549,0.00625,0.0615384615384615
"1596","2016","울산","중구","초등학교",2016-04-01,"남자",1113,1032,1119,87,-6,81,0.0843023255813953,-0.00536193029490617,0.0784883720930233
"1597","2016","울산","남구","초등학교",2016-04-01,"전체",2702,2864,2820,-44,-118,-162,-0.0153631284916201,-0.0418439716312057,-0.0565642458100559
"1598","2016","울산","남구","초등학교",2016-04-01,"여자",1291,1367,1347,-20,-56,-76,-0.0146305779078274,-0.0415738678544915,-0.055596196049744
"1599","2016","울산","남구","초등학교",2016-04-01,"남자",1411,1497,1473,-24,-62,-86,-0.0160320641282565,-0.0420909708078751,-0.0574482297929192
"1600","2016","울산","동구","초등학교",2016-04-01,"전체",1772,1957,1880,-77,-108,-185,-0.0393459376596832,-0.0574468085106383,-0.0945324476239141
"1601","2016","울산","동구","초등학교",2016-04-01,"여자",872,948,904,-44,-32,-76,-0.0464135021097046,-0.0353982300884956,-0.080168776371308
"1602","2016","울산","동구","초등학교",2016-04-01,"남자",900,1009,976,-33,-76,-109,-0.0327056491575818,-0.0778688524590164,-0.10802775024777
"1603","2016","울산","북구","초등학교",2016-04-01,"전체",2278,2313,2301,-12,-23,-35,-0.00518806744487678,-0.00999565406345067,-0.0151318633808906
"1604","2016","울산","북구","초등학교",2016-04-01,"여자",1055,1078,1081,3,-26,-23,0.00278293135435993,-0.0240518038852914,-0.0213358070500928
"1605","2016","울산","북구","초등학교",2016-04-01,"남자",1223,1235,1220,-15,3,-12,-0.0121457489878543,0.00245901639344262,-0.0097165991902834
"1606","2016","울산","울주군","초등학교",2016-04-01,"전체",2179,2156,2156,0,23,23,0,0.0106679035250464,0.0106679035250464
"1607","2016","울산","울주군","초등학교",2016-04-01,"여자",1086,1044,1048,4,38,42,0.00383141762452107,0.0362595419847328,0.0402298850574713
"1608","2016","울산","울주군","초등학교",2016-04-01,"남자",1093,1112,1108,-4,-15,-19,-0.00359712230215827,-0.0135379061371841,-0.0170863309352518
"1609","2016","세종","세종시","초등학교",2016-04-01,"전체",3248,1444,2434,990,814,1804,0.685595567867036,0.33442892358258,1.24930747922438
"1610","2016","세종","세종시","초등학교",2016-04-01,"전체",3248,1444,2434,990,814,1804,0.685595567867036,0.33442892358258,1.24930747922438
"1611","2016","세종","세종시","초등학교",2016-04-01,"전체",3248,1444,2434,990,814,1804,0.685595567867036,0.33442892358258,1.24930747922438
"1612","2016","세종","세종시","초등학교",2016-04-01,"전체",3248,1444,2434,990,814,1804,0.685595567867036,0.33442892358258,1.24930747922438
"1613","2016","세종","세종시","초등학교",2016-04-01,"여자",1599,746,1211,465,388,853,0.623324396782842,0.320396366639141,1.14343163538874
"1614","2016","세종","세종시","초등학교",2016-04-01,"여자",1599,746,1211,465,388,853,0.623324396782842,0.320396366639141,1.14343163538874
"1615","2016","세종","세종시","초등학교",2016-04-01,"여자",1599,746,1211,465,388,853,0.623324396782842,0.320396366639141,1.14343163538874
"1616","2016","세종","세종시","초등학교",2016-04-01,"여자",1599,746,1211,465,388,853,0.623324396782842,0.320396366639141,1.14343163538874
"1617","2016","세종","세종시","초등학교",2016-04-01,"남자",1649,698,1223,525,426,951,0.752148997134671,0.348323793949305,1.36246418338109
"1618","2016","세종","세종시","초등학교",2016-04-01,"남자",1649,698,1223,525,426,951,0.752148997134671,0.348323793949305,1.36246418338109
"1619","2016","세종","세종시","초등학교",2016-04-01,"남자",1649,698,1223,525,426,951,0.752148997134671,0.348323793949305,1.36246418338109
"1620","2016","세종","세종시","초등학교",2016-04-01,"남자",1649,698,1223,525,426,951,0.752148997134671,0.348323793949305,1.36246418338109
"1621","2016","경기","수원시","초등학교",2016-04-01,"전체",11258,11340,11447,107,-189,-82,0.00943562610229277,-0.016510876212108,-0.0072310405643739
"1622","2016","경기","수원시","초등학교",2016-04-01,"여자",5511,5566,5603,37,-92,-55,0.00664750269493353,-0.0164197751204712,-0.00988142292490119
"1623","2016","경기","수원시","초등학교",2016-04-01,"남자",5747,5774,5844,70,-97,-27,0.0121233113959127,-0.0165982203969884,-0.00467613439556633
"1624","2016","경기","성남시","초등학교",2016-04-01,"전체",7483,8036,7881,-155,-398,-553,-0.0192882030861125,-0.0505012054307829,-0.068815331010453
"1625","2016","경기","성남시","초등학교",2016-04-01,"여자",3658,3971,3881,-90,-223,-313,-0.0226643162931252,-0.0574594176758567,-0.0788214555527575
"1626","2016","경기","성남시","초등학교",2016-04-01,"남자",3825,4065,4000,-65,-175,-240,-0.015990159901599,-0.04375,-0.0590405904059041
"1627","2016","경기","부천시","초등학교",2016-04-01,"전체",6657,7301,7106,-195,-449,-644,-0.0267086700451993,-0.0631860399662257,-0.0882070949185043
"1628","2016","경기","부천시","초등학교",2016-04-01,"여자",3254,3588,3496,-92,-242,-334,-0.0256410256410256,-0.0692219679633867,-0.0930880713489409
"1629","2016","경기","부천시","초등학교",2016-04-01,"남자",3403,3713,3610,-103,-207,-310,-0.0277403716671155,-0.0573407202216066,-0.0834904389981147
"1630","2016","경기","안양시","초등학교",2016-04-01,"전체",4642,4927,4837,-90,-195,-285,-0.0182666937284352,-0.0403142443663428,-0.0578445301400447
"1631","2016","경기","안양시","초등학교",2016-04-01,"여자",2253,2387,2357,-30,-104,-134,-0.0125680770842061,-0.0441238862961392,-0.0561374109761207
"1632","2016","경기","안양시","초등학교",2016-04-01,"남자",2389,2540,2480,-60,-91,-151,-0.0236220472440945,-0.0366935483870968,-0.0594488188976378
"1633","2016","경기","과천시","초등학교",2016-04-01,"전체",496,589,568,-21,-72,-93,-0.0356536502546689,-0.126760563380282,-0.157894736842105
"1634","2016","경기","과천시","초등학교",2016-04-01,"여자",238,279,274,-5,-36,-41,-0.017921146953405,-0.131386861313869,-0.146953405017921
"1635","2016","경기","과천시","초등학교",2016-04-01,"남자",258,310,294,-16,-36,-52,-0.0516129032258065,-0.122448979591837,-0.167741935483871
"1636","2016","경기","안산시","초등학교",2016-04-01,"전체",5900,6315,6102,-213,-202,-415,-0.033729216152019,-0.0331039003605375,-0.0657165479018211
"1637","2016","경기","안산시","초등학교",2016-04-01,"여자",2863,3017,2924,-93,-61,-154,-0.0308253231687106,-0.0208618331053352,-0.0510440835266821
"1638","2016","경기","안산시","초등학교",2016-04-01,"남자",3037,3298,3178,-120,-141,-261,-0.0363856882959369,-0.0443675267463814,-0.0791388720436628
"1639","2016","경기","용인시","초등학교",2016-04-01,"전체",10993,11340,11493,153,-500,-347,0.0134920634920635,-0.0435047420168798,-0.0305996472663139
"1640","2016","경기","용인시","초등학교",2016-04-01,"여자",5300,5517,5572,55,-272,-217,0.00996918615189414,-0.0488155061019383,-0.0393329708174733
"1641","2016","경기","용인시","초등학교",2016-04-01,"남자",5693,5823,5921,98,-228,-130,0.0168298128112657,-0.0385070089511907,-0.0223252618924953
"1642","2016","경기","군포시","초등학교",2016-04-01,"전체",2679,2866,2840,-26,-161,-187,-0.00907187718073971,-0.0566901408450704,-0.0652477320307048
"1643","2016","경기","군포시","초등학교",2016-04-01,"여자",1318,1379,1362,-17,-44,-61,-0.0123277737490935,-0.0323054331864905,-0.0442349528643945
"1644","2016","경기","군포시","초등학교",2016-04-01,"남자",1361,1487,1478,-9,-117,-126,-0.00605245460659045,-0.0791610284167794,-0.0847343644922663
"1645","2016","경기","의왕시","초등학교",2016-04-01,"전체",1368,1617,1530,-87,-162,-249,-0.0538033395176252,-0.105882352941176,-0.153988868274583
"1646","2016","경기","의왕시","초등학교",2016-04-01,"여자",667,816,755,-61,-88,-149,-0.0747549019607843,-0.116556291390728,-0.182598039215686
"1647","2016","경기","의왕시","초등학교",2016-04-01,"남자",701,801,775,-26,-74,-100,-0.0324594257178527,-0.0954838709677419,-0.124843945068664
"1648","2016","경기","시흥시","초등학교",2016-04-01,"전체",4069,4064,3996,-68,73,5,-0.0167322834645669,0.0182682682682683,0.00123031496062992
"1649","2016","경기","시흥시","초등학교",2016-04-01,"여자",1963,1988,1962,-26,1,-25,-0.0130784708249497,0.000509683995922528,-0.0125754527162978
"1650","2016","경기","시흥시","초등학교",2016-04-01,"남자",2106,2076,2034,-42,72,30,-0.0202312138728324,0.0353982300884956,0.0144508670520231
"1651","2016","경기","평택시","초등학교",2016-04-01,"전체",4704,4589,4649,60,55,115,0.0130747439529309,0.0118305011830501,0.0250599259097843
"1652","2016","경기","평택시","초등학교",2016-04-01,"여자",2303,2214,2243,29,60,89,0.0130984643179765,0.0267498885421311,0.0401987353206865
"1653","2016","경기","평택시","초등학교",2016-04-01,"남자",2401,2375,2406,31,-5,26,0.0130526315789474,-0.00207813798836243,0.0109473684210526
"1654","2016","경기","화성시","초등학교",2016-04-01,"전체",8751,7917,8230,313,521,834,0.0395351774662119,0.0633049817739976,0.10534293292914
"1655","2016","경기","화성시","초등학교",2016-04-01,"여자",4268,3852,4003,151,265,416,0.0392004153686397,0.0662003497376967,0.107995846313603
"1656","2016","경기","화성시","초등학교",2016-04-01,"남자",4483,4065,4227,162,256,418,0.0398523985239852,0.0605630470783061,0.102829028290283
"1657","2016","경기","오산시","초등학교",2016-04-01,"전체",2728,3012,2918,-94,-190,-284,-0.0312084993359894,-0.0651130911583276,-0.0942895086321381
"1658","2016","경기","오산시","초등학교",2016-04-01,"여자",1301,1467,1427,-40,-126,-166,-0.027266530334015,-0.0882971268395235,-0.113156100886162
"1659","2016","경기","오산시","초등학교",2016-04-01,"남자",1427,1545,1491,-54,-64,-118,-0.0349514563106796,-0.0429242119382964,-0.0763754045307443
"1660","2016","경기","광명시","초등학교",2016-04-01,"전체",3274,3497,3407,-90,-133,-223,-0.0257363454389477,-0.0390372761960669,-0.063768944809837
"1661","2016","경기","광명시","초등학교",2016-04-01,"여자",1539,1665,1612,-53,-73,-126,-0.0318318318318318,-0.0452853598014888,-0.0756756756756757
"1662","2016","경기","광명시","초등학교",2016-04-01,"남자",1735,1832,1795,-37,-60,-97,-0.0201965065502183,-0.0334261838440111,-0.0529475982532751
"1663","2016","경기","광주시","초등학교",2016-04-01,"전체",2816,3050,3015,-35,-199,-234,-0.0114754098360656,-0.0660033167495854,-0.0767213114754098
"1664","2016","경기","광주시","초등학교",2016-04-01,"여자",1392,1461,1455,-6,-63,-69,-0.00410677618069815,-0.0432989690721649,-0.0472279260780287
"1665","2016","경기","광주시","초등학교",2016-04-01,"남자",1424,1589,1560,-29,-136,-165,-0.0182504719949654,-0.0871794871794872,-0.103838892385148
"1666","2016","경기","하남시","초등학교",2016-04-01,"전체",1652,1320,1507,187,145,332,0.141666666666667,0.0962176509621765,0.251515151515152
"1667","2016","경기","하남시","초등학교",2016-04-01,"여자",816,635,735,100,81,181,0.15748031496063,0.110204081632653,0.28503937007874
"1668","2016","경기","하남시","초등학교",2016-04-01,"남자",836,685,772,87,64,151,0.127007299270073,0.0829015544041451,0.22043795620438
"1669","2016","경기","김포시","초등학교",2016-04-01,"전체",4133,3903,4238,335,-105,230,0.0858314117345632,-0.0247758376592732,0.0589290289520881
"1670","2016","경기","김포시","초등학교",2016-04-01,"여자",1996,1872,2055,183,-59,124,0.0977564102564103,-0.0287104622871046,0.0662393162393162
"1671","2016","경기","김포시","초등학교",2016-04-01,"남자",2137,2031,2183,152,-46,106,0.0748399803052683,-0.0210719193770041,0.052191038897095
"1672","2016","경기","이천시","초등학교",2016-04-01,"전체",2032,2190,2133,-57,-101,-158,-0.026027397260274,-0.0473511486169714,-0.0721461187214612
"1673","2016","경기","이천시","초등학교",2016-04-01,"여자",968,1029,1006,-23,-38,-61,-0.0223517978620019,-0.0377733598409543,-0.0592808551992225
"1674","2016","경기","이천시","초등학교",2016-04-01,"남자",1064,1161,1127,-34,-63,-97,-0.0292850990525409,-0.0559006211180124,-0.0835486649440138
"1675","2016","경기","안성시","초등학교",2016-04-01,"전체",1802,1929,1891,-38,-89,-127,-0.0196993260756869,-0.047065044949762,-0.0658372213582167
"1676","2016","경기","안성시","초등학교",2016-04-01,"여자",883,926,905,-21,-22,-43,-0.0226781857451404,-0.0243093922651934,-0.0464362850971922
"1677","2016","경기","안성시","초등학교",2016-04-01,"남자",919,1003,986,-17,-67,-84,-0.0169491525423729,-0.0679513184584179,-0.0837487537387837
"1678","2016","경기","여주시","초등학교",2016-04-01,"전체",908,865,882,17,26,43,0.0196531791907514,0.0294784580498866,0.0497109826589595
"1679","2016","경기","여주시","초등학교",2016-04-01,"여자",427,401,409,8,18,26,0.0199501246882793,0.0440097799511002,0.0648379052369077
"1680","2016","경기","여주시","초등학교",2016-04-01,"남자",481,464,473,9,8,17,0.0193965517241379,0.0169133192389006,0.0366379310344828
"1681","2016","경기","양평군","초등학교",2016-04-01,"전체",822,761,805,44,17,61,0.0578186596583443,0.0211180124223602,0.0801576872536137
"1682","2016","경기","양평군","초등학교",2016-04-01,"여자",391,383,401,18,-10,8,0.0469973890339426,-0.0249376558603491,0.02088772845953
"1683","2016","경기","양평군","초등학교",2016-04-01,"남자",431,378,404,26,27,53,0.0687830687830688,0.0668316831683168,0.14021164021164
"1684","2016","경기","고양시","초등학교",2016-04-01,"전체",8646,8858,9097,239,-451,-212,0.0269812598780763,-0.0495767835550181,-0.0239331677579589
"1685","2016","경기","고양시","초등학교",2016-04-01,"여자",4156,4245,4348,103,-192,-89,0.024263839811543,-0.0441582336706532,-0.0209658421672556
"1686","2016","경기","고양시","초등학교",2016-04-01,"남자",4490,4613,4749,136,-259,-123,0.0294818989811403,-0.0545377974310381,-0.0266637762844136
"1687","2016","경기","남양주시","초등학교",2016-04-01,"전체",7049,7196,7308,112,-259,-147,0.0155642023346304,-0.0354406130268199,-0.0204280155642023
"1688","2016","경기","남양주시","초등학교",2016-04-01,"여자",3421,3500,3544,44,-123,-79,0.0125714285714286,-0.034706546275395,-0.0225714285714286
"1689","2016","경기","남양주시","초등학교",2016-04-01,"남자",3628,3696,3764,68,-136,-68,0.0183982683982684,-0.0361317747077577,-0.0183982683982684
"1690","2016","경기","구리시","초등학교",2016-04-01,"전체",1524,1702,1650,-52,-126,-178,-0.0305522914218566,-0.0763636363636364,-0.104582843713279
"1691","2016","경기","구리시","초등학교",2016-04-01,"여자",720,794,769,-25,-49,-74,-0.0314861460957179,-0.0637191157347204,-0.0931989924433249
"1692","2016","경기","구리시","초등학교",2016-04-01,"남자",804,908,881,-27,-77,-104,-0.0297356828193833,-0.0874006810442679,-0.114537444933921
"1693","2016","경기","의정부시","초등학교",2016-04-01,"전체",3466,3767,3681,-86,-215,-301,-0.0228298380674277,-0.0584080412931269,-0.0799044332359968
"1694","2016","경기","의정부시","초등학교",2016-04-01,"여자",1735,1859,1814,-45,-79,-124,-0.0242065626681011,-0.0435501653803749,-0.0667025282409898
"1695","2016","경기","의정부시","초등학교",2016-04-01,"남자",1731,1908,1867,-41,-136,-177,-0.0214884696016771,-0.0728441349758972,-0.0927672955974843
"1696","2016","경기","파주시","초등학교",2016-04-01,"전체",4591,4599,4721,122,-130,-8,0.0265275059795608,-0.0275365388688837,-0.00173950858882366
"1697","2016","경기","파주시","초등학교",2016-04-01,"여자",2195,2224,2289,65,-94,-29,0.029226618705036,-0.0410659676714723,-0.0130395683453237
"1698","2016","경기","파주시","초등학교",2016-04-01,"남자",2396,2375,2432,57,-36,21,0.024,-0.0148026315789474,0.00884210526315789
"1699","2016","경기","동두천시","초등학교",2016-04-01,"전체",863,926,919,-7,-56,-63,-0.00755939524838013,-0.0609357997823721,-0.0680345572354212
"1700","2016","경기","동두천시","초등학교",2016-04-01,"여자",432,463,459,-4,-27,-31,-0.00863930885529158,-0.0588235294117647,-0.0669546436285097
"1701","2016","경기","동두천시","초등학교",2016-04-01,"남자",431,463,460,-3,-29,-32,-0.00647948164146868,-0.0630434782608696,-0.0691144708423326
"1702","2016","경기","양주시","초등학교",2016-04-01,"전체",2141,2091,2142,51,-1,50,0.024390243902439,-0.000466853408029879,0.0239120038259206
"1703","2016","경기","양주시","초등학교",2016-04-01,"여자",1052,1029,1057,28,-5,23,0.0272108843537415,-0.00473036896877956,0.0223517978620019
"1704","2016","경기","양주시","초등학교",2016-04-01,"남자",1089,1062,1085,23,4,27,0.0216572504708098,0.00368663594470046,0.0254237288135593
"1705","2016","경기","포천시","초등학교",2016-04-01,"전체",1192,1295,1290,-5,-98,-103,-0.00386100386100386,-0.075968992248062,-0.0795366795366795
"1706","2016","경기","포천시","초등학교",2016-04-01,"여자",589,615,617,2,-28,-26,0.0032520325203252,-0.0453808752025932,-0.0422764227642276
"1707","2016","경기","포천시","초등학교",2016-04-01,"남자",603,680,673,-7,-70,-77,-0.0102941176470588,-0.104011887072808,-0.113235294117647
"1708","2016","경기","가평군","초등학교",2016-04-01,"전체",418,426,413,-13,5,-8,-0.0305164319248826,0.0121065375302663,-0.0187793427230047
"1709","2016","경기","가평군","초등학교",2016-04-01,"여자",201,207,198,-9,3,-6,-0.0434782608695652,0.0151515151515152,-0.0289855072463768
"1710","2016","경기","가평군","초등학교",2016-04-01,"남자",217,219,215,-4,2,-2,-0.0182648401826484,0.00930232558139535,-0.0091324200913242
"1711","2016","경기","연천군","초등학교",2016-04-01,"전체",271,320,299,-21,-28,-49,-0.065625,-0.0936454849498328,-0.153125
"1712","2016","경기","연천군","초등학교",2016-04-01,"여자",124,145,134,-11,-10,-21,-0.0758620689655172,-0.0746268656716418,-0.144827586206897
"1713","2016","경기","연천군","초등학교",2016-04-01,"남자",147,175,165,-10,-18,-28,-0.0571428571428571,-0.109090909090909,-0.16
"1714","2016","강원","춘천시","초등학교",2016-04-01,"전체",2297,2324,2372,48,-75,-27,0.0206540447504303,-0.0316188870151771,-0.011617900172117
"1715","2016","강원","춘천시","초등학교",2016-04-01,"여자",1107,1119,1139,20,-32,-12,0.0178731009830206,-0.0280948200175593,-0.0107238605898123
"1716","2016","강원","춘천시","초등학교",2016-04-01,"남자",1190,1205,1233,28,-43,-15,0.0232365145228216,-0.0348742903487429,-0.012448132780083
"1717","2016","강원","원주시","초등학교",2016-04-01,"전체",3173,3000,3025,25,148,173,0.00833333333333333,0.0489256198347107,0.0576666666666667
"1718","2016","강원","원주시","초등학교",2016-04-01,"여자",1518,1467,1484,17,34,51,0.0115882753919564,0.022911051212938,0.0347648261758691
"1719","2016","강원","원주시","초등학교",2016-04-01,"남자",1655,1533,1541,8,114,122,0.00521852576647097,0.0739779364049319,0.0795825179386823
"1720","2016","강원","강릉시","초등학교",2016-04-01,"전체",1659,1647,1666,19,-7,12,0.0115361262902247,-0.00420168067226891,0.00728597449908925
"1721","2016","강원","강릉시","초등학교",2016-04-01,"여자",839,812,826,14,13,27,0.0172413793103448,0.0157384987893462,0.0332512315270936
"1722","2016","강원","강릉시","초등학교",2016-04-01,"남자",820,835,840,5,-20,-15,0.00598802395209581,-0.0238095238095238,-0.0179640718562874
"1723","2016","강원","동해시","초등학교",2016-04-01,"전체",869,847,865,18,4,22,0.0212514757969303,0.0046242774566474,0.025974025974026
"1724","2016","강원","동해시","초등학교",2016-04-01,"여자",440,399,412,13,28,41,0.0325814536340852,0.0679611650485437,0.102756892230576
"1725","2016","강원","동해시","초등학교",2016-04-01,"남자",429,448,453,5,-24,-19,0.0111607142857143,-0.0529801324503311,-0.0424107142857143
"1726","2016","강원","태백시","초등학교",2016-04-01,"전체",399,416,401,-15,-2,-17,-0.0360576923076923,-0.00498753117206983,-0.0408653846153846
"1727","2016","강원","태백시","초등학교",2016-04-01,"여자",210,216,208,-8,2,-6,-0.037037037037037,0.00961538461538462,-0.0277777777777778
"1728","2016","강원","태백시","초등학교",2016-04-01,"남자",189,200,193,-7,-4,-11,-0.035,-0.0207253886010363,-0.055
"1729","2016","강원","속초시","초등학교",2016-04-01,"전체",597,634,628,-6,-31,-37,-0.00946372239747634,-0.0493630573248408,-0.0583596214511041
"1730","2016","강원","속초시","초등학교",2016-04-01,"여자",283,302,300,-2,-17,-19,-0.00662251655629139,-0.0566666666666667,-0.0629139072847682
"1731","2016","강원","속초시","초등학교",2016-04-01,"남자",314,332,328,-4,-14,-18,-0.0120481927710843,-0.0426829268292683,-0.0542168674698795
"1732","2016","강원","삼척시","초등학교",2016-04-01,"전체",461,463,469,6,-8,-2,0.0129589632829374,-0.0170575692963753,-0.00431965442764579
"1733","2016","강원","삼척시","초등학교",2016-04-01,"여자",212,222,222,0,-10,-10,0,-0.045045045045045,-0.045045045045045
"1734","2016","강원","삼척시","초등학교",2016-04-01,"남자",249,241,247,6,2,8,0.024896265560166,0.00809716599190283,0.033195020746888
"1735","2016","강원","홍천군","초등학교",2016-04-01,"전체",504,496,497,1,7,8,0.00201612903225806,0.0140845070422535,0.0161290322580645
"1736","2016","강원","홍천군","초등학교",2016-04-01,"여자",230,231,236,5,-6,-1,0.0216450216450216,-0.0254237288135593,-0.00432900432900433
"1737","2016","강원","홍천군","초등학교",2016-04-01,"남자",274,265,261,-4,13,9,-0.0150943396226415,0.0498084291187739,0.0339622641509434
"1738","2016","강원","횡성군","초등학교",2016-04-01,"전체",260,275,278,3,-18,-15,0.0109090909090909,-0.0647482014388489,-0.0545454545454545
"1739","2016","강원","횡성군","초등학교",2016-04-01,"여자",125,144,144,0,-19,-19,0,-0.131944444444444,-0.131944444444444
"1740","2016","강원","횡성군","초등학교",2016-04-01,"남자",135,131,134,3,1,4,0.0229007633587786,0.00746268656716418,0.0305343511450382
"1741","2016","강원","영월군","초등학교",2016-04-01,"전체",205,213,200,-13,5,-8,-0.0610328638497653,0.025,-0.0375586854460094
"1742","2016","강원","영월군","초등학교",2016-04-01,"여자",92,103,98,-5,-6,-11,-0.0485436893203883,-0.0612244897959184,-0.106796116504854
"1743","2016","강원","영월군","초등학교",2016-04-01,"남자",113,110,102,-8,11,3,-0.0727272727272727,0.107843137254902,0.0272727272727273
"1744","2016","강원","평창군","초등학교",2016-04-01,"전체",258,262,252,-10,6,-4,-0.0381679389312977,0.0238095238095238,-0.0152671755725191
"1745","2016","강원","평창군","초등학교",2016-04-01,"여자",130,129,126,-3,4,1,-0.0232558139534884,0.0317460317460317,0.00775193798449612
"1746","2016","강원","평창군","초등학교",2016-04-01,"남자",128,133,126,-7,2,-5,-0.0526315789473684,0.0158730158730159,-0.037593984962406
"1747","2016","강원","정선군","초등학교",2016-04-01,"전체",267,268,263,-5,4,-1,-0.0186567164179104,0.0152091254752852,-0.00373134328358209
"1748","2016","강원","정선군","초등학교",2016-04-01,"여자",124,131,127,-4,-3,-7,-0.0305343511450382,-0.0236220472440945,-0.0534351145038168
"1749","2016","강원","정선군","초등학교",2016-04-01,"남자",143,137,136,-1,7,6,-0.0072992700729927,0.0514705882352941,0.0437956204379562
"1750","2016","강원","철원군","초등학교",2016-04-01,"전체",361,383,363,-20,-2,-22,-0.0522193211488251,-0.00550964187327824,-0.0574412532637076
"1751","2016","강원","철원군","초등학교",2016-04-01,"여자",177,184,169,-15,8,-7,-0.0815217391304348,0.0473372781065089,-0.0380434782608696
"1752","2016","강원","철원군","초등학교",2016-04-01,"남자",184,199,194,-5,-10,-15,-0.0251256281407035,-0.0515463917525773,-0.0753768844221105
"1753","2016","강원","화천군","초등학교",2016-04-01,"전체",208,227,209,-18,-1,-19,-0.079295154185022,-0.00478468899521531,-0.0837004405286344
"1754","2016","강원","화천군","초등학교",2016-04-01,"여자",111,122,114,-8,-3,-11,-0.0655737704918033,-0.0263157894736842,-0.0901639344262295
"1755","2016","강원","화천군","초등학교",2016-04-01,"남자",97,105,95,-10,2,-8,-0.0952380952380952,0.0210526315789474,-0.0761904761904762
"1756","2016","강원","양구군","초등학교",2016-04-01,"전체",166,198,204,6,-38,-32,0.0303030303030303,-0.186274509803922,-0.161616161616162
"1757","2016","강원","양구군","초등학교",2016-04-01,"여자",81,99,100,1,-19,-18,0.0101010101010101,-0.19,-0.181818181818182
"1758","2016","강원","양구군","초등학교",2016-04-01,"남자",85,99,104,5,-19,-14,0.0505050505050505,-0.182692307692308,-0.141414141414141
"1759","2016","강원","인제군","초등학교",2016-04-01,"전체",264,285,271,-14,-7,-21,-0.0491228070175439,-0.025830258302583,-0.0736842105263158
"1760","2016","강원","인제군","초등학교",2016-04-01,"여자",127,131,126,-5,1,-4,-0.0381679389312977,0.00793650793650794,-0.0305343511450382
"1761","2016","강원","인제군","초등학교",2016-04-01,"남자",137,154,145,-9,-8,-17,-0.0584415584415584,-0.0551724137931034,-0.11038961038961
"1762","2016","강원","고성군","초등학교",2016-04-01,"전체",144,143,144,1,0,1,0.00699300699300699,0,0.00699300699300699
"1763","2016","강원","고성군","초등학교",2016-04-01,"여자",75,75,73,-2,2,0,-0.0266666666666667,0.0273972602739726,0
"1764","2016","강원","고성군","초등학교",2016-04-01,"남자",69,68,71,3,-2,1,0.0441176470588235,-0.028169014084507,0.0147058823529412
"1765","2016","강원","양양군","초등학교",2016-04-01,"전체",151,148,156,8,-5,3,0.0540540540540541,-0.032051282051282,0.0202702702702703
"1766","2016","강원","양양군","초등학교",2016-04-01,"여자",81,76,83,7,-2,5,0.0921052631578947,-0.0240963855421687,0.0657894736842105
"1767","2016","강원","양양군","초등학교",2016-04-01,"남자",70,72,73,1,-3,-2,0.0138888888888889,-0.0410958904109589,-0.0277777777777778
"1768","2016","충북","청주시","초등학교",2016-04-01,"전체",8134,6672,8317,1645,-183,1462,0.246552757793765,-0.0220031261272093,0.219124700239808
"1769","2016","충북","청주시","초등학교",2016-04-01,"여자",3871,3158,3956,798,-85,713,0.252691576947435,-0.0214863498483316,0.225775807473084
"1770","2016","충북","청주시","초등학교",2016-04-01,"남자",4263,3514,4361,847,-98,749,0.241035856573705,-0.0224719101123595,0.213147410358566
"1771","2016","충북","충주시","초등학교",2016-04-01,"전체",1594,1629,1643,14,-49,-35,0.00859422958870473,-0.0298234936092514,-0.0214855739717618
"1772","2016","충북","충주시","초등학교",2016-04-01,"여자",805,840,855,15,-50,-35,0.0178571428571429,-0.0584795321637427,-0.0416666666666667
"1773","2016","충북","충주시","초등학교",2016-04-01,"남자",789,789,788,-1,1,0,-0.00126742712294043,0.00126903553299492,0
"1774","2016","충북","제천시","초등학교",2016-04-01,"전체",993,1042,1031,-11,-38,-49,-0.0105566218809981,-0.0368574199806014,-0.0470249520153551
"1775","2016","충북","제천시","초등학교",2016-04-01,"여자",497,531,530,-1,-33,-34,-0.00188323917137476,-0.0622641509433962,-0.064030131826742
"1776","2016","충북","제천시","초등학교",2016-04-01,"남자",496,511,501,-10,-5,-15,-0.0195694716242661,-0.00998003992015968,-0.0293542074363992
"1777","2016","충북","보은군","초등학교",2016-04-01,"전체",196,193,184,-9,12,3,-0.0466321243523316,0.0652173913043478,0.0155440414507772
"1778","2016","충북","보은군","초등학교",2016-04-01,"여자",95,92,85,-7,10,3,-0.0760869565217391,0.117647058823529,0.0326086956521739
"1779","2016","충북","보은군","초등학교",2016-04-01,"남자",101,101,99,-2,2,0,-0.0198019801980198,0.0202020202020202,0
"1780","2016","충북","옥천군","초등학교",2016-04-01,"전체",350,354,355,1,-5,-4,0.00282485875706215,-0.0140845070422535,-0.0112994350282486
"1781","2016","충북","옥천군","초등학교",2016-04-01,"여자",171,168,171,3,0,3,0.0178571428571429,0,0.0178571428571429
"1782","2016","충북","옥천군","초등학교",2016-04-01,"남자",179,186,184,-2,-5,-7,-0.010752688172043,-0.0271739130434783,-0.0376344086021505
"1783","2016","충북","영동군","초등학교",2016-04-01,"전체",272,320,321,1,-49,-48,0.003125,-0.152647975077882,-0.15
"1784","2016","충북","영동군","초등학교",2016-04-01,"여자",129,152,156,4,-27,-23,0.0263157894736842,-0.173076923076923,-0.151315789473684
"1785","2016","충북","영동군","초등학교",2016-04-01,"남자",143,168,165,-3,-22,-25,-0.0178571428571429,-0.133333333333333,-0.148809523809524
"1786","2016","충북","진천군","초등학교",2016-04-01,"전체",681,574,597,23,84,107,0.0400696864111498,0.14070351758794,0.186411149825784
"1787","2016","충북","진천군","초등학교",2016-04-01,"여자",356,299,314,15,42,57,0.0501672240802676,0.133757961783439,0.190635451505017
"1788","2016","충북","진천군","초등학교",2016-04-01,"남자",325,275,283,8,42,50,0.0290909090909091,0.148409893992933,0.181818181818182
"1789","2016","충북","괴산군","초등학교",2016-04-01,"전체",182,182,194,12,-12,0,0.0659340659340659,-0.0618556701030928,0
"1790","2016","충북","괴산군","초등학교",2016-04-01,"여자",105,83,97,14,8,22,0.168674698795181,0.0824742268041237,0.265060240963855
"1791","2016","충북","괴산군","초등학교",2016-04-01,"남자",77,99,97,-2,-20,-22,-0.0202020202020202,-0.206185567010309,-0.222222222222222
"1792","2016","충북","음성군","초등학교",2016-04-01,"전체",785,765,801,36,-16,20,0.0470588235294118,-0.0199750312109863,0.0261437908496732
"1793","2016","충북","음성군","초등학교",2016-04-01,"여자",358,350,360,10,-2,8,0.0285714285714286,-0.00555555555555556,0.0228571428571429
"1794","2016","충북","음성군","초등학교",2016-04-01,"남자",427,415,441,26,-14,12,0.0626506024096386,-0.0317460317460317,0.0289156626506024
"1795","2016","충북","단양군","초등학교",2016-04-01,"전체",175,158,165,7,10,17,0.0443037974683544,0.0606060606060606,0.107594936708861
"1796","2016","충북","단양군","초등학교",2016-04-01,"여자",75,70,73,3,2,5,0.0428571428571429,0.0273972602739726,0.0714285714285714
"1797","2016","충북","단양군","초등학교",2016-04-01,"남자",100,88,92,4,8,12,0.0454545454545455,0.0869565217391304,0.136363636363636
"1798","2016","충북","증평군","초등학교",2016-04-01,"전체",341,392,384,-8,-43,-51,-0.0204081632653061,-0.111979166666667,-0.130102040816327
"1799","2016","충북","증평군","초등학교",2016-04-01,"여자",148,193,183,-10,-35,-45,-0.0518134715025907,-0.191256830601093,-0.233160621761658
"1800","2016","충북","증평군","초등학교",2016-04-01,"남자",193,199,201,2,-8,-6,0.0100502512562814,-0.0398009950248756,-0.0301507537688442
"1801","2016","충남","천안시","초등학교",2016-04-01,"전체",6326,6332,6330,-2,-4,-6,-0.000315855969677827,-0.000631911532385466,-0.000947567909033481
"1802","2016","충남","천안시","초등학교",2016-04-01,"여자",3053,3030,3033,3,20,23,0.00099009900990099,0.00659413122321134,0.00759075907590759
"1803","2016","충남","천안시","초등학교",2016-04-01,"남자",3273,3302,3297,-5,-24,-29,-0.00151423379769836,-0.00727934485896269,-0.00878255602665052
"1804","2016","충남","공주시","초등학교",2016-04-01,"전체",731,796,753,-43,-22,-65,-0.0540201005025126,-0.0292164674634794,-0.0816582914572864
"1805","2016","충남","공주시","초등학교",2016-04-01,"여자",351,401,373,-28,-22,-50,-0.0698254364089776,-0.0589812332439678,-0.124688279301746
"1806","2016","충남","공주시","초등학교",2016-04-01,"남자",380,395,380,-15,0,-15,-0.0379746835443038,0,-0.0379746835443038
"1807","2016","충남","보령시","초등학교",2016-04-01,"전체",768,786,787,1,-19,-18,0.00127226463104326,-0.0241423125794155,-0.0229007633587786
"1808","2016","충남","보령시","초등학교",2016-04-01,"여자",380,401,405,4,-25,-21,0.00997506234413965,-0.0617283950617284,-0.0523690773067332
"1809","2016","충남","보령시","초등학교",2016-04-01,"남자",388,385,382,-3,6,3,-0.00779220779220779,0.0157068062827225,0.00779220779220779
"1810","2016","충남","아산시","초등학교",2016-04-01,"전체",3564,3816,3796,-20,-232,-252,-0.00524109014675052,-0.0611169652265543,-0.0660377358490566
"1811","2016","충남","아산시","초등학교",2016-04-01,"여자",1747,1899,1888,-11,-141,-152,-0.00579252238020011,-0.0746822033898305,-0.0800421274354924
"1812","2016","충남","아산시","초등학교",2016-04-01,"남자",1817,1917,1908,-9,-91,-100,-0.00469483568075117,-0.0476939203354298,-0.0521648408972353
"1813","2016","충남","서산시","초등학교",2016-04-01,"전체",1641,1700,1705,5,-64,-59,0.00294117647058824,-0.0375366568914956,-0.0347058823529412
"1814","2016","충남","서산시","초등학교",2016-04-01,"여자",757,800,809,9,-52,-43,0.01125,-0.0642768850432633,-0.05375
"1815","2016","충남","서산시","초등학교",2016-04-01,"남자",884,900,896,-4,-12,-16,-0.00444444444444444,-0.0133928571428571,-0.0177777777777778
"1816","2016","충남","논산시","초등학교",2016-04-01,"전체",919,901,906,5,13,18,0.00554938956714761,0.0143487858719647,0.0199778024417314
"1817","2016","충남","논산시","초등학교",2016-04-01,"여자",452,448,445,-3,7,4,-0.00669642857142857,0.0157303370786517,0.00892857142857143
"1818","2016","충남","논산시","초등학교",2016-04-01,"남자",467,453,461,8,6,14,0.0176600441501104,0.0130151843817787,0.0309050772626932
"1819","2016","충남","계룡시","초등학교",2016-04-01,"전체",455,481,453,-28,2,-26,-0.0582120582120582,0.00441501103752759,-0.0540540540540541
"1820","2016","충남","계룡시","초등학교",2016-04-01,"여자",195,218,202,-16,-7,-23,-0.073394495412844,-0.0346534653465347,-0.105504587155963
"1821","2016","충남","계룡시","초등학교",2016-04-01,"남자",260,263,251,-12,9,-3,-0.0456273764258555,0.0358565737051793,-0.0114068441064639
"1822","2016","충남","금산군","초등학교",2016-04-01,"전체",377,410,406,-4,-29,-33,-0.00975609756097561,-0.0714285714285714,-0.0804878048780488
"1823","2016","충남","금산군","초등학교",2016-04-01,"여자",187,210,205,-5,-18,-23,-0.0238095238095238,-0.0878048780487805,-0.10952380952381
"1824","2016","충남","금산군","초등학교",2016-04-01,"남자",190,200,201,1,-11,-10,0.005,-0.054726368159204,-0.05
"1825","2016","충남","부여군","초등학교",2016-04-01,"전체",377,393,406,13,-29,-16,0.0330788804071247,-0.0714285714285714,-0.0407124681933842
"1826","2016","충남","부여군","초등학교",2016-04-01,"여자",177,198,202,4,-25,-21,0.0202020202020202,-0.123762376237624,-0.106060606060606
"1827","2016","충남","부여군","초등학교",2016-04-01,"남자",200,195,204,9,-4,5,0.0461538461538462,-0.0196078431372549,0.0256410256410256
"1828","2016","충남","서천군","초등학교",2016-04-01,"전체",293,309,312,3,-19,-16,0.00970873786407767,-0.0608974358974359,-0.0517799352750809
"1829","2016","충남","서천군","초등학교",2016-04-01,"여자",144,153,157,4,-13,-9,0.0261437908496732,-0.0828025477707006,-0.0588235294117647
"1830","2016","충남","서천군","초등학교",2016-04-01,"남자",149,156,155,-1,-6,-7,-0.00641025641025641,-0.0387096774193548,-0.0448717948717949
"1831","2016","충남","청양군","초등학교",2016-04-01,"전체",144,167,168,1,-24,-23,0.00598802395209581,-0.142857142857143,-0.137724550898204
"1832","2016","충남","청양군","초등학교",2016-04-01,"여자",81,93,92,-1,-11,-12,-0.010752688172043,-0.119565217391304,-0.129032258064516
"1833","2016","충남","청양군","초등학교",2016-04-01,"남자",63,74,76,2,-13,-11,0.027027027027027,-0.171052631578947,-0.148648648648649
"1834","2016","충남","홍성군","초등학교",2016-04-01,"전체",849,655,713,58,136,194,0.0885496183206107,0.190743338008415,0.29618320610687
"1835","2016","충남","홍성군","초등학교",2016-04-01,"여자",420,337,351,14,69,83,0.0415430267062315,0.196581196581197,0.246290801186944
"1836","2016","충남","홍성군","초등학교",2016-04-01,"남자",429,318,362,44,67,111,0.138364779874214,0.185082872928177,0.349056603773585
"1837","2016","충남","예산군","초등학교",2016-04-01,"전체",484,518,510,-8,-26,-34,-0.0154440154440154,-0.0509803921568627,-0.0656370656370656
"1838","2016","충남","예산군","초등학교",2016-04-01,"여자",220,262,256,-6,-36,-42,-0.0229007633587786,-0.140625,-0.16030534351145
"1839","2016","충남","예산군","초등학교",2016-04-01,"남자",264,256,254,-2,10,8,-0.0078125,0.0393700787401575,0.03125
"1840","2016","충남","태안군","초등학교",2016-04-01,"전체",429,377,390,13,39,52,0.0344827586206897,0.1,0.137931034482759
"1841","2016","충남","태안군","초등학교",2016-04-01,"여자",205,169,176,7,29,36,0.0414201183431953,0.164772727272727,0.21301775147929
"1842","2016","충남","태안군","초등학교",2016-04-01,"남자",224,208,214,6,10,16,0.0288461538461538,0.0467289719626168,0.0769230769230769
"1843","2016","충남","당진시","초등학교",2016-04-01,"전체",1691,1778,1756,-22,-65,-87,-0.0123734533183352,-0.0370159453302961,-0.0489313835770529
"1844","2016","충남","당진시","초등학교",2016-04-01,"여자",846,876,856,-20,-10,-30,-0.0228310502283105,-0.0116822429906542,-0.0342465753424658
"1845","2016","충남","당진시","초등학교",2016-04-01,"남자",845,902,900,-2,-55,-57,-0.00221729490022173,-0.0611111111111111,-0.0631929046563193
"1846","2016","전북","전주시","초등학교",2016-04-01,"전체",6041,6057,6135,78,-94,-16,0.0128776622090144,-0.015321923390383,-0.00264157173518243
"1847","2016","전북","전주시","초등학교",2016-04-01,"여자",2941,2888,2942,54,-1,53,0.0186980609418283,-0.000339904826648538,0.0183518005540166
"1848","2016","전북","전주시","초등학교",2016-04-01,"남자",3100,3169,3193,24,-93,-69,0.00757336699274219,-0.029126213592233,-0.0217734301041338
"1849","2016","전북","군산시","초등학교",2016-04-01,"전체",2597,2703,2687,-16,-90,-106,-0.00591934887162412,-0.0334946036471902,-0.0392156862745098
"1850","2016","전북","군산시","초등학교",2016-04-01,"여자",1270,1337,1335,-2,-65,-67,-0.00149588631264024,-0.048689138576779,-0.050112191473448
"1851","2016","전북","군산시","초등학교",2016-04-01,"남자",1327,1366,1352,-14,-25,-39,-0.0102489019033675,-0.018491124260355,-0.0285505124450952
"1852","2016","전북","익산시","초등학교",2016-04-01,"전체",2534,2537,2548,11,-14,-3,0.0043358297201419,-0.00549450549450549,-0.00118249901458415
"1853","2016","전북","익산시","초등학교",2016-04-01,"여자",1252,1274,1265,-9,-13,-22,-0.00706436420722135,-0.0102766798418972,-0.0172684458398744
"1854","2016","전북","익산시","초등학교",2016-04-01,"남자",1282,1263,1283,20,-1,19,0.0158353127474268,-0.000779423226812159,0.0150435471100554
"1855","2016","전북","정읍시","초등학교",2016-04-01,"전체",812,795,798,3,14,17,0.00377358490566038,0.0175438596491228,0.0213836477987421
"1856","2016","전북","정읍시","초등학교",2016-04-01,"여자",354,372,372,0,-18,-18,0,-0.0483870967741935,-0.0483870967741935
"1857","2016","전북","정읍시","초등학교",2016-04-01,"남자",458,423,426,3,32,35,0.00709219858156028,0.0751173708920188,0.08274231678487
"1858","2016","전북","남원시","초등학교",2016-04-01,"전체",616,621,629,8,-13,-5,0.0128824476650564,-0.0206677265500795,-0.00805152979066022
"1859","2016","전북","남원시","초등학교",2016-04-01,"여자",284,290,290,0,-6,-6,0,-0.0206896551724138,-0.0206896551724138
"1860","2016","전북","남원시","초등학교",2016-04-01,"남자",332,331,339,8,-7,1,0.0241691842900302,-0.0206489675516224,0.00302114803625378
"1861","2016","전북","김제시","초등학교",2016-04-01,"전체",591,605,614,9,-23,-14,0.0148760330578512,-0.0374592833876222,-0.0231404958677686
"1862","2016","전북","김제시","초등학교",2016-04-01,"여자",292,297,300,3,-8,-5,0.0101010101010101,-0.0266666666666667,-0.0168350168350168
"1863","2016","전북","김제시","초등학교",2016-04-01,"남자",299,308,314,6,-15,-9,0.0194805194805195,-0.0477707006369427,-0.0292207792207792
"1864","2016","전북","완주군","초등학교",2016-04-01,"전체",848,904,938,34,-90,-56,0.0376106194690266,-0.0959488272921109,-0.0619469026548673
"1865","2016","전북","완주군","초등학교",2016-04-01,"여자",405,440,448,8,-43,-35,0.0181818181818182,-0.0959821428571429,-0.0795454545454545
"1866","2016","전북","완주군","초등학교",2016-04-01,"남자",443,464,490,26,-47,-21,0.0560344827586207,-0.0959183673469388,-0.0452586206896552
"1867","2016","전북","진안군","초등학교",2016-04-01,"전체",152,187,174,-13,-22,-35,-0.0695187165775401,-0.126436781609195,-0.18716577540107
"1868","2016","전북","진안군","초등학교",2016-04-01,"여자",72,94,87,-7,-15,-22,-0.074468085106383,-0.172413793103448,-0.234042553191489
"1869","2016","전북","진안군","초등학교",2016-04-01,"남자",80,93,87,-6,-7,-13,-0.0645161290322581,-0.0804597701149425,-0.139784946236559
"1870","2016","전북","무주군","초등학교",2016-04-01,"전체",178,157,158,1,20,21,0.00636942675159236,0.126582278481013,0.133757961783439
"1871","2016","전북","무주군","초등학교",2016-04-01,"여자",103,87,90,3,13,16,0.0344827586206897,0.144444444444444,0.183908045977011
"1872","2016","전북","무주군","초등학교",2016-04-01,"남자",75,70,68,-2,7,5,-0.0285714285714286,0.102941176470588,0.0714285714285714
"1873","2016","전북","장수군","초등학교",2016-04-01,"전체",146,155,167,12,-21,-9,0.0774193548387097,-0.125748502994012,-0.0580645161290323
"1874","2016","전북","장수군","초등학교",2016-04-01,"여자",68,78,84,6,-16,-10,0.0769230769230769,-0.19047619047619,-0.128205128205128
"1875","2016","전북","장수군","초등학교",2016-04-01,"남자",78,77,83,6,-5,1,0.0779220779220779,-0.0602409638554217,0.012987012987013
"1876","2016","전북","임실군","초등학교",2016-04-01,"전체",163,181,182,1,-19,-18,0.00552486187845304,-0.104395604395604,-0.0994475138121547
"1877","2016","전북","임실군","초등학교",2016-04-01,"여자",79,87,89,2,-10,-8,0.0229885057471264,-0.112359550561798,-0.0919540229885057
"1878","2016","전북","임실군","초등학교",2016-04-01,"남자",84,94,93,-1,-9,-10,-0.0106382978723404,-0.0967741935483871,-0.106382978723404
"1879","2016","전북","순창군","초등학교",2016-04-01,"전체",181,211,209,-2,-28,-30,-0.00947867298578199,-0.133971291866029,-0.14218009478673
"1880","2016","전북","순창군","초등학교",2016-04-01,"여자",87,84,84,0,3,3,0,0.0357142857142857,0.0357142857142857
"1881","2016","전북","순창군","초등학교",2016-04-01,"남자",94,127,125,-2,-31,-33,-0.015748031496063,-0.248,-0.259842519685039
"1882","2016","전북","고창군","초등학교",2016-04-01,"전체",346,341,343,2,3,5,0.00586510263929619,0.0087463556851312,0.0146627565982405
"1883","2016","전북","고창군","초등학교",2016-04-01,"여자",175,168,168,0,7,7,0,0.0416666666666667,0.0416666666666667
"1884","2016","전북","고창군","초등학교",2016-04-01,"남자",171,173,175,2,-4,-2,0.0115606936416185,-0.0228571428571429,-0.0115606936416185
"1885","2016","전북","부안군","초등학교",2016-04-01,"전체",317,355,351,-4,-34,-38,-0.0112676056338028,-0.0968660968660969,-0.107042253521127
"1886","2016","전북","부안군","초등학교",2016-04-01,"여자",161,178,175,-3,-14,-17,-0.0168539325842697,-0.08,-0.0955056179775281
"1887","2016","전북","부안군","초등학교",2016-04-01,"남자",156,177,176,-1,-20,-21,-0.00564971751412429,-0.113636363636364,-0.11864406779661
"1888","2016","전남","목포시","초등학교",2016-04-01,"전체",2538,2458,2472,14,66,80,0.00569568755085435,0.0266990291262136,0.032546786004882
"1889","2016","전남","목포시","초등학교",2016-04-01,"여자",1246,1189,1202,13,44,57,0.0109335576114382,0.0366056572379368,0.0479394449116905
"1890","2016","전남","목포시","초등학교",2016-04-01,"남자",1292,1269,1270,1,22,23,0.000788022064617809,0.0173228346456693,0.0181245074862096
"1891","2016","전남","여수시","초등학교",2016-04-01,"전체",2367,2456,2457,1,-90,-89,0.000407166123778502,-0.0366300366300366,-0.0362377850162866
"1892","2016","전남","여수시","초등학교",2016-04-01,"여자",1185,1204,1194,-10,-9,-19,-0.00830564784053156,-0.00753768844221105,-0.01578073089701
"1893","2016","전남","여수시","초등학교",2016-04-01,"남자",1182,1252,1263,11,-81,-70,0.00878594249201278,-0.0641330166270784,-0.0559105431309904
"1894","2016","전남","순천시","초등학교",2016-04-01,"전체",2712,2522,2587,65,125,190,0.0257731958762887,0.0483185156551991,0.0753370340999207
"1895","2016","전남","순천시","초등학교",2016-04-01,"여자",1315,1198,1226,28,89,117,0.0233722871452421,0.0725938009787928,0.0976627712854758
"1896","2016","전남","순천시","초등학교",2016-04-01,"남자",1397,1324,1361,37,36,73,0.0279456193353474,0.0264511388684791,0.0551359516616314
"1897","2016","전남","나주시","초등학교",2016-04-01,"전체",728,565,648,83,80,163,0.146902654867257,0.123456790123457,0.288495575221239
"1898","2016","전남","나주시","초등학교",2016-04-01,"여자",359,251,293,42,66,108,0.167330677290837,0.225255972696246,0.430278884462151
"1899","2016","전남","나주시","초등학교",2016-04-01,"남자",369,314,355,41,14,55,0.130573248407643,0.0394366197183099,0.17515923566879
"1900","2016","전남","광양시","초등학교",2016-04-01,"전체",1459,1582,1566,-16,-107,-123,-0.0101137800252845,-0.0683269476372925,-0.0777496839443742
"1901","2016","전남","광양시","초등학교",2016-04-01,"여자",712,750,744,-6,-32,-38,-0.008,-0.043010752688172,-0.0506666666666667
"1902","2016","전남","광양시","초등학교",2016-04-01,"남자",747,832,822,-10,-75,-85,-0.0120192307692308,-0.0912408759124088,-0.102163461538462
"1903","2016","전남","담양군","초등학교",2016-04-01,"전체",246,271,258,-13,-12,-25,-0.0479704797047971,-0.0465116279069767,-0.0922509225092251
"1904","2016","전남","담양군","초등학교",2016-04-01,"여자",114,147,140,-7,-26,-33,-0.0476190476190476,-0.185714285714286,-0.224489795918367
"1905","2016","전남","담양군","초등학교",2016-04-01,"남자",132,124,118,-6,14,8,-0.0483870967741935,0.11864406779661,0.0645161290322581
"1906","2016","전남","곡성군","초등학교",2016-04-01,"전체",152,173,164,-9,-12,-21,-0.0520231213872832,-0.0731707317073171,-0.121387283236994
"1907","2016","전남","곡성군","초등학교",2016-04-01,"여자",68,83,76,-7,-8,-15,-0.0843373493975904,-0.105263157894737,-0.180722891566265
"1908","2016","전남","곡성군","초등학교",2016-04-01,"남자",84,90,88,-2,-4,-6,-0.0222222222222222,-0.0454545454545455,-0.0666666666666667
"1909","2016","전남","구례군","초등학교",2016-04-01,"전체",170,164,165,1,5,6,0.00609756097560976,0.0303030303030303,0.0365853658536585
"1910","2016","전남","구례군","초등학교",2016-04-01,"여자",83,72,76,4,7,11,0.0555555555555556,0.0921052631578947,0.152777777777778
"1911","2016","전남","구례군","초등학교",2016-04-01,"남자",87,92,89,-3,-2,-5,-0.0326086956521739,-0.0224719101123595,-0.0543478260869565
"1912","2016","전남","고흥군","초등학교",2016-04-01,"전체",319,363,374,11,-55,-44,0.0303030303030303,-0.147058823529412,-0.121212121212121
"1913","2016","전남","고흥군","초등학교",2016-04-01,"여자",155,168,169,1,-14,-13,0.00595238095238095,-0.0828402366863905,-0.0773809523809524
"1914","2016","전남","고흥군","초등학교",2016-04-01,"남자",164,195,205,10,-41,-31,0.0512820512820513,-0.2,-0.158974358974359
"1915","2016","전남","보성군","초등학교",2016-04-01,"전체",214,278,249,-29,-35,-64,-0.10431654676259,-0.140562248995984,-0.23021582733813
"1916","2016","전남","보성군","초등학교",2016-04-01,"여자",113,137,127,-10,-14,-24,-0.072992700729927,-0.110236220472441,-0.175182481751825
"1917","2016","전남","보성군","초등학교",2016-04-01,"남자",101,141,122,-19,-21,-40,-0.134751773049645,-0.172131147540984,-0.283687943262411
"1918","2016","전남","화순군","초등학교",2016-04-01,"전체",491,551,538,-13,-47,-60,-0.0235934664246824,-0.087360594795539,-0.108892921960073
"1919","2016","전남","화순군","초등학교",2016-04-01,"여자",229,264,254,-10,-25,-35,-0.0378787878787879,-0.0984251968503937,-0.132575757575758
"1920","2016","전남","화순군","초등학교",2016-04-01,"남자",262,287,284,-3,-22,-25,-0.0104529616724739,-0.0774647887323944,-0.0871080139372822
"1921","2016","전남","장흥군","초등학교",2016-04-01,"전체",243,231,243,12,0,12,0.051948051948052,0,0.051948051948052
"1922","2016","전남","장흥군","초등학교",2016-04-01,"여자",114,115,122,7,-8,-1,0.0608695652173913,-0.0655737704918033,-0.00869565217391304
"1923","2016","전남","장흥군","초등학교",2016-04-01,"남자",129,116,121,5,8,13,0.0431034482758621,0.0661157024793388,0.112068965517241
"1924","2016","전남","강진군","초등학교",2016-04-01,"전체",194,253,239,-14,-45,-59,-0.0553359683794466,-0.188284518828452,-0.233201581027668
"1925","2016","전남","강진군","초등학교",2016-04-01,"여자",98,129,123,-6,-25,-31,-0.0465116279069767,-0.203252032520325,-0.24031007751938
"1926","2016","전남","강진군","초등학교",2016-04-01,"남자",96,124,116,-8,-20,-28,-0.0645161290322581,-0.172413793103448,-0.225806451612903
"1927","2016","전남","해남군","초등학교",2016-04-01,"전체",441,492,468,-24,-27,-51,-0.0487804878048781,-0.0576923076923077,-0.103658536585366
"1928","2016","전남","해남군","초등학교",2016-04-01,"여자",220,239,233,-6,-13,-19,-0.0251046025104603,-0.055793991416309,-0.0794979079497908
"1929","2016","전남","해남군","초등학교",2016-04-01,"남자",221,253,235,-18,-14,-32,-0.0711462450592885,-0.0595744680851064,-0.126482213438735
"1930","2016","전남","영암군","초등학교",2016-04-01,"전체",453,531,513,-18,-60,-78,-0.0338983050847458,-0.116959064327485,-0.146892655367232
"1931","2016","전남","영암군","초등학교",2016-04-01,"여자",218,256,243,-13,-25,-38,-0.05078125,-0.102880658436214,-0.1484375
"1932","2016","전남","영암군","초등학교",2016-04-01,"남자",235,275,270,-5,-35,-40,-0.0181818181818182,-0.12962962962963,-0.145454545454545
"1933","2016","전남","무안군","초등학교",2016-04-01,"전체",790,850,886,36,-96,-60,0.0423529411764706,-0.108352144469526,-0.0705882352941176
"1934","2016","전남","무안군","초등학교",2016-04-01,"여자",377,419,432,13,-55,-42,0.0310262529832936,-0.127314814814815,-0.100238663484487
"1935","2016","전남","무안군","초등학교",2016-04-01,"남자",413,431,454,23,-41,-18,0.0533642691415313,-0.0903083700440529,-0.0417633410672854
"1936","2016","전남","함평군","초등학교",2016-04-01,"전체",166,201,205,4,-39,-35,0.0199004975124378,-0.190243902439024,-0.174129353233831
"1937","2016","전남","함평군","초등학교",2016-04-01,"여자",72,78,81,3,-9,-6,0.0384615384615385,-0.111111111111111,-0.0769230769230769
"1938","2016","전남","함평군","초등학교",2016-04-01,"남자",94,123,124,1,-30,-29,0.00813008130081301,-0.241935483870968,-0.235772357723577
"1939","2016","전남","영광군","초등학교",2016-04-01,"전체",373,397,387,-10,-14,-24,-0.0251889168765743,-0.0361757105943152,-0.0604534005037783
"1940","2016","전남","영광군","초등학교",2016-04-01,"여자",189,190,184,-6,5,-1,-0.0315789473684211,0.0271739130434783,-0.00526315789473684
"1941","2016","전남","영광군","초등학교",2016-04-01,"남자",184,207,203,-4,-19,-23,-0.0193236714975845,-0.0935960591133005,-0.111111111111111
"1942","2016","전남","장성군","초등학교",2016-04-01,"전체",309,333,333,0,-24,-24,0,-0.0720720720720721,-0.0720720720720721
"1943","2016","전남","장성군","초등학교",2016-04-01,"여자",155,159,156,-3,-1,-4,-0.0188679245283019,-0.00641025641025641,-0.0251572327044025
"1944","2016","전남","장성군","초등학교",2016-04-01,"남자",154,174,177,3,-23,-20,0.0172413793103448,-0.129943502824859,-0.114942528735632
"1945","2016","전남","완도군","초등학교",2016-04-01,"전체",323,379,388,9,-65,-56,0.0237467018469657,-0.167525773195876,-0.147757255936675
"1946","2016","전남","완도군","초등학교",2016-04-01,"여자",173,193,200,7,-27,-20,0.0362694300518135,-0.135,-0.103626943005181
"1947","2016","전남","완도군","초등학교",2016-04-01,"남자",150,186,188,2,-38,-36,0.010752688172043,-0.202127659574468,-0.193548387096774
"1948","2016","전남","진도군","초등학교",2016-04-01,"전체",208,205,202,-3,6,3,-0.0146341463414634,0.0297029702970297,0.0146341463414634
"1949","2016","전남","진도군","초등학교",2016-04-01,"여자",100,101,101,0,-1,-1,0,-0.0099009900990099,-0.0099009900990099
"1950","2016","전남","진도군","초등학교",2016-04-01,"남자",108,104,101,-3,7,4,-0.0288461538461538,0.0693069306930693,0.0384615384615385
"1951","2016","전남","신안군","초등학교",2016-04-01,"전체",156,201,195,-6,-39,-45,-0.0298507462686567,-0.2,-0.223880597014925
"1952","2016","전남","신안군","초등학교",2016-04-01,"여자",81,98,99,1,-18,-17,0.0102040816326531,-0.181818181818182,-0.173469387755102
"1953","2016","전남","신안군","초등학교",2016-04-01,"남자",75,103,96,-7,-21,-28,-0.0679611650485437,-0.21875,-0.271844660194175
"1954","2016","경북","포항시","초등학교",2016-04-01,"전체",4355,4436,4478,42,-123,-81,0.00946798917944094,-0.027467619472979,-0.0182596934174932
"1955","2016","경북","포항시","초등학교",2016-04-01,"여자",2080,2078,2100,22,-20,2,0.0105871029836381,-0.00952380952380952,0.000962463907603465
"1956","2016","경북","포항시","초등학교",2016-04-01,"남자",2275,2358,2378,20,-103,-83,0.00848176420695505,-0.043313708999159,-0.0351993214588634
"1957","2016","경북","경주시","초등학교",2016-04-01,"전체",1909,1953,1938,-15,-29,-44,-0.00768049155145929,-0.0149638802889577,-0.0225294418842806
"1958","2016","경북","경주시","초등학교",2016-04-01,"여자",919,934,927,-7,-8,-15,-0.00749464668094218,-0.00862998921251348,-0.0160599571734475
"1959","2016","경북","경주시","초등학교",2016-04-01,"남자",990,1019,1011,-8,-21,-29,-0.00785083415112856,-0.0207715133531157,-0.028459273797841
"1960","2016","경북","김천시","초등학교",2016-04-01,"전체",1021,1043,1049,6,-28,-22,0.00575263662511985,-0.0266920877025739,-0.0210930009587728
"1961","2016","경북","김천시","초등학교",2016-04-01,"여자",493,505,504,-1,-11,-12,-0.00198019801980198,-0.0218253968253968,-0.0237623762376238
"1962","2016","경북","김천시","초등학교",2016-04-01,"남자",528,538,545,7,-17,-10,0.0130111524163569,-0.0311926605504587,-0.0185873605947955
"1963","2016","경북","안동시","초등학교",2016-04-01,"전체",1302,1309,1302,-7,0,-7,-0.0053475935828877,0,-0.0053475935828877
"1964","2016","경북","안동시","초등학교",2016-04-01,"여자",637,626,615,-11,22,11,-0.0175718849840256,0.0357723577235772,0.0175718849840256
"1965","2016","경북","안동시","초등학교",2016-04-01,"남자",665,683,687,4,-22,-18,0.00585651537335286,-0.0320232896652111,-0.0263543191800878
"1966","2016","경북","구미시","초등학교",2016-04-01,"전체",4405,4472,4408,-64,-3,-67,-0.0143112701252236,-0.000680580762250454,-0.0149821109123435
"1967","2016","경북","구미시","초등학교",2016-04-01,"여자",2094,2220,2187,-33,-93,-126,-0.0148648648648649,-0.0425240054869684,-0.0567567567567568
"1968","2016","경북","구미시","초등학교",2016-04-01,"남자",2311,2252,2221,-31,90,59,-0.013765541740675,0.0405222872579919,0.0261989342806394
"1969","2016","경북","영주시","초등학교",2016-04-01,"전체",787,756,764,8,23,31,0.0105820105820106,0.0301047120418848,0.041005291005291
"1970","2016","경북","영주시","초등학교",2016-04-01,"여자",391,379,383,4,8,12,0.0105540897097625,0.02088772845953,0.0316622691292876
"1971","2016","경북","영주시","초등학교",2016-04-01,"남자",396,377,381,4,15,19,0.0106100795755968,0.0393700787401575,0.0503978779840849
"1972","2016","경북","영천시","초등학교",2016-04-01,"전체",577,606,613,7,-36,-29,0.0115511551155116,-0.0587275693311582,-0.0478547854785479
"1973","2016","경북","영천시","초등학교",2016-04-01,"여자",252,287,291,4,-39,-35,0.0139372822299652,-0.134020618556701,-0.121951219512195
"1974","2016","경북","영천시","초등학교",2016-04-01,"남자",325,319,322,3,3,6,0.00940438871473354,0.0093167701863354,0.0188087774294671
"1975","2016","경북","상주시","초등학교",2016-04-01,"전체",658,664,658,-6,0,-6,-0.00903614457831325,0,-0.00903614457831325
"1976","2016","경북","상주시","초등학교",2016-04-01,"여자",319,320,314,-6,5,-1,-0.01875,0.0159235668789809,-0.003125
"1977","2016","경북","상주시","초등학교",2016-04-01,"남자",339,344,344,0,-5,-5,0,-0.0145348837209302,-0.0145348837209302
"1978","2016","경북","문경시","초등학교",2016-04-01,"전체",456,458,459,1,-3,-2,0.00218340611353712,-0.0065359477124183,-0.00436681222707424
"1979","2016","경북","문경시","초등학교",2016-04-01,"여자",207,215,217,2,-10,-8,0.00930232558139535,-0.0460829493087558,-0.0372093023255814
"1980","2016","경북","문경시","초등학교",2016-04-01,"남자",249,243,242,-1,7,6,-0.00411522633744856,0.0289256198347107,0.0246913580246914
"1981","2016","경북","경산시","초등학교",2016-04-01,"전체",2155,2284,2256,-28,-101,-129,-0.0122591943957968,-0.0447695035460993,-0.0564798598949212
"1982","2016","경북","경산시","초등학교",2016-04-01,"여자",1046,1104,1094,-10,-48,-58,-0.00905797101449275,-0.0438756855575868,-0.052536231884058
"1983","2016","경북","경산시","초등학교",2016-04-01,"남자",1109,1180,1162,-18,-53,-71,-0.0152542372881356,-0.0456110154905336,-0.0601694915254237
"1984","2016","경북","군위군","초등학교",2016-04-01,"전체",70,72,66,-6,4,-2,-0.0833333333333333,0.0606060606060606,-0.0277777777777778
"1985","2016","경북","군위군","초등학교",2016-04-01,"여자",31,33,31,-2,0,-2,-0.0606060606060606,0,-0.0606060606060606
"1986","2016","경북","군위군","초등학교",2016-04-01,"남자",39,39,35,-4,4,0,-0.102564102564103,0.114285714285714,0
"1987","2016","경북","의성군","초등학교",2016-04-01,"전체",193,209,206,-3,-13,-16,-0.0143540669856459,-0.0631067961165049,-0.076555023923445
"1988","2016","경북","의성군","초등학교",2016-04-01,"여자",98,110,108,-2,-10,-12,-0.0181818181818182,-0.0925925925925926,-0.109090909090909
"1989","2016","경북","의성군","초등학교",2016-04-01,"남자",95,99,98,-1,-3,-4,-0.0101010101010101,-0.0306122448979592,-0.0404040404040404
"1990","2016","경북","청송군","초등학교",2016-04-01,"전체",106,101,105,4,1,5,0.0396039603960396,0.00952380952380952,0.0495049504950495
"1991","2016","경북","청송군","초등학교",2016-04-01,"여자",57,54,56,2,1,3,0.037037037037037,0.0178571428571429,0.0555555555555556
"1992","2016","경북","청송군","초등학교",2016-04-01,"남자",49,47,49,2,0,2,0.0425531914893617,0,0.0425531914893617
"1993","2016","경북","영양군","초등학교",2016-04-01,"전체",81,89,94,5,-13,-8,0.0561797752808989,-0.138297872340426,-0.0898876404494382
"1994","2016","경북","영양군","초등학교",2016-04-01,"여자",36,42,44,2,-8,-6,0.0476190476190476,-0.181818181818182,-0.142857142857143
"1995","2016","경북","영양군","초등학교",2016-04-01,"남자",45,47,50,3,-5,-2,0.0638297872340425,-0.1,-0.0425531914893617
"1996","2016","경북","영덕군","초등학교",2016-04-01,"전체",191,197,195,-2,-4,-6,-0.0101522842639594,-0.0205128205128205,-0.0304568527918782
"1997","2016","경북","영덕군","초등학교",2016-04-01,"여자",93,102,100,-2,-7,-9,-0.0196078431372549,-0.07,-0.0882352941176471
"1998","2016","경북","영덕군","초등학교",2016-04-01,"남자",98,95,95,0,3,3,0,0.0315789473684211,0.0315789473684211
"1999","2016","경북","청도군","초등학교",2016-04-01,"전체",175,196,193,-3,-18,-21,-0.0153061224489796,-0.0932642487046632,-0.107142857142857
"2000","2016","경북","청도군","초등학교",2016-04-01,"여자",93,88,90,2,3,5,0.0227272727272727,0.0333333333333333,0.0568181818181818
"2001","2016","경북","청도군","초등학교",2016-04-01,"남자",82,108,103,-5,-21,-26,-0.0462962962962963,-0.203883495145631,-0.240740740740741
"2002","2016","경북","고령군","초등학교",2016-04-01,"전체",213,256,247,-9,-34,-43,-0.03515625,-0.137651821862348,-0.16796875
"2003","2016","경북","고령군","초등학교",2016-04-01,"여자",99,130,122,-8,-23,-31,-0.0615384615384615,-0.188524590163934,-0.238461538461538
"2004","2016","경북","고령군","초등학교",2016-04-01,"남자",114,126,125,-1,-11,-12,-0.00793650793650794,-0.088,-0.0952380952380952
"2005","2016","경북","성주군","초등학교",2016-04-01,"전체",218,235,226,-9,-8,-17,-0.0382978723404255,-0.0353982300884956,-0.0723404255319149
"2006","2016","경북","성주군","초등학교",2016-04-01,"여자",92,107,106,-1,-14,-15,-0.00934579439252336,-0.132075471698113,-0.14018691588785
"2007","2016","경북","성주군","초등학교",2016-04-01,"남자",126,128,120,-8,6,-2,-0.0625,0.05,-0.015625
"2008","2016","경북","칠곡군","초등학교",2016-04-01,"전체",1212,1269,1261,-8,-49,-57,-0.00630417651694247,-0.0388580491673275,-0.0449172576832151
"2009","2016","경북","칠곡군","초등학교",2016-04-01,"여자",589,596,601,5,-12,-7,0.00838926174496644,-0.0199667221297837,-0.011744966442953
"2010","2016","경북","칠곡군","초등학교",2016-04-01,"남자",623,673,660,-13,-37,-50,-0.0193164933135215,-0.0560606060606061,-0.0742942050520059
"2011","2016","경북","예천군","초등학교",2016-04-01,"전체",243,266,263,-3,-20,-23,-0.0112781954887218,-0.0760456273764259,-0.0864661654135338
"2012","2016","경북","예천군","초등학교",2016-04-01,"여자",105,117,116,-1,-11,-12,-0.00854700854700855,-0.0948275862068965,-0.102564102564103
"2013","2016","경북","예천군","초등학교",2016-04-01,"남자",138,149,147,-2,-9,-11,-0.0134228187919463,-0.0612244897959184,-0.0738255033557047
"2014","2016","경북","봉화군","초등학교",2016-04-01,"전체",157,196,184,-12,-27,-39,-0.0612244897959184,-0.146739130434783,-0.198979591836735
"2015","2016","경북","봉화군","초등학교",2016-04-01,"여자",66,78,71,-7,-5,-12,-0.0897435897435897,-0.0704225352112676,-0.153846153846154
"2016","2016","경북","봉화군","초등학교",2016-04-01,"남자",91,118,113,-5,-22,-27,-0.0423728813559322,-0.194690265486726,-0.228813559322034
"2017","2016","경북","울진군","초등학교",2016-04-01,"전체",332,386,374,-12,-42,-54,-0.0310880829015544,-0.112299465240642,-0.139896373056995
"2018","2016","경북","울진군","초등학교",2016-04-01,"여자",163,186,174,-12,-11,-23,-0.0645161290322581,-0.0632183908045977,-0.123655913978495
"2019","2016","경북","울진군","초등학교",2016-04-01,"남자",169,200,200,0,-31,-31,0,-0.155,-0.155
"2020","2016","경북","울릉군","초등학교",2016-04-01,"전체",41,45,45,0,-4,-4,0,-0.0888888888888889,-0.0888888888888889
"2021","2016","경북","울릉군","초등학교",2016-04-01,"여자",20,19,19,0,1,1,0,0.0526315789473684,0.0526315789473684
"2022","2016","경북","울릉군","초등학교",2016-04-01,"남자",21,26,26,0,-5,-5,0,-0.192307692307692,-0.192307692307692
"2023","2016","경남","진주시","초등학교",2016-04-01,"전체",3086,2899,3059,160,27,187,0.0551914453259745,0.0088264138607388,0.0645050017247327
"2024","2016","경남","진주시","초등학교",2016-04-01,"여자",1436,1364,1430,66,6,72,0.0483870967741935,0.0041958041958042,0.0527859237536657
"2025","2016","경남","진주시","초등학교",2016-04-01,"남자",1650,1535,1629,94,21,115,0.0612377850162866,0.0128913443830571,0.0749185667752443
"2026","2016","경남","통영시","초등학교",2016-04-01,"전체",1411,1476,1467,-9,-56,-65,-0.00609756097560976,-0.038173142467621,-0.0440379403794038
"2027","2016","경남","통영시","초등학교",2016-04-01,"여자",655,698,700,2,-45,-43,0.00286532951289398,-0.0642857142857143,-0.0616045845272206
"2028","2016","경남","통영시","초등학교",2016-04-01,"남자",756,778,767,-11,-11,-22,-0.0141388174807198,-0.0143415906127771,-0.0282776349614396
"2029","2016","경남","사천시","초등학교",2016-04-01,"전체",1121,1232,1192,-40,-71,-111,-0.0324675324675325,-0.0595637583892617,-0.0900974025974026
"2030","2016","경남","사천시","초등학교",2016-04-01,"여자",575,629,608,-21,-33,-54,-0.0333863275039746,-0.0542763157894737,-0.0858505564387917
"2031","2016","경남","사천시","초등학교",2016-04-01,"남자",546,603,584,-19,-38,-57,-0.0315091210613599,-0.0650684931506849,-0.0945273631840796
"2032","2016","경남","김해시","초등학교",2016-04-01,"전체",5671,5774,5754,-20,-83,-103,-0.00346380325597506,-0.0144247480013903,-0.0178385867682716
"2033","2016","경남","김해시","초등학교",2016-04-01,"여자",2741,2781,2762,-19,-21,-40,-0.00683207479323984,-0.00760318609703114,-0.0143833153541891
"2034","2016","경남","김해시","초등학교",2016-04-01,"남자",2930,2993,2992,-1,-62,-63,-0.000334112930170398,-0.0207219251336898,-0.021049114600735
"2035","2016","경남","밀양시","초등학교",2016-04-01,"전체",635,614,629,15,6,21,0.0244299674267101,0.0095389507154213,0.0342019543973941
"2036","2016","경남","밀양시","초등학교",2016-04-01,"여자",305,286,298,12,7,19,0.041958041958042,0.023489932885906,0.0664335664335664
"2037","2016","경남","밀양시","초등학교",2016-04-01,"남자",330,328,331,3,-1,2,0.00914634146341463,-0.00302114803625378,0.00609756097560976
"2038","2016","경남","거제시","초등학교",2016-04-01,"전체",3054,3135,3163,28,-109,-81,0.00893141945773525,-0.0344609547897566,-0.0258373205741627
"2039","2016","경남","거제시","초등학교",2016-04-01,"여자",1459,1498,1531,33,-72,-39,0.0220293724966622,-0.0470280862181581,-0.0260347129506008
"2040","2016","경남","거제시","초등학교",2016-04-01,"남자",1595,1637,1632,-5,-37,-42,-0.0030543677458766,-0.022671568627451,-0.0256566890653635
"2041","2016","경남","양산시","초등학교",2016-04-01,"전체",3092,2986,3133,147,-41,106,0.0492297387809779,-0.013086498563677,0.0354989953114535
"2042","2016","경남","양산시","초등학교",2016-04-01,"여자",1508,1464,1521,57,-13,44,0.0389344262295082,-0.00854700854700855,0.0300546448087432
"2043","2016","경남","양산시","초등학교",2016-04-01,"남자",1584,1522,1612,90,-28,62,0.0591327201051248,-0.0173697270471464,0.0407358738501971
"2044","2016","경남","의령군","초등학교",2016-04-01,"전체",143,184,172,-12,-29,-41,-0.0652173913043478,-0.168604651162791,-0.222826086956522
"2045","2016","경남","의령군","초등학교",2016-04-01,"여자",63,92,84,-8,-21,-29,-0.0869565217391304,-0.25,-0.315217391304348
"2046","2016","경남","의령군","초등학교",2016-04-01,"남자",80,92,88,-4,-8,-12,-0.0434782608695652,-0.0909090909090909,-0.130434782608696
"2047","2016","경남","함안군","초등학교",2016-04-01,"전체",646,605,635,30,11,41,0.0495867768595041,0.0173228346456693,0.0677685950413223
"2048","2016","경남","함안군","초등학교",2016-04-01,"여자",317,284,306,22,11,33,0.0774647887323944,0.0359477124183007,0.116197183098592
"2049","2016","경남","함안군","초등학교",2016-04-01,"남자",329,321,329,8,0,8,0.0249221183800623,0,0.0249221183800623
"2050","2016","경남","창녕군","초등학교",2016-04-01,"전체",355,353,360,7,-5,2,0.0198300283286119,-0.0138888888888889,0.0056657223796034
"2051","2016","경남","창녕군","초등학교",2016-04-01,"여자",163,175,176,1,-13,-12,0.00571428571428571,-0.0738636363636364,-0.0685714285714286
"2052","2016","경남","창녕군","초등학교",2016-04-01,"남자",192,178,184,6,8,14,0.0337078651685393,0.0434782608695652,0.0786516853932584
"2053","2016","경남","고성군","초등학교",2016-04-01,"전체",364,387,394,7,-30,-23,0.0180878552971576,-0.0761421319796954,-0.0594315245478036
"2054","2016","경남","고성군","초등학교",2016-04-01,"여자",177,173,180,7,-3,4,0.0404624277456647,-0.0166666666666667,0.023121387283237
"2055","2016","경남","고성군","초등학교",2016-04-01,"남자",187,214,214,0,-27,-27,0,-0.126168224299065,-0.126168224299065
"2056","2016","경남","남해군","초등학교",2016-04-01,"전체",226,221,222,1,4,5,0.00452488687782805,0.018018018018018,0.0226244343891403
"2057","2016","경남","남해군","초등학교",2016-04-01,"여자",94,106,107,1,-13,-12,0.00943396226415094,-0.121495327102804,-0.113207547169811
"2058","2016","경남","남해군","초등학교",2016-04-01,"남자",132,115,115,0,17,17,0,0.147826086956522,0.147826086956522
"2059","2016","경남","하동군","초등학교",2016-04-01,"전체",217,277,269,-8,-52,-60,-0.0288808664259928,-0.193308550185874,-0.216606498194946
"2060","2016","경남","하동군","초등학교",2016-04-01,"여자",126,152,141,-11,-15,-26,-0.0723684210526316,-0.106382978723404,-0.171052631578947
"2061","2016","경남","하동군","초등학교",2016-04-01,"남자",91,125,128,3,-37,-34,0.024,-0.2890625,-0.272
"2062","2016","경남","산청군","초등학교",2016-04-01,"전체",159,193,181,-12,-22,-34,-0.0621761658031088,-0.121546961325967,-0.176165803108808
"2063","2016","경남","산청군","초등학교",2016-04-01,"여자",82,88,80,-8,2,-6,-0.0909090909090909,0.025,-0.0681818181818182
"2064","2016","경남","산청군","초등학교",2016-04-01,"남자",77,105,101,-4,-24,-28,-0.0380952380952381,-0.237623762376238,-0.266666666666667
"2065","2016","경남","함양군","초등학교",2016-04-01,"전체",241,262,257,-5,-16,-21,-0.0190839694656489,-0.0622568093385214,-0.0801526717557252
"2066","2016","경남","함양군","초등학교",2016-04-01,"여자",126,129,126,-3,0,-3,-0.0232558139534884,0,-0.0232558139534884
"2067","2016","경남","함양군","초등학교",2016-04-01,"남자",115,133,131,-2,-16,-18,-0.0150375939849624,-0.122137404580153,-0.135338345864662
"2068","2016","경남","거창군","초등학교",2016-04-01,"전체",490,446,458,12,32,44,0.0269058295964126,0.0698689956331878,0.0986547085201794
"2069","2016","경남","거창군","초등학교",2016-04-01,"여자",230,210,216,6,14,20,0.0285714285714286,0.0648148148148148,0.0952380952380952
"2070","2016","경남","거창군","초등학교",2016-04-01,"남자",260,236,242,6,18,24,0.0254237288135593,0.0743801652892562,0.101694915254237
"2071","2016","경남","합천군","초등학교",2016-04-01,"전체",210,229,231,2,-21,-19,0.00873362445414847,-0.0909090909090909,-0.0829694323144105
"2072","2016","경남","합천군","초등학교",2016-04-01,"여자",109,115,109,-6,0,-6,-0.0521739130434783,0,-0.0521739130434783
"2073","2016","경남","합천군","초등학교",2016-04-01,"남자",101,114,122,8,-21,-13,0.0701754385964912,-0.172131147540984,-0.114035087719298
"2074","2016","제주","제주시","초등학교",2016-04-01,"전체",4774,4577,4734,157,40,197,0.0343019445051344,0.00844951415293621,0.0430412934236399
"2075","2016","제주","제주시","초등학교",2016-04-01,"여자",2272,2178,2249,71,23,94,0.0325987144168962,0.010226767452201,0.0431588613406795
"2076","2016","제주","제주시","초등학교",2016-04-01,"남자",2502,2399,2485,86,17,103,0.0358482701125469,0.006841046277666,0.0429345560650271
"2077","2016","제주","서귀포시","초등학교",2016-04-01,"전체",1412,1340,1373,33,39,72,0.0246268656716418,0.0284049526584122,0.0537313432835821
"2078","2016","제주","서귀포시","초등학교",2016-04-01,"여자",704,676,684,8,20,28,0.0118343195266272,0.0292397660818713,0.0414201183431953
"2079","2016","제주","서귀포시","초등학교",2016-04-01,"남자",708,664,689,25,19,44,0.0376506024096386,0.0275761973875181,0.0662650602409639
"2080","2017","서울","종로구","초등학교",2017-04-01,"전체",926,939,947,8,-21,-13,0.00851970181043664,-0.0221752903907075,-0.0138445154419595
"2081","2017","서울","종로구","초등학교",2017-04-01,"여자",467,449,443,-6,24,18,-0.0133630289532294,0.054176072234763,0.0400890868596882
"2082","2017","서울","종로구","초등학교",2017-04-01,"남자",459,490,504,14,-45,-31,0.0285714285714286,-0.0892857142857143,-0.063265306122449
"2083","2017","서울","중구","초등학교",2017-04-01,"전체",868,870,830,-40,38,-2,-0.0459770114942529,0.0457831325301205,-0.00229885057471264
"2084","2017","서울","중구","초등학교",2017-04-01,"여자",412,426,409,-17,3,-14,-0.039906103286385,0.00733496332518337,-0.0328638497652582
"2085","2017","서울","중구","초등학교",2017-04-01,"남자",456,444,421,-23,35,12,-0.0518018018018018,0.0831353919239905,0.027027027027027
"2086","2017","서울","용산구","초등학교",2017-04-01,"전체",1253,1768,1705,-63,-452,-515,-0.0356334841628959,-0.265102639296188,-0.291289592760181
"2087","2017","서울","용산구","초등학교",2017-04-01,"여자",621,858,816,-42,-195,-237,-0.048951048951049,-0.238970588235294,-0.276223776223776
"2088","2017","서울","용산구","초등학교",2017-04-01,"남자",632,910,889,-21,-257,-278,-0.0230769230769231,-0.289088863892013,-0.305494505494506
"2089","2017","서울","성동구","초등학교",2017-04-01,"전체",2111,2397,2329,-68,-218,-286,-0.0283687943262411,-0.0936024044654358,-0.119315811430955
"2090","2017","서울","성동구","초등학교",2017-04-01,"여자",1019,1183,1150,-33,-131,-164,-0.0278951817413356,-0.113913043478261,-0.138630600169062
"2091","2017","서울","성동구","초등학교",2017-04-01,"남자",1092,1214,1179,-35,-87,-122,-0.028830313014827,-0.0737913486005089,-0.100494233937397
"2092","2017","서울","광진구","초등학교",2017-04-01,"전체",2550,2688,2597,-91,-47,-138,-0.0338541666666667,-0.0180978051597998,-0.0513392857142857
"2093","2017","서울","광진구","초등학교",2017-04-01,"여자",1184,1348,1301,-47,-117,-164,-0.03486646884273,-0.0899308224442736,-0.121661721068249
"2094","2017","서울","광진구","초등학교",2017-04-01,"남자",1366,1340,1296,-44,70,26,-0.0328358208955224,0.0540123456790123,0.0194029850746269
"2095","2017","서울","동대문구","초등학교",2017-04-01,"전체",2396,2788,2665,-123,-269,-392,-0.0441176470588235,-0.10093808630394,-0.140602582496413
"2096","2017","서울","동대문구","초등학교",2017-04-01,"여자",1179,1392,1329,-63,-150,-213,-0.0452586206896552,-0.112866817155756,-0.15301724137931
"2097","2017","서울","동대문구","초등학교",2017-04-01,"남자",1217,1396,1336,-60,-119,-179,-0.0429799426934097,-0.0890718562874251,-0.128223495702006
"2098","2017","서울","중랑구","초등학교",2017-04-01,"전체",2652,3102,2966,-136,-314,-450,-0.0438426821405545,-0.105866486850978,-0.145067698259188
"2099","2017","서울","중랑구","초등학교",2017-04-01,"여자",1294,1529,1472,-57,-178,-235,-0.0372792674950948,-0.120923913043478,-0.153695225637672
"2100","2017","서울","중랑구","초등학교",2017-04-01,"남자",1358,1573,1494,-79,-136,-215,-0.0502225047679593,-0.0910307898259705,-0.136681500317864
"2101","2017","서울","성북구","초등학교",2017-04-01,"전체",3718,3917,3885,-32,-167,-199,-0.00816951748787337,-0.042985842985843,-0.0508041868777125
"2102","2017","서울","성북구","초등학교",2017-04-01,"여자",1840,1904,1898,-6,-58,-64,-0.00315126050420168,-0.0305584826132771,-0.0336134453781513
"2103","2017","서울","성북구","초등학교",2017-04-01,"남자",1878,2013,1987,-26,-109,-135,-0.0129160457029309,-0.0548565676899849,-0.0670640834575261
"2104","2017","서울","강북구","초등학교",2017-04-01,"전체",1791,2589,2461,-128,-670,-798,-0.0494399382000772,-0.272247054043072,-0.308227114716107
"2105","2017","서울","강북구","초등학교",2017-04-01,"여자",880,1286,1207,-79,-327,-406,-0.0614307931570762,-0.270919635459818,-0.315707620528771
"2106","2017","서울","강북구","초등학교",2017-04-01,"남자",911,1303,1254,-49,-343,-392,-0.0376055257099002,-0.273524720893142,-0.300844205679202
"2107","2017","서울","도봉구","초등학교",2017-04-01,"전체",2737,2727,2699,-28,38,10,-0.0102676934360103,0.0140792886254168,0.00366703337000367
"2108","2017","서울","도봉구","초등학교",2017-04-01,"여자",1326,1302,1291,-11,35,24,-0.00844854070660522,0.0271107668474051,0.0184331797235023
"2109","2017","서울","도봉구","초등학교",2017-04-01,"남자",1411,1425,1408,-17,3,-14,-0.0119298245614035,0.00213068181818182,-0.00982456140350877
"2110","2017","서울","노원구","초등학교",2017-04-01,"전체",4470,4625,4555,-70,-85,-155,-0.0151351351351351,-0.0186608122941822,-0.0335135135135135
"2111","2017","서울","노원구","초등학교",2017-04-01,"여자",2199,2233,2194,-39,5,-34,-0.0174652933273623,0.00227894257064722,-0.0152261531571876
"2112","2017","서울","노원구","초등학교",2017-04-01,"남자",2271,2392,2361,-31,-90,-121,-0.0129598662207358,-0.0381194409148666,-0.0505852842809365
"2113","2017","서울","은평구","초등학교",2017-04-01,"전체",3803,4103,3974,-129,-171,-300,-0.0314404094564952,-0.0430296930045294,-0.073117231294175
"2114","2017","서울","은평구","초등학교",2017-04-01,"여자",1862,1993,1940,-53,-78,-131,-0.0265930757651781,-0.0402061855670103,-0.0657300551931761
"2115","2017","서울","은평구","초등학교",2017-04-01,"남자",1941,2110,2034,-76,-93,-169,-0.0360189573459716,-0.0457227138643068,-0.0800947867298578
"2116","2017","서울","서대문구","초등학교",2017-04-01,"전체",2288,2213,2295,82,-7,75,0.0370537731586082,-0.00305010893246187,0.0338906461816539
"2117","2017","서울","서대문구","초등학교",2017-04-01,"여자",1068,1065,1094,29,-26,3,0.0272300469483568,-0.0237659963436929,0.0028169014084507
"2118","2017","서울","서대문구","초등학교",2017-04-01,"남자",1220,1148,1201,53,19,72,0.0461672473867596,0.0158201498751041,0.0627177700348432
"2119","2017","서울","마포구","초등학교",2017-04-01,"전체",2676,3282,3199,-83,-523,-606,-0.0252894576477757,-0.163488590184433,-0.184643510054845
"2120","2017","서울","마포구","초등학교",2017-04-01,"여자",1310,1616,1579,-37,-269,-306,-0.0228960396039604,-0.170360987967068,-0.189356435643564
"2121","2017","서울","마포구","초등학교",2017-04-01,"남자",1366,1666,1620,-46,-254,-300,-0.0276110444177671,-0.15679012345679,-0.180072028811525
"2122","2017","서울","양천구","초등학교",2017-04-01,"전체",3815,3854,3963,109,-148,-39,0.0282823040996367,-0.0373454453696694,-0.0101193565127141
"2123","2017","서울","양천구","초등학교",2017-04-01,"여자",1879,1876,1921,45,-42,3,0.0239872068230277,-0.0218636127017179,0.00159914712153518
"2124","2017","서울","양천구","초등학교",2017-04-01,"남자",1936,1978,2042,64,-106,-42,0.032355915065723,-0.0519098922624878,-0.0212335692618807
"2125","2017","서울","강서구","초등학교",2017-04-01,"전체",4529,5111,4968,-143,-439,-582,-0.0279788691058501,-0.088365539452496,-0.113872040696537
"2126","2017","서울","강서구","초등학교",2017-04-01,"여자",2176,2493,2455,-38,-279,-317,-0.0152426795026073,-0.113645621181263,-0.127156036903329
"2127","2017","서울","강서구","초등학교",2017-04-01,"남자",2353,2618,2513,-105,-160,-265,-0.0401069518716578,-0.0636689216076403,-0.10122230710466
"2128","2017","서울","구로구","초등학교",2017-04-01,"전체",3464,4154,4016,-138,-552,-690,-0.033220991815118,-0.137450199203187,-0.16610495907559
"2129","2017","서울","구로구","초등학교",2017-04-01,"여자",1703,2050,1979,-71,-276,-347,-0.0346341463414634,-0.139464375947448,-0.169268292682927
"2130","2017","서울","구로구","초등학교",2017-04-01,"남자",1761,2104,2037,-67,-276,-343,-0.0318441064638783,-0.135493372606775,-0.163022813688213
"2131","2017","서울","금천구","초등학교",2017-04-01,"전체",1610,1718,1635,-83,-25,-108,-0.0483119906868452,-0.0152905198776758,-0.0628637951105937
"2132","2017","서울","금천구","초등학교",2017-04-01,"여자",782,823,792,-31,-10,-41,-0.0376670716889429,-0.0126262626262626,-0.0498177399756987
"2133","2017","서울","금천구","초등학교",2017-04-01,"남자",828,895,843,-52,-15,-67,-0.0581005586592179,-0.0177935943060498,-0.0748603351955307
"2134","2017","서울","영등포구","초등학교",2017-04-01,"전체",2377,3176,3028,-148,-651,-799,-0.0465994962216625,-0.214993394980185,-0.251574307304786
"2135","2017","서울","영등포구","초등학교",2017-04-01,"여자",1188,1569,1521,-48,-333,-381,-0.0305927342256214,-0.218934911242604,-0.24282982791587
"2136","2017","서울","영등포구","초등학교",2017-04-01,"남자",1189,1607,1507,-100,-318,-418,-0.0622277535780958,-0.211015262110153,-0.260112009956441
"2137","2017","서울","동작구","초등학교",2017-04-01,"전체",2950,3229,3117,-112,-167,-279,-0.0346856611954165,-0.0535771575232595,-0.0864044595850108
"2138","2017","서울","동작구","초등학교",2017-04-01,"여자",1389,1529,1481,-48,-92,-140,-0.0313930673642904,-0.062120189061445,-0.091563113145847
"2139","2017","서울","동작구","초등학교",2017-04-01,"남자",1561,1700,1636,-64,-75,-139,-0.0376470588235294,-0.0458435207823961,-0.0817647058823529
"2140","2017","서울","관악구","초등학교",2017-04-01,"전체",2769,3448,3276,-172,-507,-679,-0.0498839907192575,-0.154761904761905,-0.196925754060325
"2141","2017","서울","관악구","초등학교",2017-04-01,"여자",1358,1700,1599,-101,-241,-342,-0.0594117647058824,-0.150719199499687,-0.201176470588235
"2142","2017","서울","관악구","초등학교",2017-04-01,"남자",1411,1748,1677,-71,-266,-337,-0.0406178489702517,-0.158616577221228,-0.19279176201373
"2143","2017","서울","서초구","초등학교",2017-04-01,"전체",4031,4499,4467,-32,-436,-468,-0.00711269170926873,-0.0976046563689277,-0.104023116248055
"2144","2017","서울","서초구","초등학교",2017-04-01,"여자",1967,2207,2171,-36,-204,-240,-0.0163117353874037,-0.0939659143251958,-0.108744902582691
"2145","2017","서울","서초구","초등학교",2017-04-01,"남자",2064,2292,2296,4,-232,-228,0.00174520069808028,-0.101045296167247,-0.0994764397905759
"2146","2017","서울","강남구","초등학교",2017-04-01,"전체",3957,4571,4685,114,-728,-614,0.0249398381098228,-0.155389541088581,-0.134325092977467
"2147","2017","서울","강남구","초등학교",2017-04-01,"여자",1897,2231,2279,48,-382,-334,0.0215150156880323,-0.167617376042124,-0.149708650829225
"2148","2017","서울","강남구","초등학교",2017-04-01,"남자",2060,2340,2406,66,-346,-280,0.0282051282051282,-0.14380714879468,-0.11965811965812
"2149","2017","서울","송파구","초등학교",2017-04-01,"전체",5300,5921,5774,-147,-474,-621,-0.0248268873501098,-0.0820921371666089,-0.104880932274954
"2150","2017","서울","송파구","초등학교",2017-04-01,"여자",2595,2818,2769,-49,-174,-223,-0.017388218594748,-0.0628385698808234,-0.0791341376863023
"2151","2017","서울","송파구","초등학교",2017-04-01,"남자",2705,3103,3005,-98,-300,-398,-0.0315823396712859,-0.0998336106489185,-0.128262971318079
"2152","2017","서울","강동구","초등학교",2017-04-01,"전체",3470,4039,3823,-216,-353,-569,-0.0534785838078732,-0.0923358618885692,-0.140876454567962
"2153","2017","서울","강동구","초등학교",2017-04-01,"여자",1664,1923,1809,-114,-145,-259,-0.0592823712948518,-0.080154781647319,-0.134685387415497
"2154","2017","서울","강동구","초등학교",2017-04-01,"남자",1806,2116,2014,-102,-208,-310,-0.0482041587901701,-0.103277060575968,-0.146502835538752
"2155","2017","부산","중구","초등학교",2017-04-01,"전체",270,247,234,-13,36,23,-0.0526315789473684,0.153846153846154,0.0931174089068826
"2156","2017","부산","중구","초등학교",2017-04-01,"여자",141,116,110,-6,31,25,-0.0517241379310345,0.281818181818182,0.21551724137931
"2157","2017","부산","중구","초등학교",2017-04-01,"남자",129,131,124,-7,5,-2,-0.0534351145038168,0.0403225806451613,-0.0152671755725191
"2158","2017","부산","서구","초등학교",2017-04-01,"전체",644,694,674,-20,-30,-50,-0.0288184438040346,-0.0445103857566766,-0.0720461095100865
"2159","2017","부산","서구","초등학교",2017-04-01,"여자",327,354,334,-20,-7,-27,-0.0564971751412429,-0.0209580838323353,-0.076271186440678
"2160","2017","부산","서구","초등학교",2017-04-01,"남자",317,340,340,0,-23,-23,0,-0.0676470588235294,-0.0676470588235294
"2161","2017","부산","동구","초등학교",2017-04-01,"전체",403,477,453,-24,-50,-74,-0.050314465408805,-0.11037527593819,-0.155136268343816
"2162","2017","부산","동구","초등학교",2017-04-01,"여자",200,227,218,-9,-18,-27,-0.039647577092511,-0.0825688073394495,-0.118942731277533
"2163","2017","부산","동구","초등학교",2017-04-01,"남자",203,250,235,-15,-32,-47,-0.06,-0.136170212765957,-0.188
"2164","2017","부산","영도구","초등학교",2017-04-01,"전체",708,847,842,-5,-134,-139,-0.00590318772136954,-0.159144893111639,-0.164108618654073
"2165","2017","부산","영도구","초등학교",2017-04-01,"여자",349,415,405,-10,-56,-66,-0.0240963855421687,-0.138271604938272,-0.159036144578313
"2166","2017","부산","영도구","초등학교",2017-04-01,"남자",359,432,437,5,-78,-73,0.0115740740740741,-0.178489702517162,-0.168981481481481
"2167","2017","부산","부산진구","초등학교",2017-04-01,"전체",2673,2881,2788,-93,-115,-208,-0.0322804581742451,-0.0412482065997131,-0.0721971537660535
"2168","2017","부산","부산진구","초등학교",2017-04-01,"여자",1278,1427,1385,-42,-107,-149,-0.0294323756131745,-0.0772563176895307,-0.104414856341976
"2169","2017","부산","부산진구","초등학교",2017-04-01,"남자",1395,1454,1403,-51,-8,-59,-0.0350756533700138,-0.00570206699928724,-0.0405777166437414
"2170","2017","부산","동래구","초등학교",2017-04-01,"전체",2214,2108,2175,67,39,106,0.0317836812144213,0.0179310344827586,0.0502846299810247
"2171","2017","부산","동래구","초등학교",2017-04-01,"여자",1047,1028,1063,35,-16,19,0.0340466926070039,-0.0150517403574788,0.0184824902723735
"2172","2017","부산","동래구","초등학교",2017-04-01,"남자",1167,1080,1112,32,55,87,0.0296296296296296,0.0494604316546763,0.0805555555555556
"2173","2017","부산","남구","초등학교",2017-04-01,"전체",2120,2335,2291,-44,-171,-215,-0.0188436830835118,-0.0746398952422523,-0.0920770877944325
"2174","2017","부산","남구","초등학교",2017-04-01,"여자",1051,1144,1138,-6,-87,-93,-0.00524475524475524,-0.0764499121265378,-0.0812937062937063
"2175","2017","부산","남구","초등학교",2017-04-01,"남자",1069,1191,1153,-38,-84,-122,-0.0319059613769941,-0.0728534258456201,-0.102434928631402
"2176","2017","부산","북구","초등학교",2017-04-01,"전체",2235,2338,2414,76,-179,-103,0.0325064157399487,-0.0741507870753935,-0.044054747647562
"2177","2017","부산","북구","초등학교",2017-04-01,"여자",1049,1139,1184,45,-135,-90,0.0395083406496927,-0.11402027027027,-0.0790166812993854
"2178","2017","부산","북구","초등학교",2017-04-01,"남자",1186,1199,1230,31,-44,-13,0.0258548790658882,-0.0357723577235772,-0.0108423686405338
"2179","2017","부산","해운대구","초등학교",2017-04-01,"전체",3285,3644,3649,5,-364,-359,0.00137211855104281,-0.0997533570841326,-0.0985181119648738
"2180","2017","부산","해운대구","초등학교",2017-04-01,"여자",1574,1744,1734,-10,-160,-170,-0.00573394495412844,-0.0922722029988466,-0.0974770642201835
"2181","2017","부산","해운대구","초등학교",2017-04-01,"남자",1711,1900,1915,15,-204,-189,0.00789473684210526,-0.106527415143603,-0.0994736842105263
"2182","2017","부산","사하구","초등학교",2017-04-01,"전체",2498,2961,2809,-152,-311,-463,-0.0513340087808173,-0.110715557137771,-0.156366092536305
"2183","2017","부산","사하구","초등학교",2017-04-01,"여자",1248,1454,1394,-60,-146,-206,-0.0412654745529574,-0.104734576757532,-0.141678129298487
"2184","2017","부산","사하구","초등학교",2017-04-01,"남자",1250,1507,1415,-92,-165,-257,-0.0610484406104844,-0.11660777385159,-0.170537491705375
"2185","2017","부산","금정구","초등학교",2017-04-01,"전체",1656,1663,1640,-23,16,-7,-0.0138304269392664,0.00975609756097561,-0.0042092603728202
"2186","2017","부산","금정구","초등학교",2017-04-01,"여자",782,810,788,-22,-6,-28,-0.0271604938271605,-0.00761421319796954,-0.0345679012345679
"2187","2017","부산","금정구","초등학교",2017-04-01,"남자",874,853,852,-1,22,21,-0.00117233294255569,0.0258215962441315,0.0246189917936694
"2188","2017","부산","강서구","초등학교",2017-04-01,"전체",1561,1141,1454,313,107,420,0.274320771253287,0.0735900962861073,0.368098159509202
"2189","2017","부산","강서구","초등학교",2017-04-01,"여자",772,549,702,153,70,223,0.278688524590164,0.0997150997150997,0.406193078324226
"2190","2017","부산","강서구","초등학교",2017-04-01,"남자",789,592,752,160,37,197,0.27027027027027,0.0492021276595745,0.33277027027027
"2191","2017","부산","연제구","초등학교",2017-04-01,"전체",1650,1628,1675,47,-25,22,0.0288697788697789,-0.0149253731343284,0.0135135135135135
"2192","2017","부산","연제구","초등학교",2017-04-01,"여자",826,797,818,21,8,29,0.0263488080301129,0.0097799511002445,0.0363864491844417
"2193","2017","부산","연제구","초등학교",2017-04-01,"남자",824,831,857,26,-33,-7,0.0312876052948255,-0.0385064177362894,-0.00842358604091456
"2194","2017","부산","수영구","초등학교",2017-04-01,"전체",992,1188,1160,-28,-168,-196,-0.0235690235690236,-0.144827586206897,-0.164983164983165
"2195","2017","부산","수영구","초등학교",2017-04-01,"여자",464,596,578,-18,-114,-132,-0.0302013422818792,-0.197231833910035,-0.221476510067114
"2196","2017","부산","수영구","초등학교",2017-04-01,"남자",528,592,582,-10,-54,-64,-0.0168918918918919,-0.0927835051546392,-0.108108108108108
"2197","2017","부산","사상구","초등학교",2017-04-01,"전체",1462,1866,1768,-98,-306,-404,-0.052518756698821,-0.173076923076923,-0.216505894962487
"2198","2017","부산","사상구","초등학교",2017-04-01,"여자",716,903,862,-41,-146,-187,-0.0454042081949059,-0.169373549883991,-0.207087486157254
"2199","2017","부산","사상구","초등학교",2017-04-01,"남자",746,963,906,-57,-160,-217,-0.059190031152648,-0.176600441501104,-0.22533748701973
"2200","2017","부산","기장군","초등학교",2017-04-01,"전체",1987,2144,2223,79,-236,-157,0.0368470149253731,-0.106162843004948,-0.0732276119402985
"2201","2017","부산","기장군","초등학교",2017-04-01,"여자",997,1066,1109,43,-112,-69,0.0403377110694184,-0.100991884580703,-0.0647279549718574
"2202","2017","부산","기장군","초등학교",2017-04-01,"남자",990,1078,1114,36,-124,-88,0.0333951762523191,-0.111310592459605,-0.0816326530612245
"2203","2017","대구","중구","초등학교",2017-04-01,"전체",735,613,613,0,122,122,0,0.199021207177814,0.199021207177814
"2204","2017","대구","중구","초등학교",2017-04-01,"여자",350,311,310,-1,40,39,-0.00321543408360129,0.129032258064516,0.12540192926045
"2205","2017","대구","중구","초등학교",2017-04-01,"남자",385,302,303,1,82,83,0.0033112582781457,0.270627062706271,0.274834437086093
"2206","2017","대구","동구","초등학교",2017-04-01,"전체",3072,3251,3215,-36,-143,-179,-0.0110735158412796,-0.0444790046656299,-0.0550599815441403
"2207","2017","대구","동구","초등학교",2017-04-01,"여자",1494,1557,1550,-7,-56,-63,-0.00449582530507386,-0.0361290322580645,-0.0404624277456647
"2208","2017","대구","동구","초등학교",2017-04-01,"남자",1578,1694,1665,-29,-87,-116,-0.0171192443919717,-0.0522522522522523,-0.0684769775678867
"2209","2017","대구","서구","초등학교",2017-04-01,"전체",991,1359,1269,-90,-278,-368,-0.0662251655629139,-0.219070133963751,-0.270787343635026
"2210","2017","대구","서구","초등학교",2017-04-01,"여자",482,660,621,-39,-139,-178,-0.0590909090909091,-0.223832528180354,-0.26969696969697
"2211","2017","대구","서구","초등학교",2017-04-01,"남자",509,699,648,-51,-139,-190,-0.0729613733905579,-0.214506172839506,-0.271816881258941
"2212","2017","대구","남구","초등학교",2017-04-01,"전체",731,965,941,-24,-210,-234,-0.0248704663212435,-0.223166843783209,-0.242487046632124
"2213","2017","대구","남구","초등학교",2017-04-01,"여자",345,463,446,-17,-101,-118,-0.0367170626349892,-0.226457399103139,-0.254859611231102
"2214","2017","대구","남구","초등학교",2017-04-01,"남자",386,502,495,-7,-109,-116,-0.0139442231075697,-0.22020202020202,-0.231075697211155
"2215","2017","대구","북구","초등학교",2017-04-01,"전체",3816,4307,4248,-59,-432,-491,-0.0136986301369863,-0.101694915254237,-0.114000464360344
"2216","2017","대구","북구","초등학교",2017-04-01,"여자",1828,2071,2051,-20,-223,-243,-0.00965717044905843,-0.108727450024378,-0.11733462095606
"2217","2017","대구","북구","초등학교",2017-04-01,"남자",1988,2236,2197,-39,-209,-248,-0.0174418604651163,-0.0951297223486573,-0.110912343470483
"2218","2017","대구","수성구","초등학교",2017-04-01,"전체",3571,3539,3750,211,-179,32,0.0596213619666572,-0.0477333333333333,0.00904210228878214
"2219","2017","대구","수성구","초등학교",2017-04-01,"여자",1719,1727,1835,108,-116,-8,0.062536189924725,-0.0632152588555858,-0.00463231036479444
"2220","2017","대구","수성구","초등학교",2017-04-01,"남자",1852,1812,1915,103,-63,40,0.0568432671081678,-0.0328981723237598,0.022075055187638
"2221","2017","대구","달서구","초등학교",2017-04-01,"전체",5415,5634,5501,-133,-86,-219,-0.0236066737664182,-0.0156335211779676,-0.0388711395101171
"2222","2017","대구","달서구","초등학교",2017-04-01,"여자",2619,2723,2659,-64,-40,-104,-0.0235034887991186,-0.0150432493418578,-0.0381931692985678
"2223","2017","대구","달서구","초등학교",2017-04-01,"남자",2796,2911,2842,-69,-46,-115,-0.0237031947784267,-0.0161857846586911,-0.0395053246307111
"2224","2017","대구","달성군","초등학교",2017-04-01,"전체",2687,2162,2420,258,267,525,0.119333950046253,0.110330578512397,0.242830712303423
"2225","2017","대구","달성군","초등학교",2017-04-01,"여자",1310,1054,1182,128,128,256,0.121442125237192,0.1082910321489,0.242884250474383
"2226","2017","대구","달성군","초등학교",2017-04-01,"남자",1377,1108,1238,130,139,269,0.117328519855596,0.112277867528271,0.242779783393502
"2227","2017","인천","중구","초등학교",2017-04-01,"전체",1244,1207,1210,3,34,37,0.00248550124275062,0.028099173553719,0.0306545153272577
"2228","2017","인천","중구","초등학교",2017-04-01,"여자",601,575,571,-4,30,26,-0.00695652173913044,0.0525394045534151,0.0452173913043478
"2229","2017","인천","중구","초등학교",2017-04-01,"남자",643,632,639,7,4,11,0.0110759493670886,0.00625978090766823,0.0174050632911392
"2230","2017","인천","동구","초등학교",2017-04-01,"전체",714,696,654,-42,60,18,-0.0603448275862069,0.0917431192660551,0.0258620689655172
"2231","2017","인천","동구","초등학교",2017-04-01,"여자",353,329,314,-15,39,24,-0.0455927051671733,0.124203821656051,0.0729483282674772
"2232","2017","인천","동구","초등학교",2017-04-01,"남자",361,367,340,-27,21,-6,-0.0735694822888283,0.0617647058823529,-0.0163487738419619
"2233","2017","인천","남구","초등학교",2017-04-01,"전체",3076,3516,3409,-107,-333,-440,-0.0304323094425483,-0.0976826048694632,-0.12514220705347
"2234","2017","인천","남구","초등학교",2017-04-01,"여자",1515,1677,1641,-36,-126,-162,-0.0214669051878354,-0.076782449725777,-0.0966010733452594
"2235","2017","인천","남구","초등학교",2017-04-01,"남자",1561,1839,1768,-71,-207,-278,-0.0386079390973355,-0.117081447963801,-0.151169113648722
"2236","2017","인천","연수구","초등학교",2017-04-01,"전체",3514,3205,3485,280,29,309,0.0873634945397816,0.00832137733142037,0.096411856474259
"2237","2017","인천","연수구","초등학교",2017-04-01,"여자",1687,1548,1649,101,38,139,0.0652454780361757,0.0230442692540934,0.0897932816537468
"2238","2017","인천","연수구","초등학교",2017-04-01,"남자",1827,1657,1836,179,-9,170,0.108026554013277,-0.00490196078431373,0.102595051297526
"2239","2017","인천","남동구","초등학교",2017-04-01,"전체",5243,5478,5642,164,-399,-235,0.0299379335523914,-0.0707196029776675,-0.042898868200073
"2240","2017","인천","남동구","초등학교",2017-04-01,"여자",2547,2636,2712,76,-165,-89,0.0288315629742033,-0.0608407079646018,-0.033763277693475
"2241","2017","인천","남동구","초등학교",2017-04-01,"남자",2696,2842,2930,88,-234,-146,0.0309641097818438,-0.0798634812286689,-0.0513722730471499
"2242","2017","인천","부평구","초등학교",2017-04-01,"전체",4338,4962,4785,-177,-447,-624,-0.035671100362757,-0.0934169278996865,-0.125755743651753
"2243","2017","인천","부평구","초등학교",2017-04-01,"여자",2101,2445,2349,-96,-248,-344,-0.0392638036809816,-0.105576841209025,-0.140695296523517
"2244","2017","인천","부평구","초등학교",2017-04-01,"남자",2237,2517,2436,-81,-199,-280,-0.032181168057211,-0.0816912972085386,-0.11124354390147
"2245","2017","인천","계양구","초등학교",2017-04-01,"전체",2836,3146,3039,-107,-203,-310,-0.0340114431023522,-0.0667982889108259,-0.0985378258105531
"2246","2017","인천","계양구","초등학교",2017-04-01,"여자",1406,1555,1507,-48,-101,-149,-0.0308681672025723,-0.0670205706702057,-0.0958199356913183
"2247","2017","인천","계양구","초등학교",2017-04-01,"남자",1430,1591,1532,-59,-102,-161,-0.0370835952231301,-0.066579634464752,-0.101194217473287
"2248","2017","인천","서구","초등학교",2017-04-01,"전체",5554,5964,5966,2,-412,-410,0.000335345405767941,-0.0690579953067382,-0.0687458081824279
"2249","2017","인천","서구","초등학교",2017-04-01,"여자",2692,2921,2925,4,-233,-229,0.00136939404313591,-0.0796581196581197,-0.078397808969531
"2250","2017","인천","서구","초등학교",2017-04-01,"남자",2862,3043,3041,-2,-179,-181,-0.000657246138678935,-0.058862216376192,-0.0594807755504436
"2251","2017","인천","강화군","초등학교",2017-04-01,"전체",402,347,376,29,26,55,0.0835734870317003,0.0691489361702128,0.15850144092219
"2252","2017","인천","강화군","초등학교",2017-04-01,"여자",189,165,180,15,9,24,0.0909090909090909,0.05,0.145454545454545
"2253","2017","인천","강화군","초등학교",2017-04-01,"남자",213,182,196,14,17,31,0.0769230769230769,0.086734693877551,0.17032967032967
"2254","2017","인천","옹진군","초등학교",2017-04-01,"전체",111,140,143,3,-32,-29,0.0214285714285714,-0.223776223776224,-0.207142857142857
"2255","2017","인천","옹진군","초등학교",2017-04-01,"여자",54,66,68,2,-14,-12,0.0303030303030303,-0.205882352941176,-0.181818181818182
"2256","2017","인천","옹진군","초등학교",2017-04-01,"남자",57,74,75,1,-18,-17,0.0135135135135135,-0.24,-0.22972972972973
"2257","2017","광주","동구","초등학교",2017-04-01,"전체",560,710,691,-19,-131,-150,-0.0267605633802817,-0.189580318379161,-0.211267605633803
"2258","2017","광주","동구","초등학교",2017-04-01,"여자",260,351,347,-4,-87,-91,-0.0113960113960114,-0.250720461095101,-0.259259259259259
"2259","2017","광주","동구","초등학교",2017-04-01,"남자",300,359,344,-15,-44,-59,-0.0417827298050139,-0.127906976744186,-0.164345403899721
"2260","2017","광주","서구","초등학교",2017-04-01,"전체",2820,2868,2852,-16,-32,-48,-0.00557880055788006,-0.0112201963534362,-0.0167364016736402
"2261","2017","광주","서구","초등학교",2017-04-01,"여자",1348,1411,1394,-17,-46,-63,-0.0120481927710843,-0.0329985652797704,-0.0446491849751949
"2262","2017","광주","서구","초등학교",2017-04-01,"남자",1472,1457,1458,1,14,15,0.000686341798215511,0.00960219478737997,0.0102951269732327
"2263","2017","광주","남구","초등학교",2017-04-01,"전체",2240,2002,2047,45,193,238,0.0224775224775225,0.0942843185148999,0.118881118881119
"2264","2017","광주","남구","초등학교",2017-04-01,"여자",1097,977,997,20,100,120,0.0204708290685773,0.100300902708124,0.122824974411464
"2265","2017","광주","남구","초등학교",2017-04-01,"남자",1143,1025,1050,25,93,118,0.024390243902439,0.0885714285714286,0.115121951219512
"2266","2017","광주","북구","초등학교",2017-04-01,"전체",3957,4117,4079,-38,-122,-160,-0.00923002186057809,-0.029909291493013,-0.0388632499392762
"2267","2017","광주","북구","초등학교",2017-04-01,"여자",1939,2040,2017,-23,-78,-101,-0.0112745098039216,-0.0386712940009916,-0.0495098039215686
"2268","2017","광주","북구","초등학교",2017-04-01,"남자",2018,2077,2062,-15,-44,-59,-0.00722195474241695,-0.0213385063045587,-0.0284063553201733
"2269","2017","광주","광산구","초등학교",2017-04-01,"전체",5323,5543,5515,-28,-192,-220,-0.00505141620061339,-0.0348141432456936,-0.0396896987191052
"2270","2017","광주","광산구","초등학교",2017-04-01,"여자",2586,2697,2675,-22,-89,-111,-0.00815721171672228,-0.0332710280373832,-0.0411568409343715
"2271","2017","광주","광산구","초등학교",2017-04-01,"남자",2737,2846,2840,-6,-103,-109,-0.00210822206605762,-0.0362676056338028,-0.0382993675333802
"2272","2017","대전","동구","초등학교",2017-04-01,"전체",1953,2297,2195,-102,-242,-344,-0.044405746626034,-0.110250569476082,-0.149760557248585
"2273","2017","대전","동구","초등학교",2017-04-01,"여자",954,1120,1089,-31,-135,-166,-0.0276785714285714,-0.12396694214876,-0.148214285714286
"2274","2017","대전","동구","초등학교",2017-04-01,"남자",999,1177,1106,-71,-107,-178,-0.0603228547153781,-0.096745027124774,-0.151231945624469
"2275","2017","대전","중구","초등학교",2017-04-01,"전체",2166,2231,2183,-48,-17,-65,-0.0215150156880323,-0.00778744846541457,-0.0291349170775437
"2276","2017","대전","중구","초등학교",2017-04-01,"여자",1080,1126,1076,-50,4,-46,-0.044404973357016,0.00371747211895911,-0.0408525754884547
"2277","2017","대전","중구","초등학교",2017-04-01,"남자",1086,1105,1107,2,-21,-19,0.00180995475113122,-0.018970189701897,-0.0171945701357466
"2278","2017","대전","서구","초등학교",2017-04-01,"전체",4454,4762,4714,-48,-260,-308,-0.0100797984040319,-0.0551548578701739,-0.0646787064258715
"2279","2017","대전","서구","초등학교",2017-04-01,"여자",2155,2272,2253,-19,-98,-117,-0.00836267605633803,-0.0434975588104749,-0.0514964788732394
"2280","2017","대전","서구","초등학교",2017-04-01,"남자",2299,2490,2461,-29,-162,-191,-0.0116465863453815,-0.065826899634295,-0.0767068273092369
"2281","2017","대전","유성구","초등학교",2017-04-01,"전체",4067,4187,4189,2,-122,-120,0.000477668975400048,-0.0291238959178802,-0.0286601385240029
"2282","2017","대전","유성구","초등학교",2017-04-01,"여자",1959,2050,2061,11,-102,-91,0.00536585365853659,-0.049490538573508,-0.044390243902439
"2283","2017","대전","유성구","초등학교",2017-04-01,"남자",2108,2137,2128,-9,-20,-29,-0.0042115114646701,-0.0093984962406015,-0.0135704258306037
"2284","2017","대전","대덕구","초등학교",2017-04-01,"전체",1553,1762,1652,-110,-99,-209,-0.0624290578887628,-0.0599273607748184,-0.118615209988649
"2285","2017","대전","대덕구","초등학교",2017-04-01,"여자",722,835,778,-57,-56,-113,-0.0682634730538922,-0.0719794344473008,-0.135329341317365
"2286","2017","대전","대덕구","초등학교",2017-04-01,"남자",831,927,874,-53,-43,-96,-0.0571736785329018,-0.0491990846681922,-0.103559870550162
"2287","2017","울산","중구","초등학교",2017-04-01,"전체",2179,2255,2328,73,-149,-76,0.0323725055432372,-0.0640034364261168,-0.0337028824833703
"2288","2017","울산","중구","초등학교",2017-04-01,"여자",1033,1083,1115,32,-82,-50,0.0295475530932595,-0.073542600896861,-0.0461680517082179
"2289","2017","울산","중구","초등학교",2017-04-01,"남자",1146,1172,1213,41,-67,-26,0.0349829351535836,-0.055234954657873,-0.0221843003412969
"2290","2017","울산","남구","초등학교",2017-04-01,"전체",2649,2972,2898,-74,-249,-323,-0.0248990578734859,-0.0859213250517598,-0.108681022880215
"2291","2017","울산","남구","초등학교",2017-04-01,"여자",1239,1432,1379,-53,-140,-193,-0.0370111731843575,-0.101522842639594,-0.134776536312849
"2292","2017","울산","남구","초등학교",2017-04-01,"남자",1410,1540,1519,-21,-109,-130,-0.0136363636363636,-0.0717577353522054,-0.0844155844155844
"2293","2017","울산","동구","초등학교",2017-04-01,"전체",1890,2082,2040,-42,-150,-192,-0.0201729106628242,-0.0735294117647059,-0.0922190201729107
"2294","2017","울산","동구","초등학교",2017-04-01,"여자",893,980,956,-24,-63,-87,-0.0244897959183673,-0.0658995815899582,-0.0887755102040816
"2295","2017","울산","동구","초등학교",2017-04-01,"남자",997,1102,1084,-18,-87,-105,-0.0163339382940109,-0.0802583025830258,-0.0952813067150635
"2296","2017","울산","북구","초등학교",2017-04-01,"전체",2446,2535,2524,-11,-78,-89,-0.00433925049309665,-0.0309033280507132,-0.0351084812623274
"2297","2017","울산","북구","초등학교",2017-04-01,"여자",1221,1238,1230,-8,-9,-17,-0.00646203554119548,-0.00731707317073171,-0.0137318255250404
"2298","2017","울산","북구","초등학교",2017-04-01,"남자",1225,1297,1294,-3,-69,-72,-0.0023130300693909,-0.053323029366306,-0.0555127216653816
"2299","2017","울산","울주군","초등학교",2017-04-01,"전체",2320,2316,2323,7,-3,4,0.00302245250431779,-0.0012914334911752,0.00172711571675302
"2300","2017","울산","울주군","초등학교",2017-04-01,"여자",1137,1157,1172,15,-35,-20,0.0129645635263613,-0.0298634812286689,-0.017286084701815
"2301","2017","울산","울주군","초등학교",2017-04-01,"남자",1183,1159,1151,-8,32,24,-0.00690250215703192,0.0278019113814075,0.0207075064710958
"2302","2017","세종","세종시","초등학교",2017-04-01,"전체",3839,2680,3550,870,289,1159,0.324626865671642,0.0814084507042254,0.432462686567164
"2303","2017","세종","세종시","초등학교",2017-04-01,"전체",3839,2680,3550,870,289,1159,0.324626865671642,0.0814084507042254,0.432462686567164
"2304","2017","세종","세종시","초등학교",2017-04-01,"전체",3839,2680,3550,870,289,1159,0.324626865671642,0.0814084507042254,0.432462686567164
"2305","2017","세종","세종시","초등학교",2017-04-01,"전체",3839,2680,3550,870,289,1159,0.324626865671642,0.0814084507042254,0.432462686567164
"2306","2017","세종","세종시","초등학교",2017-04-01,"여자",1871,1332,1735,403,136,539,0.302552552552553,0.0783861671469741,0.404654654654655
"2307","2017","세종","세종시","초등학교",2017-04-01,"여자",1871,1332,1735,403,136,539,0.302552552552553,0.0783861671469741,0.404654654654655
"2308","2017","세종","세종시","초등학교",2017-04-01,"여자",1871,1332,1735,403,136,539,0.302552552552553,0.0783861671469741,0.404654654654655
"2309","2017","세종","세종시","초등학교",2017-04-01,"여자",1871,1332,1735,403,136,539,0.302552552552553,0.0783861671469741,0.404654654654655
"2310","2017","세종","세종시","초등학교",2017-04-01,"남자",1968,1348,1815,467,153,620,0.346439169139466,0.084297520661157,0.459940652818991
"2311","2017","세종","세종시","초등학교",2017-04-01,"남자",1968,1348,1815,467,153,620,0.346439169139466,0.084297520661157,0.459940652818991
"2312","2017","세종","세종시","초등학교",2017-04-01,"남자",1968,1348,1815,467,153,620,0.346439169139466,0.084297520661157,0.459940652818991
"2313","2017","세종","세종시","초등학교",2017-04-01,"남자",1968,1348,1815,467,153,620,0.346439169139466,0.084297520661157,0.459940652818991
"2314","2017","경기","수원시","초등학교",2017-04-01,"전체",11580,12475,12332,-143,-752,-895,-0.0114629258517034,-0.0609795653584171,-0.0717434869739479
"2315","2017","경기","수원시","초등학교",2017-04-01,"여자",5596,6014,5960,-54,-364,-418,-0.00897904888593282,-0.0610738255033557,-0.069504489524443
"2316","2017","경기","수원시","초등학교",2017-04-01,"남자",5984,6461,6372,-89,-388,-477,-0.0137749574369293,-0.0608913998744507,-0.0738275808698344
"2317","2017","경기","성남시","초등학교",2017-04-01,"전체",8106,8780,8662,-118,-556,-674,-0.0134396355353075,-0.0641884091433849,-0.0767653758542141
"2318","2017","경기","성남시","초등학교",2017-04-01,"여자",3949,4206,4159,-47,-210,-257,-0.0111745126010461,-0.0504929069487858,-0.0611031859248692
"2319","2017","경기","성남시","초등학교",2017-04-01,"남자",4157,4574,4503,-71,-346,-417,-0.0155225185832969,-0.0768376637797024,-0.0911674682990818
"2320","2017","경기","부천시","초등학교",2017-04-01,"전체",6934,7467,7310,-157,-376,-533,-0.0210258470603991,-0.0514363885088919,-0.0713807419311638
"2321","2017","경기","부천시","초등학교",2017-04-01,"여자",3406,3648,3582,-66,-176,-242,-0.0180921052631579,-0.0491345616973758,-0.0663377192982456
"2322","2017","경기","부천시","초등학교",2017-04-01,"남자",3528,3819,3728,-91,-200,-291,-0.0238282272846295,-0.0536480686695279,-0.0761979575805185
"2323","2017","경기","안양시","초등학교",2017-04-01,"전체",4978,5356,5257,-99,-279,-378,-0.0184839432412248,-0.05307209435039,-0.0705750560119492
"2324","2017","경기","안양시","초등학교",2017-04-01,"여자",2395,2575,2538,-37,-143,-180,-0.014368932038835,-0.0563435776201734,-0.0699029126213592
"2325","2017","경기","안양시","초등학교",2017-04-01,"남자",2583,2781,2719,-62,-136,-198,-0.0222941387989932,-0.0500183891136447,-0.0711974110032362
"2326","2017","경기","과천시","초등학교",2017-04-01,"전체",440,582,568,-14,-128,-142,-0.0240549828178694,-0.225352112676056,-0.243986254295533
"2327","2017","경기","과천시","초등학교",2017-04-01,"여자",211,265,266,1,-55,-54,0.00377358490566038,-0.206766917293233,-0.20377358490566
"2328","2017","경기","과천시","초등학교",2017-04-01,"남자",229,317,302,-15,-73,-88,-0.0473186119873817,-0.241721854304636,-0.277602523659306
"2329","2017","경기","안산시","초등학교",2017-04-01,"전체",6090,6595,6394,-201,-304,-505,-0.0304776345716452,-0.0475445730372224,-0.0765731614859742
"2330","2017","경기","안산시","초등학교",2017-04-01,"여자",2944,3222,3130,-92,-186,-278,-0.0285536933581626,-0.0594249201277955,-0.0862818125387958
"2331","2017","경기","안산시","초등학교",2017-04-01,"남자",3146,3373,3264,-109,-118,-227,-0.032315446190335,-0.0361519607843137,-0.0672991402312482
"2332","2017","경기","용인시","초등학교",2017-04-01,"전체",11437,12248,12297,49,-860,-811,0.00400065316786414,-0.0699357566886232,-0.0662148922273024
"2333","2017","경기","용인시","초등학교",2017-04-01,"여자",5555,6038,6053,15,-498,-483,0.00248426631334879,-0.0822732529324302,-0.0799933752898311
"2334","2017","경기","용인시","초등학교",2017-04-01,"남자",5882,6210,6244,34,-362,-328,0.00547504025764895,-0.0579756566303651,-0.0528180354267311
"2335","2017","경기","군포시","초등학교",2017-04-01,"전체",2682,3073,2974,-99,-292,-391,-0.0322160754962577,-0.0981842636180229,-0.127237227465018
"2336","2017","경기","군포시","초등학교",2017-04-01,"여자",1267,1475,1431,-44,-164,-208,-0.0298305084745763,-0.114605171208945,-0.141016949152542
"2337","2017","경기","군포시","초등학교",2017-04-01,"남자",1415,1598,1543,-55,-128,-183,-0.0344180225281602,-0.0829552819183409,-0.114518147684606
"2338","2017","경기","의왕시","초등학교",2017-04-01,"전체",1326,1654,1578,-76,-252,-328,-0.0459492140266022,-0.159695817490494,-0.198307134220073
"2339","2017","경기","의왕시","초등학교",2017-04-01,"여자",618,791,761,-30,-143,-173,-0.0379266750948167,-0.187910643889619,-0.218710493046776
"2340","2017","경기","의왕시","초등학교",2017-04-01,"남자",708,863,817,-46,-109,-155,-0.0533024333719583,-0.133414932680539,-0.179606025492468
"2341","2017","경기","시흥시","초등학교",2017-04-01,"전체",4248,4172,4201,29,47,76,0.00695110258868648,0.0111878124256129,0.0182166826462128
"2342","2017","경기","시흥시","초등학교",2017-04-01,"여자",2083,2080,2071,-9,12,3,-0.00432692307692308,0.00579430226943506,0.00144230769230769
"2343","2017","경기","시흥시","초등학교",2017-04-01,"남자",2165,2092,2130,38,35,73,0.0181644359464627,0.0164319248826291,0.0348948374760994
"2344","2017","경기","평택시","초등학교",2017-04-01,"전체",4918,4936,5046,110,-128,-18,0.0222852512155592,-0.0253666270313119,-0.00364667747163695
"2345","2017","경기","평택시","초등학교",2017-04-01,"여자",2346,2385,2433,48,-87,-39,0.020125786163522,-0.0357583230579531,-0.0163522012578616
"2346","2017","경기","평택시","초등학교",2017-04-01,"남자",2572,2551,2613,62,-41,21,0.0243041944335555,-0.0156907768848067,0.00823206585652685
"2347","2017","경기","화성시","초등학교",2017-04-01,"전체",9716,8730,9574,844,142,986,0.0966781214203895,0.0148318362231042,0.112943871706758
"2348","2017","경기","화성시","초등학교",2017-04-01,"여자",4732,4256,4651,395,81,476,0.0928101503759398,0.0174156095463341,0.111842105263158
"2349","2017","경기","화성시","초등학교",2017-04-01,"남자",4984,4474,4923,449,61,510,0.100357621814931,0.0123908186065407,0.113991953509164
"2350","2017","경기","오산시","초등학교",2017-04-01,"전체",2839,3081,2975,-106,-136,-242,-0.0344044141512496,-0.0457142857142857,-0.0785459266471925
"2351","2017","경기","오산시","초등학교",2017-04-01,"여자",1400,1514,1472,-42,-72,-114,-0.0277410832232497,-0.0489130434782609,-0.0752972258916777
"2352","2017","경기","오산시","초등학교",2017-04-01,"남자",1439,1567,1503,-64,-64,-128,-0.0408423739629866,-0.042581503659348,-0.0816847479259732
"2353","2017","경기","광명시","초등학교",2017-04-01,"전체",3272,3732,3615,-117,-343,-460,-0.0313504823151125,-0.0948824343015214,-0.123258306538049
"2354","2017","경기","광명시","초등학교",2017-04-01,"여자",1621,1825,1767,-58,-146,-204,-0.0317808219178082,-0.0826259196378042,-0.111780821917808
"2355","2017","경기","광명시","초등학교",2017-04-01,"남자",1651,1907,1848,-59,-197,-256,-0.0309386470896696,-0.106601731601732,-0.134242265338228
"2356","2017","경기","광주시","초등학교",2017-04-01,"전체",3151,3559,3579,20,-428,-408,0.00561955605507165,-0.119586476669461,-0.114638943523462
"2357","2017","경기","광주시","초등학교",2017-04-01,"여자",1523,1691,1720,29,-197,-168,0.0171496156120639,-0.11453488372093,-0.0993494973388527
"2358","2017","경기","광주시","초등학교",2017-04-01,"남자",1628,1868,1859,-9,-231,-240,-0.00481798715203426,-0.124260355029586,-0.12847965738758
"2359","2017","경기","하남시","초등학교",2017-04-01,"전체",2477,1610,2032,422,445,867,0.262111801242236,0.218996062992126,0.538509316770186
"2360","2017","경기","하남시","초등학교",2017-04-01,"여자",1208,806,985,179,223,402,0.222084367245658,0.226395939086294,0.498759305210918
"2361","2017","경기","하남시","초등학교",2017-04-01,"남자",1269,804,1047,243,222,465,0.302238805970149,0.212034383954155,0.578358208955224
"2362","2017","경기","김포시","초등학교",2017-04-01,"전체",4856,4626,4712,86,144,230,0.0185905750108085,0.0305602716468591,0.0497189796800692
"2363","2017","경기","김포시","초등학교",2017-04-01,"여자",2265,2195,2232,37,33,70,0.0168564920273349,0.0147849462365591,0.0318906605922551
"2364","2017","경기","김포시","초등학교",2017-04-01,"남자",2591,2431,2480,49,111,160,0.0201563142739613,0.044758064516129,0.0658165364047717
"2365","2017","경기","이천시","초등학교",2017-04-01,"전체",2274,2285,2303,18,-29,-11,0.00787746170678337,-0.0125922709509336,-0.00481400437636762
"2366","2017","경기","이천시","초등학교",2017-04-01,"여자",1071,1088,1097,9,-26,-17,0.00827205882352941,-0.0237010027347311,-0.015625
"2367","2017","경기","이천시","초등학교",2017-04-01,"남자",1203,1197,1206,9,-3,6,0.0075187969924812,-0.00248756218905473,0.0050125313283208
"2368","2017","경기","안성시","초등학교",2017-04-01,"전체",1809,1959,1898,-61,-89,-150,-0.0311383358856559,-0.0468914646996839,-0.0765696784073507
"2369","2017","경기","안성시","초등학교",2017-04-01,"여자",871,984,938,-46,-67,-113,-0.0467479674796748,-0.0714285714285714,-0.114837398373984
"2370","2017","경기","안성시","초등학교",2017-04-01,"남자",938,975,960,-15,-22,-37,-0.0153846153846154,-0.0229166666666667,-0.037948717948718
"2371","2017","경기","여주시","초등학교",2017-04-01,"전체",939,992,984,-8,-45,-53,-0.00806451612903226,-0.0457317073170732,-0.0534274193548387
"2372","2017","경기","여주시","초등학교",2017-04-01,"여자",476,509,510,1,-34,-33,0.00196463654223969,-0.0666666666666667,-0.0648330058939096
"2373","2017","경기","여주시","초등학교",2017-04-01,"남자",463,483,474,-9,-11,-20,-0.0186335403726708,-0.0232067510548523,-0.041407867494824
"2374","2017","경기","양평군","초등학교",2017-04-01,"전체",831,825,866,41,-35,6,0.0496969696969697,-0.0404157043879908,0.00727272727272727
"2375","2017","경기","양평군","초등학교",2017-04-01,"여자",410,400,415,15,-5,10,0.0375,-0.0120481927710843,0.025
"2376","2017","경기","양평군","초등학교",2017-04-01,"남자",421,425,451,26,-30,-4,0.0611764705882353,-0.0665188470066519,-0.00941176470588235
"2377","2017","경기","고양시","초등학교",2017-04-01,"전체",9165,9638,9865,227,-700,-473,0.0235526042747458,-0.0709579320831221,-0.0490765719028844
"2378","2017","경기","고양시","초등학교",2017-04-01,"여자",4444,4685,4830,145,-386,-241,0.0309498399146211,-0.0799171842650103,-0.0514407684098186
"2379","2017","경기","고양시","초등학교",2017-04-01,"남자",4721,4953,5035,82,-314,-232,0.0165556228548355,-0.0623634558093347,-0.0468402988088027
"2380","2017","경기","남양주시","초등학교",2017-04-01,"전체",7192,7605,7756,151,-564,-413,0.0198553583168968,-0.072717895822589,-0.0543063773833005
"2381","2017","경기","남양주시","초등학교",2017-04-01,"여자",3492,3716,3782,66,-290,-224,0.0177610333692142,-0.076679005817028,-0.0602798708288482
"2382","2017","경기","남양주시","초등학교",2017-04-01,"남자",3700,3889,3974,85,-274,-189,0.021856518385189,-0.0689481630598893,-0.0485986114682438
"2383","2017","경기","구리시","초등학교",2017-04-01,"전체",1598,1742,1706,-36,-108,-144,-0.0206659012629162,-0.063305978898007,-0.0826636050516648
"2384","2017","경기","구리시","초등학교",2017-04-01,"여자",759,855,845,-10,-86,-96,-0.0116959064327485,-0.101775147928994,-0.112280701754386
"2385","2017","경기","구리시","초등학교",2017-04-01,"남자",839,887,861,-26,-22,-48,-0.0293122886133033,-0.0255516840882695,-0.0541149943630214
"2386","2017","경기","의정부시","초등학교",2017-04-01,"전체",3749,3916,3915,-1,-166,-167,-0.000255362614913177,-0.0424010217113665,-0.0426455566905005
"2387","2017","경기","의정부시","초등학교",2017-04-01,"여자",1852,1884,1892,8,-40,-32,0.00424628450106157,-0.0211416490486258,-0.0169851380042463
"2388","2017","경기","의정부시","초등학교",2017-04-01,"남자",1897,2032,2023,-9,-126,-135,-0.00442913385826772,-0.0622837370242214,-0.0664370078740158
"2389","2017","경기","파주시","초등학교",2017-04-01,"전체",4992,5159,5236,77,-244,-167,0.0149253731343284,-0.0466004583651643,-0.0323706144601667
"2390","2017","경기","파주시","초등학교",2017-04-01,"여자",2500,2603,2644,41,-144,-103,0.0157510564733,-0.0544629349470499,-0.0395697272378025
"2391","2017","경기","파주시","초등학교",2017-04-01,"남자",2492,2556,2592,36,-100,-64,0.0140845070422535,-0.0385802469135802,-0.0250391236306729
"2392","2017","경기","동두천시","초등학교",2017-04-01,"전체",923,982,976,-6,-53,-59,-0.00610997963340122,-0.0543032786885246,-0.060081466395112
"2393","2017","경기","동두천시","초등학교",2017-04-01,"여자",441,460,460,0,-19,-19,0,-0.041304347826087,-0.041304347826087
"2394","2017","경기","동두천시","초등학교",2017-04-01,"남자",482,522,516,-6,-34,-40,-0.0114942528735632,-0.0658914728682171,-0.0766283524904215
"2395","2017","경기","양주시","초등학교",2017-04-01,"전체",2136,2303,2292,-11,-156,-167,-0.00477637863656101,-0.0680628272251309,-0.0725141120277898
"2396","2017","경기","양주시","초등학교",2017-04-01,"여자",1062,1153,1140,-13,-78,-91,-0.0112749349522984,-0.068421052631579,-0.0789245446660885
"2397","2017","경기","양주시","초등학교",2017-04-01,"남자",1074,1150,1152,2,-78,-76,0.00173913043478261,-0.0677083333333333,-0.0660869565217391
"2398","2017","경기","포천시","초등학교",2017-04-01,"전체",1171,1255,1235,-20,-64,-84,-0.0159362549800797,-0.0518218623481781,-0.0669322709163347
"2399","2017","경기","포천시","초등학교",2017-04-01,"여자",566,600,598,-2,-32,-34,-0.00333333333333333,-0.0535117056856187,-0.0566666666666667
"2400","2017","경기","포천시","초등학교",2017-04-01,"남자",605,655,637,-18,-32,-50,-0.0274809160305344,-0.0502354788069074,-0.0763358778625954
"2401","2017","경기","가평군","초등학교",2017-04-01,"전체",459,457,471,14,-12,2,0.0306345733041575,-0.0254777070063694,0.00437636761487965
"2402","2017","경기","가평군","초등학교",2017-04-01,"여자",221,238,241,3,-20,-17,0.0126050420168067,-0.0829875518672199,-0.0714285714285714
"2403","2017","경기","가평군","초등학교",2017-04-01,"남자",238,219,230,11,8,19,0.0502283105022831,0.0347826086956522,0.0867579908675799
"2404","2017","경기","연천군","초등학교",2017-04-01,"전체",334,377,366,-11,-32,-43,-0.0291777188328912,-0.087431693989071,-0.114058355437666
"2405","2017","경기","연천군","초등학교",2017-04-01,"여자",169,188,184,-4,-15,-19,-0.0212765957446809,-0.0815217391304348,-0.101063829787234
"2406","2017","경기","연천군","초등학교",2017-04-01,"남자",165,189,182,-7,-17,-24,-0.037037037037037,-0.0934065934065934,-0.126984126984127
"2407","2017","강원","춘천시","초등학교",2017-04-01,"전체",2485,2527,2558,31,-73,-42,0.0122675108824693,-0.0285379202501955,-0.0166204986149584
"2408","2017","강원","춘천시","초등학교",2017-04-01,"여자",1196,1228,1231,3,-35,-32,0.00244299674267101,-0.0284321689683184,-0.0260586319218241
"2409","2017","강원","춘천시","초등학교",2017-04-01,"남자",1289,1299,1327,28,-38,-10,0.0215550423402617,-0.0286360211002261,-0.00769822940723634
"2410","2017","강원","원주시","초등학교",2017-04-01,"전체",3285,3256,3391,135,-106,29,0.0414619164619165,-0.0312592155706281,0.00890663390663391
"2411","2017","강원","원주시","초등학교",2017-04-01,"여자",1636,1609,1675,66,-39,27,0.0410192666252331,-0.0232835820895522,0.016780609073959
"2412","2017","강원","원주시","초등학교",2017-04-01,"남자",1649,1647,1716,69,-67,2,0.0418943533697632,-0.039044289044289,0.00121432908318154
"2413","2017","강원","강릉시","초등학교",2017-04-01,"전체",1625,1651,1685,34,-60,-26,0.0205935796486978,-0.0356083086053412,-0.015748031496063
"2414","2017","강원","강릉시","초등학교",2017-04-01,"여자",756,804,815,11,-59,-48,0.013681592039801,-0.0723926380368098,-0.0597014925373134
"2415","2017","강원","강릉시","초등학교",2017-04-01,"남자",869,847,870,23,-1,22,0.0271546635182999,-0.00114942528735632,0.025974025974026
"2416","2017","강원","동해시","초등학교",2017-04-01,"전체",810,826,819,-7,-9,-16,-0.00847457627118644,-0.010989010989011,-0.0193704600484262
"2417","2017","강원","동해시","초등학교",2017-04-01,"여자",384,399,401,2,-17,-15,0.0050125313283208,-0.0423940149625935,-0.037593984962406
"2418","2017","강원","동해시","초등학교",2017-04-01,"남자",426,427,418,-9,8,-1,-0.0210772833723653,0.0191387559808612,-0.00234192037470726
"2419","2017","강원","태백시","초등학교",2017-04-01,"전체",397,415,418,3,-21,-18,0.0072289156626506,-0.0502392344497608,-0.0433734939759036
"2420","2017","강원","태백시","초등학교",2017-04-01,"여자",204,210,217,7,-13,-6,0.0333333333333333,-0.0599078341013825,-0.0285714285714286
"2421","2017","강원","태백시","초등학교",2017-04-01,"남자",193,205,201,-4,-8,-12,-0.0195121951219512,-0.0398009950248756,-0.0585365853658537
"2422","2017","강원","속초시","초등학교",2017-04-01,"전체",666,694,692,-2,-26,-28,-0.00288184438040346,-0.0375722543352601,-0.0403458213256484
"2423","2017","강원","속초시","초등학교",2017-04-01,"여자",350,343,344,1,6,7,0.00291545189504373,0.0174418604651163,0.0204081632653061
"2424","2017","강원","속초시","초등학교",2017-04-01,"남자",316,351,348,-3,-32,-35,-0.00854700854700855,-0.0919540229885057,-0.0997150997150997
"2425","2017","강원","삼척시","초등학교",2017-04-01,"전체",464,506,507,1,-43,-42,0.00197628458498024,-0.0848126232741617,-0.08300395256917
"2426","2017","강원","삼척시","초등학교",2017-04-01,"여자",228,248,250,2,-22,-20,0.00806451612903226,-0.088,-0.0806451612903226
"2427","2017","강원","삼척시","초등학교",2017-04-01,"남자",236,258,257,-1,-21,-22,-0.00387596899224806,-0.0817120622568093,-0.0852713178294574
"2428","2017","강원","홍천군","초등학교",2017-04-01,"전체",495,506,497,-9,-2,-11,-0.0177865612648221,-0.00402414486921529,-0.0217391304347826
"2429","2017","강원","홍천군","초등학교",2017-04-01,"여자",255,248,250,2,5,7,0.00806451612903226,0.02,0.0282258064516129
"2430","2017","강원","홍천군","초등학교",2017-04-01,"남자",240,258,247,-11,-7,-18,-0.0426356589147287,-0.0283400809716599,-0.0697674418604651
"2431","2017","강원","횡성군","초등학교",2017-04-01,"전체",255,269,266,-3,-11,-14,-0.0111524163568773,-0.0413533834586466,-0.0520446096654275
"2432","2017","강원","횡성군","초등학교",2017-04-01,"여자",129,134,129,-5,0,-5,-0.0373134328358209,0,-0.0373134328358209
"2433","2017","강원","횡성군","초등학교",2017-04-01,"남자",126,135,137,2,-11,-9,0.0148148148148148,-0.0802919708029197,-0.0666666666666667
"2434","2017","강원","영월군","초등학교",2017-04-01,"전체",221,230,239,9,-18,-9,0.0391304347826087,-0.0753138075313808,-0.0391304347826087
"2435","2017","강원","영월군","초등학교",2017-04-01,"여자",100,103,104,1,-4,-3,0.00970873786407767,-0.0384615384615385,-0.029126213592233
"2436","2017","강원","영월군","초등학교",2017-04-01,"남자",121,127,135,8,-14,-6,0.062992125984252,-0.103703703703704,-0.047244094488189
"2437","2017","강원","평창군","초등학교",2017-04-01,"전체",278,283,271,-12,7,-5,-0.0424028268551237,0.025830258302583,-0.0176678445229682
"2438","2017","강원","평창군","초등학교",2017-04-01,"여자",121,132,126,-6,-5,-11,-0.0454545454545455,-0.0396825396825397,-0.0833333333333333
"2439","2017","강원","평창군","초등학교",2017-04-01,"남자",157,151,145,-6,12,6,-0.0397350993377483,0.0827586206896552,0.0397350993377483
"2440","2017","강원","정선군","초등학교",2017-04-01,"전체",262,260,247,-13,15,2,-0.05,0.0607287449392713,0.00769230769230769
"2441","2017","강원","정선군","초등학교",2017-04-01,"여자",128,123,122,-1,6,5,-0.00813008130081301,0.0491803278688525,0.040650406504065
"2442","2017","강원","정선군","초등학교",2017-04-01,"남자",134,137,125,-12,9,-3,-0.0875912408759124,0.072,-0.0218978102189781
"2443","2017","강원","철원군","초등학교",2017-04-01,"전체",371,408,399,-9,-28,-37,-0.0220588235294118,-0.0701754385964912,-0.0906862745098039
"2444","2017","강원","철원군","초등학교",2017-04-01,"여자",171,186,172,-14,-1,-15,-0.0752688172043011,-0.00581395348837209,-0.0806451612903226
"2445","2017","강원","철원군","초등학교",2017-04-01,"남자",200,222,227,5,-27,-22,0.0225225225225225,-0.118942731277533,-0.0990990990990991
"2446","2017","강원","화천군","초등학교",2017-04-01,"전체",197,256,234,-22,-37,-59,-0.0859375,-0.158119658119658,-0.23046875
"2447","2017","강원","화천군","초등학교",2017-04-01,"여자",96,133,121,-12,-25,-37,-0.0902255639097744,-0.206611570247934,-0.278195488721804
"2448","2017","강원","화천군","초등학교",2017-04-01,"남자",101,123,113,-10,-12,-22,-0.0813008130081301,-0.106194690265487,-0.178861788617886
"2449","2017","강원","양구군","초등학교",2017-04-01,"전체",197,227,220,-7,-23,-30,-0.0308370044052863,-0.104545454545455,-0.13215859030837
"2450","2017","강원","양구군","초등학교",2017-04-01,"여자",104,114,109,-5,-5,-10,-0.043859649122807,-0.0458715596330275,-0.087719298245614
"2451","2017","강원","양구군","초등학교",2017-04-01,"남자",93,113,111,-2,-18,-20,-0.0176991150442478,-0.162162162162162,-0.176991150442478
"2452","2017","강원","인제군","초등학교",2017-04-01,"전체",300,333,322,-11,-22,-33,-0.033033033033033,-0.0683229813664596,-0.0990990990990991
"2453","2017","강원","인제군","초등학교",2017-04-01,"여자",137,153,152,-1,-15,-16,-0.0065359477124183,-0.0986842105263158,-0.104575163398693
"2454","2017","강원","인제군","초등학교",2017-04-01,"남자",163,180,170,-10,-7,-17,-0.0555555555555556,-0.0411764705882353,-0.0944444444444444
"2455","2017","강원","고성군","초등학교",2017-04-01,"전체",154,161,165,4,-11,-7,0.0248447204968944,-0.0666666666666667,-0.0434782608695652
"2456","2017","강원","고성군","초등학교",2017-04-01,"여자",72,66,66,0,6,6,0,0.0909090909090909,0.0909090909090909
"2457","2017","강원","고성군","초등학교",2017-04-01,"남자",82,95,99,4,-17,-13,0.0421052631578947,-0.171717171717172,-0.136842105263158
"2458","2017","강원","양양군","초등학교",2017-04-01,"전체",158,180,168,-12,-10,-22,-0.0666666666666667,-0.0595238095238095,-0.122222222222222
"2459","2017","강원","양양군","초등학교",2017-04-01,"여자",73,85,76,-9,-3,-12,-0.105882352941176,-0.0394736842105263,-0.141176470588235
"2460","2017","강원","양양군","초등학교",2017-04-01,"남자",85,95,92,-3,-7,-10,-0.0315789473684211,-0.0760869565217391,-0.105263157894737
"2461","2017","충북","청주시","초등학교",2017-04-01,"전체",8554,8935,8868,-67,-314,-381,-0.00749860100727476,-0.0354082092918358,-0.042641298265249
"2462","2017","충북","청주시","초등학교",2017-04-01,"여자",4147,4390,4361,-29,-214,-243,-0.00660592255125285,-0.049071313918826,-0.0553530751708428
"2463","2017","충북","청주시","초등학교",2017-04-01,"남자",4407,4545,4507,-38,-100,-138,-0.00836083608360836,-0.0221877080097626,-0.0303630363036304
"2464","2017","충북","충주시","초등학교",2017-04-01,"전체",1738,1759,1781,22,-43,-21,0.0125071063104036,-0.0241437394722066,-0.0119386014781126
"2465","2017","충북","충주시","초등학교",2017-04-01,"여자",864,840,850,10,14,24,0.0119047619047619,0.0164705882352941,0.0285714285714286
"2466","2017","충북","충주시","초등학교",2017-04-01,"남자",874,919,931,12,-57,-45,0.0130576713819369,-0.0612244897959184,-0.0489662676822633
"2467","2017","충북","제천시","초등학교",2017-04-01,"전체",1061,1098,1071,-27,-10,-37,-0.0245901639344262,-0.00933706816059757,-0.0336976320582878
"2468","2017","충북","제천시","초등학교",2017-04-01,"여자",550,547,540,-7,10,3,-0.0127970749542962,0.0185185185185185,0.00548446069469835
"2469","2017","충북","제천시","초등학교",2017-04-01,"남자",511,551,531,-20,-20,-40,-0.0362976406533575,-0.0376647834274953,-0.0725952813067151
"2470","2017","충북","보은군","초등학교",2017-04-01,"전체",185,185,201,16,-16,0,0.0864864864864865,-0.0796019900497512,0
"2471","2017","충북","보은군","초등학교",2017-04-01,"여자",75,81,87,6,-12,-6,0.0740740740740741,-0.137931034482759,-0.0740740740740741
"2472","2017","충북","보은군","초등학교",2017-04-01,"남자",110,104,114,10,-4,6,0.0961538461538462,-0.0350877192982456,0.0576923076923077
"2473","2017","충북","옥천군","초등학교",2017-04-01,"전체",362,392,395,3,-33,-30,0.0076530612244898,-0.0835443037974684,-0.076530612244898
"2474","2017","충북","옥천군","초등학교",2017-04-01,"여자",167,181,181,0,-14,-14,0,-0.0773480662983425,-0.0773480662983425
"2475","2017","충북","옥천군","초등학교",2017-04-01,"남자",195,211,214,3,-19,-16,0.014218009478673,-0.088785046728972,-0.0758293838862559
"2476","2017","충북","영동군","초등학교",2017-04-01,"전체",298,322,317,-5,-19,-24,-0.015527950310559,-0.0599369085173502,-0.0745341614906832
"2477","2017","충북","영동군","초등학교",2017-04-01,"여자",117,131,125,-6,-8,-14,-0.0458015267175573,-0.064,-0.106870229007634
"2478","2017","충북","영동군","초등학교",2017-04-01,"남자",181,191,192,1,-11,-10,0.00523560209424084,-0.0572916666666667,-0.0523560209424084
"2479","2017","충북","진천군","초등학교",2017-04-01,"전체",767,661,697,36,70,106,0.0544629349470499,0.100430416068867,0.16036308623298
"2480","2017","충북","진천군","초등학교",2017-04-01,"여자",375,322,341,19,34,53,0.0590062111801242,0.0997067448680352,0.164596273291925
"2481","2017","충북","진천군","초등학교",2017-04-01,"남자",392,339,356,17,36,53,0.0501474926253687,0.101123595505618,0.156342182890855
"2482","2017","충북","괴산군","초등학교",2017-04-01,"전체",190,171,165,-6,25,19,-0.0350877192982456,0.151515151515152,0.111111111111111
"2483","2017","충북","괴산군","초등학교",2017-04-01,"여자",86,77,73,-4,13,9,-0.051948051948052,0.178082191780822,0.116883116883117
"2484","2017","충북","괴산군","초등학교",2017-04-01,"남자",104,94,92,-2,12,10,-0.0212765957446809,0.130434782608696,0.106382978723404
"2485","2017","충북","음성군","초등학교",2017-04-01,"전체",823,859,871,12,-48,-36,0.0139697322467986,-0.0551090700344432,-0.0419091967403958
"2486","2017","충북","음성군","초등학교",2017-04-01,"여자",369,412,412,0,-43,-43,0,-0.104368932038835,-0.104368932038835
"2487","2017","충북","음성군","초등학교",2017-04-01,"남자",454,447,459,12,-5,7,0.0268456375838926,-0.0108932461873638,0.0156599552572707
"2488","2017","충북","단양군","초등학교",2017-04-01,"전체",152,185,184,-1,-32,-33,-0.00540540540540541,-0.173913043478261,-0.178378378378378
"2489","2017","충북","단양군","초등학교",2017-04-01,"여자",64,79,78,-1,-14,-15,-0.0126582278481013,-0.179487179487179,-0.189873417721519
"2490","2017","충북","단양군","초등학교",2017-04-01,"남자",88,106,106,0,-18,-18,0,-0.169811320754717,-0.169811320754717
"2491","2017","충북","증평군","초등학교",2017-04-01,"전체",397,413,424,11,-27,-16,0.026634382566586,-0.0636792452830189,-0.0387409200968523
"2492","2017","충북","증평군","초등학교",2017-04-01,"여자",183,204,210,6,-27,-21,0.0294117647058824,-0.128571428571429,-0.102941176470588
"2493","2017","충북","증평군","초등학교",2017-04-01,"남자",214,209,214,5,0,5,0.0239234449760766,0,0.0239234449760766
"2494","2017","충남","천안시","초등학교",2017-04-01,"전체",6857,6681,6635,-46,222,176,-0.00688519682682233,0.0334589299171063,0.0263433617721898
"2495","2017","충남","천안시","초등학교",2017-04-01,"여자",3340,3268,3245,-23,95,72,-0.00703794369645043,0.0292758089368259,0.02203182374541
"2496","2017","충남","천안시","초등학교",2017-04-01,"남자",3517,3413,3390,-23,127,104,-0.00673893934954585,0.0374631268436578,0.0304717257544682
"2497","2017","충남","공주시","초등학교",2017-04-01,"전체",749,807,789,-18,-40,-58,-0.0223048327137546,-0.0506970849176172,-0.0718711276332094
"2498","2017","충남","공주시","초등학교",2017-04-01,"여자",359,366,359,-7,0,-7,-0.0191256830601093,0,-0.0191256830601093
"2499","2017","충남","공주시","초등학교",2017-04-01,"남자",390,441,430,-11,-40,-51,-0.0249433106575964,-0.0930232558139535,-0.115646258503401
"2500","2017","충남","보령시","초등학교",2017-04-01,"전체",797,842,860,18,-63,-45,0.0213776722090261,-0.0732558139534884,-0.0534441805225653
"2501","2017","충남","보령시","초등학교",2017-04-01,"여자",385,407,410,3,-25,-22,0.00737100737100737,-0.0609756097560976,-0.0540540540540541
"2502","2017","충남","보령시","초등학교",2017-04-01,"남자",412,435,450,15,-38,-23,0.0344827586206897,-0.0844444444444444,-0.0528735632183908
"2503","2017","충남","아산시","초등학교",2017-04-01,"전체",3824,4168,4195,27,-371,-344,0.00647792706333973,-0.0884386174016687,-0.0825335892514395
"2504","2017","충남","아산시","초등학교",2017-04-01,"여자",1834,1953,1972,19,-138,-119,0.00972862263184844,-0.0699797160243408,-0.0609318996415771
"2505","2017","충남","아산시","초등학교",2017-04-01,"남자",1990,2215,2223,8,-233,-225,0.0036117381489842,-0.104813315339631,-0.101580135440181
"2506","2017","충남","서산시","초등학교",2017-04-01,"전체",1716,1849,1840,-9,-124,-133,-0.00486749594375338,-0.0673913043478261,-0.0719307733910222
"2507","2017","충남","서산시","초등학교",2017-04-01,"여자",827,891,892,1,-65,-64,0.00112233445566779,-0.0728699551569507,-0.0718294051627385
"2508","2017","충남","서산시","초등학교",2017-04-01,"남자",889,958,948,-10,-59,-69,-0.0104384133611691,-0.0622362869198312,-0.0720250521920668
"2509","2017","충남","논산시","초등학교",2017-04-01,"전체",918,911,909,-2,9,7,-0.0021953896816685,0.0099009900990099,0.00768386388583974
"2510","2017","충남","논산시","초등학교",2017-04-01,"여자",423,444,439,-5,-16,-21,-0.0112612612612613,-0.0364464692482916,-0.0472972972972973
"2511","2017","충남","논산시","초등학교",2017-04-01,"남자",495,467,470,3,25,28,0.00642398286937901,0.0531914893617021,0.0599571734475375
"2512","2017","충남","계룡시","초등학교",2017-04-01,"전체",480,459,501,42,-21,21,0.0915032679738562,-0.0419161676646707,0.0457516339869281
"2513","2017","충남","계룡시","초등학교",2017-04-01,"여자",231,225,241,16,-10,6,0.0711111111111111,-0.04149377593361,0.0266666666666667
"2514","2017","충남","계룡시","초등학교",2017-04-01,"남자",249,234,260,26,-11,15,0.111111111111111,-0.0423076923076923,0.0641025641025641
"2515","2017","충남","금산군","초등학교",2017-04-01,"전체",400,432,424,-8,-24,-32,-0.0185185185185185,-0.0566037735849057,-0.0740740740740741
"2516","2017","충남","금산군","초등학교",2017-04-01,"여자",182,193,189,-4,-7,-11,-0.0207253886010363,-0.037037037037037,-0.0569948186528497
"2517","2017","충남","금산군","초등학교",2017-04-01,"남자",218,239,235,-4,-17,-21,-0.0167364016736402,-0.0723404255319149,-0.0878661087866109
"2518","2017","충남","부여군","초등학교",2017-04-01,"전체",380,396,396,0,-16,-16,0,-0.0404040404040404,-0.0404040404040404
"2519","2017","충남","부여군","초등학교",2017-04-01,"여자",168,174,174,0,-6,-6,0,-0.0344827586206897,-0.0344827586206897
"2520","2017","충남","부여군","초등학교",2017-04-01,"남자",212,222,222,0,-10,-10,0,-0.045045045045045,-0.045045045045045
"2521","2017","충남","서천군","초등학교",2017-04-01,"전체",316,345,347,2,-31,-29,0.00579710144927536,-0.0893371757925072,-0.0840579710144927
"2522","2017","충남","서천군","초등학교",2017-04-01,"여자",162,168,176,8,-14,-6,0.0476190476190476,-0.0795454545454545,-0.0357142857142857
"2523","2017","충남","서천군","초등학교",2017-04-01,"남자",154,177,171,-6,-17,-23,-0.0338983050847458,-0.0994152046783626,-0.129943502824859
"2524","2017","충남","청양군","초등학교",2017-04-01,"전체",165,207,208,1,-43,-42,0.00483091787439614,-0.206730769230769,-0.202898550724638
"2525","2017","충남","청양군","초등학교",2017-04-01,"여자",77,101,102,1,-25,-24,0.0099009900990099,-0.245098039215686,-0.237623762376238
"2526","2017","충남","청양군","초등학교",2017-04-01,"남자",88,106,106,0,-18,-18,0,-0.169811320754717,-0.169811320754717
"2527","2017","충남","홍성군","초등학교",2017-04-01,"전체",950,795,876,81,74,155,0.10188679245283,0.0844748858447489,0.19496855345912
"2528","2017","충남","홍성군","초등학교",2017-04-01,"여자",472,387,421,34,51,85,0.0878552971576227,0.121140142517815,0.219638242894057
"2529","2017","충남","홍성군","초등학교",2017-04-01,"남자",478,408,455,47,23,70,0.115196078431373,0.0505494505494506,0.17156862745098
"2530","2017","충남","예산군","초등학교",2017-04-01,"전체",496,526,509,-17,-13,-30,-0.032319391634981,-0.0255402750491159,-0.0570342205323194
"2531","2017","충남","예산군","초등학교",2017-04-01,"여자",237,238,238,0,-1,-1,0,-0.00420168067226891,-0.00420168067226891
"2532","2017","충남","예산군","초등학교",2017-04-01,"남자",259,288,271,-17,-12,-29,-0.0590277777777778,-0.044280442804428,-0.100694444444444
"2533","2017","충남","태안군","초등학교",2017-04-01,"전체",349,379,400,21,-51,-30,0.0554089709762533,-0.1275,-0.079155672823219
"2534","2017","충남","태안군","초등학교",2017-04-01,"여자",160,181,194,13,-34,-21,0.0718232044198895,-0.175257731958763,-0.116022099447514
"2535","2017","충남","태안군","초등학교",2017-04-01,"남자",189,198,206,8,-17,-9,0.0404040404040404,-0.0825242718446602,-0.0454545454545455
"2536","2017","충남","당진시","초등학교",2017-04-01,"전체",1862,1954,1944,-10,-82,-92,-0.00511770726714432,-0.0421810699588477,-0.0470829068577277
"2537","2017","충남","당진시","초등학교",2017-04-01,"여자",873,935,937,2,-64,-62,0.00213903743315508,-0.0683030949839915,-0.0663101604278075
"2538","2017","충남","당진시","초등학교",2017-04-01,"남자",989,1019,1007,-12,-18,-30,-0.0117762512266928,-0.0178748758689176,-0.0294406280667321
"2539","2017","전북","전주시","초등학교",2017-04-01,"전체",6505,6428,6474,46,31,77,0.00715619166148102,0.0047883843064566,0.0119788425637834
"2540","2017","전북","전주시","초등학교",2017-04-01,"여자",3159,3106,3140,34,19,53,0.0109465550547328,0.00605095541401274,0.0170637475853187
"2541","2017","전북","전주시","초등학교",2017-04-01,"남자",3346,3322,3334,12,12,24,0.00361228175797712,0.00359928014397121,0.00722456351595424
"2542","2017","전북","군산시","초등학교",2017-04-01,"전체",2708,2857,2847,-10,-139,-149,-0.00350017500875044,-0.0488233227959255,-0.0521526076303815
"2543","2017","전북","군산시","초등학교",2017-04-01,"여자",1342,1399,1396,-3,-54,-57,-0.00214438884917798,-0.0386819484240688,-0.0407433881343817
"2544","2017","전북","군산시","초등학교",2017-04-01,"남자",1366,1458,1451,-7,-85,-92,-0.00480109739368999,-0.0585802894555479,-0.0631001371742112
"2545","2017","전북","익산시","초등학교",2017-04-01,"전체",2651,2733,2748,15,-97,-82,0.00548847420417124,-0.0352983988355167,-0.0300036589828028
"2546","2017","전북","익산시","초등학교",2017-04-01,"여자",1307,1385,1402,17,-95,-78,0.0122743682310469,-0.0677603423680457,-0.0563176895306859
"2547","2017","전북","익산시","초등학교",2017-04-01,"남자",1344,1348,1346,-2,-2,-4,-0.00148367952522255,-0.00148588410104012,-0.0029673590504451
"2548","2017","전북","정읍시","초등학교",2017-04-01,"전체",829,917,904,-13,-75,-88,-0.0141766630316249,-0.0829646017699115,-0.0959651035986914
"2549","2017","전북","정읍시","초등학교",2017-04-01,"여자",395,461,449,-12,-54,-66,-0.0260303687635575,-0.120267260579065,-0.143167028199566
"2550","2017","전북","정읍시","초등학교",2017-04-01,"남자",434,456,455,-1,-21,-22,-0.00219298245614035,-0.0461538461538462,-0.0482456140350877
"2551","2017","전북","남원시","초등학교",2017-04-01,"전체",686,681,702,21,-16,5,0.0308370044052863,-0.0227920227920228,0.00734214390602056
"2552","2017","전북","남원시","초등학교",2017-04-01,"여자",338,345,359,14,-21,-7,0.0405797101449275,-0.0584958217270195,-0.0202898550724638
"2553","2017","전북","남원시","초등학교",2017-04-01,"남자",348,336,343,7,5,12,0.0208333333333333,0.0145772594752187,0.0357142857142857
"2554","2017","전북","김제시","초등학교",2017-04-01,"전체",602,618,622,4,-20,-16,0.00647249190938511,-0.0321543408360129,-0.0258899676375405
"2555","2017","전북","김제시","초등학교",2017-04-01,"여자",303,321,327,6,-24,-18,0.0186915887850467,-0.073394495412844,-0.0560747663551402
"2556","2017","전북","김제시","초등학교",2017-04-01,"남자",299,297,295,-2,4,2,-0.00673400673400673,0.0135593220338983,0.00673400673400673
"2557","2017","전북","완주군","초등학교",2017-04-01,"전체",898,1015,1043,28,-145,-117,0.0275862068965517,-0.13902205177373,-0.115270935960591
"2558","2017","전북","완주군","초등학교",2017-04-01,"여자",394,476,473,-3,-79,-82,-0.00630252100840336,-0.167019027484144,-0.172268907563025
"2559","2017","전북","완주군","초등학교",2017-04-01,"남자",504,539,570,31,-66,-35,0.0575139146567718,-0.115789473684211,-0.0649350649350649
"2560","2017","전북","진안군","초등학교",2017-04-01,"전체",166,191,181,-10,-15,-25,-0.0523560209424084,-0.0828729281767956,-0.130890052356021
"2561","2017","전북","진안군","초등학교",2017-04-01,"여자",81,90,85,-5,-4,-9,-0.0555555555555556,-0.0470588235294118,-0.1
"2562","2017","전북","진안군","초등학교",2017-04-01,"남자",85,101,96,-5,-11,-16,-0.0495049504950495,-0.114583333333333,-0.158415841584158
"2563","2017","전북","무주군","초등학교",2017-04-01,"전체",164,205,204,-1,-40,-41,-0.0048780487804878,-0.196078431372549,-0.2
"2564","2017","전북","무주군","초등학교",2017-04-01,"여자",74,85,93,8,-19,-11,0.0941176470588235,-0.204301075268817,-0.129411764705882
"2565","2017","전북","무주군","초등학교",2017-04-01,"남자",90,120,111,-9,-21,-30,-0.075,-0.189189189189189,-0.25
"2566","2017","전북","장수군","초등학교",2017-04-01,"전체",165,206,205,-1,-40,-41,-0.00485436893203883,-0.195121951219512,-0.199029126213592
"2567","2017","전북","장수군","초등학교",2017-04-01,"여자",75,93,93,0,-18,-18,0,-0.193548387096774,-0.193548387096774
"2568","2017","전북","장수군","초등학교",2017-04-01,"남자",90,113,112,-1,-22,-23,-0.00884955752212389,-0.196428571428571,-0.20353982300885
"2569","2017","전북","임실군","초등학교",2017-04-01,"전체",164,175,170,-5,-6,-11,-0.0285714285714286,-0.0352941176470588,-0.0628571428571429
"2570","2017","전북","임실군","초등학교",2017-04-01,"여자",86,99,97,-2,-11,-13,-0.0202020202020202,-0.11340206185567,-0.131313131313131
"2571","2017","전북","임실군","초등학교",2017-04-01,"남자",78,76,73,-3,5,2,-0.0394736842105263,0.0684931506849315,0.0263157894736842
"2572","2017","전북","순창군","초등학교",2017-04-01,"전체",192,187,199,12,-7,5,0.0641711229946524,-0.0351758793969849,0.0267379679144385
"2573","2017","전북","순창군","초등학교",2017-04-01,"여자",88,95,103,8,-15,-7,0.0842105263157895,-0.145631067961165,-0.0736842105263158
"2574","2017","전북","순창군","초등학교",2017-04-01,"남자",104,92,96,4,8,12,0.0434782608695652,0.0833333333333333,0.130434782608696
"2575","2017","전북","고창군","초등학교",2017-04-01,"전체",348,393,392,-1,-44,-45,-0.00254452926208651,-0.112244897959184,-0.114503816793893
"2576","2017","전북","고창군","초등학교",2017-04-01,"여자",154,173,171,-2,-17,-19,-0.0115606936416185,-0.0994152046783626,-0.109826589595376
"2577","2017","전북","고창군","초등학교",2017-04-01,"남자",194,220,221,1,-27,-26,0.00454545454545455,-0.122171945701357,-0.118181818181818
"2578","2017","전북","부안군","초등학교",2017-04-01,"전체",341,377,378,1,-37,-36,0.0026525198938992,-0.0978835978835979,-0.0954907161803713
"2579","2017","전북","부안군","초등학교",2017-04-01,"여자",159,177,179,2,-20,-18,0.0112994350282486,-0.111731843575419,-0.101694915254237
"2580","2017","전북","부안군","초등학교",2017-04-01,"남자",182,200,199,-1,-17,-18,-0.005,-0.085427135678392,-0.09
"2581","2017","전남","목포시","초등학교",2017-04-01,"전체",2756,2548,2632,84,124,208,0.032967032967033,0.047112462006079,0.0816326530612245
"2582","2017","전남","목포시","초등학교",2017-04-01,"여자",1326,1244,1304,60,22,82,0.0482315112540193,0.0168711656441718,0.0659163987138264
"2583","2017","전남","목포시","초등학교",2017-04-01,"남자",1430,1304,1328,24,102,126,0.0184049079754601,0.0768072289156626,0.0966257668711656
"2584","2017","전남","여수시","초등학교",2017-04-01,"전체",2477,2724,2689,-35,-212,-247,-0.012848751835536,-0.0788397173670509,-0.0906754772393539
"2585","2017","전남","여수시","초등학교",2017-04-01,"여자",1190,1305,1289,-16,-99,-115,-0.0122605363984674,-0.0768037238169123,-0.0881226053639847
"2586","2017","전남","여수시","초등학교",2017-04-01,"남자",1287,1419,1400,-19,-113,-132,-0.0133897110641297,-0.0807142857142857,-0.0930232558139535
"2587","2017","전남","순천시","초등학교",2017-04-01,"전체",2761,2679,2795,116,-34,82,0.0432997387084733,-0.0121645796064401,0.030608435983576
"2588","2017","전남","순천시","초등학교",2017-04-01,"여자",1287,1294,1360,66,-73,-7,0.0510046367851623,-0.0536764705882353,-0.00540958268933539
"2589","2017","전남","순천시","초등학교",2017-04-01,"남자",1474,1385,1435,50,39,89,0.036101083032491,0.0271777003484321,0.0642599277978339
"2590","2017","전남","나주시","초등학교",2017-04-01,"전체",914,670,797,127,117,244,0.18955223880597,0.146800501882058,0.364179104477612
"2591","2017","전남","나주시","초등학교",2017-04-01,"여자",435,325,394,69,41,110,0.212307692307692,0.104060913705584,0.338461538461538
"2592","2017","전남","나주시","초등학교",2017-04-01,"남자",479,345,403,58,76,134,0.168115942028985,0.188585607940447,0.388405797101449
"2593","2017","전남","광양시","초등학교",2017-04-01,"전체",1652,1738,1706,-32,-54,-86,-0.0184119677790564,-0.0316529894490035,-0.049482163406214
"2594","2017","전남","광양시","초등학교",2017-04-01,"여자",786,863,842,-21,-56,-77,-0.0243337195828505,-0.0665083135391924,-0.0892236384704519
"2595","2017","전남","광양시","초등학교",2017-04-01,"남자",866,875,864,-11,2,-9,-0.0125714285714286,0.00231481481481481,-0.0102857142857143
"2596","2017","전남","담양군","초등학교",2017-04-01,"전체",269,286,280,-6,-11,-17,-0.020979020979021,-0.0392857142857143,-0.0594405594405594
"2597","2017","전남","담양군","초등학교",2017-04-01,"여자",139,146,138,-8,1,-7,-0.0547945205479452,0.0072463768115942,-0.0479452054794521
"2598","2017","전남","담양군","초등학교",2017-04-01,"남자",130,140,142,2,-12,-10,0.0142857142857143,-0.0845070422535211,-0.0714285714285714
"2599","2017","전남","곡성군","초등학교",2017-04-01,"전체",155,170,173,3,-18,-15,0.0176470588235294,-0.104046242774566,-0.0882352941176471
"2600","2017","전남","곡성군","초등학교",2017-04-01,"여자",82,88,89,1,-7,-6,0.0113636363636364,-0.0786516853932584,-0.0681818181818182
"2601","2017","전남","곡성군","초등학교",2017-04-01,"남자",73,82,84,2,-11,-9,0.024390243902439,-0.130952380952381,-0.109756097560976
"2602","2017","전남","구례군","초등학교",2017-04-01,"전체",155,152,162,10,-7,3,0.0657894736842105,-0.0432098765432099,0.0197368421052632
"2603","2017","전남","구례군","초등학교",2017-04-01,"여자",75,79,82,3,-7,-4,0.0379746835443038,-0.0853658536585366,-0.0506329113924051
"2604","2017","전남","구례군","초등학교",2017-04-01,"남자",80,73,80,7,0,7,0.0958904109589041,0,0.0958904109589041
"2605","2017","전남","고흥군","초등학교",2017-04-01,"전체",326,317,319,2,7,9,0.00630914826498423,0.0219435736677116,0.028391167192429
"2606","2017","전남","고흥군","초등학교",2017-04-01,"여자",158,150,151,1,7,8,0.00666666666666667,0.0463576158940397,0.0533333333333333
"2607","2017","전남","고흥군","초등학교",2017-04-01,"남자",168,167,168,1,0,1,0.00598802395209581,0,0.00598802395209581
"2608","2017","전남","보성군","초등학교",2017-04-01,"전체",224,321,294,-27,-70,-97,-0.0841121495327103,-0.238095238095238,-0.302180685358255
"2609","2017","전남","보성군","초등학교",2017-04-01,"여자",116,166,154,-12,-38,-50,-0.072289156626506,-0.246753246753247,-0.301204819277108
"2610","2017","전남","보성군","초등학교",2017-04-01,"남자",108,155,140,-15,-32,-47,-0.0967741935483871,-0.228571428571429,-0.303225806451613
"2611","2017","전남","화순군","초등학교",2017-04-01,"전체",450,491,473,-18,-23,-41,-0.0366598778004073,-0.0486257928118393,-0.0835030549898167
"2612","2017","전남","화순군","초등학교",2017-04-01,"여자",213,231,225,-6,-12,-18,-0.025974025974026,-0.0533333333333333,-0.0779220779220779
"2613","2017","전남","화순군","초등학교",2017-04-01,"남자",237,260,248,-12,-11,-23,-0.0461538461538462,-0.0443548387096774,-0.0884615384615385
"2614","2017","전남","장흥군","초등학교",2017-04-01,"전체",230,240,240,0,-10,-10,0,-0.0416666666666667,-0.0416666666666667
"2615","2017","전남","장흥군","초등학교",2017-04-01,"여자",120,107,107,0,13,13,0,0.121495327102804,0.121495327102804
"2616","2017","전남","장흥군","초등학교",2017-04-01,"남자",110,133,133,0,-23,-23,0,-0.172932330827068,-0.172932330827068
"2617","2017","전남","강진군","초등학교",2017-04-01,"전체",219,301,273,-28,-54,-82,-0.0930232558139535,-0.197802197802198,-0.272425249169435
"2618","2017","전남","강진군","초등학교",2017-04-01,"여자",102,144,132,-12,-30,-42,-0.0833333333333333,-0.227272727272727,-0.291666666666667
"2619","2017","전남","강진군","초등학교",2017-04-01,"남자",117,157,141,-16,-24,-40,-0.101910828025478,-0.170212765957447,-0.254777070063694
"2620","2017","전남","해남군","초등학교",2017-04-01,"전체",479,534,542,8,-63,-55,0.0149812734082397,-0.116236162361624,-0.102996254681648
"2621","2017","전남","해남군","초등학교",2017-04-01,"여자",215,272,266,-6,-51,-57,-0.0220588235294118,-0.191729323308271,-0.209558823529412
"2622","2017","전남","해남군","초등학교",2017-04-01,"남자",264,262,276,14,-12,2,0.0534351145038168,-0.0434782608695652,0.00763358778625954
"2623","2017","전남","영암군","초등학교",2017-04-01,"전체",448,577,544,-33,-96,-129,-0.0571923743500867,-0.176470588235294,-0.223570190641248
"2624","2017","전남","영암군","초등학교",2017-04-01,"여자",204,272,267,-5,-63,-68,-0.0183823529411765,-0.235955056179775,-0.25
"2625","2017","전남","영암군","초등학교",2017-04-01,"남자",244,305,277,-28,-33,-61,-0.0918032786885246,-0.11913357400722,-0.2
"2626","2017","전남","무안군","초등학교",2017-04-01,"전체",819,926,954,28,-135,-107,0.0302375809935205,-0.141509433962264,-0.115550755939525
"2627","2017","전남","무안군","초등학교",2017-04-01,"여자",412,477,485,8,-73,-65,0.0167714884696017,-0.150515463917526,-0.136268343815514
"2628","2017","전남","무안군","초등학교",2017-04-01,"남자",407,449,469,20,-62,-42,0.044543429844098,-0.132196162046908,-0.0935412026726058
"2629","2017","전남","함평군","초등학교",2017-04-01,"전체",167,240,232,-8,-65,-73,-0.0333333333333333,-0.280172413793103,-0.304166666666667
"2630","2017","전남","함평군","초등학교",2017-04-01,"여자",80,113,110,-3,-30,-33,-0.0265486725663717,-0.272727272727273,-0.292035398230089
"2631","2017","전남","함평군","초등학교",2017-04-01,"남자",87,127,122,-5,-35,-40,-0.0393700787401575,-0.286885245901639,-0.31496062992126
"2632","2017","전남","영광군","초등학교",2017-04-01,"전체",387,448,439,-9,-52,-61,-0.0200892857142857,-0.118451025056948,-0.136160714285714
"2633","2017","전남","영광군","초등학교",2017-04-01,"여자",187,238,228,-10,-41,-51,-0.0420168067226891,-0.179824561403509,-0.214285714285714
"2634","2017","전남","영광군","초등학교",2017-04-01,"남자",200,210,211,1,-11,-10,0.00476190476190476,-0.0521327014218009,-0.0476190476190476
"2635","2017","전남","장성군","초등학교",2017-04-01,"전체",339,347,351,4,-12,-8,0.0115273775216138,-0.0341880341880342,-0.0230547550432277
"2636","2017","전남","장성군","초등학교",2017-04-01,"여자",152,161,169,8,-17,-9,0.0496894409937888,-0.100591715976331,-0.0559006211180124
"2637","2017","전남","장성군","초등학교",2017-04-01,"남자",187,186,182,-4,5,1,-0.021505376344086,0.0274725274725275,0.00537634408602151
"2638","2017","전남","완도군","초등학교",2017-04-01,"전체",390,388,397,9,-7,2,0.0231958762886598,-0.017632241813602,0.00515463917525773
"2639","2017","전남","완도군","초등학교",2017-04-01,"여자",192,180,182,2,10,12,0.0111111111111111,0.0549450549450549,0.0666666666666667
"2640","2017","전남","완도군","초등학교",2017-04-01,"남자",198,208,215,7,-17,-10,0.0336538461538462,-0.0790697674418605,-0.0480769230769231
"2641","2017","전남","진도군","초등학교",2017-04-01,"전체",185,237,240,3,-55,-52,0.0126582278481013,-0.229166666666667,-0.219409282700422
"2642","2017","전남","진도군","초등학교",2017-04-01,"여자",83,120,121,1,-38,-37,0.00833333333333333,-0.31404958677686,-0.308333333333333
"2643","2017","전남","진도군","초등학교",2017-04-01,"남자",102,117,119,2,-17,-15,0.0170940170940171,-0.142857142857143,-0.128205128205128
"2644","2017","전남","신안군","초등학교",2017-04-01,"전체",160,259,245,-14,-85,-99,-0.0540540540540541,-0.346938775510204,-0.382239382239382
"2645","2017","전남","신안군","초등학교",2017-04-01,"여자",71,116,106,-10,-35,-45,-0.0862068965517241,-0.330188679245283,-0.387931034482759
"2646","2017","전남","신안군","초등학교",2017-04-01,"남자",89,143,139,-4,-50,-54,-0.027972027972028,-0.359712230215827,-0.377622377622378
"2647","2017","경북","포항시","초등학교",2017-04-01,"전체",4712,4939,4937,-2,-225,-227,-0.000404940271309982,-0.0455742353656066,-0.0459607207936829
"2648","2017","경북","포항시","초등학교",2017-04-01,"여자",2280,2375,2368,-7,-88,-95,-0.00294736842105263,-0.0371621621621622,-0.04
"2649","2017","경북","포항시","초등학교",2017-04-01,"남자",2432,2564,2569,5,-137,-132,0.00195007800312012,-0.0533281432463994,-0.0514820592823713
"2650","2017","경북","경주시","초등학교",2017-04-01,"전체",1946,2001,2021,20,-75,-55,0.00999500249875063,-0.037110341415141,-0.0274862568715642
"2651","2017","경북","경주시","초등학교",2017-04-01,"여자",954,982,992,10,-38,-28,0.010183299389002,-0.0383064516129032,-0.0285132382892057
"2652","2017","경북","경주시","초등학교",2017-04-01,"남자",992,1019,1029,10,-37,-27,0.0098135426889107,-0.0359572400388727,-0.0264965652600589
"2653","2017","경북","김천시","초등학교",2017-04-01,"전체",1130,1134,1194,60,-64,-4,0.0529100529100529,-0.0536013400335008,-0.00352733686067019
"2654","2017","경북","김천시","초등학교",2017-04-01,"여자",562,549,574,25,-12,13,0.0455373406193078,-0.0209059233449477,0.0236794171220401
"2655","2017","경북","김천시","초등학교",2017-04-01,"남자",568,585,620,35,-52,-17,0.0598290598290598,-0.0838709677419355,-0.0290598290598291
"2656","2017","경북","안동시","초등학교",2017-04-01,"전체",1407,1401,1419,18,-12,6,0.012847965738758,-0.00845665961945032,0.00428265524625268
"2657","2017","경북","안동시","초등학교",2017-04-01,"여자",664,679,688,9,-24,-15,0.0132547864506627,-0.0348837209302326,-0.0220913107511046
"2658","2017","경북","안동시","초등학교",2017-04-01,"남자",743,722,731,9,12,21,0.0124653739612188,0.0164158686730506,0.0290858725761773
"2659","2017","경북","구미시","초등학교",2017-04-01,"전체",4667,4988,4951,-37,-284,-321,-0.0074178027265437,-0.0573621490607958,-0.0643544506816359
"2660","2017","경북","구미시","초등학교",2017-04-01,"여자",2256,2346,2318,-28,-62,-90,-0.0119352088661552,-0.0267471958584987,-0.0383631713554987
"2661","2017","경북","구미시","초등학교",2017-04-01,"남자",2411,2642,2633,-9,-222,-231,-0.00340651021953066,-0.0843144701860995,-0.0874337623012869
"2662","2017","경북","영주시","초등학교",2017-04-01,"전체",830,827,822,-5,8,3,-0.0060459492140266,0.0097323600973236,0.00362756952841596
"2663","2017","경북","영주시","초등학교",2017-04-01,"여자",403,394,390,-4,13,9,-0.0101522842639594,0.0333333333333333,0.0228426395939086
"2664","2017","경북","영주시","초등학교",2017-04-01,"남자",427,433,432,-1,-5,-6,-0.0023094688221709,-0.0115740740740741,-0.0138568129330254
"2665","2017","경북","영천시","초등학교",2017-04-01,"전체",615,674,666,-8,-51,-59,-0.0118694362017804,-0.0765765765765766,-0.0875370919881306
"2666","2017","경북","영천시","초등학교",2017-04-01,"여자",291,322,318,-4,-27,-31,-0.0124223602484472,-0.0849056603773585,-0.0962732919254658
"2667","2017","경북","영천시","초등학교",2017-04-01,"남자",324,352,348,-4,-24,-28,-0.0113636363636364,-0.0689655172413793,-0.0795454545454545
"2668","2017","경북","상주시","초등학교",2017-04-01,"전체",637,680,674,-6,-37,-43,-0.00882352941176471,-0.0548961424332344,-0.0632352941176471
"2669","2017","경북","상주시","초등학교",2017-04-01,"여자",289,310,302,-8,-13,-21,-0.0258064516129032,-0.043046357615894,-0.067741935483871
"2670","2017","경북","상주시","초등학교",2017-04-01,"남자",348,370,372,2,-24,-22,0.00540540540540541,-0.0645161290322581,-0.0594594594594595
"2671","2017","경북","문경시","초등학교",2017-04-01,"전체",464,540,541,1,-77,-76,0.00185185185185185,-0.142329020332717,-0.140740740740741
"2672","2017","경북","문경시","초등학교",2017-04-01,"여자",226,266,265,-1,-39,-40,-0.0037593984962406,-0.147169811320755,-0.150375939849624
"2673","2017","경북","문경시","초등학교",2017-04-01,"남자",238,274,276,2,-38,-36,0.0072992700729927,-0.13768115942029,-0.131386861313869
"2674","2017","경북","경산시","초등학교",2017-04-01,"전체",2164,2435,2407,-28,-243,-271,-0.0114989733059548,-0.100955546323224,-0.11129363449692
"2675","2017","경북","경산시","초등학교",2017-04-01,"여자",1062,1229,1205,-24,-143,-167,-0.0195280716029292,-0.118672199170124,-0.135882831570382
"2676","2017","경북","경산시","초등학교",2017-04-01,"남자",1102,1206,1202,-4,-100,-104,-0.0033167495854063,-0.0831946755407654,-0.0862354892205638
"2677","2017","경북","군위군","초등학교",2017-04-01,"전체",78,85,85,0,-7,-7,0,-0.0823529411764706,-0.0823529411764706
"2678","2017","경북","군위군","초등학교",2017-04-01,"여자",40,42,41,-1,-1,-2,-0.0238095238095238,-0.024390243902439,-0.0476190476190476
"2679","2017","경북","군위군","초등학교",2017-04-01,"남자",38,43,44,1,-6,-5,0.0232558139534884,-0.136363636363636,-0.116279069767442
"2680","2017","경북","의성군","초등학교",2017-04-01,"전체",192,222,218,-4,-26,-30,-0.018018018018018,-0.119266055045872,-0.135135135135135
"2681","2017","경북","의성군","초등학교",2017-04-01,"여자",88,112,108,-4,-20,-24,-0.0357142857142857,-0.185185185185185,-0.214285714285714
"2682","2017","경북","의성군","초등학교",2017-04-01,"남자",104,110,110,0,-6,-6,0,-0.0545454545454545,-0.0545454545454545
"2683","2017","경북","청송군","초등학교",2017-04-01,"전체",98,110,117,7,-19,-12,0.0636363636363636,-0.162393162393162,-0.109090909090909
"2684","2017","경북","청송군","초등학교",2017-04-01,"여자",48,50,57,7,-9,-2,0.14,-0.157894736842105,-0.04
"2685","2017","경북","청송군","초등학교",2017-04-01,"남자",50,60,60,0,-10,-10,0,-0.166666666666667,-0.166666666666667
"2686","2017","경북","영양군","초등학교",2017-04-01,"전체",93,95,94,-1,-1,-2,-0.0105263157894737,-0.0106382978723404,-0.0210526315789474
"2687","2017","경북","영양군","초등학교",2017-04-01,"여자",47,38,41,3,6,9,0.0789473684210526,0.146341463414634,0.236842105263158
"2688","2017","경북","영양군","초등학교",2017-04-01,"남자",46,57,53,-4,-7,-11,-0.0701754385964912,-0.132075471698113,-0.192982456140351
"2689","2017","경북","영덕군","초등학교",2017-04-01,"전체",203,199,195,-4,8,4,-0.0201005025125628,0.041025641025641,0.0201005025125628
"2690","2017","경북","영덕군","초등학교",2017-04-01,"여자",97,104,103,-1,-6,-7,-0.00961538461538462,-0.058252427184466,-0.0673076923076923
"2691","2017","경북","영덕군","초등학교",2017-04-01,"남자",106,95,92,-3,14,11,-0.0315789473684211,0.152173913043478,0.115789473684211
"2692","2017","경북","청도군","초등학교",2017-04-01,"전체",182,218,216,-2,-34,-36,-0.00917431192660551,-0.157407407407407,-0.165137614678899
"2693","2017","경북","청도군","초등학교",2017-04-01,"여자",85,122,120,-2,-35,-37,-0.0163934426229508,-0.291666666666667,-0.30327868852459
"2694","2017","경북","청도군","초등학교",2017-04-01,"남자",97,96,96,0,1,1,0,0.0104166666666667,0.0104166666666667
"2695","2017","경북","고령군","초등학교",2017-04-01,"전체",191,208,200,-8,-9,-17,-0.0384615384615385,-0.045,-0.0817307692307692
"2696","2017","경북","고령군","초등학교",2017-04-01,"여자",92,109,102,-7,-10,-17,-0.0642201834862385,-0.0980392156862745,-0.155963302752294
"2697","2017","경북","고령군","초등학교",2017-04-01,"남자",99,99,98,-1,1,0,-0.0101010101010101,0.0102040816326531,0
"2698","2017","경북","성주군","초등학교",2017-04-01,"전체",178,232,239,7,-61,-54,0.0301724137931034,-0.255230125523013,-0.232758620689655
"2699","2017","경북","성주군","초등학교",2017-04-01,"여자",94,112,118,6,-24,-18,0.0535714285714286,-0.203389830508475,-0.160714285714286
"2700","2017","경북","성주군","초등학교",2017-04-01,"남자",84,120,121,1,-37,-36,0.00833333333333333,-0.305785123966942,-0.3
"2701","2017","경북","칠곡군","초등학교",2017-04-01,"전체",1223,1352,1315,-37,-92,-129,-0.0273668639053254,-0.0699619771863118,-0.095414201183432
"2702","2017","경북","칠곡군","초등학교",2017-04-01,"여자",572,673,656,-17,-84,-101,-0.025260029717682,-0.128048780487805,-0.150074294205052
"2703","2017","경북","칠곡군","초등학교",2017-04-01,"남자",651,679,659,-20,-8,-28,-0.0294550810014728,-0.0121396054628225,-0.0412371134020619
"2704","2017","경북","예천군","초등학교",2017-04-01,"전체",208,276,277,1,-69,-68,0.0036231884057971,-0.249097472924188,-0.246376811594203
"2705","2017","경북","예천군","초등학교",2017-04-01,"여자",100,133,139,6,-39,-33,0.0451127819548872,-0.280575539568345,-0.24812030075188
"2706","2017","경북","예천군","초등학교",2017-04-01,"남자",108,143,138,-5,-30,-35,-0.034965034965035,-0.217391304347826,-0.244755244755245
"2707","2017","경북","봉화군","초등학교",2017-04-01,"전체",177,235,228,-7,-51,-58,-0.0297872340425532,-0.223684210526316,-0.246808510638298
"2708","2017","경북","봉화군","초등학교",2017-04-01,"여자",88,121,115,-6,-27,-33,-0.0495867768595041,-0.234782608695652,-0.272727272727273
"2709","2017","경북","봉화군","초등학교",2017-04-01,"남자",89,114,113,-1,-24,-25,-0.0087719298245614,-0.212389380530973,-0.219298245614035
"2710","2017","경북","울진군","초등학교",2017-04-01,"전체",335,375,362,-13,-27,-40,-0.0346666666666667,-0.074585635359116,-0.106666666666667
"2711","2017","경북","울진군","초등학교",2017-04-01,"여자",154,195,182,-13,-28,-41,-0.0666666666666667,-0.153846153846154,-0.21025641025641
"2712","2017","경북","울진군","초등학교",2017-04-01,"남자",181,180,180,0,1,1,0,0.00555555555555556,0.00555555555555556
"2713","2017","경북","울릉군","초등학교",2017-04-01,"전체",40,55,55,0,-15,-15,0,-0.272727272727273,-0.272727272727273
"2714","2017","경북","울릉군","초등학교",2017-04-01,"여자",18,24,25,1,-7,-6,0.0416666666666667,-0.28,-0.25
"2715","2017","경북","울릉군","초등학교",2017-04-01,"남자",22,31,30,-1,-8,-9,-0.032258064516129,-0.266666666666667,-0.290322580645161
"2716","2017","경남","진주시","초등학교",2017-04-01,"전체",3352,3285,3397,112,-45,67,0.0340943683409437,-0.0132469826317339,0.0203957382039574
"2717","2017","경남","진주시","초등학교",2017-04-01,"여자",1576,1518,1580,62,-4,58,0.0408432147562582,-0.00253164556962025,0.0382081686429512
"2718","2017","경남","진주시","초등학교",2017-04-01,"남자",1776,1767,1817,50,-41,9,0.0282965478211658,-0.0225646670335718,0.00509337860780985
"2719","2017","경남","통영시","초등학교",2017-04-01,"전체",1522,1556,1566,10,-44,-34,0.006426735218509,-0.0280970625798212,-0.0218508997429306
"2720","2017","경남","통영시","초등학교",2017-04-01,"여자",733,748,754,6,-21,-15,0.00802139037433155,-0.0278514588859416,-0.0200534759358289
"2721","2017","경남","통영시","초등학교",2017-04-01,"남자",789,808,812,4,-23,-19,0.00495049504950495,-0.0283251231527094,-0.0235148514851485
"2722","2017","경남","사천시","초등학교",2017-04-01,"전체",1167,1238,1189,-49,-22,-71,-0.0395799676898223,-0.0185029436501262,-0.0573505654281099
"2723","2017","경남","사천시","초등학교",2017-04-01,"여자",548,573,546,-27,2,-25,-0.0471204188481675,0.00366300366300366,-0.043630017452007
"2724","2017","경남","사천시","초등학교",2017-04-01,"남자",619,665,643,-22,-24,-46,-0.0330827067669173,-0.0373250388802488,-0.0691729323308271
"2725","2017","경남","김해시","초등학교",2017-04-01,"전체",5886,6219,6199,-20,-313,-333,-0.00321595111754301,-0.0504920148411034,-0.0535455861070912
"2726","2017","경남","김해시","초등학교",2017-04-01,"여자",2848,2990,3000,10,-152,-142,0.00334448160535117,-0.0506666666666667,-0.0474916387959866
"2727","2017","경남","김해시","초등학교",2017-04-01,"남자",3038,3229,3199,-30,-161,-191,-0.00929080210591514,-0.050328227571116,-0.0591514400743264
"2728","2017","경남","밀양시","초등학교",2017-04-01,"전체",692,716,736,20,-44,-24,0.0279329608938547,-0.0597826086956522,-0.0335195530726257
"2729","2017","경남","밀양시","초등학교",2017-04-01,"여자",333,349,360,11,-27,-16,0.0315186246418338,-0.075,-0.0458452722063037
"2730","2017","경남","밀양시","초등학교",2017-04-01,"남자",359,367,376,9,-17,-8,0.0245231607629428,-0.0452127659574468,-0.0217983651226158
"2731","2017","경남","거제시","초등학교",2017-04-01,"전체",3305,3442,3469,27,-164,-137,0.00784427658338176,-0.0472758720092246,-0.0398024404416037
"2732","2017","경남","거제시","초등학교",2017-04-01,"여자",1631,1691,1690,-1,-59,-60,-0.000591366055588409,-0.0349112426035503,-0.0354819633353046
"2733","2017","경남","거제시","초등학교",2017-04-01,"남자",1674,1751,1779,28,-105,-77,0.0159908623643632,-0.0590219224283305,-0.0439748715019989
"2734","2017","경남","양산시","초등학교",2017-04-01,"전체",3559,3485,3566,81,-7,74,0.0232424677187948,-0.00196298373527762,0.0212338593974175
"2735","2017","경남","양산시","초등학교",2017-04-01,"여자",1759,1660,1716,56,43,99,0.0337349397590361,0.0250582750582751,0.0596385542168675
"2736","2017","경남","양산시","초등학교",2017-04-01,"남자",1800,1825,1850,25,-50,-25,0.0136986301369863,-0.027027027027027,-0.0136986301369863
"2737","2017","경남","의령군","초등학교",2017-04-01,"전체",127,173,163,-10,-36,-46,-0.0578034682080925,-0.220858895705521,-0.265895953757225
"2738","2017","경남","의령군","초등학교",2017-04-01,"여자",61,85,78,-7,-17,-24,-0.0823529411764706,-0.217948717948718,-0.282352941176471
"2739","2017","경남","의령군","초등학교",2017-04-01,"남자",66,88,85,-3,-19,-22,-0.0340909090909091,-0.223529411764706,-0.25
"2740","2017","경남","함안군","초등학교",2017-04-01,"전체",628,656,659,3,-31,-28,0.00457317073170732,-0.047040971168437,-0.0426829268292683
"2741","2017","경남","함안군","초등학교",2017-04-01,"여자",291,321,315,-6,-24,-30,-0.0186915887850467,-0.0761904761904762,-0.0934579439252336
"2742","2017","경남","함안군","초등학교",2017-04-01,"남자",337,335,344,9,-7,2,0.026865671641791,-0.0203488372093023,0.00597014925373134
"2743","2017","경남","창녕군","초등학교",2017-04-01,"전체",382,403,397,-6,-15,-21,-0.0148883374689826,-0.0377833753148615,-0.0521091811414392
"2744","2017","경남","창녕군","초등학교",2017-04-01,"여자",179,193,185,-8,-6,-14,-0.0414507772020725,-0.0324324324324324,-0.0725388601036269
"2745","2017","경남","창녕군","초등학교",2017-04-01,"남자",203,210,212,2,-9,-7,0.00952380952380952,-0.0424528301886792,-0.0333333333333333
"2746","2017","경남","고성군","초등학교",2017-04-01,"전체",397,432,425,-7,-28,-35,-0.0162037037037037,-0.0658823529411765,-0.0810185185185185
"2747","2017","경남","고성군","초등학교",2017-04-01,"여자",183,203,192,-11,-9,-20,-0.0541871921182266,-0.046875,-0.0985221674876847
"2748","2017","경남","고성군","초등학교",2017-04-01,"남자",214,229,233,4,-19,-15,0.0174672489082969,-0.0815450643776824,-0.0655021834061135
"2749","2017","경남","남해군","초등학교",2017-04-01,"전체",221,240,235,-5,-14,-19,-0.0208333333333333,-0.0595744680851064,-0.0791666666666667
"2750","2017","경남","남해군","초등학교",2017-04-01,"여자",107,103,97,-6,10,4,-0.058252427184466,0.103092783505155,0.0388349514563107
"2751","2017","경남","남해군","초등학교",2017-04-01,"남자",114,137,138,1,-24,-23,0.0072992700729927,-0.173913043478261,-0.167883211678832
"2752","2017","경남","하동군","초등학교",2017-04-01,"전체",266,310,305,-5,-39,-44,-0.0161290322580645,-0.127868852459016,-0.141935483870968
"2753","2017","경남","하동군","초등학교",2017-04-01,"여자",116,139,137,-2,-21,-23,-0.0143884892086331,-0.153284671532847,-0.165467625899281
"2754","2017","경남","하동군","초등학교",2017-04-01,"남자",150,171,168,-3,-18,-21,-0.0175438596491228,-0.107142857142857,-0.12280701754386
"2755","2017","경남","산청군","초등학교",2017-04-01,"전체",194,209,199,-10,-5,-15,-0.0478468899521531,-0.0251256281407035,-0.0717703349282297
"2756","2017","경남","산청군","초등학교",2017-04-01,"여자",86,96,82,-14,4,-10,-0.145833333333333,0.0487804878048781,-0.104166666666667
"2757","2017","경남","산청군","초등학교",2017-04-01,"남자",108,113,117,4,-9,-5,0.0353982300884956,-0.0769230769230769,-0.0442477876106195
"2758","2017","경남","함양군","초등학교",2017-04-01,"전체",253,278,282,4,-29,-25,0.0143884892086331,-0.102836879432624,-0.0899280575539568
"2759","2017","경남","함양군","초등학교",2017-04-01,"여자",111,132,131,-1,-20,-21,-0.00757575757575758,-0.152671755725191,-0.159090909090909
"2760","2017","경남","함양군","초등학교",2017-04-01,"남자",142,146,151,5,-9,-4,0.0342465753424658,-0.0596026490066225,-0.0273972602739726
"2761","2017","경남","거창군","초등학교",2017-04-01,"전체",454,443,462,19,-8,11,0.0428893905191874,-0.0173160173160173,0.0248306997742664
"2762","2017","경남","거창군","초등학교",2017-04-01,"여자",214,202,210,8,4,12,0.0396039603960396,0.019047619047619,0.0594059405940594
"2763","2017","경남","거창군","초등학교",2017-04-01,"남자",240,241,252,11,-12,-1,0.045643153526971,-0.0476190476190476,-0.004149377593361
"2764","2017","경남","합천군","초등학교",2017-04-01,"전체",165,244,241,-3,-76,-79,-0.0122950819672131,-0.315352697095436,-0.323770491803279
"2765","2017","경남","합천군","초등학교",2017-04-01,"여자",80,125,124,-1,-44,-45,-0.008,-0.354838709677419,-0.36
"2766","2017","경남","합천군","초등학교",2017-04-01,"남자",85,119,117,-2,-32,-34,-0.0168067226890756,-0.273504273504274,-0.285714285714286
"2767","2017","제주","제주시","초등학교",2017-04-01,"전체",5048,5002,5128,126,-80,46,0.0251899240303878,-0.015600624024961,0.00919632147141144
"2768","2017","제주","제주시","초등학교",2017-04-01,"여자",2419,2457,2522,65,-103,-38,0.0264550264550265,-0.0408406026962728,-0.0154660154660155
"2769","2017","제주","제주시","초등학교",2017-04-01,"남자",2629,2545,2606,61,23,84,0.0239685658153242,0.00882578664620107,0.0330058939096267
"2770","2017","제주","서귀포시","초등학교",2017-04-01,"전체",1515,1467,1604,137,-89,48,0.0933878663940014,-0.0554862842892768,0.032719836400818
"2771","2017","제주","서귀포시","초등학교",2017-04-01,"여자",746,706,765,59,-19,40,0.0835694050991501,-0.0248366013071895,0.056657223796034
"2772","2017","제주","서귀포시","초등학교",2017-04-01,"남자",769,761,839,78,-70,8,0.102496714848883,-0.0834326579261025,0.0105124835742444
"2773","2018","서울","종로구","초등학교",2018-04-01,"전체",862,885,919,34,-57,-23,0.0384180790960452,-0.0620239390642002,-0.0259887005649717
"2774","2018","서울","종로구","초등학교",2018-04-01,"여자",419,446,449,3,-30,-27,0.00672645739910314,-0.066815144766147,-0.0605381165919283
"2775","2018","서울","종로구","초등학교",2018-04-01,"남자",443,439,470,31,-27,4,0.0706150341685649,-0.0574468085106383,0.00911161731207289
"2776","2018","서울","중구","초등학교",2018-04-01,"전체",898,893,828,-65,70,5,-0.0727883538633819,0.0845410628019324,0.00559910414333707
"2777","2018","서울","중구","초등학교",2018-04-01,"여자",459,436,400,-36,59,23,-0.0825688073394495,0.1475,0.0527522935779817
"2778","2018","서울","중구","초등학교",2018-04-01,"남자",439,457,428,-29,11,-18,-0.0634573304157549,0.0257009345794393,-0.0393873085339169
"2779","2018","서울","용산구","초등학교",2018-04-01,"전체",1248,1731,1656,-75,-408,-483,-0.0433275563258232,-0.246376811594203,-0.279029462738302
"2780","2018","서울","용산구","초등학교",2018-04-01,"여자",588,855,805,-50,-217,-267,-0.0584795321637427,-0.269565217391304,-0.312280701754386
"2781","2018","서울","용산구","초등학교",2018-04-01,"남자",660,876,851,-25,-191,-216,-0.0285388127853881,-0.224441833137485,-0.246575342465753
"2782","2018","서울","성동구","초등학교",2018-04-01,"전체",2100,2368,2359,-9,-259,-268,-0.00380067567567568,-0.109792284866469,-0.113175675675676
"2783","2018","서울","성동구","초등학교",2018-04-01,"여자",1031,1165,1155,-10,-124,-134,-0.00858369098712446,-0.107359307359307,-0.115021459227468
"2784","2018","서울","성동구","초등학교",2018-04-01,"남자",1069,1203,1204,1,-135,-134,0.000831255195344971,-0.112126245847176,-0.111388196176226
"2785","2018","서울","광진구","초등학교",2018-04-01,"전체",2480,2522,2438,-84,42,-42,-0.0333068992862807,0.0172272354388843,-0.0166534496431404
"2786","2018","서울","광진구","초등학교",2018-04-01,"여자",1232,1242,1209,-33,23,-10,-0.0265700483091787,0.0190239867659222,-0.00805152979066022
"2787","2018","서울","광진구","초등학교",2018-04-01,"남자",1248,1280,1229,-51,19,-32,-0.03984375,0.015459723352319,-0.025
"2788","2018","서울","동대문구","초등학교",2018-04-01,"전체",2284,2645,2505,-140,-221,-361,-0.052930056710775,-0.0882235528942116,-0.13648393194707
"2789","2018","서울","동대문구","초등학교",2018-04-01,"여자",1116,1280,1225,-55,-109,-164,-0.04296875,-0.0889795918367347,-0.128125
"2790","2018","서울","동대문구","초등학교",2018-04-01,"남자",1168,1365,1280,-85,-112,-197,-0.0622710622710623,-0.0875,-0.144322344322344
"2791","2018","서울","중랑구","초등학교",2018-04-01,"전체",2647,3106,2999,-107,-352,-459,-0.0344494526722473,-0.117372457485829,-0.147778493238892
"2792","2018","서울","중랑구","초등학교",2018-04-01,"여자",1279,1486,1427,-59,-148,-207,-0.0397039030955585,-0.103714085494043,-0.139300134589502
"2793","2018","서울","중랑구","초등학교",2018-04-01,"남자",1368,1620,1572,-48,-204,-252,-0.0296296296296296,-0.129770992366412,-0.155555555555556
"2794","2018","서울","성북구","초등학교",2018-04-01,"전체",3604,3712,3633,-79,-29,-108,-0.0212823275862069,-0.00798238370492706,-0.0290948275862069
"2795","2018","서울","성북구","초등학교",2018-04-01,"여자",1745,1775,1738,-37,7,-30,-0.0208450704225352,0.00402761795166858,-0.0169014084507042
"2796","2018","서울","성북구","초등학교",2018-04-01,"남자",1859,1937,1895,-42,-36,-78,-0.0216830149716056,-0.0189973614775726,-0.0402684563758389
"2797","2018","서울","강북구","초등학교",2018-04-01,"전체",1753,2333,2244,-89,-491,-580,-0.0381483069009859,-0.218805704099822,-0.248606943849121
"2798","2018","서울","강북구","초등학교",2018-04-01,"여자",856,1142,1098,-44,-242,-286,-0.0385288966725044,-0.22040072859745,-0.250437828371278
"2799","2018","서울","강북구","초등학교",2018-04-01,"남자",897,1191,1146,-45,-249,-294,-0.0377833753148615,-0.217277486910995,-0.246851385390428
"2800","2018","서울","도봉구","초등학교",2018-04-01,"전체",2572,2659,2563,-96,9,-87,-0.0361037984204588,0.00351150994927819,-0.0327190673185408
"2801","2018","서울","도봉구","초등학교",2018-04-01,"여자",1259,1286,1247,-39,12,-27,-0.0303265940902022,0.00962309542902967,-0.02099533437014
"2802","2018","서울","도봉구","초등학교",2018-04-01,"남자",1313,1373,1316,-57,-3,-60,-0.0415149308084487,-0.00227963525835866,-0.0436999271667881
"2803","2018","서울","노원구","초등학교",2018-04-01,"전체",4236,4382,4265,-117,-29,-146,-0.0267001369237791,-0.00679953106682298,-0.0333181195801004
"2804","2018","서울","노원구","초등학교",2018-04-01,"여자",2090,2166,2104,-62,-14,-76,-0.0286241920590951,-0.00665399239543726,-0.0350877192982456
"2805","2018","서울","노원구","초등학교",2018-04-01,"남자",2146,2216,2161,-55,-15,-70,-0.0248194945848375,-0.00694123091161499,-0.0315884476534296
"2806","2018","서울","은평구","초등학교",2018-04-01,"전체",3569,3985,3853,-132,-284,-416,-0.0331242158092848,-0.0737087983389567,-0.104391468005019
"2807","2018","서울","은평구","초등학교",2018-04-01,"여자",1732,1921,1853,-68,-121,-189,-0.0353982300884956,-0.0652995143011333,-0.0983862571577303
"2808","2018","서울","은평구","초등학교",2018-04-01,"남자",1837,2064,2000,-64,-163,-227,-0.0310077519379845,-0.0815,-0.109980620155039
"2809","2018","서울","서대문구","초등학교",2018-04-01,"전체",2140,2292,2239,-53,-99,-152,-0.0231239092495637,-0.0442161679321125,-0.0663176265270506
"2810","2018","서울","서대문구","초등학교",2018-04-01,"여자",1086,1132,1117,-15,-31,-46,-0.0132508833922261,-0.0277529095792301,-0.0406360424028269
"2811","2018","서울","서대문구","초등학교",2018-04-01,"남자",1054,1160,1122,-38,-68,-106,-0.0327586206896552,-0.0606060606060606,-0.0913793103448276
"2812","2018","서울","마포구","초등학교",2018-04-01,"전체",2458,2999,2867,-132,-409,-541,-0.0440146715571857,-0.142657830484827,-0.180393464488163
"2813","2018","서울","마포구","초등학교",2018-04-01,"여자",1235,1473,1404,-69,-169,-238,-0.0468431771894094,-0.12037037037037,-0.161575016972166
"2814","2018","서울","마포구","초등학교",2018-04-01,"남자",1223,1526,1463,-63,-240,-303,-0.0412844036697248,-0.164046479835954,-0.198558322411533
"2815","2018","서울","양천구","초등학교",2018-04-01,"전체",3736,3710,3772,62,-36,26,0.016711590296496,-0.0095440084835631,0.00700808625336927
"2816","2018","서울","양천구","초등학교",2018-04-01,"여자",1771,1749,1777,28,-6,22,0.0160091480846198,-0.00337647720877884,0.0125786163522013
"2817","2018","서울","양천구","초등학교",2018-04-01,"남자",1965,1961,1995,34,-30,4,0.0173380928097909,-0.0150375939849624,0.00203977562468129
"2818","2018","서울","강서구","초등학교",2018-04-01,"전체",4816,5319,5161,-158,-345,-503,-0.0297048317352886,-0.0668475101724472,-0.0945666478661402
"2819","2018","서울","강서구","초등학교",2018-04-01,"여자",2356,2551,2465,-86,-109,-195,-0.0337122696981576,-0.0442190669371197,-0.0764406115248922
"2820","2018","서울","강서구","초등학교",2018-04-01,"남자",2460,2768,2696,-72,-236,-308,-0.0260115606936416,-0.0875370919881306,-0.111271676300578
"2821","2018","서울","구로구","초등학교",2018-04-01,"전체",3320,3929,3724,-205,-404,-609,-0.0521761262407737,-0.108485499462943,-0.155001272588445
"2822","2018","서울","구로구","초등학교",2018-04-01,"여자",1636,1916,1826,-90,-190,-280,-0.046972860125261,-0.104052573932092,-0.146137787056367
"2823","2018","서울","구로구","초등학교",2018-04-01,"남자",1684,2013,1898,-115,-214,-329,-0.0571286636860407,-0.112750263435195,-0.163437655240934
"2824","2018","서울","금천구","초등학교",2018-04-01,"전체",1561,1617,1606,-11,-45,-56,-0.00680272108843537,-0.0280199252801993,-0.0346320346320346
"2825","2018","서울","금천구","초등학교",2018-04-01,"여자",775,777,785,8,-10,-2,0.0102960102960103,-0.0127388535031847,-0.00257400257400257
"2826","2018","서울","금천구","초등학교",2018-04-01,"남자",786,840,821,-19,-35,-54,-0.0226190476190476,-0.0426309378806334,-0.0642857142857143
"2827","2018","서울","영등포구","초등학교",2018-04-01,"전체",2457,3003,2784,-219,-327,-546,-0.0729270729270729,-0.117456896551724,-0.181818181818182
"2828","2018","서울","영등포구","초등학교",2018-04-01,"여자",1270,1532,1420,-112,-150,-262,-0.0731070496083551,-0.105633802816901,-0.171018276762402
"2829","2018","서울","영등포구","초등학교",2018-04-01,"남자",1187,1471,1364,-107,-177,-284,-0.0727396329027872,-0.129765395894428,-0.19306594153637
"2830","2018","서울","동작구","초등학교",2018-04-01,"전체",2801,3244,3159,-85,-358,-443,-0.0262022194821208,-0.113327002215891,-0.1365598027127
"2831","2018","서울","동작구","초등학교",2018-04-01,"여자",1382,1570,1527,-43,-145,-188,-0.0273885350318471,-0.0949574328749181,-0.119745222929936
"2832","2018","서울","동작구","초등학교",2018-04-01,"남자",1419,1674,1632,-42,-213,-255,-0.025089605734767,-0.130514705882353,-0.152329749103943
"2833","2018","서울","관악구","초등학교",2018-04-01,"전체",2687,3439,3228,-211,-541,-752,-0.0613550450712416,-0.167596034696406,-0.218668217505089
"2834","2018","서울","관악구","초등학교",2018-04-01,"여자",1294,1691,1595,-96,-301,-397,-0.0567711413364873,-0.18871473354232,-0.234772324068598
"2835","2018","서울","관악구","초등학교",2018-04-01,"남자",1393,1748,1633,-115,-240,-355,-0.0657894736842105,-0.146968769136558,-0.203089244851259
"2836","2018","서울","서초구","초등학교",2018-04-01,"전체",3861,4223,4301,78,-440,-362,0.0184702817901965,-0.10230179028133,-0.0857210513852711
"2837","2018","서울","서초구","초등학교",2018-04-01,"여자",1843,2003,2045,42,-202,-160,0.0209685471792312,-0.0987775061124694,-0.0798801797304044
"2838","2018","서울","서초구","초등학교",2018-04-01,"남자",2018,2220,2256,36,-238,-202,0.0162162162162162,-0.105496453900709,-0.090990990990991
"2839","2018","서울","강남구","초등학교",2018-04-01,"전체",3938,4414,4425,11,-487,-476,0.00249207068418668,-0.110056497175141,-0.107838695061169
"2840","2018","서울","강남구","초등학교",2018-04-01,"여자",1882,2142,2154,12,-272,-260,0.00560224089635854,-0.12627669452182,-0.121381886087768
"2841","2018","서울","강남구","초등학교",2018-04-01,"남자",2056,2272,2271,-1,-215,-216,-0.000440140845070423,-0.0946719506825187,-0.0950704225352113
"2842","2018","서울","송파구","초등학교",2018-04-01,"전체",5216,5696,5761,65,-545,-480,0.0114115168539326,-0.0946016316611699,-0.0842696629213483
"2843","2018","서울","송파구","초등학교",2018-04-01,"여자",2499,2745,2783,38,-284,-246,0.0138433515482696,-0.10204814947898,-0.0896174863387978
"2844","2018","서울","송파구","초등학교",2018-04-01,"남자",2717,2951,2978,27,-261,-234,0.00914944086750254,-0.0876427132303559,-0.079295154185022
"2845","2018","서울","강동구","초등학교",2018-04-01,"전체",3210,3644,3615,-29,-405,-434,-0.0079582875960483,-0.112033195020747,-0.119099890230516
"2846","2018","서울","강동구","초등학교",2018-04-01,"여자",1513,1777,1763,-14,-250,-264,-0.00787844682048396,-0.141803743618832,-0.148564997186269
"2847","2018","서울","강동구","초등학교",2018-04-01,"남자",1697,1867,1852,-15,-155,-170,-0.00803427959292983,-0.0836933045356372,-0.0910551687198714
"2848","2018","부산","중구","초등학교",2018-04-01,"전체",229,234,221,-13,8,-5,-0.0555555555555556,0.0361990950226244,-0.0213675213675214
"2849","2018","부산","중구","초등학교",2018-04-01,"여자",114,106,106,0,8,8,0,0.0754716981132075,0.0754716981132075
"2850","2018","부산","중구","초등학교",2018-04-01,"남자",115,128,115,-13,0,-13,-0.1015625,0,-0.1015625
"2851","2018","부산","서구","초등학교",2018-04-01,"전체",615,655,648,-7,-33,-40,-0.0106870229007634,-0.0509259259259259,-0.0610687022900763
"2852","2018","부산","서구","초등학교",2018-04-01,"여자",292,322,316,-6,-24,-30,-0.0186335403726708,-0.0759493670886076,-0.093167701863354
"2853","2018","부산","서구","초등학교",2018-04-01,"남자",323,333,332,-1,-9,-10,-0.003003003003003,-0.0271084337349398,-0.03003003003003
"2854","2018","부산","동구","초등학교",2018-04-01,"전체",435,518,506,-12,-71,-83,-0.0231660231660232,-0.140316205533597,-0.16023166023166
"2855","2018","부산","동구","초등학교",2018-04-01,"여자",212,259,245,-14,-33,-47,-0.0540540540540541,-0.13469387755102,-0.181467181467181
"2856","2018","부산","동구","초등학교",2018-04-01,"남자",223,259,261,2,-38,-36,0.00772200772200772,-0.145593869731801,-0.138996138996139
"2857","2018","부산","영도구","초등학교",2018-04-01,"전체",686,723,712,-11,-26,-37,-0.0152143845089903,-0.0365168539325843,-0.0511756569847856
"2858","2018","부산","영도구","초등학교",2018-04-01,"여자",365,357,360,3,5,8,0.00840336134453781,0.0138888888888889,0.0224089635854342
"2859","2018","부산","영도구","초등학교",2018-04-01,"남자",321,366,352,-14,-31,-45,-0.0382513661202186,-0.0880681818181818,-0.122950819672131
"2860","2018","부산","부산진구","초등학교",2018-04-01,"전체",2659,2798,2705,-93,-46,-139,-0.0332380271622588,-0.0170055452865065,-0.0496783416726233
"2861","2018","부산","부산진구","초등학교",2018-04-01,"여자",1367,1408,1355,-53,12,-41,-0.0376420454545455,0.00885608856088561,-0.0291193181818182
"2862","2018","부산","부산진구","초등학교",2018-04-01,"남자",1292,1390,1350,-40,-58,-98,-0.0287769784172662,-0.042962962962963,-0.0705035971223022
"2863","2018","부산","동래구","초등학교",2018-04-01,"전체",2004,2036,2155,119,-151,-32,0.0584479371316306,-0.0700696055684455,-0.0157170923379175
"2864","2018","부산","동래구","초등학교",2018-04-01,"여자",972,997,1055,58,-83,-25,0.0581745235707121,-0.0786729857819905,-0.0250752256770311
"2865","2018","부산","동래구","초등학교",2018-04-01,"남자",1032,1039,1100,61,-68,-7,0.0587102983638114,-0.0618181818181818,-0.00673724735322425
"2866","2018","부산","남구","초등학교",2018-04-01,"전체",2139,2233,2198,-35,-59,-94,-0.0156739811912226,-0.0268425841674249,-0.0420958351992835
"2867","2018","부산","남구","초등학교",2018-04-01,"여자",1046,1129,1106,-23,-60,-83,-0.0203720106288751,-0.054249547920434,-0.0735163861824624
"2868","2018","부산","남구","초등학교",2018-04-01,"남자",1093,1104,1092,-12,1,-11,-0.0108695652173913,0.000915750915750916,-0.00996376811594203
"2869","2018","부산","북구","초등학교",2018-04-01,"전체",2224,2507,2435,-72,-211,-283,-0.0287195851615477,-0.086652977412731,-0.112883925009972
"2870","2018","부산","북구","초등학교",2018-04-01,"여자",1083,1216,1193,-23,-110,-133,-0.0189144736842105,-0.0922045264040235,-0.109375
"2871","2018","부산","북구","초등학교",2018-04-01,"남자",1141,1291,1242,-49,-101,-150,-0.0379550735863672,-0.0813204508856683,-0.116189000774593
"2872","2018","부산","해운대구","초등학교",2018-04-01,"전체",3294,3610,3578,-32,-284,-316,-0.00886426592797784,-0.0793739519284516,-0.0875346260387812
"2873","2018","부산","해운대구","초등학교",2018-04-01,"여자",1584,1735,1718,-17,-134,-151,-0.00979827089337176,-0.0779976717112922,-0.0870317002881844
"2874","2018","부산","해운대구","초등학교",2018-04-01,"남자",1710,1875,1860,-15,-150,-165,-0.008,-0.0806451612903226,-0.088
"2875","2018","부산","사하구","초등학교",2018-04-01,"전체",2577,2800,2742,-58,-165,-223,-0.0207142857142857,-0.0601750547045952,-0.0796428571428571
"2876","2018","부산","사하구","초등학교",2018-04-01,"여자",1267,1358,1331,-27,-64,-91,-0.0198821796759941,-0.048084147257701,-0.0670103092783505
"2877","2018","부산","사하구","초등학교",2018-04-01,"남자",1310,1442,1411,-31,-101,-132,-0.021497919556172,-0.0715804394046775,-0.0915395284327323
"2878","2018","부산","금정구","초등학교",2018-04-01,"전체",1709,1642,1644,2,65,67,0.00121802679658952,0.0395377128953771,0.0408038976857491
"2879","2018","부산","금정구","초등학교",2018-04-01,"여자",850,777,786,9,64,73,0.0115830115830116,0.0814249363867685,0.093951093951094
"2880","2018","부산","금정구","초등학교",2018-04-01,"남자",859,865,858,-7,1,-6,-0.00809248554913295,0.00116550116550117,-0.0069364161849711
"2881","2018","부산","강서구","초등학교",2018-04-01,"전체",1750,1487,1695,208,55,263,0.139878950907868,0.0324483775811209,0.176866173503699
"2882","2018","부산","강서구","초등학교",2018-04-01,"여자",863,736,831,95,32,127,0.129076086956522,0.0385078219013237,0.172554347826087
"2883","2018","부산","강서구","초등학교",2018-04-01,"남자",887,751,864,113,23,136,0.150466045272969,0.0266203703703704,0.181091877496671
"2884","2018","부산","연제구","초등학교",2018-04-01,"전체",1675,1687,1678,-9,-3,-12,-0.00533491404860699,-0.00178784266984505,-0.00711321873147599
"2885","2018","부산","연제구","초등학교",2018-04-01,"여자",790,834,827,-7,-37,-44,-0.00839328537170264,-0.0447400241837969,-0.052757793764988
"2886","2018","부산","연제구","초등학교",2018-04-01,"남자",885,853,851,-2,34,32,-0.00234466588511137,0.0399529964747356,0.0375146541617819
"2887","2018","부산","수영구","초등학교",2018-04-01,"전체",1089,1176,1165,-11,-76,-87,-0.00935374149659864,-0.0652360515021459,-0.0739795918367347
"2888","2018","부산","수영구","초등학교",2018-04-01,"여자",534,569,561,-8,-27,-35,-0.0140597539543058,-0.0481283422459893,-0.0615114235500879
"2889","2018","부산","수영구","초등학교",2018-04-01,"남자",555,607,604,-3,-49,-52,-0.00494233937397035,-0.0811258278145695,-0.085667215815486
"2890","2018","부산","사상구","초등학교",2018-04-01,"전체",1434,1821,1738,-83,-304,-387,-0.0455793520043932,-0.174913693901036,-0.212520593080725
"2891","2018","부산","사상구","초등학교",2018-04-01,"여자",686,871,837,-34,-151,-185,-0.0390355912743972,-0.180406212664277,-0.21239954075775
"2892","2018","부산","사상구","초등학교",2018-04-01,"남자",748,950,901,-49,-153,-202,-0.0515789473684211,-0.169811320754717,-0.212631578947368
"2893","2018","부산","기장군","초등학교",2018-04-01,"전체",2106,2160,2156,-4,-50,-54,-0.00185185185185185,-0.023191094619666,-0.025
"2894","2018","부산","기장군","초등학교",2018-04-01,"여자",1032,1043,1030,-13,2,-11,-0.012464046021093,0.00194174757281553,-0.0105465004793864
"2895","2018","부산","기장군","초등학교",2018-04-01,"남자",1074,1117,1126,9,-52,-43,0.00805729632945389,-0.0461811722912966,-0.0384959713518353
"2896","2018","대구","중구","초등학교",2018-04-01,"전체",797,581,563,-18,234,216,-0.0309810671256454,0.41563055062167,0.371772805507745
"2897","2018","대구","중구","초등학교",2018-04-01,"여자",381,271,254,-17,127,110,-0.0627306273062731,0.5,0.40590405904059
"2898","2018","대구","중구","초등학교",2018-04-01,"남자",416,310,309,-1,107,106,-0.0032258064516129,0.346278317152104,0.341935483870968
"2899","2018","대구","동구","초등학교",2018-04-01,"전체",3015,3311,3246,-65,-231,-296,-0.0196315312594382,-0.0711645101663586,-0.0893989731199034
"2900","2018","대구","동구","초등학교",2018-04-01,"여자",1436,1594,1553,-41,-117,-158,-0.0257214554579674,-0.0753380553766903,-0.0991217063989962
"2901","2018","대구","동구","초등학교",2018-04-01,"남자",1579,1717,1693,-24,-114,-138,-0.0139778683750728,-0.067336089781453,-0.0803727431566686
"2902","2018","대구","서구","초등학교",2018-04-01,"전체",1018,1209,1110,-99,-92,-191,-0.0818858560794045,-0.0828828828828829,-0.157981803143093
"2903","2018","대구","서구","초등학교",2018-04-01,"여자",487,589,536,-53,-49,-102,-0.0899830220713073,-0.0914179104477612,-0.173174872665535
"2904","2018","대구","서구","초등학교",2018-04-01,"남자",531,620,574,-46,-43,-89,-0.0741935483870968,-0.0749128919860627,-0.143548387096774
"2905","2018","대구","남구","초등학교",2018-04-01,"전체",732,954,885,-69,-153,-222,-0.0723270440251572,-0.172881355932203,-0.232704402515723
"2906","2018","대구","남구","초등학교",2018-04-01,"여자",343,466,419,-47,-76,-123,-0.100858369098712,-0.181384248210024,-0.263948497854077
"2907","2018","대구","남구","초등학교",2018-04-01,"남자",389,488,466,-22,-77,-99,-0.0450819672131148,-0.165236051502146,-0.202868852459016
"2908","2018","대구","북구","초등학교",2018-04-01,"전체",3807,4099,4050,-49,-243,-292,-0.0119541351549158,-0.06,-0.0712368870456209
"2909","2018","대구","북구","초등학교",2018-04-01,"여자",1864,1954,1946,-8,-82,-90,-0.00409416581371546,-0.0421377183967112,-0.0460593654042989
"2910","2018","대구","북구","초등학교",2018-04-01,"남자",1943,2145,2104,-41,-161,-202,-0.0191142191142191,-0.0765209125475285,-0.0941724941724942
"2911","2018","대구","수성구","초등학교",2018-04-01,"전체",3553,3462,3616,154,-63,91,0.0444829578278452,-0.0174225663716814,0.0262853841709994
"2912","2018","대구","수성구","초등학교",2018-04-01,"여자",1775,1730,1806,76,-31,45,0.0439306358381503,-0.0171650055370986,0.0260115606936416
"2913","2018","대구","수성구","초등학교",2018-04-01,"남자",1778,1732,1810,78,-32,46,0.0450346420323326,-0.0176795580110497,0.0265588914549654
"2914","2018","대구","달서구","초등학교",2018-04-01,"전체",5249,5315,5267,-48,-18,-66,-0.0090310442144873,-0.00341750522118853,-0.01241768579492
"2915","2018","대구","달서구","초등학교",2018-04-01,"여자",2613,2618,2627,9,-14,-5,0.00343773873185638,-0.00532927293490674,-0.00190985485103132
"2916","2018","대구","달서구","초등학교",2018-04-01,"남자",2636,2697,2640,-57,-4,-61,-0.0211345939933259,-0.00151515151515152,-0.0226177233963663
"2917","2018","대구","달성군","초등학교",2018-04-01,"전체",2910,2470,2870,400,40,440,0.161943319838057,0.0139372822299652,0.178137651821862
"2918","2018","대구","달성군","초등학교",2018-04-01,"여자",1400,1214,1408,194,-8,186,0.159802306425041,-0.00568181818181818,0.153212520593081
"2919","2018","대구","달성군","초등학교",2018-04-01,"남자",1510,1256,1462,206,48,254,0.164012738853503,0.0328317373461012,0.202229299363057
"2920","2018","인천","중구","초등학교",2018-04-01,"전체",1345,1262,1221,-41,124,83,-0.0324881141045959,0.101556101556102,0.0657686212361331
"2921","2018","인천","중구","초등학교",2018-04-01,"여자",655,623,602,-21,53,32,-0.0337078651685393,0.0880398671096345,0.0513643659711075
"2922","2018","인천","중구","초등학교",2018-04-01,"남자",690,639,619,-20,71,51,-0.0312989045383412,0.11470113085622,0.07981220657277
"2923","2018","인천","동구","초등학교",2018-04-01,"전체",663,641,624,-17,39,22,-0.0265210608424337,0.0625,0.0343213728549142
"2924","2018","인천","동구","초등학교",2018-04-01,"여자",318,318,310,-8,8,0,-0.0251572327044025,0.0258064516129032,0
"2925","2018","인천","동구","초등학교",2018-04-01,"남자",345,323,314,-9,31,22,-0.0278637770897833,0.0987261146496815,0.0681114551083591
"2926","2018","인천","남구","초등학교",2018-04-01,"전체",3200,3384,3525,141,-325,-184,0.0416666666666667,-0.0921985815602837,-0.0543735224586288
"2927","2018","인천","남구","초등학교",2018-04-01,"여자",1526,1589,1657,68,-131,-63,0.0427942101950913,-0.0790585395292698,-0.039647577092511
"2928","2018","인천","남구","초등학교",2018-04-01,"남자",1674,1795,1868,73,-194,-121,0.0406685236768802,-0.103854389721627,-0.0674094707520891
"2929","2018","인천","연수구","초등학교",2018-04-01,"전체",3667,3326,3540,214,127,341,0.0643415514131088,0.0358757062146893,0.102525556223692
"2930","2018","인천","연수구","초등학교",2018-04-01,"여자",1794,1622,1730,108,64,172,0.0665844636251541,0.0369942196531792,0.106041923551171
"2931","2018","인천","연수구","초등학교",2018-04-01,"남자",1873,1704,1810,106,63,169,0.0622065727699531,0.0348066298342541,0.0991784037558685
"2932","2018","인천","남동구","초등학교",2018-04-01,"전체",5242,5536,5459,-77,-217,-294,-0.0139089595375723,-0.0397508701227331,-0.053106936416185
"2933","2018","인천","남동구","초등학교",2018-04-01,"여자",2546,2705,2662,-43,-116,-159,-0.0158964879852126,-0.0435762584522915,-0.0587800369685767
"2934","2018","인천","남동구","초등학교",2018-04-01,"남자",2696,2831,2797,-34,-101,-135,-0.0120098904980572,-0.0361101179835538,-0.0476863299187566
"2935","2018","인천","부평구","초등학교",2018-04-01,"전체",4209,4833,4644,-189,-435,-624,-0.0391061452513966,-0.0936692506459948,-0.12911235257604
"2936","2018","인천","부평구","초등학교",2018-04-01,"여자",2038,2393,2303,-90,-265,-355,-0.0376096949435855,-0.115067303517152,-0.148349352277476
"2937","2018","인천","부평구","초등학교",2018-04-01,"남자",2171,2440,2341,-99,-170,-269,-0.0405737704918033,-0.0726185390858607,-0.110245901639344
"2938","2018","인천","계양구","초등학교",2018-04-01,"전체",2606,2946,2804,-142,-198,-340,-0.0482009504412763,-0.0706134094151213,-0.11541072640869
"2939","2018","인천","계양구","초등학교",2018-04-01,"여자",1287,1441,1384,-57,-97,-154,-0.0395558639833449,-0.0700867052023121,-0.106870229007634
"2940","2018","인천","계양구","초등학교",2018-04-01,"남자",1319,1505,1420,-85,-101,-186,-0.0564784053156146,-0.0711267605633803,-0.12358803986711
"2941","2018","인천","서구","초등학교",2018-04-01,"전체",5863,5879,5782,-97,81,-16,-0.0164994046606566,0.0140089934278796,-0.00272155128423201
"2942","2018","인천","서구","초등학교",2018-04-01,"여자",2828,2803,2757,-46,71,25,-0.0164109882268998,0.0257526296699311,0.00891901534070639
"2943","2018","인천","서구","초등학교",2018-04-01,"남자",3035,3076,3025,-51,10,-41,-0.0165799739921977,0.00330578512396694,-0.0133289986996099
"2944","2018","인천","강화군","초등학교",2018-04-01,"전체",386,360,389,29,-3,26,0.0805555555555556,-0.0077120822622108,0.0722222222222222
"2945","2018","인천","강화군","초등학교",2018-04-01,"여자",182,167,185,18,-3,15,0.107784431137725,-0.0162162162162162,0.0898203592814371
"2946","2018","인천","강화군","초등학교",2018-04-01,"남자",204,193,204,11,0,11,0.0569948186528497,0,0.0569948186528497
"2947","2018","인천","옹진군","초등학교",2018-04-01,"전체",108,135,132,-3,-24,-27,-0.0222222222222222,-0.181818181818182,-0.2
"2948","2018","인천","옹진군","초등학교",2018-04-01,"여자",45,57,54,-3,-9,-12,-0.0526315789473684,-0.166666666666667,-0.210526315789474
"2949","2018","인천","옹진군","초등학교",2018-04-01,"남자",63,78,78,0,-15,-15,0,-0.192307692307692,-0.192307692307692
"2950","2018","광주","동구","초등학교",2018-04-01,"전체",578,672,659,-13,-81,-94,-0.0193452380952381,-0.122913505311077,-0.139880952380952
"2951","2018","광주","동구","초등학교",2018-04-01,"여자",302,330,322,-8,-20,-28,-0.0242424242424242,-0.062111801242236,-0.0848484848484849
"2952","2018","광주","동구","초등학교",2018-04-01,"남자",276,342,337,-5,-61,-66,-0.0146198830409357,-0.181008902077151,-0.192982456140351
"2953","2018","광주","서구","초등학교",2018-04-01,"전체",2794,2791,2894,103,-100,3,0.0369043353636689,-0.0345542501727713,0.00107488355428162
"2954","2018","광주","서구","초등학교",2018-04-01,"여자",1349,1383,1432,49,-83,-34,0.0354302241503977,-0.0579608938547486,-0.0245842371655821
"2955","2018","광주","서구","초등학교",2018-04-01,"남자",1445,1408,1462,54,-17,37,0.0383522727272727,-0.0116279069767442,0.0262784090909091
"2956","2018","광주","남구","초등학교",2018-04-01,"전체",2195,2028,2041,13,154,167,0.00641025641025641,0.075453209211171,0.0823471400394477
"2957","2018","광주","남구","초등학교",2018-04-01,"여자",1072,999,1000,1,72,73,0.001001001001001,0.072,0.0730730730730731
"2958","2018","광주","남구","초등학교",2018-04-01,"남자",1123,1029,1041,12,82,94,0.0116618075801749,0.0787704130643612,0.0913508260447036
"2959","2018","광주","북구","초등학교",2018-04-01,"전체",3978,4057,4018,-39,-40,-79,-0.00961301454276559,-0.00995520159283225,-0.0194725166379098
"2960","2018","광주","북구","초등학교",2018-04-01,"여자",1920,1914,1888,-26,32,6,-0.0135841170323929,0.0169491525423729,0.00313479623824451
"2961","2018","광주","북구","초등학교",2018-04-01,"남자",2058,2143,2130,-13,-72,-85,-0.00606626224918339,-0.0338028169014084,-0.0396640223985068
"2962","2018","광주","광산구","초등학교",2018-04-01,"전체",5100,5179,5173,-6,-73,-79,-0.00115852481173972,-0.0141117340034796,-0.0152539100212396
"2963","2018","광주","광산구","초등학교",2018-04-01,"여자",2436,2451,2450,-1,-14,-15,-0.000407996736026112,-0.00571428571428571,-0.00611995104039168
"2964","2018","광주","광산구","초등학교",2018-04-01,"남자",2664,2728,2723,-5,-59,-64,-0.00183284457478006,-0.0216672787366875,-0.0234604105571848
"2965","2018","대전","동구","초등학교",2018-04-01,"전체",1931,2152,2064,-88,-133,-221,-0.0408921933085502,-0.064437984496124,-0.102695167286245
"2966","2018","대전","동구","초등학교",2018-04-01,"여자",971,1074,1023,-51,-52,-103,-0.0474860335195531,-0.050830889540567,-0.095903165735568
"2967","2018","대전","동구","초등학교",2018-04-01,"남자",960,1078,1041,-37,-81,-118,-0.0343228200371058,-0.0778097982708934,-0.109461966604824
"2968","2018","대전","중구","초등학교",2018-04-01,"전체",2057,2213,2159,-54,-102,-156,-0.0244012652507908,-0.047244094488189,-0.07049254405784
"2969","2018","대전","중구","초등학교",2018-04-01,"여자",990,1058,1020,-38,-30,-68,-0.0359168241965974,-0.0294117647058824,-0.0642722117202268
"2970","2018","대전","중구","초등학교",2018-04-01,"남자",1067,1155,1139,-16,-72,-88,-0.0138528138528139,-0.0632133450395083,-0.0761904761904762
"2971","2018","대전","서구","초등학교",2018-04-01,"전체",4459,4577,4583,6,-124,-118,0.00131090233777584,-0.0270565132009601,-0.0257810793095914
"2972","2018","대전","서구","초등학교",2018-04-01,"여자",2165,2205,2196,-9,-31,-40,-0.00408163265306122,-0.0141165755919854,-0.018140589569161
"2973","2018","대전","서구","초등학교",2018-04-01,"남자",2294,2372,2387,15,-93,-78,0.00632377740303541,-0.038961038961039,-0.0328836424957841
"2974","2018","대전","유성구","초등학교",2018-04-01,"전체",4099,4227,4273,46,-174,-128,0.0108824225218831,-0.0407208050549965,-0.0302815235391531
"2975","2018","대전","유성구","초등학교",2018-04-01,"여자",1958,2027,2037,10,-79,-69,0.00493339911198816,-0.0387825233186058,-0.0340404538727183
"2976","2018","대전","유성구","초등학교",2018-04-01,"남자",2141,2200,2236,36,-95,-59,0.0163636363636364,-0.0424865831842576,-0.0268181818181818
"2977","2018","대전","대덕구","초등학교",2018-04-01,"전체",1510,1679,1624,-55,-114,-169,-0.0327575938058368,-0.0701970443349754,-0.100655151876117
"2978","2018","대전","대덕구","초등학교",2018-04-01,"여자",718,800,771,-29,-53,-82,-0.03625,-0.0687418936446174,-0.1025
"2979","2018","대전","대덕구","초등학교",2018-04-01,"남자",792,879,853,-26,-61,-87,-0.0295790671217292,-0.0715123094958968,-0.0989761092150171
"2980","2018","울산","중구","초등학교",2018-04-01,"전체",2181,2355,2352,-3,-171,-174,-0.00127388535031847,-0.0727040816326531,-0.0738853503184713
"2981","2018","울산","중구","초등학교",2018-04-01,"여자",1047,1072,1076,4,-29,-25,0.00373134328358209,-0.0269516728624535,-0.0233208955223881
"2982","2018","울산","중구","초등학교",2018-04-01,"남자",1134,1283,1276,-7,-142,-149,-0.00545596258768511,-0.11128526645768,-0.116134060795012
"2983","2018","울산","남구","초등학교",2018-04-01,"전체",2678,2926,2864,-62,-186,-248,-0.0211893369788107,-0.0649441340782123,-0.0847573479152427
"2984","2018","울산","남구","초등학교",2018-04-01,"여자",1264,1415,1403,-12,-139,-151,-0.00848056537102473,-0.0990734141126158,-0.106713780918728
"2985","2018","울산","남구","초등학교",2018-04-01,"남자",1414,1511,1461,-50,-47,-97,-0.0330906684315023,-0.0321697467488022,-0.0641958967571145
"2986","2018","울산","동구","초등학교",2018-04-01,"전체",1869,2091,2029,-62,-160,-222,-0.0296508847441416,-0.07885657959586,-0.106169296987088
"2987","2018","울산","동구","초등학교",2018-04-01,"여자",894,1003,974,-29,-80,-109,-0.028913260219342,-0.082135523613963,-0.108673978065803
"2988","2018","울산","동구","초등학교",2018-04-01,"남자",975,1088,1055,-33,-80,-113,-0.0303308823529412,-0.0758293838862559,-0.103860294117647
"2989","2018","울산","북구","초등학교",2018-04-01,"전체",2599,2441,2542,101,57,158,0.0413764850471118,0.0224232887490165,0.0647275706677591
"2990","2018","울산","북구","초등학교",2018-04-01,"여자",1271,1207,1255,48,16,64,0.0397680198840099,0.0127490039840637,0.0530240265120133
"2991","2018","울산","북구","초등학교",2018-04-01,"남자",1328,1234,1287,53,41,94,0.0429497568881686,0.0318570318570319,0.0761750405186386
"2992","2018","울산","울주군","초등학교",2018-04-01,"전체",2262,2237,2182,-55,80,25,-0.0245864997764864,0.0366636113657195,0.0111756817165847
"2993","2018","울산","울주군","초등학교",2018-04-01,"여자",1063,1092,1066,-26,-3,-29,-0.0238095238095238,-0.00281425891181989,-0.0265567765567766
"2994","2018","울산","울주군","초등학교",2018-04-01,"남자",1199,1145,1116,-29,83,54,-0.0253275109170306,0.0743727598566308,0.0471615720524017
"2995","2018","세종","세종시","초등학교",2018-04-01,"전체",4442,3310,3782,472,660,1132,0.142598187311178,0.17451084082496,0.341993957703927
"2996","2018","세종","세종시","초등학교",2018-04-01,"전체",4442,3310,3782,472,660,1132,0.142598187311178,0.17451084082496,0.341993957703927
"2997","2018","세종","세종시","초등학교",2018-04-01,"전체",4442,3310,3782,472,660,1132,0.142598187311178,0.17451084082496,0.341993957703927
"2998","2018","세종","세종시","초등학교",2018-04-01,"전체",4442,3310,3782,472,660,1132,0.142598187311178,0.17451084082496,0.341993957703927
"2999","2018","세종","세종시","초등학교",2018-04-01,"여자",2132,1642,1873,231,259,490,0.14068209500609,0.138280832888414,0.298416565164434
"3000","2018","세종","세종시","초등학교",2018-04-01,"여자",2132,1642,1873,231,259,490,0.14068209500609,0.138280832888414,0.298416565164434
"3001","2018","세종","세종시","초등학교",2018-04-01,"여자",2132,1642,1873,231,259,490,0.14068209500609,0.138280832888414,0.298416565164434
"3002","2018","세종","세종시","초등학교",2018-04-01,"여자",2132,1642,1873,231,259,490,0.14068209500609,0.138280832888414,0.298416565164434
"3003","2018","세종","세종시","초등학교",2018-04-01,"남자",2310,1668,1909,241,401,642,0.144484412470024,0.210057621791514,0.384892086330935
"3004","2018","세종","세종시","초등학교",2018-04-01,"남자",2310,1668,1909,241,401,642,0.144484412470024,0.210057621791514,0.384892086330935
"3005","2018","세종","세종시","초등학교",2018-04-01,"남자",2310,1668,1909,241,401,642,0.144484412470024,0.210057621791514,0.384892086330935
"3006","2018","세종","세종시","초등학교",2018-04-01,"남자",2310,1668,1909,241,401,642,0.144484412470024,0.210057621791514,0.384892086330935
"3007","2018","경기","수원시","초등학교",2018-04-01,"전체",11749,12047,11919,-128,-170,-298,-0.0106250518801361,-0.0142629415219398,-0.0247364489084419
"3008","2018","경기","수원시","초등학교",2018-04-01,"여자",5677,5879,5789,-90,-112,-202,-0.0153087259738051,-0.0193470374848851,-0.0343595849634292
"3009","2018","경기","수원시","초등학교",2018-04-01,"남자",6072,6168,6130,-38,-58,-96,-0.00616083009079118,-0.00946166394779772,-0.0155642023346304
"3010","2018","경기","성남시","초등학교",2018-04-01,"전체",7902,8294,8359,65,-457,-392,0.00783699059561128,-0.0546716114367747,-0.0472630817458404
"3011","2018","경기","성남시","초등학교",2018-04-01,"여자",3831,3960,4026,66,-195,-129,0.0166666666666667,-0.0484351713859911,-0.0325757575757576
"3012","2018","경기","성남시","초등학교",2018-04-01,"남자",4071,4334,4333,-1,-262,-263,-0.000230733733271804,-0.0604661897069005,-0.0606829718504845
"3013","2018","경기","부천시","초등학교",2018-04-01,"전체",7070,7322,7313,-9,-243,-252,-0.00122917235727943,-0.0332284971967729,-0.0344168260038241
"3014","2018","경기","부천시","초등학교",2018-04-01,"여자",3495,3602,3593,-9,-98,-107,-0.00249861188228762,-0.027275257445032,-0.029705719044975
"3015","2018","경기","부천시","초등학교",2018-04-01,"남자",3575,3720,3720,0,-145,-145,0,-0.0389784946236559,-0.0389784946236559
"3016","2018","경기","안양시","초등학교",2018-04-01,"전체",4837,5207,5229,22,-392,-370,0.00422508162089495,-0.0749665327978581,-0.0710581908968696
"3017","2018","경기","안양시","초등학교",2018-04-01,"여자",2394,2525,2543,18,-149,-131,0.00712871287128713,-0.0585922139205663,-0.0518811881188119
"3018","2018","경기","안양시","초등학교",2018-04-01,"남자",2443,2682,2686,4,-243,-239,0.00149142431021626,-0.0904690990320179,-0.0891126025354213
"3019","2018","경기","과천시","초등학교",2018-04-01,"전체",418,557,509,-48,-91,-139,-0.0861759425493716,-0.178781925343811,-0.249551166965889
"3020","2018","경기","과천시","초등학교",2018-04-01,"여자",213,286,263,-23,-50,-73,-0.0804195804195804,-0.190114068441065,-0.255244755244755
"3021","2018","경기","과천시","초등학교",2018-04-01,"남자",205,271,246,-25,-41,-66,-0.0922509225092251,-0.166666666666667,-0.243542435424354
"3022","2018","경기","안산시","초등학교",2018-04-01,"전체",5745,6196,5986,-210,-241,-451,-0.0338928340865074,-0.0402606080855329,-0.0727888960619755
"3023","2018","경기","안산시","초등학교",2018-04-01,"여자",2836,3109,3000,-109,-164,-273,-0.0350595046638791,-0.0546666666666667,-0.087809585075587
"3024","2018","경기","안산시","초등학교",2018-04-01,"남자",2909,3087,2986,-101,-77,-178,-0.0327178490443797,-0.0257870060281313,-0.057661159701976
"3025","2018","경기","용인시","초등학교",2018-04-01,"전체",11495,11751,11796,45,-301,-256,0.00382946132244064,-0.0255171244489658,-0.0217853799676623
"3026","2018","경기","용인시","초등학교",2018-04-01,"여자",5629,5717,5717,0,-88,-88,0,-0.0153926884729753,-0.0153926884729753
"3027","2018","경기","용인시","초등학교",2018-04-01,"남자",5866,6034,6079,45,-213,-168,0.00745773947630096,-0.0350386576739595,-0.0278422273781903
"3028","2018","경기","군포시","초등학교",2018-04-01,"전체",2625,2904,2808,-96,-183,-279,-0.0330578512396694,-0.0651709401709402,-0.0960743801652893
"3029","2018","경기","군포시","초등학교",2018-04-01,"여자",1279,1425,1391,-34,-112,-146,-0.023859649122807,-0.0805176132278936,-0.102456140350877
"3030","2018","경기","군포시","초등학교",2018-04-01,"남자",1346,1479,1417,-62,-71,-133,-0.041920216362407,-0.050105857445307,-0.0899256254225828
"3031","2018","경기","의왕시","초등학교",2018-04-01,"전체",1237,1603,1540,-63,-303,-366,-0.0393013100436681,-0.196753246753247,-0.228321896444167
"3032","2018","경기","의왕시","초등학교",2018-04-01,"여자",590,767,737,-30,-147,-177,-0.0391134289439374,-0.199457259158752,-0.230769230769231
"3033","2018","경기","의왕시","초등학교",2018-04-01,"남자",647,836,803,-33,-156,-189,-0.0394736842105263,-0.194271481942715,-0.226076555023923
"3034","2018","경기","시흥시","초등학교",2018-04-01,"전체",4662,4003,4113,110,549,659,0.0274793904571571,0.133479212253829,0.164626530102423
"3035","2018","경기","시흥시","초등학교",2018-04-01,"여자",2240,1895,1946,51,294,345,0.0269129287598945,0.151079136690647,0.182058047493404
"3036","2018","경기","시흥시","초등학교",2018-04-01,"남자",2422,2108,2167,59,255,314,0.027988614800759,0.11767420396862,0.148956356736243
"3037","2018","경기","평택시","초등학교",2018-04-01,"전체",5043,4862,4971,109,72,181,0.0224187577128754,0.0144840072420036,0.037227478403949
"3038","2018","경기","평택시","초등학교",2018-04-01,"여자",2450,2355,2413,58,37,95,0.0246284501061571,0.0153336096145876,0.0403397027600849
"3039","2018","경기","평택시","초등학교",2018-04-01,"남자",2593,2507,2558,51,35,86,0.0203430394894296,0.0136825645035184,0.0343039489429597
"3040","2018","경기","화성시","초등학교",2018-04-01,"전체",10549,9308,9860,552,689,1241,0.0593038246669532,0.0698782961460446,0.133326171035668
"3041","2018","경기","화성시","초등학교",2018-04-01,"여자",5171,4537,4815,278,356,634,0.0612739695834252,0.0739356178608515,0.139739916244214
"3042","2018","경기","화성시","초등학교",2018-04-01,"남자",5378,4771,5045,274,333,607,0.057430308111507,0.066005946481665,0.127226996436806
"3043","2018","경기","오산시","초등학교",2018-04-01,"전체",2943,2962,2938,-24,5,-19,-0.00810263335584065,0.00170183798502383,-0.00641458474004051
"3044","2018","경기","오산시","초등학교",2018-04-01,"여자",1441,1443,1429,-14,12,-2,-0.0097020097020097,0.00839748075577327,-0.00138600138600139
"3045","2018","경기","오산시","초등학교",2018-04-01,"남자",1502,1519,1509,-10,-7,-17,-0.00658327847267939,-0.0046388336646786,-0.011191573403555
"3046","2018","경기","광명시","초등학교",2018-04-01,"전체",3176,3539,3316,-223,-140,-363,-0.0630121503249506,-0.0422195416164053,-0.102571347838372
"3047","2018","경기","광명시","초등학교",2018-04-01,"여자",1522,1695,1572,-123,-50,-173,-0.0725663716814159,-0.0318066157760814,-0.102064896755162
"3048","2018","경기","광명시","초등학교",2018-04-01,"남자",1654,1844,1744,-100,-90,-190,-0.0542299349240781,-0.051605504587156,-0.103036876355748
"3049","2018","경기","광주시","초등학교",2018-04-01,"전체",3451,3537,3577,40,-126,-86,0.0113090189426067,-0.0352250489236791,-0.0243143907266045
"3050","2018","경기","광주시","초등학교",2018-04-01,"여자",1670,1699,1707,8,-37,-29,0.00470865214832254,-0.0216754540128881,-0.0170688640376692
"3051","2018","경기","광주시","초등학교",2018-04-01,"남자",1781,1838,1870,32,-89,-57,0.0174102285092492,-0.0475935828877005,-0.0310119695321001
"3052","2018","경기","하남시","초등학교",2018-04-01,"전체",2735,1975,2653,678,82,760,0.343291139240506,0.0309084055785903,0.384810126582278
"3053","2018","경기","하남시","초등학교",2018-04-01,"여자",1402,974,1313,339,89,428,0.348049281314168,0.0677837014470678,0.439425051334702
"3054","2018","경기","하남시","초등학교",2018-04-01,"남자",1333,1001,1340,339,-7,332,0.338661338661339,-0.00522388059701493,0.331668331668332
"3055","2018","경기","김포시","초등학교",2018-04-01,"전체",5362,4751,5186,435,176,611,0.0915596716480741,0.0339375241033552,0.128604504314881
"3056","2018","경기","김포시","초등학교",2018-04-01,"여자",2650,2381,2617,236,33,269,0.0991180176396472,0.0126098586167367,0.112977740445191
"3057","2018","경기","김포시","초등학교",2018-04-01,"남자",2712,2370,2569,199,143,342,0.0839662447257384,0.0556636823666796,0.144303797468354
"3058","2018","경기","이천시","초등학교",2018-04-01,"전체",2274,2258,2297,39,-23,16,0.0172719220549159,-0.0100130605137135,0.0070859167404783
"3059","2018","경기","이천시","초등학교",2018-04-01,"여자",1093,1105,1141,36,-48,-12,0.032579185520362,-0.042068361086766,-0.0108597285067873
"3060","2018","경기","이천시","초등학교",2018-04-01,"남자",1181,1153,1156,3,25,28,0.002601908065915,0.0216262975778547,0.0242844752818734
"3061","2018","경기","안성시","초등학교",2018-04-01,"전체",1888,1902,1894,-8,-6,-14,-0.00420609884332282,-0.00316789862724393,-0.00736067297581493
"3062","2018","경기","안성시","초등학교",2018-04-01,"여자",904,949,948,-1,-44,-45,-0.00105374077976818,-0.0464135021097046,-0.047418335089568
"3063","2018","경기","안성시","초등학교",2018-04-01,"남자",984,953,946,-7,38,31,-0.00734522560335782,0.040169133192389,0.0325288562434418
"3064","2018","경기","여주시","초등학교",2018-04-01,"전체",955,961,952,-9,3,-6,-0.00936524453694069,0.00315126050420168,-0.00624349635796046
"3065","2018","경기","여주시","초등학교",2018-04-01,"여자",461,460,457,-3,4,1,-0.00652173913043478,0.0087527352297593,0.00217391304347826
"3066","2018","경기","여주시","초등학교",2018-04-01,"남자",494,501,495,-6,-1,-7,-0.0119760479041916,-0.00202020202020202,-0.0139720558882236
"3067","2018","경기","양평군","초등학교",2018-04-01,"전체",873,887,936,49,-63,-14,0.0552423900789177,-0.0673076923076923,-0.0157835400225479
"3068","2018","경기","양평군","초등학교",2018-04-01,"여자",429,430,454,24,-25,-1,0.0558139534883721,-0.0550660792951542,-0.00232558139534884
"3069","2018","경기","양평군","초등학교",2018-04-01,"남자",444,457,482,25,-38,-13,0.0547045951859956,-0.0788381742738589,-0.0284463894967177
"3070","2018","경기","고양시","초등학교",2018-04-01,"전체",9095,9559,9600,41,-505,-464,0.00428915158489382,-0.0526041666666667,-0.0485406423266032
"3071","2018","경기","고양시","초등학교",2018-04-01,"여자",4464,4645,4663,18,-199,-181,0.0038751345532831,-0.0426763885910358,-0.0389666307857912
"3072","2018","경기","고양시","초등학교",2018-04-01,"남자",4631,4914,4937,23,-306,-283,0.00468050468050468,-0.061980960097225,-0.0575905575905576
"3073","2018","경기","남양주시","초등학교",2018-04-01,"전체",7351,7698,7659,-39,-308,-347,-0.00506625097427903,-0.0402141271706489,-0.0450766432839699
"3074","2018","경기","남양주시","초등학교",2018-04-01,"여자",3571,3760,3707,-53,-136,-189,-0.0140957446808511,-0.0366873482600486,-0.0502659574468085
"3075","2018","경기","남양주시","초등학교",2018-04-01,"남자",3780,3938,3952,14,-172,-158,0.00355510411376333,-0.0435222672064777,-0.0401218892839005
"3076","2018","경기","구리시","초등학교",2018-04-01,"전체",1693,1549,1704,155,-11,144,0.100064557779212,-0.00645539906103286,0.0929632020658489
"3077","2018","경기","구리시","초등학교",2018-04-01,"여자",840,797,871,74,-31,43,0.0928481806775408,-0.0355912743972445,0.0539523212045169
"3078","2018","경기","구리시","초등학교",2018-04-01,"남자",853,752,833,81,20,101,0.107712765957447,0.0240096038415366,0.134308510638298
"3079","2018","경기","의정부시","초등학교",2018-04-01,"전체",3683,3910,3931,21,-248,-227,0.00537084398976982,-0.0630882727041465,-0.0580562659846547
"3080","2018","경기","의정부시","초등학교",2018-04-01,"여자",1799,1936,1933,-3,-134,-137,-0.0015495867768595,-0.0693222969477496,-0.0707644628099174
"3081","2018","경기","의정부시","초등학교",2018-04-01,"남자",1884,1974,1998,24,-114,-90,0.0121580547112462,-0.0570570570570571,-0.0455927051671733
"3082","2018","경기","파주시","초등학교",2018-04-01,"전체",4847,4986,5005,19,-158,-139,0.00381066987565182,-0.0315684315684316,-0.0278780585639791
"3083","2018","경기","파주시","초등학교",2018-04-01,"여자",2364,2401,2417,16,-53,-37,0.00666389004581424,-0.0219280099296649,-0.0154102457309454
"3084","2018","경기","파주시","초등학교",2018-04-01,"남자",2483,2585,2588,3,-105,-102,0.0011605415860735,-0.0405718701700155,-0.039458413926499
"3085","2018","경기","동두천시","초등학교",2018-04-01,"전체",835,899,884,-15,-49,-64,-0.0166852057842047,-0.0554298642533937,-0.0711902113459399
"3086","2018","경기","동두천시","초등학교",2018-04-01,"여자",396,426,415,-11,-19,-30,-0.0258215962441315,-0.0457831325301205,-0.0704225352112676
"3087","2018","경기","동두천시","초등학교",2018-04-01,"남자",439,473,469,-4,-30,-34,-0.00845665961945032,-0.0639658848614073,-0.0718816067653277
"3088","2018","경기","양주시","초등학교",2018-04-01,"전체",2187,2174,2185,11,2,13,0.00505979760809568,0.00091533180778032,0.00597976080956762
"3089","2018","경기","양주시","초등학교",2018-04-01,"여자",1087,1040,1056,16,31,47,0.0153846153846154,0.0293560606060606,0.0451923076923077
"3090","2018","경기","양주시","초등학교",2018-04-01,"남자",1100,1134,1129,-5,-29,-34,-0.00440917107583774,-0.0256864481842338,-0.0299823633156966
"3091","2018","경기","포천시","초등학교",2018-04-01,"전체",1110,1176,1164,-12,-54,-66,-0.0102040816326531,-0.0463917525773196,-0.0561224489795918
"3092","2018","경기","포천시","초등학교",2018-04-01,"여자",504,530,531,1,-27,-26,0.00188679245283019,-0.0508474576271186,-0.0490566037735849
"3093","2018","경기","포천시","초등학교",2018-04-01,"남자",606,646,633,-13,-27,-40,-0.0201238390092879,-0.042654028436019,-0.0619195046439628
"3094","2018","경기","가평군","초등학교",2018-04-01,"전체",422,460,474,14,-52,-38,0.0304347826086957,-0.109704641350211,-0.0826086956521739
"3095","2018","경기","가평군","초등학교",2018-04-01,"여자",226,242,245,3,-19,-16,0.012396694214876,-0.0775510204081633,-0.0661157024793388
"3096","2018","경기","가평군","초등학교",2018-04-01,"남자",196,218,229,11,-33,-22,0.0504587155963303,-0.14410480349345,-0.100917431192661
"3097","2018","경기","연천군","초등학교",2018-04-01,"전체",300,344,339,-5,-39,-44,-0.0145348837209302,-0.115044247787611,-0.127906976744186
"3098","2018","경기","연천군","초등학교",2018-04-01,"여자",134,168,160,-8,-26,-34,-0.0476190476190476,-0.1625,-0.202380952380952
"3099","2018","경기","연천군","초등학교",2018-04-01,"남자",166,176,179,3,-13,-10,0.0170454545454545,-0.0726256983240224,-0.0568181818181818
"3100","2018","강원","춘천시","초등학교",2018-04-01,"전체",2570,2565,2575,10,-5,5,0.00389863547758285,-0.00194174757281553,0.00194931773879142
"3101","2018","강원","춘천시","초등학교",2018-04-01,"여자",1233,1248,1261,13,-28,-15,0.0104166666666667,-0.0222045995241872,-0.0120192307692308
"3102","2018","강원","춘천시","초등학교",2018-04-01,"남자",1337,1317,1314,-3,23,20,-0.00227790432801822,0.0175038051750381,0.0151860288534548
"3103","2018","강원","원주시","초등학교",2018-04-01,"전체",3224,3186,3225,39,-1,38,0.012241054613936,-0.000310077519379845,0.0119271814187068
"3104","2018","강원","원주시","초등학교",2018-04-01,"여자",1576,1545,1575,30,1,31,0.0194174757281553,0.000634920634920635,0.0200647249190939
"3105","2018","강원","원주시","초등학교",2018-04-01,"남자",1648,1641,1650,9,-2,7,0.00548446069469835,-0.00121212121212121,0.00426569165143205
"3106","2018","강원","강릉시","초등학교",2018-04-01,"전체",1662,1615,1625,10,37,47,0.00619195046439629,0.0227692307692308,0.0291021671826625
"3107","2018","강원","강릉시","초등학교",2018-04-01,"여자",787,749,753,4,34,38,0.00534045393858478,0.0451527224435591,0.0507343124165554
"3108","2018","강원","강릉시","초등학교",2018-04-01,"남자",875,866,872,6,3,9,0.0069284064665127,0.00344036697247706,0.0103926096997691
"3109","2018","강원","동해시","초등학교",2018-04-01,"전체",829,832,842,10,-13,-3,0.0120192307692308,-0.0154394299287411,-0.00360576923076923
"3110","2018","강원","동해시","초등학교",2018-04-01,"여자",393,399,403,4,-10,-6,0.0100250626566416,-0.0248138957816377,-0.0150375939849624
"3111","2018","강원","동해시","초등학교",2018-04-01,"남자",436,433,439,6,-3,3,0.0138568129330254,-0.00683371298405467,0.0069284064665127
"3112","2018","강원","태백시","초등학교",2018-04-01,"전체",373,396,389,-7,-16,-23,-0.0176767676767677,-0.0411311053984576,-0.0580808080808081
"3113","2018","강원","태백시","초등학교",2018-04-01,"여자",192,187,181,-6,11,5,-0.0320855614973262,0.0607734806629834,0.0267379679144385
"3114","2018","강원","태백시","초등학교",2018-04-01,"남자",181,209,208,-1,-27,-28,-0.00478468899521531,-0.129807692307692,-0.133971291866029
"3115","2018","강원","속초시","초등학교",2018-04-01,"전체",648,672,658,-14,-10,-24,-0.0208333333333333,-0.0151975683890578,-0.0357142857142857
"3116","2018","강원","속초시","초등학교",2018-04-01,"여자",306,336,322,-14,-16,-30,-0.0416666666666667,-0.0496894409937888,-0.0892857142857143
"3117","2018","강원","속초시","초등학교",2018-04-01,"남자",342,336,336,0,6,6,0,0.0178571428571429,0.0178571428571429
"3118","2018","강원","삼척시","초등학교",2018-04-01,"전체",450,496,502,6,-52,-46,0.0120967741935484,-0.103585657370518,-0.092741935483871
"3119","2018","강원","삼척시","초등학교",2018-04-01,"여자",217,237,234,-3,-17,-20,-0.0126582278481013,-0.0726495726495727,-0.0843881856540084
"3120","2018","강원","삼척시","초등학교",2018-04-01,"남자",233,259,268,9,-35,-26,0.0347490347490347,-0.130597014925373,-0.1003861003861
"3121","2018","강원","홍천군","초등학교",2018-04-01,"전체",474,497,503,6,-29,-23,0.0120724346076459,-0.0576540755467197,-0.0462776659959759
"3122","2018","강원","홍천군","초등학교",2018-04-01,"여자",242,266,268,2,-26,-24,0.0075187969924812,-0.0970149253731343,-0.0902255639097744
"3123","2018","강원","홍천군","초등학교",2018-04-01,"남자",232,231,235,4,-3,1,0.0173160173160173,-0.0127659574468085,0.00432900432900433
"3124","2018","강원","횡성군","초등학교",2018-04-01,"전체",268,256,264,8,4,12,0.03125,0.0151515151515152,0.046875
"3125","2018","강원","횡성군","초등학교",2018-04-01,"여자",125,124,127,3,-2,1,0.0241935483870968,-0.015748031496063,0.00806451612903226
"3126","2018","강원","횡성군","초등학교",2018-04-01,"남자",143,132,137,5,6,11,0.0378787878787879,0.0437956204379562,0.0833333333333333
"3127","2018","강원","영월군","초등학교",2018-04-01,"전체",238,231,240,9,-2,7,0.038961038961039,-0.00833333333333333,0.0303030303030303
"3128","2018","강원","영월군","초등학교",2018-04-01,"여자",123,114,116,2,7,9,0.0175438596491228,0.0603448275862069,0.0789473684210526
"3129","2018","강원","영월군","초등학교",2018-04-01,"남자",115,117,124,7,-9,-2,0.0598290598290598,-0.0725806451612903,-0.0170940170940171
"3130","2018","강원","평창군","초등학교",2018-04-01,"전체",237,258,259,1,-22,-21,0.00387596899224806,-0.0849420849420849,-0.0813953488372093
"3131","2018","강원","평창군","초등학교",2018-04-01,"여자",121,123,128,5,-7,-2,0.040650406504065,-0.0546875,-0.016260162601626
"3132","2018","강원","평창군","초등학교",2018-04-01,"남자",116,135,131,-4,-15,-19,-0.0296296296296296,-0.114503816793893,-0.140740740740741
"3133","2018","강원","정선군","초등학교",2018-04-01,"전체",218,235,238,3,-20,-17,0.0127659574468085,-0.0840336134453782,-0.0723404255319149
"3134","2018","강원","정선군","초등학교",2018-04-01,"여자",110,115,117,2,-7,-5,0.0173913043478261,-0.0598290598290598,-0.0434782608695652
"3135","2018","강원","정선군","초등학교",2018-04-01,"남자",108,120,121,1,-13,-12,0.00833333333333333,-0.107438016528926,-0.1
"3136","2018","강원","철원군","초등학교",2018-04-01,"전체",359,398,396,-2,-37,-39,-0.0050251256281407,-0.0934343434343434,-0.0979899497487437
"3137","2018","강원","철원군","초등학교",2018-04-01,"여자",159,190,192,2,-33,-31,0.0105263157894737,-0.171875,-0.163157894736842
"3138","2018","강원","철원군","초등학교",2018-04-01,"남자",200,208,204,-4,-4,-8,-0.0192307692307692,-0.0196078431372549,-0.0384615384615385
"3139","2018","강원","화천군","초등학교",2018-04-01,"전체",190,220,213,-7,-23,-30,-0.0318181818181818,-0.107981220657277,-0.136363636363636
"3140","2018","강원","화천군","초등학교",2018-04-01,"여자",90,107,105,-2,-15,-17,-0.0186915887850467,-0.142857142857143,-0.158878504672897
"3141","2018","강원","화천군","초등학교",2018-04-01,"남자",100,113,108,-5,-8,-13,-0.0442477876106195,-0.0740740740740741,-0.115044247787611
"3142","2018","강원","양구군","초등학교",2018-04-01,"전체",199,214,210,-4,-11,-15,-0.0186915887850467,-0.0523809523809524,-0.0700934579439252
"3143","2018","강원","양구군","초등학교",2018-04-01,"여자",89,93,88,-5,1,-4,-0.0537634408602151,0.0113636363636364,-0.043010752688172
"3144","2018","강원","양구군","초등학교",2018-04-01,"남자",110,121,122,1,-12,-11,0.00826446280991736,-0.0983606557377049,-0.0909090909090909
"3145","2018","강원","인제군","초등학교",2018-04-01,"전체",253,297,275,-22,-22,-44,-0.0740740740740741,-0.08,-0.148148148148148
"3146","2018","강원","인제군","초등학교",2018-04-01,"여자",101,135,128,-7,-27,-34,-0.0518518518518519,-0.2109375,-0.251851851851852
"3147","2018","강원","인제군","초등학교",2018-04-01,"남자",152,162,147,-15,5,-10,-0.0925925925925926,0.0340136054421769,-0.0617283950617284
"3148","2018","강원","고성군","초등학교",2018-04-01,"전체",163,153,151,-2,12,10,-0.0130718954248366,0.0794701986754967,0.065359477124183
"3149","2018","강원","고성군","초등학교",2018-04-01,"여자",73,72,69,-3,4,1,-0.0416666666666667,0.0579710144927536,0.0138888888888889
"3150","2018","강원","고성군","초등학교",2018-04-01,"남자",90,81,82,1,8,9,0.0123456790123457,0.0975609756097561,0.111111111111111
"3151","2018","강원","양양군","초등학교",2018-04-01,"전체",146,154,157,3,-11,-8,0.0194805194805195,-0.0700636942675159,-0.051948051948052
"3152","2018","강원","양양군","초등학교",2018-04-01,"여자",72,83,83,0,-11,-11,0,-0.132530120481928,-0.132530120481928
"3153","2018","강원","양양군","초등학교",2018-04-01,"남자",74,71,74,3,0,3,0.0422535211267606,0,0.0422535211267606
"3154","2018","충북","청주시","초등학교",2018-04-01,"전체",8496,8844,8843,-1,-347,-348,-0.000113071008593397,-0.0392400768969807,-0.039348710990502
"3155","2018","충북","청주시","초등학교",2018-04-01,"여자",4212,4342,4333,-9,-121,-130,-0.00207277752187932,-0.027925225017309,-0.029940119760479
"3156","2018","충북","청주시","초등학교",2018-04-01,"남자",4284,4502,4510,8,-226,-218,0.00177698800533096,-0.0501108647450111,-0.0484229231452688
"3157","2018","충북","충주시","초등학교",2018-04-01,"전체",1735,1626,1628,2,107,109,0.001230012300123,0.0657248157248157,0.0670356703567036
"3158","2018","충북","충주시","초등학교",2018-04-01,"여자",821,796,801,5,20,25,0.00628140703517588,0.0249687890137328,0.0314070351758794
"3159","2018","충북","충주시","초등학교",2018-04-01,"남자",914,830,827,-3,87,84,-0.0036144578313253,0.105199516324063,0.101204819277108
"3160","2018","충북","제천시","초등학교",2018-04-01,"전체",1057,1125,1143,18,-86,-68,0.016,-0.0752405949256343,-0.0604444444444444
"3161","2018","충북","제천시","초등학교",2018-04-01,"여자",533,561,579,18,-46,-28,0.0320855614973262,-0.079447322970639,-0.0499108734402852
"3162","2018","충북","제천시","초등학교",2018-04-01,"남자",524,564,564,0,-40,-40,0,-0.0709219858156028,-0.0709219858156028
"3163","2018","충북","보은군","초등학교",2018-04-01,"전체",202,175,178,3,24,27,0.0171428571428571,0.134831460674157,0.154285714285714
"3164","2018","충북","보은군","초등학교",2018-04-01,"여자",101,83,90,7,11,18,0.0843373493975904,0.122222222222222,0.216867469879518
"3165","2018","충북","보은군","초등학교",2018-04-01,"남자",101,92,88,-4,13,9,-0.0434782608695652,0.147727272727273,0.0978260869565217
"3166","2018","충북","옥천군","초등학교",2018-04-01,"전체",379,355,364,9,15,24,0.0253521126760563,0.0412087912087912,0.0676056338028169
"3167","2018","충북","옥천군","초등학교",2018-04-01,"여자",169,161,176,15,-7,8,0.093167701863354,-0.0397727272727273,0.0496894409937888
"3168","2018","충북","옥천군","초등학교",2018-04-01,"남자",210,194,188,-6,22,16,-0.0309278350515464,0.117021276595745,0.0824742268041237
"3169","2018","충북","영동군","초등학교",2018-04-01,"전체",279,309,307,-2,-28,-30,-0.00647249190938511,-0.0912052117263844,-0.0970873786407767
"3170","2018","충북","영동군","초등학교",2018-04-01,"여자",138,155,150,-5,-12,-17,-0.032258064516129,-0.08,-0.109677419354839
"3171","2018","충북","영동군","초등학교",2018-04-01,"남자",141,154,157,3,-16,-13,0.0194805194805195,-0.101910828025478,-0.0844155844155844
"3172","2018","충북","진천군","초등학교",2018-04-01,"전체",852,715,747,32,105,137,0.0447552447552448,0.140562248995984,0.191608391608392
"3173","2018","충북","진천군","초등학교",2018-04-01,"여자",415,349,363,14,52,66,0.0401146131805158,0.143250688705234,0.189111747851003
"3174","2018","충북","진천군","초등학교",2018-04-01,"남자",437,366,384,18,53,71,0.0491803278688525,0.138020833333333,0.193989071038251
"3175","2018","충북","괴산군","초등학교",2018-04-01,"전체",142,165,175,10,-33,-23,0.0606060606060606,-0.188571428571429,-0.139393939393939
"3176","2018","충북","괴산군","초등학교",2018-04-01,"여자",81,92,93,1,-12,-11,0.0108695652173913,-0.129032258064516,-0.119565217391304
"3177","2018","충북","괴산군","초등학교",2018-04-01,"남자",61,73,82,9,-21,-12,0.123287671232877,-0.25609756097561,-0.164383561643836
"3178","2018","충북","음성군","초등학교",2018-04-01,"전체",801,872,862,-10,-61,-71,-0.0114678899082569,-0.0707656612529002,-0.0814220183486239
"3179","2018","충북","음성군","초등학교",2018-04-01,"여자",373,384,394,10,-21,-11,0.0260416666666667,-0.0532994923857868,-0.0286458333333333
"3180","2018","충북","음성군","초등학교",2018-04-01,"남자",428,488,468,-20,-40,-60,-0.040983606557377,-0.0854700854700855,-0.122950819672131
"3181","2018","충북","단양군","초등학교",2018-04-01,"전체",164,165,167,2,-3,-1,0.0121212121212121,-0.0179640718562874,-0.00606060606060606
"3182","2018","충북","단양군","초등학교",2018-04-01,"여자",72,84,84,0,-12,-12,0,-0.142857142857143,-0.142857142857143
"3183","2018","충북","단양군","초등학교",2018-04-01,"남자",92,81,83,2,9,11,0.0246913580246914,0.108433734939759,0.135802469135802
"3184","2018","충북","증평군","초등학교",2018-04-01,"전체",381,390,394,4,-13,-9,0.0102564102564103,-0.032994923857868,-0.0230769230769231
"3185","2018","충북","증평군","초등학교",2018-04-01,"여자",189,186,191,5,-2,3,0.0268817204301075,-0.0104712041884817,0.0161290322580645
"3186","2018","충북","증평군","초등학교",2018-04-01,"남자",192,204,203,-1,-11,-12,-0.00490196078431373,-0.0541871921182266,-0.0588235294117647
"3187","2018","충남","천안시","초등학교",2018-04-01,"전체",7076,6789,7029,240,47,287,0.0353513035793195,0.00668658415137288,0.0422742671969362
"3188","2018","충남","천안시","초등학교",2018-04-01,"여자",3376,3262,3396,134,-20,114,0.0410790925812385,-0.00588928150765607,0.0349478847332925
"3189","2018","충남","천안시","초등학교",2018-04-01,"남자",3700,3527,3633,106,67,173,0.0300538701445988,0.0184420589044866,0.0490501842925999
"3190","2018","충남","공주시","초등학교",2018-04-01,"전체",735,757,738,-19,-3,-22,-0.0250990752972259,-0.0040650406504065,-0.0290620871862616
"3191","2018","충남","공주시","초등학교",2018-04-01,"여자",371,390,377,-13,-6,-19,-0.0333333333333333,-0.0159151193633952,-0.0487179487179487
"3192","2018","충남","공주시","초등학교",2018-04-01,"남자",364,367,361,-6,3,-3,-0.0163487738419619,0.00831024930747922,-0.00817438692098093
"3193","2018","충남","보령시","초등학교",2018-04-01,"전체",811,824,816,-8,-5,-13,-0.00970873786407767,-0.00612745098039216,-0.0157766990291262
"3194","2018","충남","보령시","초등학교",2018-04-01,"여자",410,404,400,-4,10,6,-0.0099009900990099,0.025,0.0148514851485149
"3195","2018","충남","보령시","초등학교",2018-04-01,"남자",401,420,416,-4,-15,-19,-0.00952380952380952,-0.0360576923076923,-0.0452380952380952
"3196","2018","충남","아산시","초등학교",2018-04-01,"전체",3957,4190,4124,-66,-167,-233,-0.0157517899761337,-0.0404946653734239,-0.0556085918854415
"3197","2018","충남","아산시","초등학교",2018-04-01,"여자",1923,2098,2054,-44,-131,-175,-0.0209723546234509,-0.063777994157741,-0.0834127740705434
"3198","2018","충남","아산시","초등학교",2018-04-01,"남자",2034,2092,2070,-22,-36,-58,-0.0105162523900574,-0.0173913043478261,-0.0277246653919694
"3199","2018","충남","서산시","초등학교",2018-04-01,"전체",1716,1719,1709,-10,7,-3,-0.0058173356602676,0.00409596255119953,-0.00174520069808028
"3200","2018","충남","서산시","초등학교",2018-04-01,"여자",812,812,807,-5,5,0,-0.0061576354679803,0.00619578686493185,0
"3201","2018","충남","서산시","초등학교",2018-04-01,"남자",904,907,902,-5,2,-3,-0.00551267916207277,0.00221729490022173,-0.00330760749724366
"3202","2018","충남","논산시","초등학교",2018-04-01,"전체",909,918,910,-8,-1,-9,-0.00871459694989107,-0.0010989010989011,-0.00980392156862745
"3203","2018","충남","논산시","초등학교",2018-04-01,"여자",444,434,432,-2,12,10,-0.00460829493087558,0.0277777777777778,0.0230414746543779
"3204","2018","충남","논산시","초등학교",2018-04-01,"남자",465,484,478,-6,-13,-19,-0.012396694214876,-0.0271966527196653,-0.0392561983471074
"3205","2018","충남","계룡시","초등학교",2018-04-01,"전체",508,485,530,45,-22,23,0.0927835051546392,-0.0415094339622641,0.0474226804123711
"3206","2018","충남","계룡시","초등학교",2018-04-01,"여자",235,231,254,23,-19,4,0.0995670995670996,-0.0748031496062992,0.0173160173160173
"3207","2018","충남","계룡시","초등학교",2018-04-01,"남자",273,254,276,22,-3,19,0.0866141732283465,-0.0108695652173913,0.0748031496062992
"3208","2018","충남","금산군","초등학교",2018-04-01,"전체",370,360,359,-1,11,10,-0.00277777777777778,0.0306406685236769,0.0277777777777778
"3209","2018","충남","금산군","초등학교",2018-04-01,"여자",183,186,187,1,-4,-3,0.00537634408602151,-0.0213903743315508,-0.0161290322580645
"3210","2018","충남","금산군","초등학교",2018-04-01,"남자",187,174,172,-2,15,13,-0.0114942528735632,0.0872093023255814,0.0747126436781609
"3211","2018","충남","부여군","초등학교",2018-04-01,"전체",359,412,407,-5,-48,-53,-0.0121359223300971,-0.117936117936118,-0.128640776699029
"3212","2018","충남","부여군","초등학교",2018-04-01,"여자",161,186,187,1,-26,-25,0.00537634408602151,-0.13903743315508,-0.134408602150538
"3213","2018","충남","부여군","초등학교",2018-04-01,"남자",198,226,220,-6,-22,-28,-0.0265486725663717,-0.1,-0.123893805309735
"3214","2018","충남","서천군","초등학교",2018-04-01,"전체",306,305,300,-5,6,1,-0.0163934426229508,0.02,0.00327868852459016
"3215","2018","충남","서천군","초등학교",2018-04-01,"여자",150,148,151,3,-1,2,0.0202702702702703,-0.00662251655629139,0.0135135135135135
"3216","2018","충남","서천군","초등학교",2018-04-01,"남자",156,157,149,-8,7,-1,-0.0509554140127389,0.0469798657718121,-0.00636942675159236
"3217","2018","충남","청양군","초등학교",2018-04-01,"전체",169,173,164,-9,5,-4,-0.0520231213872832,0.0304878048780488,-0.023121387283237
"3218","2018","충남","청양군","초등학교",2018-04-01,"여자",80,75,71,-4,9,5,-0.0533333333333333,0.126760563380282,0.0666666666666667
"3219","2018","충남","청양군","초등학교",2018-04-01,"남자",89,98,93,-5,-4,-9,-0.0510204081632653,-0.043010752688172,-0.0918367346938776
"3220","2018","충남","홍성군","초등학교",2018-04-01,"전체",942,825,912,87,30,117,0.105454545454545,0.0328947368421053,0.141818181818182
"3221","2018","충남","홍성군","초등학교",2018-04-01,"여자",452,379,421,42,31,73,0.110817941952507,0.0736342042755344,0.192612137203166
"3222","2018","충남","홍성군","초등학교",2018-04-01,"남자",490,446,491,45,-1,44,0.100896860986547,-0.00203665987780041,0.0986547085201794
"3223","2018","충남","예산군","초등학교",2018-04-01,"전체",497,522,513,-9,-16,-25,-0.0172413793103448,-0.0311890838206628,-0.0478927203065134
"3224","2018","충남","예산군","초등학교",2018-04-01,"여자",235,251,240,-11,-5,-16,-0.0438247011952191,-0.0208333333333333,-0.0637450199203187
"3225","2018","충남","예산군","초등학교",2018-04-01,"남자",262,271,273,2,-11,-9,0.00738007380073801,-0.0402930402930403,-0.033210332103321
"3226","2018","충남","태안군","초등학교",2018-04-01,"전체",422,443,439,-4,-17,-21,-0.0090293453724605,-0.0387243735763098,-0.0474040632054176
"3227","2018","충남","태안군","초등학교",2018-04-01,"여자",201,215,214,-1,-13,-14,-0.00465116279069767,-0.0607476635514019,-0.0651162790697674
"3228","2018","충남","태안군","초등학교",2018-04-01,"남자",221,228,225,-3,-4,-7,-0.0131578947368421,-0.0177777777777778,-0.0307017543859649
"3229","2018","충남","당진시","초등학교",2018-04-01,"전체",1865,1964,1951,-13,-86,-99,-0.00661914460285132,-0.044079958995387,-0.0504073319755601
"3230","2018","충남","당진시","초등학교",2018-04-01,"여자",898,936,937,1,-39,-38,0.00106837606837607,-0.0416221985058698,-0.0405982905982906
"3231","2018","충남","당진시","초등학교",2018-04-01,"남자",967,1028,1014,-14,-47,-61,-0.0136186770428016,-0.0463510848126233,-0.0593385214007782
"3232","2018","전북","전주시","초등학교",2018-04-01,"전체",6532,6246,6345,99,187,286,0.015850144092219,0.0294720252167061,0.0457893051552994
"3233","2018","전북","전주시","초등학교",2018-04-01,"여자",3266,3064,3138,74,128,202,0.0241514360313316,0.0407903123008286,0.0659268929503916
"3234","2018","전북","전주시","초등학교",2018-04-01,"남자",3266,3182,3207,25,59,84,0.00785669390320553,0.0183972560024945,0.0263984915147706
"3235","2018","전북","군산시","초등학교",2018-04-01,"전체",2721,2776,2754,-22,-33,-55,-0.00792507204610951,-0.0119825708061002,-0.0198126801152738
"3236","2018","전북","군산시","초등학교",2018-04-01,"여자",1319,1330,1323,-7,-4,-11,-0.00526315789473684,-0.00302343159486017,-0.00827067669172932
"3237","2018","전북","군산시","초등학교",2018-04-01,"남자",1402,1446,1431,-15,-29,-44,-0.0103734439834025,-0.0202655485674354,-0.0304287690179806
"3238","2018","전북","익산시","초등학교",2018-04-01,"전체",2610,2748,2731,-17,-121,-138,-0.0061863173216885,-0.0443061149761992,-0.0502183406113537
"3239","2018","전북","익산시","초등학교",2018-04-01,"여자",1301,1303,1304,1,-3,-2,0.000767459708365311,-0.00230061349693252,-0.00153491941673062
"3240","2018","전북","익산시","초등학교",2018-04-01,"남자",1309,1445,1427,-18,-118,-136,-0.0124567474048443,-0.0826909600560617,-0.0941176470588235
"3241","2018","전북","정읍시","초등학교",2018-04-01,"전체",873,859,861,2,12,14,0.00232828870779977,0.0139372822299652,0.0162980209545984
"3242","2018","전북","정읍시","초등학교",2018-04-01,"여자",418,413,417,4,1,5,0.00968523002421308,0.00239808153477218,0.0121065375302663
"3243","2018","전북","정읍시","초등학교",2018-04-01,"남자",455,446,444,-2,11,9,-0.00448430493273543,0.0247747747747748,0.0201793721973094
"3244","2018","전북","남원시","초등학교",2018-04-01,"전체",638,619,631,12,7,19,0.0193861066235864,0.0110935023771791,0.0306946688206785
"3245","2018","전북","남원시","초등학교",2018-04-01,"여자",311,292,292,0,19,19,0,0.0650684931506849,0.0650684931506849
"3246","2018","전북","남원시","초등학교",2018-04-01,"남자",327,327,339,12,-12,0,0.036697247706422,-0.0353982300884956,0
"3247","2018","전북","김제시","초등학교",2018-04-01,"전체",658,621,640,19,18,37,0.0305958132045089,0.028125,0.0595813204508857
"3248","2018","전북","김제시","초등학교",2018-04-01,"여자",340,321,330,9,10,19,0.0280373831775701,0.0303030303030303,0.059190031152648
"3249","2018","전북","김제시","초등학교",2018-04-01,"남자",318,300,310,10,8,18,0.0333333333333333,0.0258064516129032,0.06
"3250","2018","전북","완주군","초등학교",2018-04-01,"전체",829,1037,1010,-27,-181,-208,-0.0260366441658631,-0.179207920792079,-0.200578592092575
"3251","2018","전북","완주군","초등학교",2018-04-01,"여자",378,499,475,-24,-97,-121,-0.0480961923847695,-0.204210526315789,-0.24248496993988
"3252","2018","전북","완주군","초등학교",2018-04-01,"남자",451,538,535,-3,-84,-87,-0.00557620817843866,-0.157009345794393,-0.161710037174721
"3253","2018","전북","진안군","초등학교",2018-04-01,"전체",146,191,183,-8,-37,-45,-0.0418848167539267,-0.202185792349727,-0.235602094240838
"3254","2018","전북","진안군","초등학교",2018-04-01,"여자",61,86,84,-2,-23,-25,-0.0232558139534884,-0.273809523809524,-0.290697674418605
"3255","2018","전북","진안군","초등학교",2018-04-01,"남자",85,105,99,-6,-14,-20,-0.0571428571428571,-0.141414141414141,-0.19047619047619
"3256","2018","전북","무주군","초등학교",2018-04-01,"전체",165,161,163,2,2,4,0.0124223602484472,0.0122699386503067,0.0248447204968944
"3257","2018","전북","무주군","초등학교",2018-04-01,"여자",80,77,77,0,3,3,0,0.038961038961039,0.038961038961039
"3258","2018","전북","무주군","초등학교",2018-04-01,"남자",85,84,86,2,-1,1,0.0238095238095238,-0.0116279069767442,0.0119047619047619
"3259","2018","전북","장수군","초등학교",2018-04-01,"전체",161,157,153,-4,8,4,-0.0254777070063694,0.0522875816993464,0.0254777070063694
"3260","2018","전북","장수군","초등학교",2018-04-01,"여자",83,77,73,-4,10,6,-0.051948051948052,0.136986301369863,0.0779220779220779
"3261","2018","전북","장수군","초등학교",2018-04-01,"남자",78,80,80,0,-2,-2,0,-0.025,-0.025
"3262","2018","전북","임실군","초등학교",2018-04-01,"전체",158,172,190,18,-32,-14,0.104651162790698,-0.168421052631579,-0.0813953488372093
"3263","2018","전북","임실군","초등학교",2018-04-01,"여자",67,76,80,4,-13,-9,0.0526315789473684,-0.1625,-0.118421052631579
"3264","2018","전북","임실군","초등학교",2018-04-01,"남자",91,96,110,14,-19,-5,0.145833333333333,-0.172727272727273,-0.0520833333333333
"3265","2018","전북","순창군","초등학교",2018-04-01,"전체",160,175,171,-4,-11,-15,-0.0228571428571429,-0.064327485380117,-0.0857142857142857
"3266","2018","전북","순창군","초등학교",2018-04-01,"여자",88,92,91,-1,-3,-4,-0.0108695652173913,-0.032967032967033,-0.0434782608695652
"3267","2018","전북","순창군","초등학교",2018-04-01,"남자",72,83,80,-3,-8,-11,-0.036144578313253,-0.1,-0.132530120481928
"3268","2018","전북","고창군","초등학교",2018-04-01,"전체",362,354,351,-3,11,8,-0.00847457627118644,0.0313390313390313,0.0225988700564972
"3269","2018","전북","고창군","초등학교",2018-04-01,"여자",166,167,164,-3,2,-1,-0.0179640718562874,0.0121951219512195,-0.00598802395209581
"3270","2018","전북","고창군","초등학교",2018-04-01,"남자",196,187,187,0,9,9,0,0.0481283422459893,0.0481283422459893
"3271","2018","전북","부안군","초등학교",2018-04-01,"전체",328,345,352,7,-24,-17,0.0202898550724638,-0.0681818181818182,-0.0492753623188406
"3272","2018","전북","부안군","초등학교",2018-04-01,"여자",155,160,161,1,-6,-5,0.00625,-0.0372670807453416,-0.03125
"3273","2018","전북","부안군","초등학교",2018-04-01,"남자",173,185,191,6,-18,-12,0.0324324324324324,-0.0942408376963351,-0.0648648648648649
"3274","2018","전남","목포시","초등학교",2018-04-01,"전체",2756,2560,2577,17,179,196,0.006640625,0.0694606131160264,0.0765625
"3275","2018","전남","목포시","초등학교",2018-04-01,"여자",1396,1299,1301,2,95,97,0.00153964588144727,0.0730207532667179,0.0746728252501925
"3276","2018","전남","목포시","초등학교",2018-04-01,"남자",1360,1261,1276,15,84,99,0.0118953211736717,0.0658307210031348,0.0785091197462331
"3277","2018","전남","여수시","초등학교",2018-04-01,"전체",2614,2684,2659,-25,-45,-70,-0.00931445603576751,-0.0169236555095901,-0.026080476900149
"3278","2018","전남","여수시","초등학교",2018-04-01,"여자",1303,1374,1362,-12,-59,-71,-0.00873362445414847,-0.0433186490455213,-0.0516739446870451
"3279","2018","전남","여수시","초등학교",2018-04-01,"남자",1311,1310,1297,-13,14,1,-0.0099236641221374,0.0107941403238242,0.000763358778625954
"3280","2018","전남","순천시","초등학교",2018-04-01,"전체",2747,2561,2635,74,112,186,0.0288949629051152,0.0425047438330171,0.0726278797344787
"3281","2018","전남","순천시","초등학교",2018-04-01,"여자",1339,1238,1271,33,68,101,0.0266558966074313,0.0535011801730921,0.0815831987075929
"3282","2018","전남","순천시","초등학교",2018-04-01,"남자",1408,1323,1364,41,44,85,0.0309901738473167,0.032258064516129,0.0642479213907785
"3283","2018","전남","나주시","초등학교",2018-04-01,"전체",1006,902,1041,139,-35,104,0.15410199556541,-0.0336215177713737,0.11529933481153
"3284","2018","전남","나주시","초등학교",2018-04-01,"여자",531,450,524,74,7,81,0.164444444444444,0.0133587786259542,0.18
"3285","2018","전남","나주시","초등학교",2018-04-01,"남자",475,452,517,65,-42,23,0.143805309734513,-0.0812379110251451,0.0508849557522124
"3286","2018","전남","광양시","초등학교",2018-04-01,"전체",1606,1676,1669,-7,-63,-70,-0.00417661097852029,-0.0377471539844218,-0.0417661097852029
"3287","2018","전남","광양시","초등학교",2018-04-01,"여자",804,821,819,-2,-15,-17,-0.00243605359317905,-0.0183150183150183,-0.0207064555420219
"3288","2018","전남","광양시","초등학교",2018-04-01,"남자",802,855,850,-5,-48,-53,-0.00584795321637427,-0.0564705882352941,-0.0619883040935673
"3289","2018","전남","담양군","초등학교",2018-04-01,"전체",221,260,262,2,-41,-39,0.00769230769230769,-0.156488549618321,-0.15
"3290","2018","전남","담양군","초등학교",2018-04-01,"여자",96,109,115,6,-19,-13,0.055045871559633,-0.165217391304348,-0.119266055045872
"3291","2018","전남","담양군","초등학교",2018-04-01,"남자",125,151,147,-4,-22,-26,-0.0264900662251656,-0.149659863945578,-0.172185430463576
"3292","2018","전남","곡성군","초등학교",2018-04-01,"전체",169,173,169,-4,0,-4,-0.023121387283237,0,-0.023121387283237
"3293","2018","전남","곡성군","초등학교",2018-04-01,"여자",86,91,92,1,-6,-5,0.010989010989011,-0.0652173913043478,-0.0549450549450549
"3294","2018","전남","곡성군","초등학교",2018-04-01,"남자",83,82,77,-5,6,1,-0.0609756097560976,0.0779220779220779,0.0121951219512195
"3295","2018","전남","구례군","초등학교",2018-04-01,"전체",158,181,176,-5,-18,-23,-0.0276243093922652,-0.102272727272727,-0.12707182320442
"3296","2018","전남","구례군","초등학교",2018-04-01,"여자",83,87,84,-3,-1,-4,-0.0344827586206897,-0.0119047619047619,-0.0459770114942529
"3297","2018","전남","구례군","초등학교",2018-04-01,"남자",75,94,92,-2,-17,-19,-0.0212765957446809,-0.184782608695652,-0.202127659574468
"3298","2018","전남","고흥군","초등학교",2018-04-01,"전체",292,322,328,6,-36,-30,0.0186335403726708,-0.109756097560976,-0.093167701863354
"3299","2018","전남","고흥군","초등학교",2018-04-01,"여자",135,153,153,0,-18,-18,0,-0.117647058823529,-0.117647058823529
"3300","2018","전남","고흥군","초등학교",2018-04-01,"남자",157,169,175,6,-18,-12,0.0355029585798817,-0.102857142857143,-0.0710059171597633
"3301","2018","전남","보성군","초등학교",2018-04-01,"전체",238,298,274,-24,-36,-60,-0.0805369127516778,-0.131386861313869,-0.201342281879195
"3302","2018","전남","보성군","초등학교",2018-04-01,"여자",116,138,124,-14,-8,-22,-0.101449275362319,-0.0645161290322581,-0.159420289855072
"3303","2018","전남","보성군","초등학교",2018-04-01,"남자",122,160,150,-10,-28,-38,-0.0625,-0.186666666666667,-0.2375
"3304","2018","전남","화순군","초등학교",2018-04-01,"전체",470,527,507,-20,-37,-57,-0.0379506641366224,-0.0729783037475345,-0.108159392789374
"3305","2018","전남","화순군","초등학교",2018-04-01,"여자",232,253,248,-5,-16,-21,-0.0197628458498024,-0.0645161290322581,-0.08300395256917
"3306","2018","전남","화순군","초등학교",2018-04-01,"남자",238,274,259,-15,-21,-36,-0.0547445255474453,-0.0810810810810811,-0.131386861313869
"3307","2018","전남","장흥군","초등학교",2018-04-01,"전체",233,239,237,-2,-4,-6,-0.00836820083682008,-0.0168776371308017,-0.0251046025104603
"3308","2018","전남","장흥군","초등학교",2018-04-01,"여자",104,112,108,-4,-4,-8,-0.0357142857142857,-0.037037037037037,-0.0714285714285714
"3309","2018","전남","장흥군","초등학교",2018-04-01,"남자",129,127,129,2,0,2,0.015748031496063,0,0.015748031496063
"3310","2018","전남","강진군","초등학교",2018-04-01,"전체",223,270,254,-16,-31,-47,-0.0592592592592593,-0.122047244094488,-0.174074074074074
"3311","2018","전남","강진군","초등학교",2018-04-01,"여자",105,136,130,-6,-25,-31,-0.0441176470588235,-0.192307692307692,-0.227941176470588
"3312","2018","전남","강진군","초등학교",2018-04-01,"남자",118,134,124,-10,-6,-16,-0.0746268656716418,-0.0483870967741935,-0.119402985074627
"3313","2018","전남","해남군","초등학교",2018-04-01,"전체",415,481,450,-31,-35,-66,-0.0644490644490645,-0.0777777777777778,-0.137214137214137
"3314","2018","전남","해남군","초등학교",2018-04-01,"여자",210,260,242,-18,-32,-50,-0.0692307692307692,-0.132231404958678,-0.192307692307692
"3315","2018","전남","해남군","초등학교",2018-04-01,"남자",205,221,208,-13,-3,-16,-0.0588235294117647,-0.0144230769230769,-0.0723981900452489
"3316","2018","전남","영암군","초등학교",2018-04-01,"전체",413,531,474,-57,-61,-118,-0.107344632768362,-0.128691983122363,-0.222222222222222
"3317","2018","전남","영암군","초등학교",2018-04-01,"여자",217,264,234,-30,-17,-47,-0.113636363636364,-0.0726495726495727,-0.178030303030303
"3318","2018","전남","영암군","초등학교",2018-04-01,"남자",196,267,240,-27,-44,-71,-0.101123595505618,-0.183333333333333,-0.265917602996255
"3319","2018","전남","무안군","초등학교",2018-04-01,"전체",777,896,910,14,-133,-119,0.015625,-0.146153846153846,-0.1328125
"3320","2018","전남","무안군","초등학교",2018-04-01,"여자",395,445,440,-5,-45,-50,-0.0112359550561798,-0.102272727272727,-0.112359550561798
"3321","2018","전남","무안군","초등학교",2018-04-01,"남자",382,451,470,19,-88,-69,0.0421286031042129,-0.187234042553191,-0.152993348115299
"3322","2018","전남","함평군","초등학교",2018-04-01,"전체",164,204,195,-9,-31,-40,-0.0441176470588235,-0.158974358974359,-0.196078431372549
"3323","2018","전남","함평군","초등학교",2018-04-01,"여자",75,89,89,0,-14,-14,0,-0.157303370786517,-0.157303370786517
"3324","2018","전남","함평군","초등학교",2018-04-01,"남자",89,115,106,-9,-17,-26,-0.0782608695652174,-0.160377358490566,-0.226086956521739
"3325","2018","전남","영광군","초등학교",2018-04-01,"전체",372,423,396,-27,-24,-51,-0.0638297872340425,-0.0606060606060606,-0.120567375886525
"3326","2018","전남","영광군","초등학교",2018-04-01,"여자",186,199,184,-15,2,-13,-0.0753768844221105,0.0108695652173913,-0.0653266331658292
"3327","2018","전남","영광군","초등학교",2018-04-01,"남자",186,224,212,-12,-26,-38,-0.0535714285714286,-0.122641509433962,-0.169642857142857
"3328","2018","전남","장성군","초등학교",2018-04-01,"전체",366,382,362,-20,4,-16,-0.0523560209424084,0.0110497237569061,-0.0418848167539267
"3329","2018","전남","장성군","초등학교",2018-04-01,"여자",175,192,183,-9,-8,-17,-0.046875,-0.0437158469945355,-0.0885416666666667
"3330","2018","전남","장성군","초등학교",2018-04-01,"남자",191,190,179,-11,12,1,-0.0578947368421053,0.0670391061452514,0.00526315789473684
"3331","2018","전남","완도군","초등학교",2018-04-01,"전체",354,388,395,7,-41,-34,0.0180412371134021,-0.10379746835443,-0.0876288659793814
"3332","2018","전남","완도군","초등학교",2018-04-01,"여자",168,201,200,-1,-32,-33,-0.00497512437810945,-0.16,-0.164179104477612
"3333","2018","전남","완도군","초등학교",2018-04-01,"남자",186,187,195,8,-9,-1,0.0427807486631016,-0.0461538461538462,-0.0053475935828877
"3334","2018","전남","진도군","초등학교",2018-04-01,"전체",202,223,223,0,-21,-21,0,-0.0941704035874439,-0.0941704035874439
"3335","2018","전남","진도군","초등학교",2018-04-01,"여자",113,109,109,0,4,4,0,0.036697247706422,0.036697247706422
"3336","2018","전남","진도군","초등학교",2018-04-01,"남자",89,114,114,0,-25,-25,0,-0.219298245614035,-0.219298245614035
"3337","2018","전남","신안군","초등학교",2018-04-01,"전체",177,210,205,-5,-28,-33,-0.0238095238095238,-0.136585365853659,-0.157142857142857
"3338","2018","전남","신안군","초등학교",2018-04-01,"여자",97,118,116,-2,-19,-21,-0.0169491525423729,-0.163793103448276,-0.177966101694915
"3339","2018","전남","신안군","초등학교",2018-04-01,"남자",80,92,89,-3,-9,-12,-0.0326086956521739,-0.101123595505618,-0.130434782608696
"3340","2018","경북","포항시","초등학교",2018-04-01,"전체",4691,4832,4840,8,-149,-141,0.00165562913907285,-0.0307851239669421,-0.0291804635761589
"3341","2018","경북","포항시","초등학교",2018-04-01,"여자",2206,2322,2317,-5,-111,-116,-0.00215331610680448,-0.0479067760034527,-0.0499569336778639
"3342","2018","경북","포항시","초등학교",2018-04-01,"남자",2485,2510,2523,13,-38,-25,0.0051792828685259,-0.0150614347998415,-0.0099601593625498
"3343","2018","경북","경주시","초등학교",2018-04-01,"전체",1939,2031,2011,-20,-72,-92,-0.00984736582964057,-0.0358030830432621,-0.0452978828163466
"3344","2018","경북","경주시","초등학교",2018-04-01,"여자",946,1007,1004,-3,-58,-61,-0.00297914597815293,-0.0577689243027888,-0.0605759682224429
"3345","2018","경북","경주시","초등학교",2018-04-01,"남자",993,1024,1007,-17,-14,-31,-0.0166015625,-0.0139026812313803,-0.0302734375
"3346","2018","경북","김천시","초등학교",2018-04-01,"전체",1131,1187,1207,20,-76,-56,0.016849199663016,-0.0629660314830157,-0.0471777590564448
"3347","2018","경북","김천시","초등학교",2018-04-01,"여자",526,581,593,12,-67,-55,0.0206540447504303,-0.112984822934233,-0.0946643717728055
"3348","2018","경북","김천시","초등학교",2018-04-01,"남자",605,606,614,8,-9,-1,0.0132013201320132,-0.0146579804560261,-0.00165016501650165
"3349","2018","경북","안동시","초등학교",2018-04-01,"전체",1473,1442,1412,-30,61,31,-0.0208044382801664,0.0432011331444759,0.021497919556172
"3350","2018","경북","안동시","초등학교",2018-04-01,"여자",697,666,648,-18,49,31,-0.027027027027027,0.0756172839506173,0.0465465465465465
"3351","2018","경북","안동시","초등학교",2018-04-01,"남자",776,776,764,-12,12,0,-0.0154639175257732,0.0157068062827225,0
"3352","2018","경북","구미시","초등학교",2018-04-01,"전체",4998,5075,5058,-17,-60,-77,-0.00334975369458128,-0.0118623962040332,-0.0151724137931034
"3353","2018","경북","구미시","초등학교",2018-04-01,"여자",2382,2461,2459,-2,-77,-79,-0.000812677773262901,-0.0313135420902806,-0.0321007720438846
"3354","2018","경북","구미시","초등학교",2018-04-01,"남자",2616,2614,2599,-15,17,2,-0.00573833205814843,0.00654097729896114,0.000765110941086458
"3355","2018","경북","영주시","초등학교",2018-04-01,"전체",809,770,820,50,-11,39,0.0649350649350649,-0.0134146341463415,0.0506493506493507
"3356","2018","경북","영주시","초등학교",2018-04-01,"여자",406,389,414,25,-8,17,0.06426735218509,-0.0193236714975845,0.0437017994858612
"3357","2018","경북","영주시","초등학교",2018-04-01,"남자",403,381,406,25,-3,22,0.0656167979002625,-0.00738916256157635,0.057742782152231
"3358","2018","경북","영천시","초등학교",2018-04-01,"전체",552,638,619,-19,-67,-86,-0.0297805642633229,-0.108239095315024,-0.134796238244514
"3359","2018","경북","영천시","초등학교",2018-04-01,"여자",278,307,299,-8,-21,-29,-0.0260586319218241,-0.0702341137123746,-0.0944625407166124
"3360","2018","경북","영천시","초등학교",2018-04-01,"남자",274,331,320,-11,-46,-57,-0.0332326283987915,-0.14375,-0.172205438066465
"3361","2018","경북","상주시","초등학교",2018-04-01,"전체",609,618,638,20,-29,-9,0.0323624595469256,-0.0454545454545455,-0.0145631067961165
"3362","2018","경북","상주시","초등학교",2018-04-01,"여자",304,304,315,11,-11,0,0.0361842105263158,-0.0349206349206349,0
"3363","2018","경북","상주시","초등학교",2018-04-01,"남자",305,314,323,9,-18,-9,0.0286624203821656,-0.0557275541795666,-0.0286624203821656
"3364","2018","경북","문경시","초등학교",2018-04-01,"전체",513,523,498,-25,15,-10,-0.0478011472275335,0.0301204819277108,-0.0191204588910134
"3365","2018","경북","문경시","초등학교",2018-04-01,"여자",235,234,221,-13,14,1,-0.0555555555555556,0.0633484162895928,0.00427350427350427
"3366","2018","경북","문경시","초등학교",2018-04-01,"남자",278,289,277,-12,1,-11,-0.041522491349481,0.0036101083032491,-0.0380622837370242
"3367","2018","경북","경산시","초등학교",2018-04-01,"전체",2342,2442,2403,-39,-61,-100,-0.015970515970516,-0.025384935497295,-0.0409500409500409
"3368","2018","경북","경산시","초등학교",2018-04-01,"여자",1122,1158,1141,-17,-19,-36,-0.0146804835924007,-0.0166520595968449,-0.0310880829015544
"3369","2018","경북","경산시","초등학교",2018-04-01,"남자",1220,1284,1262,-22,-42,-64,-0.0171339563862928,-0.0332805071315372,-0.0498442367601246
"3370","2018","경북","군위군","초등학교",2018-04-01,"전체",79,117,111,-6,-32,-38,-0.0512820512820513,-0.288288288288288,-0.324786324786325
"3371","2018","경북","군위군","초등학교",2018-04-01,"여자",36,60,55,-5,-19,-24,-0.0833333333333333,-0.345454545454545,-0.4
"3372","2018","경북","군위군","초등학교",2018-04-01,"남자",43,57,56,-1,-13,-14,-0.0175438596491228,-0.232142857142857,-0.245614035087719
"3373","2018","경북","의성군","초등학교",2018-04-01,"전체",183,224,217,-7,-34,-41,-0.03125,-0.15668202764977,-0.183035714285714
"3374","2018","경북","의성군","초등학교",2018-04-01,"여자",95,101,98,-3,-3,-6,-0.0297029702970297,-0.0306122448979592,-0.0594059405940594
"3375","2018","경북","의성군","초등학교",2018-04-01,"남자",88,123,119,-4,-31,-35,-0.032520325203252,-0.260504201680672,-0.284552845528455
"3376","2018","경북","청송군","초등학교",2018-04-01,"전체",116,122,122,0,-6,-6,0,-0.0491803278688525,-0.0491803278688525
"3377","2018","경북","청송군","초등학교",2018-04-01,"여자",52,60,60,0,-8,-8,0,-0.133333333333333,-0.133333333333333
"3378","2018","경북","청송군","초등학교",2018-04-01,"남자",64,62,62,0,2,2,0,0.032258064516129,0.032258064516129
"3379","2018","경북","영양군","초등학교",2018-04-01,"전체",71,85,83,-2,-12,-14,-0.0235294117647059,-0.144578313253012,-0.164705882352941
"3380","2018","경북","영양군","초등학교",2018-04-01,"여자",26,34,38,4,-12,-8,0.117647058823529,-0.315789473684211,-0.235294117647059
"3381","2018","경북","영양군","초등학교",2018-04-01,"남자",45,51,45,-6,0,-6,-0.117647058823529,0,-0.117647058823529
"3382","2018","경북","영덕군","초등학교",2018-04-01,"전체",186,212,204,-8,-18,-26,-0.0377358490566038,-0.0882352941176471,-0.122641509433962
"3383","2018","경북","영덕군","초등학교",2018-04-01,"여자",92,103,98,-5,-6,-11,-0.0485436893203883,-0.0612244897959184,-0.106796116504854
"3384","2018","경북","영덕군","초등학교",2018-04-01,"남자",94,109,106,-3,-12,-15,-0.0275229357798165,-0.113207547169811,-0.137614678899083
"3385","2018","경북","청도군","초등학교",2018-04-01,"전체",174,185,172,-13,2,-11,-0.0702702702702703,0.0116279069767442,-0.0594594594594595
"3386","2018","경북","청도군","초등학교",2018-04-01,"여자",91,91,81,-10,10,0,-0.10989010989011,0.123456790123457,0
"3387","2018","경북","청도군","초등학교",2018-04-01,"남자",83,94,91,-3,-8,-11,-0.0319148936170213,-0.0879120879120879,-0.117021276595745
"3388","2018","경북","고령군","초등학교",2018-04-01,"전체",160,215,195,-20,-35,-55,-0.0930232558139535,-0.179487179487179,-0.255813953488372
"3389","2018","경북","고령군","초등학교",2018-04-01,"여자",84,105,92,-13,-8,-21,-0.123809523809524,-0.0869565217391304,-0.2
"3390","2018","경북","고령군","초등학교",2018-04-01,"남자",76,110,103,-7,-27,-34,-0.0636363636363636,-0.262135922330097,-0.309090909090909
"3391","2018","경북","성주군","초등학교",2018-04-01,"전체",192,251,233,-18,-41,-59,-0.0717131474103586,-0.175965665236052,-0.235059760956175
"3392","2018","경북","성주군","초등학교",2018-04-01,"여자",100,136,131,-5,-31,-36,-0.0367647058823529,-0.236641221374046,-0.264705882352941
"3393","2018","경북","성주군","초등학교",2018-04-01,"남자",92,115,102,-13,-10,-23,-0.11304347826087,-0.0980392156862745,-0.2
"3394","2018","경북","칠곡군","초등학교",2018-04-01,"전체",1206,1374,1334,-40,-128,-168,-0.0291120815138282,-0.095952023988006,-0.122270742358079
"3395","2018","경북","칠곡군","초등학교",2018-04-01,"여자",615,661,631,-30,-16,-46,-0.0453857791225416,-0.0253565768621236,-0.0695915279878971
"3396","2018","경북","칠곡군","초등학교",2018-04-01,"남자",591,713,703,-10,-112,-122,-0.0140252454417952,-0.159317211948791,-0.171107994389902
"3397","2018","경북","예천군","초등학교",2018-04-01,"전체",219,316,343,27,-124,-97,0.0854430379746835,-0.361516034985423,-0.306962025316456
"3398","2018","경북","예천군","초등학교",2018-04-01,"여자",111,158,171,13,-60,-47,0.0822784810126582,-0.350877192982456,-0.29746835443038
"3399","2018","경북","예천군","초등학교",2018-04-01,"남자",108,158,172,14,-64,-50,0.0886075949367089,-0.372093023255814,-0.316455696202532
"3400","2018","경북","봉화군","초등학교",2018-04-01,"전체",160,225,198,-27,-38,-65,-0.12,-0.191919191919192,-0.288888888888889
"3401","2018","경북","봉화군","초등학교",2018-04-01,"여자",78,129,109,-20,-31,-51,-0.155038759689922,-0.284403669724771,-0.395348837209302
"3402","2018","경북","봉화군","초등학교",2018-04-01,"남자",82,96,89,-7,-7,-14,-0.0729166666666667,-0.0786516853932584,-0.145833333333333
"3403","2018","경북","울진군","초등학교",2018-04-01,"전체",343,408,389,-19,-46,-65,-0.0465686274509804,-0.118251928020566,-0.159313725490196
"3404","2018","경북","울진군","초등학교",2018-04-01,"여자",177,203,197,-6,-20,-26,-0.0295566502463054,-0.101522842639594,-0.12807881773399
"3405","2018","경북","울진군","초등학교",2018-04-01,"남자",166,205,192,-13,-26,-39,-0.0634146341463415,-0.135416666666667,-0.190243902439024
"3406","2018","경북","울릉군","초등학교",2018-04-01,"전체",50,49,49,0,1,1,0,0.0204081632653061,0.0204081632653061
"3407","2018","경북","울릉군","초등학교",2018-04-01,"여자",21,19,17,-2,4,2,-0.105263157894737,0.235294117647059,0.105263157894737
"3408","2018","경북","울릉군","초등학교",2018-04-01,"남자",29,30,32,2,-3,-1,0.0666666666666667,-0.09375,-0.0333333333333333
"3409","2018","경남","진주시","초등학교",2018-04-01,"전체",3368,3285,3315,30,53,83,0.0091324200913242,0.0159879336349925,0.0252663622526636
"3410","2018","경남","진주시","초등학교",2018-04-01,"여자",1579,1564,1585,21,-6,15,0.0134271099744246,-0.00378548895899054,0.00959079283887468
"3411","2018","경남","진주시","초등학교",2018-04-01,"남자",1789,1721,1730,9,59,68,0.0052295177222545,0.0341040462427746,0.0395119116792562
"3412","2018","경남","통영시","초등학교",2018-04-01,"전체",1455,1517,1486,-31,-31,-62,-0.020435069215557,-0.0208613728129206,-0.040870138431114
"3413","2018","경남","통영시","초등학교",2018-04-01,"여자",723,757,749,-8,-26,-34,-0.0105680317040951,-0.0347129506008011,-0.0449141347424042
"3414","2018","경남","통영시","초등학교",2018-04-01,"남자",732,760,737,-23,-5,-28,-0.0302631578947368,-0.0067842605156038,-0.0368421052631579
"3415","2018","경남","사천시","초등학교",2018-04-01,"전체",1061,1117,1097,-20,-36,-56,-0.017905102954342,-0.03281677301732,-0.0501342882721576
"3416","2018","경남","사천시","초등학교",2018-04-01,"여자",507,537,521,-16,-14,-30,-0.0297951582867784,-0.0268714011516315,-0.0558659217877095
"3417","2018","경남","사천시","초등학교",2018-04-01,"남자",554,580,576,-4,-22,-26,-0.00689655172413793,-0.0381944444444444,-0.0448275862068966
"3418","2018","경남","김해시","초등학교",2018-04-01,"전체",5838,5979,5923,-56,-85,-141,-0.0093661147349055,-0.0143508357251393,-0.0235825388861014
"3419","2018","경남","김해시","초등학교",2018-04-01,"여자",2929,2982,2952,-30,-23,-53,-0.0100603621730382,-0.00779132791327913,-0.0177733065057009
"3420","2018","경남","김해시","초등학교",2018-04-01,"남자",2909,2997,2971,-26,-62,-88,-0.00867534200867534,-0.0208683944799731,-0.0293626960293627
"3421","2018","경남","밀양시","초등학교",2018-04-01,"전체",648,664,680,16,-32,-16,0.0240963855421687,-0.0470588235294118,-0.0240963855421687
"3422","2018","경남","밀양시","초등학교",2018-04-01,"여자",315,334,329,-5,-14,-19,-0.0149700598802395,-0.0425531914893617,-0.0568862275449102
"3423","2018","경남","밀양시","초등학교",2018-04-01,"남자",333,330,351,21,-18,3,0.0636363636363636,-0.0512820512820513,0.00909090909090909
"3424","2018","경남","거제시","초등학교",2018-04-01,"전체",3396,3626,3542,-84,-146,-230,-0.0231660231660232,-0.0412196499153021,-0.063430777716492
"3425","2018","경남","거제시","초등학교",2018-04-01,"여자",1665,1749,1716,-33,-51,-84,-0.0188679245283019,-0.0297202797202797,-0.0480274442538593
"3426","2018","경남","거제시","초등학교",2018-04-01,"남자",1731,1877,1826,-51,-95,-146,-0.0271710175812467,-0.052026286966046,-0.0777836973894512
"3427","2018","경남","양산시","초등학교",2018-04-01,"전체",3935,3567,3793,226,142,368,0.063358564620129,0.0374373846559452,0.103167928231006
"3428","2018","경남","양산시","초등학교",2018-04-01,"여자",1948,1760,1851,91,97,188,0.0517045454545455,0.0524041058887088,0.106818181818182
"3429","2018","경남","양산시","초등학교",2018-04-01,"남자",1987,1807,1942,135,45,180,0.0747094631986718,0.0231719876416066,0.0996126175982291
"3430","2018","경남","의령군","초등학교",2018-04-01,"전체",120,150,137,-13,-17,-30,-0.0866666666666667,-0.124087591240876,-0.2
"3431","2018","경남","의령군","초등학교",2018-04-01,"여자",66,81,72,-9,-6,-15,-0.111111111111111,-0.0833333333333333,-0.185185185185185
"3432","2018","경남","의령군","초등학교",2018-04-01,"남자",54,69,65,-4,-11,-15,-0.0579710144927536,-0.169230769230769,-0.217391304347826
"3433","2018","경남","함안군","초등학교",2018-04-01,"전체",598,602,594,-8,4,-4,-0.0132890365448505,0.00673400673400673,-0.00664451827242525
"3434","2018","경남","함안군","초등학교",2018-04-01,"여자",308,319,319,0,-11,-11,0,-0.0344827586206897,-0.0344827586206897
"3435","2018","경남","함안군","초등학교",2018-04-01,"남자",290,283,275,-8,15,7,-0.0282685512367491,0.0545454545454545,0.0247349823321555
"3436","2018","경남","창녕군","초등학교",2018-04-01,"전체",391,422,429,7,-38,-31,0.0165876777251185,-0.0885780885780886,-0.0734597156398104
"3437","2018","경남","창녕군","초등학교",2018-04-01,"여자",191,191,196,5,-5,0,0.0261780104712042,-0.0255102040816327,0
"3438","2018","경남","창녕군","초등학교",2018-04-01,"남자",200,231,233,2,-33,-31,0.00865800865800866,-0.141630901287554,-0.134199134199134
"3439","2018","경남","고성군","초등학교",2018-04-01,"전체",368,372,364,-8,4,-4,-0.021505376344086,0.010989010989011,-0.010752688172043
"3440","2018","경남","고성군","초등학교",2018-04-01,"여자",174,174,171,-3,3,0,-0.0172413793103448,0.0175438596491228,0
"3441","2018","경남","고성군","초등학교",2018-04-01,"남자",194,198,193,-5,1,-4,-0.0252525252525253,0.00518134715025907,-0.0202020202020202
"3442","2018","경남","남해군","초등학교",2018-04-01,"전체",197,202,209,7,-12,-5,0.0346534653465347,-0.0574162679425837,-0.0247524752475248
"3443","2018","경남","남해군","초등학교",2018-04-01,"여자",78,91,97,6,-19,-13,0.0659340659340659,-0.195876288659794,-0.142857142857143
"3444","2018","경남","남해군","초등학교",2018-04-01,"남자",119,111,112,1,7,8,0.00900900900900901,0.0625,0.0720720720720721
"3445","2018","경남","하동군","초등학교",2018-04-01,"전체",226,247,238,-9,-12,-21,-0.0364372469635627,-0.0504201680672269,-0.0850202429149798
"3446","2018","경남","하동군","초등학교",2018-04-01,"여자",95,121,114,-7,-19,-26,-0.0578512396694215,-0.166666666666667,-0.214876033057851
"3447","2018","경남","하동군","초등학교",2018-04-01,"남자",131,126,124,-2,7,5,-0.0158730158730159,0.0564516129032258,0.0396825396825397
"3448","2018","경남","산청군","초등학교",2018-04-01,"전체",149,163,154,-9,-5,-14,-0.0552147239263804,-0.0324675324675325,-0.0858895705521472
"3449","2018","경남","산청군","초등학교",2018-04-01,"여자",61,69,63,-6,-2,-8,-0.0869565217391304,-0.0317460317460317,-0.115942028985507
"3450","2018","경남","산청군","초등학교",2018-04-01,"남자",88,94,91,-3,-3,-6,-0.0319148936170213,-0.032967032967033,-0.0638297872340425
"3451","2018","경남","함양군","초등학교",2018-04-01,"전체",191,211,208,-3,-17,-20,-0.014218009478673,-0.0817307692307692,-0.0947867298578199
"3452","2018","경남","함양군","초등학교",2018-04-01,"여자",98,109,107,-2,-9,-11,-0.018348623853211,-0.0841121495327103,-0.100917431192661
"3453","2018","경남","함양군","초등학교",2018-04-01,"남자",93,102,101,-1,-8,-9,-0.00980392156862745,-0.0792079207920792,-0.0882352941176471
"3454","2018","경남","거창군","초등학교",2018-04-01,"전체",519,502,517,15,2,17,0.0298804780876494,0.00386847195357834,0.0338645418326693
"3455","2018","경남","거창군","초등학교",2018-04-01,"여자",250,236,237,1,13,14,0.00423728813559322,0.0548523206751055,0.0593220338983051
"3456","2018","경남","거창군","초등학교",2018-04-01,"남자",269,266,280,14,-11,3,0.0526315789473684,-0.0392857142857143,0.0112781954887218
"3457","2018","경남","합천군","초등학교",2018-04-01,"전체",212,247,239,-8,-27,-35,-0.0323886639676113,-0.112970711297071,-0.1417004048583
"3458","2018","경남","합천군","초등학교",2018-04-01,"여자",103,130,123,-7,-20,-27,-0.0538461538461538,-0.16260162601626,-0.207692307692308
"3459","2018","경남","합천군","초등학교",2018-04-01,"남자",109,117,116,-1,-7,-8,-0.00854700854700855,-0.0603448275862069,-0.0683760683760684
"3460","2018","제주","제주시","초등학교",2018-04-01,"전체",5182,5085,5204,119,-22,97,0.0234021632251721,-0.00422751729438893,0.0190757128810226
"3461","2018","제주","제주시","초등학교",2018-04-01,"여자",2515,2449,2513,64,2,66,0.0261331155573704,0.000795861520095503,0.0269497754185382
"3462","2018","제주","제주시","초등학교",2018-04-01,"남자",2667,2636,2691,55,-24,31,0.0208649468892261,-0.00891861761426979,0.0117602427921093
"3463","2018","제주","서귀포시","초등학교",2018-04-01,"전체",1618,1510,1605,95,13,108,0.0629139072847682,0.00809968847352025,0.071523178807947
"3464","2018","제주","서귀포시","초등학교",2018-04-01,"여자",736,712,750,38,-14,24,0.0533707865168539,-0.0186666666666667,0.0337078651685393
"3465","2018","제주","서귀포시","초등학교",2018-04-01,"남자",882,798,855,57,27,84,0.0714285714285714,0.0315789473684211,0.105263157894737
"3466","2019","서울","종로구","초등학교",2019-04-01,"전체",946,1014,1019,5,-73,-68,0.00493096646942801,-0.0716388616290481,-0.0670611439842209
"3467","2019","서울","종로구","초등학교",2019-04-01,"여자",468,490,497,7,-29,-22,0.0142857142857143,-0.0583501006036217,-0.0448979591836735
"3468","2019","서울","종로구","초등학교",2019-04-01,"남자",478,524,522,-2,-44,-46,-0.00381679389312977,-0.0842911877394636,-0.0877862595419847
"3469","2019","서울","중구","초등학교",2019-04-01,"전체",919,795,795,0,124,124,0,0.155974842767296,0.155974842767296
"3470","2019","서울","중구","초등학교",2019-04-01,"여자",460,397,399,2,61,63,0.00503778337531486,0.152882205513784,0.158690176322418
"3471","2019","서울","중구","초등학교",2019-04-01,"남자",459,398,396,-2,63,61,-0.0050251256281407,0.159090909090909,0.153266331658291
"3472","2019","서울","용산구","초등학교",2019-04-01,"전체",1245,1735,1695,-40,-450,-490,-0.0230547550432277,-0.265486725663717,-0.282420749279539
"3473","2019","서울","용산구","초등학교",2019-04-01,"여자",603,829,819,-10,-216,-226,-0.0120627261761158,-0.263736263736264,-0.272617611580217
"3474","2019","서울","용산구","초등학교",2019-04-01,"남자",642,906,876,-30,-234,-264,-0.033112582781457,-0.267123287671233,-0.291390728476821
"3475","2019","서울","성동구","초등학교",2019-04-01,"전체",2102,2467,2419,-48,-317,-365,-0.0194568301580867,-0.131045886730054,-0.147952979327118
"3476","2019","서울","성동구","초등학교",2019-04-01,"여자",1060,1196,1171,-25,-111,-136,-0.0209030100334448,-0.0947907771135781,-0.11371237458194
"3477","2019","서울","성동구","초등학교",2019-04-01,"남자",1042,1271,1248,-23,-206,-229,-0.018095987411487,-0.165064102564103,-0.180173092053501
"3478","2019","서울","광진구","초등학교",2019-04-01,"전체",2599,2564,2511,-53,88,35,-0.0206708268330733,0.0350457984866587,0.0136505460218409
"3479","2019","서울","광진구","초등학교",2019-04-01,"여자",1249,1266,1258,-8,-9,-17,-0.00631911532385466,-0.00715421303656598,-0.0134281200631912
"3480","2019","서울","광진구","초등학교",2019-04-01,"남자",1350,1298,1253,-45,97,52,-0.0346687211093991,0.077414205905826,0.0400616332819723
"3481","2019","서울","동대문구","초등학교",2019-04-01,"전체",2386,2610,2509,-101,-123,-224,-0.0386973180076628,-0.0490235153447589,-0.085823754789272
"3482","2019","서울","동대문구","초등학교",2019-04-01,"여자",1159,1260,1203,-57,-44,-101,-0.0452380952380952,-0.0365752285951787,-0.0801587301587302
"3483","2019","서울","동대문구","초등학교",2019-04-01,"남자",1227,1350,1306,-44,-79,-123,-0.0325925925925926,-0.060490045941807,-0.0911111111111111
"3484","2019","서울","중랑구","초등학교",2019-04-01,"전체",2717,3050,2917,-133,-200,-333,-0.0436065573770492,-0.0685635927322592,-0.109180327868852
"3485","2019","서울","중랑구","초등학교",2019-04-01,"여자",1301,1509,1445,-64,-144,-208,-0.0424121935056329,-0.0996539792387543,-0.137839628893307
"3486","2019","서울","중랑구","초등학교",2019-04-01,"남자",1416,1541,1472,-69,-56,-125,-0.0447761194029851,-0.0380434782608696,-0.0811161583387411
"3487","2019","서울","성북구","초등학교",2019-04-01,"전체",3539,3621,3563,-58,-24,-82,-0.016017674675504,-0.00673589671625035,-0.0226456779895057
"3488","2019","서울","성북구","초등학교",2019-04-01,"여자",1712,1797,1772,-25,-60,-85,-0.0139120756816917,-0.0338600451467269,-0.0473010573177518
"3489","2019","서울","성북구","초등학교",2019-04-01,"남자",1827,1824,1791,-33,36,3,-0.0180921052631579,0.0201005025125628,0.00164473684210526
"3490","2019","서울","강북구","초등학교",2019-04-01,"전체",1706,2251,2151,-100,-445,-545,-0.0444247001332741,-0.206880520688052,-0.242114615726344
"3491","2019","서울","강북구","초등학교",2019-04-01,"여자",814,1076,1010,-66,-196,-262,-0.0613382899628253,-0.194059405940594,-0.243494423791822
"3492","2019","서울","강북구","초등학교",2019-04-01,"남자",892,1175,1141,-34,-249,-283,-0.028936170212766,-0.218229623137599,-0.240851063829787
"3493","2019","서울","도봉구","초등학교",2019-04-01,"전체",2601,2545,2479,-66,122,56,-0.0259332023575638,0.0492133924969746,0.0220039292730845
"3494","2019","서울","도봉구","초등학교",2019-04-01,"여자",1253,1228,1182,-46,71,25,-0.0374592833876222,0.0600676818950931,0.0203583061889251
"3495","2019","서울","도봉구","초등학교",2019-04-01,"남자",1348,1317,1297,-20,51,31,-0.0151860288534548,0.0393215111796453,0.023538344722855
"3496","2019","서울","노원구","초등학교",2019-04-01,"전체",4318,4368,4213,-155,105,-50,-0.035485347985348,0.0249228578210301,-0.0114468864468864
"3497","2019","서울","노원구","초등학교",2019-04-01,"여자",2101,2100,2011,-89,90,1,-0.0423809523809524,0.0447538538040776,0.000476190476190476
"3498","2019","서울","노원구","초등학교",2019-04-01,"남자",2217,2268,2202,-66,15,-51,-0.0291005291005291,0.00681198910081744,-0.0224867724867725
"3499","2019","서울","은평구","초등학교",2019-04-01,"전체",3686,3863,3734,-129,-48,-177,-0.0333937354387782,-0.0128548473486877,-0.0458193114159979
"3500","2019","서울","은평구","초등학교",2019-04-01,"여자",1756,1874,1802,-72,-46,-118,-0.0384204909284952,-0.025527192008879,-0.0629669156883671
"3501","2019","서울","은평구","초등학교",2019-04-01,"남자",1930,1989,1932,-57,-2,-59,-0.028657616892911,-0.0010351966873706,-0.0296631473102061
"3502","2019","서울","서대문구","초등학교",2019-04-01,"전체",2243,2335,2233,-102,10,-92,-0.0436830835117773,0.00447828034034931,-0.0394004282655246
"3503","2019","서울","서대문구","초등학교",2019-04-01,"여자",1099,1144,1108,-36,-9,-45,-0.0314685314685315,-0.00812274368231047,-0.0393356643356643
"3504","2019","서울","서대문구","초등학교",2019-04-01,"남자",1144,1191,1125,-66,19,-47,-0.0554156171284635,0.0168888888888889,-0.0394626364399664
"3505","2019","서울","마포구","초등학교",2019-04-01,"전체",2572,3023,2944,-79,-372,-451,-0.0261329804829639,-0.126358695652174,-0.149189546807807
"3506","2019","서울","마포구","초등학교",2019-04-01,"여자",1260,1515,1469,-46,-209,-255,-0.0303630363036304,-0.142273655547992,-0.168316831683168
"3507","2019","서울","마포구","초등학교",2019-04-01,"남자",1312,1508,1475,-33,-163,-196,-0.0218832891246684,-0.110508474576271,-0.129973474801061
"3508","2019","서울","양천구","초등학교",2019-04-01,"전체",3731,3805,3876,71,-145,-74,0.0186596583442838,-0.0374097007223942,-0.0194480946123522
"3509","2019","서울","양천구","초등학교",2019-04-01,"여자",1832,1869,1924,55,-92,-37,0.0294275013376137,-0.0478170478170478,-0.019796682718031
"3510","2019","서울","양천구","초등학교",2019-04-01,"남자",1899,1936,1952,16,-53,-37,0.00826446280991736,-0.0271516393442623,-0.0191115702479339
"3511","2019","서울","강서구","초등학교",2019-04-01,"전체",4946,5320,5205,-115,-259,-374,-0.0216165413533835,-0.049759846301633,-0.0703007518796993
"3512","2019","서울","강서구","초등학교",2019-04-01,"여자",2390,2643,2576,-67,-186,-253,-0.0253499810821037,-0.0722049689440994,-0.0957245554294363
"3513","2019","서울","강서구","초등학교",2019-04-01,"남자",2556,2677,2629,-48,-73,-121,-0.0179305192379529,-0.0277672118676303,-0.0451998505790063
"3514","2019","서울","구로구","초등학교",2019-04-01,"전체",3305,3753,3493,-260,-188,-448,-0.0692779110045297,-0.0538219295734326,-0.119371169730882
"3515","2019","서울","구로구","초등학교",2019-04-01,"여자",1690,1895,1767,-128,-77,-205,-0.0675461741424802,-0.0435766836445954,-0.108179419525066
"3516","2019","서울","구로구","초등학교",2019-04-01,"남자",1615,1858,1726,-132,-111,-243,-0.0710441334768568,-0.0643105446118192,-0.130785791173305
"3517","2019","서울","금천구","초등학교",2019-04-01,"전체",1656,1751,1633,-118,23,-95,-0.067390062821245,0.0140845070422535,-0.0542547115933752
"3518","2019","서울","금천구","초등학교",2019-04-01,"여자",812,865,811,-54,1,-53,-0.0624277456647399,0.00123304562268804,-0.061271676300578
"3519","2019","서울","금천구","초등학교",2019-04-01,"남자",844,886,822,-64,22,-42,-0.072234762979684,0.0267639902676399,-0.0474040632054176
"3520","2019","서울","영등포구","초등학교",2019-04-01,"전체",2564,2889,2816,-73,-252,-325,-0.0252682589131187,-0.0894886363636364,-0.112495673243337
"3521","2019","서울","영등포구","초등학교",2019-04-01,"여자",1279,1433,1397,-36,-118,-154,-0.0251221214235869,-0.0844667143879742,-0.107466852756455
"3522","2019","서울","영등포구","초등학교",2019-04-01,"남자",1285,1456,1419,-37,-134,-171,-0.0254120879120879,-0.0944326990838619,-0.117445054945055
"3523","2019","서울","동작구","초등학교",2019-04-01,"전체",2805,3123,3020,-103,-215,-318,-0.0329811079090618,-0.0711920529801325,-0.101825168107589
"3524","2019","서울","동작구","초등학교",2019-04-01,"여자",1378,1503,1456,-47,-78,-125,-0.0312707917498337,-0.0535714285714286,-0.083166999334664
"3525","2019","서울","동작구","초등학교",2019-04-01,"남자",1427,1620,1564,-56,-137,-193,-0.0345679012345679,-0.0875959079283887,-0.119135802469136
"3526","2019","서울","관악구","초등학교",2019-04-01,"전체",2581,3181,2999,-182,-418,-600,-0.0572147123546055,-0.139379793264421,-0.188619930839359
"3527","2019","서울","관악구","초등학교",2019-04-01,"여자",1263,1567,1479,-88,-216,-304,-0.0561582641991066,-0.14604462474645,-0.194001276324186
"3528","2019","서울","관악구","초등학교",2019-04-01,"남자",1318,1614,1520,-94,-202,-296,-0.0582403965303594,-0.132894736842105,-0.183395291201983
"3529","2019","서울","서초구","초등학교",2019-04-01,"전체",3854,4349,4375,26,-521,-495,0.00597838583582433,-0.119085714285714,-0.113819268797425
"3530","2019","서울","서초구","초등학교",2019-04-01,"여자",1870,2121,2147,26,-277,-251,0.0122583686940123,-0.129017233348859,-0.118340405469118
"3531","2019","서울","서초구","초등학교",2019-04-01,"남자",1984,2228,2228,0,-244,-244,0,-0.10951526032316,-0.10951526032316
"3532","2019","서울","강남구","초등학교",2019-04-01,"전체",4096,4468,4501,33,-405,-372,0.00738585496866607,-0.089980004443457,-0.0832587287376902
"3533","2019","서울","강남구","초등학교",2019-04-01,"여자",1980,2185,2194,9,-214,-205,0.00411899313501144,-0.097538742023701,-0.0938215102974828
"3534","2019","서울","강남구","초등학교",2019-04-01,"남자",2116,2283,2307,24,-191,-167,0.0105124835742444,-0.082791504117902,-0.0731493648707841
"3535","2019","서울","송파구","초등학교",2019-04-01,"전체",5620,5748,5763,15,-143,-128,0.00260960334029228,-0.0248134652090925,-0.0222686151704941
"3536","2019","서울","송파구","초등학교",2019-04-01,"여자",2767,2819,2810,-9,-43,-52,-0.00319262149698475,-0.0153024911032028,-0.0184462575381341
"3537","2019","서울","송파구","초등학교",2019-04-01,"남자",2853,2929,2953,24,-100,-76,0.00819392284055992,-0.0338638672536404,-0.0259474223284397
"3538","2019","서울","강동구","초등학교",2019-04-01,"전체",3292,3616,3441,-175,-149,-324,-0.048396017699115,-0.043301365882011,-0.0896017699115044
"3539","2019","서울","강동구","초등학교",2019-04-01,"여자",1581,1736,1640,-96,-59,-155,-0.0552995391705069,-0.0359756097560976,-0.0892857142857143
"3540","2019","서울","강동구","초등학교",2019-04-01,"남자",1711,1880,1801,-79,-90,-169,-0.0420212765957447,-0.0499722376457524,-0.0898936170212766
"3541","2019","부산","중구","초등학교",2019-04-01,"전체",229,206,181,-25,48,23,-0.121359223300971,0.265193370165746,0.111650485436893
"3542","2019","부산","중구","초등학교",2019-04-01,"여자",104,105,93,-12,11,-1,-0.114285714285714,0.118279569892473,-0.00952380952380952
"3543","2019","부산","중구","초등학교",2019-04-01,"남자",125,101,88,-13,37,24,-0.128712871287129,0.420454545454545,0.237623762376238
"3544","2019","부산","서구","초등학교",2019-04-01,"전체",655,596,621,25,34,59,0.0419463087248322,0.0547504025764895,0.098993288590604
"3545","2019","부산","서구","초등학교",2019-04-01,"여자",319,273,277,4,42,46,0.0146520146520147,0.151624548736462,0.168498168498169
"3546","2019","부산","서구","초등학교",2019-04-01,"남자",336,323,344,21,-8,13,0.065015479876161,-0.0232558139534884,0.0402476780185759
"3547","2019","부산","동구","초등학교",2019-04-01,"전체",404,456,435,-21,-31,-52,-0.0460526315789474,-0.071264367816092,-0.114035087719298
"3548","2019","부산","동구","초등학교",2019-04-01,"여자",198,217,204,-13,-6,-19,-0.0599078341013825,-0.0294117647058824,-0.0875576036866359
"3549","2019","부산","동구","초등학교",2019-04-01,"남자",206,239,231,-8,-25,-33,-0.0334728033472803,-0.108225108225108,-0.138075313807531
"3550","2019","부산","영도구","초등학교",2019-04-01,"전체",645,702,691,-11,-46,-57,-0.0156695156695157,-0.0665701881331404,-0.0811965811965812
"3551","2019","부산","영도구","초등학교",2019-04-01,"여자",297,340,331,-9,-34,-43,-0.0264705882352941,-0.102719033232628,-0.126470588235294
"3552","2019","부산","영도구","초등학교",2019-04-01,"남자",348,362,360,-2,-12,-14,-0.00552486187845304,-0.0333333333333333,-0.0386740331491713
"3553","2019","부산","부산진구","초등학교",2019-04-01,"전체",2739,2716,2653,-63,86,23,-0.0231958762886598,0.0324161326799849,0.00846833578792342
"3554","2019","부산","부산진구","초등학교",2019-04-01,"여자",1353,1359,1333,-26,20,-6,-0.0191317144959529,0.0150037509377344,-0.00441501103752759
"3555","2019","부산","부산진구","초등학교",2019-04-01,"남자",1386,1357,1320,-37,66,29,-0.0272660280029477,0.05,0.0213706705969049
"3556","2019","부산","동래구","초등학교",2019-04-01,"전체",2225,2194,2171,-23,54,31,-0.0104831358249772,0.0248733302625518,0.0141294439380128
"3557","2019","부산","동래구","초등학교",2019-04-01,"여자",1058,1056,1046,-10,12,2,-0.00946969696969697,0.011472275334608,0.00189393939393939
"3558","2019","부산","동래구","초등학교",2019-04-01,"남자",1167,1138,1125,-13,42,29,-0.0114235500878735,0.0373333333333333,0.0254833040421793
"3559","2019","부산","남구","초등학교",2019-04-01,"전체",2214,2045,2101,56,113,169,0.0273838630806846,0.0537839124226559,0.082640586797066
"3560","2019","부산","남구","초등학교",2019-04-01,"여자",1098,987,1023,36,75,111,0.0364741641337386,0.0733137829912024,0.112462006079027
"3561","2019","부산","남구","초등학교",2019-04-01,"남자",1116,1058,1078,20,38,58,0.0189035916824197,0.0352504638218924,0.054820415879017
"3562","2019","부산","북구","초등학교",2019-04-01,"전체",2275,2468,2370,-98,-95,-193,-0.039708265802269,-0.040084388185654,-0.0782009724473258
"3563","2019","부산","북구","초등학교",2019-04-01,"여자",1080,1189,1139,-50,-59,-109,-0.0420521446593776,-0.0517998244073749,-0.0916736753574432
"3564","2019","부산","북구","초등학교",2019-04-01,"남자",1195,1279,1231,-48,-36,-84,-0.037529319781079,-0.0292445166531275,-0.0656763096168882
"3565","2019","부산","해운대구","초등학교",2019-04-01,"전체",3398,3574,3550,-24,-152,-176,-0.00671516508114158,-0.0428169014084507,-0.0492445439283716
"3566","2019","부산","해운대구","초등학교",2019-04-01,"여자",1605,1664,1647,-17,-42,-59,-0.0102163461538462,-0.0255009107468124,-0.0354567307692308
"3567","2019","부산","해운대구","초등학교",2019-04-01,"남자",1793,1910,1903,-7,-110,-117,-0.00366492146596859,-0.0578034682080925,-0.0612565445026178
"3568","2019","부산","사하구","초등학교",2019-04-01,"전체",2572,2740,2681,-59,-109,-168,-0.0215328467153285,-0.0406564714658709,-0.0613138686131387
"3569","2019","부산","사하구","초등학교",2019-04-01,"여자",1282,1360,1341,-19,-59,-78,-0.0139705882352941,-0.0439970171513796,-0.0573529411764706
"3570","2019","부산","사하구","초등학교",2019-04-01,"남자",1290,1380,1340,-40,-50,-90,-0.0289855072463768,-0.0373134328358209,-0.0652173913043478
"3571","2019","부산","금정구","초등학교",2019-04-01,"전체",1702,1594,1680,86,22,108,0.0539523212045169,0.0130952380952381,0.067754077791719
"3572","2019","부산","금정구","초등학교",2019-04-01,"여자",812,776,815,39,-3,36,0.0502577319587629,-0.00368098159509202,0.0463917525773196
"3573","2019","부산","금정구","초등학교",2019-04-01,"남자",890,818,865,47,25,72,0.0574572127139364,0.0289017341040462,0.0880195599022005
"3574","2019","부산","강서구","초등학교",2019-04-01,"전체",1958,1833,1908,75,50,125,0.0409165302782324,0.0262054507337526,0.0681942171303873
"3575","2019","부산","강서구","초등학교",2019-04-01,"여자",925,874,904,30,21,51,0.034324942791762,0.0232300884955752,0.0583524027459954
"3576","2019","부산","강서구","초등학교",2019-04-01,"남자",1033,959,1004,45,29,74,0.0469238790406674,0.0288844621513944,0.0771637122002086
"3577","2019","부산","연제구","초등학교",2019-04-01,"전체",1654,1619,1606,-13,48,35,-0.0080296479308215,0.0298879202988792,0.0216182828906733
"3578","2019","부산","연제구","초등학교",2019-04-01,"여자",825,813,810,-3,15,12,-0.003690036900369,0.0185185185185185,0.014760147601476
"3579","2019","부산","연제구","초등학교",2019-04-01,"남자",829,806,796,-10,33,23,-0.0124069478908189,0.0414572864321608,0.0285359801488834
"3580","2019","부산","수영구","초등학교",2019-04-01,"전체",1042,1247,1251,4,-209,-205,0.00320769847634322,-0.167066346922462,-0.16439454691259
"3581","2019","부산","수영구","초등학교",2019-04-01,"여자",507,602,599,-3,-92,-95,-0.00498338870431894,-0.153589315525876,-0.1578073089701
"3582","2019","부산","수영구","초등학교",2019-04-01,"남자",535,645,652,7,-117,-110,0.0108527131782946,-0.179447852760736,-0.170542635658915
"3583","2019","부산","사상구","초등학교",2019-04-01,"전체",1489,1759,1683,-76,-194,-270,-0.0432063672541217,-0.115270350564468,-0.15349630471859
"3584","2019","부산","사상구","초등학교",2019-04-01,"여자",739,899,857,-42,-118,-160,-0.0467185761957731,-0.137689614935823,-0.17797552836485
"3585","2019","부산","사상구","초등학교",2019-04-01,"남자",750,860,826,-34,-76,-110,-0.0395348837209302,-0.0920096852300242,-0.127906976744186
"3586","2019","부산","기장군","초등학교",2019-04-01,"전체",2166,2302,2271,-31,-105,-136,-0.0134665508253692,-0.0462351387054161,-0.0590790616854909
"3587","2019","부산","기장군","초등학교",2019-04-01,"여자",1066,1132,1107,-25,-41,-66,-0.0220848056537102,-0.037037037037037,-0.0583038869257951
"3588","2019","부산","기장군","초등학교",2019-04-01,"남자",1100,1170,1164,-6,-64,-70,-0.00512820512820513,-0.0549828178694158,-0.0598290598290598
"3589","2019","대구","중구","초등학교",2019-04-01,"전체",787,596,614,18,173,191,0.0302013422818792,0.281758957654723,0.320469798657718
"3590","2019","대구","중구","초등학교",2019-04-01,"여자",351,270,273,3,78,81,0.0111111111111111,0.285714285714286,0.3
"3591","2019","대구","중구","초등학교",2019-04-01,"남자",436,326,341,15,95,110,0.0460122699386503,0.278592375366569,0.337423312883436
"3592","2019","대구","동구","초등학교",2019-04-01,"전체",3154,3271,3165,-106,-11,-117,-0.0324059920513604,-0.00347551342812006,-0.0357688780189544
"3593","2019","대구","동구","초등학교",2019-04-01,"여자",1510,1591,1530,-61,-20,-81,-0.038340666247643,-0.0130718954248366,-0.0509113764927718
"3594","2019","대구","동구","초등학교",2019-04-01,"남자",1644,1680,1635,-45,9,-36,-0.0267857142857143,0.0055045871559633,-0.0214285714285714
"3595","2019","대구","서구","초등학교",2019-04-01,"전체",1024,1169,1092,-77,-68,-145,-0.0658682634730539,-0.0622710622710623,-0.124037639007699
"3596","2019","대구","서구","초등학교",2019-04-01,"여자",515,597,568,-29,-53,-82,-0.0485762144053601,-0.0933098591549296,-0.137353433835846
"3597","2019","대구","서구","초등학교",2019-04-01,"남자",509,572,524,-48,-15,-63,-0.0839160839160839,-0.0286259541984733,-0.11013986013986
"3598","2019","대구","남구","초등학교",2019-04-01,"전체",737,909,857,-52,-120,-172,-0.0572057205720572,-0.14002333722287,-0.189218921892189
"3599","2019","대구","남구","초등학교",2019-04-01,"여자",366,466,428,-38,-62,-100,-0.0815450643776824,-0.144859813084112,-0.214592274678112
"3600","2019","대구","남구","초등학교",2019-04-01,"남자",371,443,429,-14,-58,-72,-0.0316027088036117,-0.135198135198135,-0.162528216704289
"3601","2019","대구","북구","초등학교",2019-04-01,"전체",3864,4112,4115,3,-251,-248,0.000729571984435798,-0.060996354799514,-0.0603112840466926
"3602","2019","대구","북구","초등학교",2019-04-01,"여자",1897,1976,2008,32,-111,-79,0.0161943319838057,-0.0552788844621514,-0.0399797570850202
"3603","2019","대구","북구","초등학교",2019-04-01,"남자",1967,2136,2107,-29,-140,-169,-0.0135767790262172,-0.0664451827242525,-0.0791198501872659
"3604","2019","대구","수성구","초등학교",2019-04-01,"전체",3675,3452,3587,135,88,223,0.0391077636152955,0.0245330359632004,0.0646002317497103
"3605","2019","대구","수성구","초등학교",2019-04-01,"여자",1756,1687,1743,56,13,69,0.033195020746888,0.00745840504876649,0.040901007705987
"3606","2019","대구","수성구","초등학교",2019-04-01,"남자",1919,1765,1844,79,75,154,0.0447592067988669,0.0406724511930586,0.0872521246458924
"3607","2019","대구","달서구","초등학교",2019-04-01,"전체",5343,5186,5050,-136,293,157,-0.0262244504435017,0.058019801980198,0.0302738141149248
"3608","2019","대구","달서구","초등학교",2019-04-01,"여자",2666,2550,2495,-55,171,116,-0.0215686274509804,0.0685370741482966,0.0454901960784314
"3609","2019","대구","달서구","초등학교",2019-04-01,"남자",2677,2636,2555,-81,122,41,-0.0307283763277693,0.0477495107632094,0.0155538694992413
"3610","2019","대구","달성군","초등학교",2019-04-01,"전체",3044,2942,3203,261,-159,102,0.0887151597552685,-0.0496409615985014,0.0346702923181509
"3611","2019","대구","달성군","초등학교",2019-04-01,"여자",1475,1414,1513,99,-38,61,0.07001414427157,-0.0251156642432254,0.0431400282885431
"3612","2019","대구","달성군","초등학교",2019-04-01,"남자",1569,1528,1690,162,-121,41,0.106020942408377,-0.0715976331360947,0.0268324607329843
"3613","2019","인천","중구","초등학교",2019-04-01,"전체",1442,1199,1203,4,239,243,0.00333611342785655,0.198669991687448,0.202668890742285
"3614","2019","인천","중구","초등학교",2019-04-01,"여자",696,598,598,0,98,98,0,0.163879598662207,0.163879598662207
"3615","2019","인천","중구","초등학교",2019-04-01,"남자",746,601,605,4,141,145,0.00665557404326123,0.233057851239669,0.24126455906822
"3616","2019","인천","동구","초등학교",2019-04-01,"전체",658,609,555,-54,103,49,-0.0886699507389163,0.185585585585586,0.0804597701149425
"3617","2019","인천","동구","초등학교",2019-04-01,"여자",333,301,276,-25,57,32,-0.0830564784053156,0.206521739130435,0.106312292358804
"3618","2019","인천","동구","초등학교",2019-04-01,"남자",325,308,279,-29,46,17,-0.0941558441558442,0.164874551971326,0.0551948051948052
"3619","2019","인천","연수구","초등학교",2019-04-01,"전체",3981,3545,3740,195,241,436,0.0550070521861777,0.0644385026737968,0.122990126939351
"3620","2019","인천","연수구","초등학교",2019-04-01,"여자",1964,1732,1847,115,117,232,0.0663972286374134,0.063345966432052,0.133949191685912
"3621","2019","인천","연수구","초등학교",2019-04-01,"남자",2017,1813,1893,80,124,204,0.0441257584114727,0.0655044902271527,0.112520683949255
"3622","2019","인천","미추홀구","초등학교",2019-04-01,"전체",3144,3497,3442,-55,-298,-353,-0.0157277666571347,-0.0865775711795468,-0.100943665999428
"3623","2019","인천","미추홀구","초등학교",2019-04-01,"여자",1511,1734,1684,-50,-173,-223,-0.0288350634371396,-0.102731591448931,-0.128604382929642
"3624","2019","인천","미추홀구","초등학교",2019-04-01,"남자",1633,1763,1758,-5,-125,-130,-0.00283607487237663,-0.0711035267349261,-0.0737379466817924
"3625","2019","인천","남동구","초등학교",2019-04-01,"전체",5246,5572,5587,15,-341,-326,0.00269203158650395,-0.0610345444782531,-0.0585068198133525
"3626","2019","인천","남동구","초등학교",2019-04-01,"여자",2567,2682,2703,21,-136,-115,0.00782997762863535,-0.050314465408805,-0.0428784489187174
"3627","2019","인천","남동구","초등학교",2019-04-01,"남자",2679,2890,2884,-6,-205,-211,-0.00207612456747405,-0.0710818307905687,-0.0730103806228374
"3628","2019","인천","부평구","초등학교",2019-04-01,"전체",4246,4570,4324,-246,-78,-324,-0.0538293216630197,-0.0180388529139685,-0.0708971553610503
"3629","2019","인천","부평구","초등학교",2019-04-01,"여자",2076,2248,2115,-133,-39,-172,-0.0591637010676157,-0.0184397163120567,-0.0765124555160142
"3630","2019","인천","부평구","초등학교",2019-04-01,"남자",2170,2322,2209,-113,-39,-152,-0.0486649440137812,-0.0176550475328203,-0.0654608096468562
"3631","2019","인천","계양구","초등학교",2019-04-01,"전체",2465,2755,2585,-170,-120,-290,-0.0617059891107078,-0.04642166344294,-0.105263157894737
"3632","2019","인천","계양구","초등학교",2019-04-01,"여자",1207,1351,1270,-81,-63,-144,-0.0599555884529978,-0.0496062992125984,-0.106587712805329
"3633","2019","인천","계양구","초등학교",2019-04-01,"남자",1258,1404,1315,-89,-57,-146,-0.0633903133903134,-0.0433460076045627,-0.103988603988604
"3634","2019","인천","서구","초등학교",2019-04-01,"전체",5921,5914,6024,110,-103,7,0.0185999323638823,-0.0170982735723772,0.00118363205951978
"3635","2019","인천","서구","초등학교",2019-04-01,"여자",2826,2854,2902,48,-76,-28,0.0168185003503854,-0.0261888352860096,-0.00981079187105816
"3636","2019","인천","서구","초등학교",2019-04-01,"남자",3095,3060,3122,62,-27,35,0.0202614379084967,-0.00864830237027546,0.011437908496732
"3637","2019","인천","강화군","초등학교",2019-04-01,"전체",353,381,395,14,-42,-28,0.036745406824147,-0.106329113924051,-0.073490813648294
"3638","2019","인천","강화군","초등학교",2019-04-01,"여자",170,185,190,5,-20,-15,0.027027027027027,-0.105263157894737,-0.0810810810810811
"3639","2019","인천","강화군","초등학교",2019-04-01,"남자",183,196,205,9,-22,-13,0.0459183673469388,-0.107317073170732,-0.0663265306122449
"3640","2019","인천","옹진군","초등학교",2019-04-01,"전체",102,120,123,3,-21,-18,0.025,-0.170731707317073,-0.15
"3641","2019","인천","옹진군","초등학교",2019-04-01,"여자",55,60,64,4,-9,-5,0.0666666666666667,-0.140625,-0.0833333333333333
"3642","2019","인천","옹진군","초등학교",2019-04-01,"남자",47,60,59,-1,-12,-13,-0.0166666666666667,-0.203389830508475,-0.216666666666667
"3643","2019","광주","동구","초등학교",2019-04-01,"전체",587,716,679,-37,-92,-129,-0.0516759776536313,-0.135493372606775,-0.180167597765363
"3644","2019","광주","동구","초등학교",2019-04-01,"여자",295,358,337,-21,-42,-63,-0.058659217877095,-0.124629080118694,-0.175977653631285
"3645","2019","광주","동구","초등학교",2019-04-01,"남자",292,358,342,-16,-50,-66,-0.0446927374301676,-0.146198830409357,-0.184357541899441
"3646","2019","광주","서구","초등학교",2019-04-01,"전체",2803,2776,2773,-3,30,27,-0.0010806916426513,0.0108186080057699,0.00972622478386167
"3647","2019","광주","서구","초등학교",2019-04-01,"여자",1331,1327,1318,-9,13,4,-0.00678221552373775,0.00986342943854325,0.00301431801055011
"3648","2019","광주","서구","초등학교",2019-04-01,"남자",1472,1449,1455,6,17,23,0.0041407867494824,0.0116838487972509,0.0158730158730159
"3649","2019","광주","남구","초등학교",2019-04-01,"전체",2317,2006,2058,52,259,311,0.0259222333000997,0.125850340136054,0.155034895314058
"3650","2019","광주","남구","초등학교",2019-04-01,"여자",1112,944,963,19,149,168,0.0201271186440678,0.15472481827622,0.177966101694915
"3651","2019","광주","남구","초등학교",2019-04-01,"남자",1205,1062,1095,33,110,143,0.0310734463276836,0.100456621004566,0.134651600753296
"3652","2019","광주","북구","초등학교",2019-04-01,"전체",4081,3868,3943,75,138,213,0.0193898655635988,0.0349987319300025,0.0550672182006205
"3653","2019","광주","북구","초등학교",2019-04-01,"여자",1971,1846,1869,23,102,125,0.0124593716143012,0.0545746388443018,0.0677139761646804
"3654","2019","광주","북구","초등학교",2019-04-01,"남자",2110,2022,2074,52,36,88,0.0257171117705242,0.017357762777242,0.0435212660731949
"3655","2019","광주","광산구","초등학교",2019-04-01,"전체",5395,5210,5246,36,149,185,0.00690978886756238,0.0284025924513915,0.0355086372360845
"3656","2019","광주","광산구","초등학교",2019-04-01,"여자",2575,2519,2549,30,26,56,0.0119094878920206,0.010200078462142,0.0222310440651052
"3657","2019","광주","광산구","초등학교",2019-04-01,"남자",2820,2691,2697,6,123,129,0.00222965440356745,0.0456062291434928,0.0479375696767001
"3658","2019","대전","동구","초등학교",2019-04-01,"전체",1869,2074,1946,-128,-77,-205,-0.0617164898746384,-0.039568345323741,-0.0988428158148505
"3659","2019","대전","동구","초등학교",2019-04-01,"여자",940,1055,976,-79,-36,-115,-0.0748815165876777,-0.0368852459016393,-0.109004739336493
"3660","2019","대전","동구","초등학교",2019-04-01,"남자",929,1019,970,-49,-41,-90,-0.0480863591756624,-0.0422680412371134,-0.0883218842001963
"3661","2019","대전","중구","초등학교",2019-04-01,"전체",2024,2134,2068,-66,-44,-110,-0.0309278350515464,-0.0212765957446809,-0.0515463917525773
"3662","2019","대전","중구","초등학교",2019-04-01,"여자",986,1041,1020,-21,-34,-55,-0.0201729106628242,-0.0333333333333333,-0.0528338136407301
"3663","2019","대전","중구","초등학교",2019-04-01,"남자",1038,1093,1048,-45,-10,-55,-0.0411710887465691,-0.00954198473282443,-0.05032021957914
"3664","2019","대전","서구","초등학교",2019-04-01,"전체",4556,4672,4673,1,-117,-116,0.000214041095890411,-0.0250374491761181,-0.0248287671232877
"3665","2019","대전","서구","초등학교",2019-04-01,"여자",2217,2307,2281,-26,-64,-90,-0.011270047680971,-0.0280578693555458,-0.0390117035110533
"3666","2019","대전","서구","초등학교",2019-04-01,"남자",2339,2365,2392,27,-53,-26,0.0114164904862579,-0.0221571906354515,-0.0109936575052854
"3667","2019","대전","유성구","초등학교",2019-04-01,"전체",4129,4174,4191,17,-62,-45,0.00407283181600383,-0.0147936053447864,-0.0107810253953043
"3668","2019","대전","유성구","초등학교",2019-04-01,"여자",1988,1999,2014,15,-26,-11,0.00750375187593797,-0.012909632571996,-0.00550275137568784
"3669","2019","대전","유성구","초등학교",2019-04-01,"남자",2141,2175,2177,2,-36,-34,0.000919540229885057,-0.0165365181442352,-0.015632183908046
"3670","2019","대전","대덕구","초등학교",2019-04-01,"전체",1376,1551,1483,-68,-107,-175,-0.0438426821405545,-0.0721510451786918,-0.112830431979368
"3671","2019","대전","대덕구","초등학교",2019-04-01,"여자",660,775,744,-31,-84,-115,-0.04,-0.112903225806452,-0.148387096774194
"3672","2019","대전","대덕구","초등학교",2019-04-01,"남자",716,776,739,-37,-23,-60,-0.047680412371134,-0.0311231393775372,-0.077319587628866
"3673","2019","울산","중구","초등학교",2019-04-01,"전체",2188,2310,2231,-79,-43,-122,-0.0341991341991342,-0.0192738682205289,-0.0528138528138528
"3674","2019","울산","중구","초등학교",2019-04-01,"여자",1001,1108,1077,-31,-76,-107,-0.0279783393501805,-0.0705663881151346,-0.0965703971119134
"3675","2019","울산","중구","초등학교",2019-04-01,"남자",1187,1202,1154,-48,33,-15,-0.0399334442595674,0.0285961871750433,-0.0124792013311148
"3676","2019","울산","남구","초등학교",2019-04-01,"전체",2817,2925,2862,-63,-45,-108,-0.0215384615384615,-0.0157232704402516,-0.0369230769230769
"3677","2019","울산","남구","초등학교",2019-04-01,"여자",1367,1424,1404,-20,-37,-57,-0.0140449438202247,-0.0263532763532764,-0.0400280898876405
"3678","2019","울산","남구","초등학교",2019-04-01,"남자",1450,1501,1458,-43,-8,-51,-0.0286475682878081,-0.00548696844993141,-0.0339773484343771
"3679","2019","울산","동구","초등학교",2019-04-01,"전체",1920,2035,1918,-117,2,-115,-0.0574938574938575,0.00104275286757039,-0.0565110565110565
"3680","2019","울산","동구","초등학교",2019-04-01,"여자",939,985,918,-67,21,-46,-0.0680203045685279,0.0228758169934641,-0.0467005076142132
"3681","2019","울산","동구","초등학교",2019-04-01,"남자",981,1050,1000,-50,-19,-69,-0.0476190476190476,-0.019,-0.0657142857142857
"3682","2019","울산","북구","초등학교",2019-04-01,"전체",2828,2620,2733,113,95,208,0.0431297709923664,0.0347603366264179,0.0793893129770992
"3683","2019","울산","북구","초등학교",2019-04-01,"여자",1369,1279,1343,64,26,90,0.0500390930414386,0.0193596425912137,0.0703674745895231
"3684","2019","울산","북구","초등학교",2019-04-01,"남자",1459,1341,1390,49,69,118,0.0365398956002983,0.0496402877697842,0.0879940343027591
"3685","2019","울산","울주군","초등학교",2019-04-01,"전체",2328,2189,2199,10,129,139,0.00456829602558246,0.0586630286493861,0.0634993147555962
"3686","2019","울산","울주군","초등학교",2019-04-01,"여자",1185,1116,1112,-4,73,69,-0.003584229390681,0.0656474820143885,0.0618279569892473
"3687","2019","울산","울주군","초등학교",2019-04-01,"남자",1143,1073,1087,14,56,70,0.0130475302889096,0.0515179392824287,0.065237651444548
"3688","2019","세종","세종시","초등학교",2019-04-01,"전체",5004,3836,4529,693,475,1168,0.180656934306569,0.104879664385074,0.304483837330553
"3689","2019","세종","세종시","초등학교",2019-04-01,"전체",5004,3836,4529,693,475,1168,0.180656934306569,0.104879664385074,0.304483837330553
"3690","2019","세종","세종시","초등학교",2019-04-01,"전체",5004,3836,4529,693,475,1168,0.180656934306569,0.104879664385074,0.304483837330553
"3691","2019","세종","세종시","초등학교",2019-04-01,"전체",5004,3836,4529,693,475,1168,0.180656934306569,0.104879664385074,0.304483837330553
"3692","2019","세종","세종시","초등학교",2019-04-01,"여자",2428,1853,2192,339,236,575,0.182946573124663,0.107664233576642,0.310307609282245
"3693","2019","세종","세종시","초등학교",2019-04-01,"여자",2428,1853,2192,339,236,575,0.182946573124663,0.107664233576642,0.310307609282245
"3694","2019","세종","세종시","초등학교",2019-04-01,"여자",2428,1853,2192,339,236,575,0.182946573124663,0.107664233576642,0.310307609282245
"3695","2019","세종","세종시","초등학교",2019-04-01,"여자",2428,1853,2192,339,236,575,0.182946573124663,0.107664233576642,0.310307609282245
"3696","2019","세종","세종시","초등학교",2019-04-01,"남자",2576,1983,2337,354,239,593,0.178517397881997,0.102267864783911,0.29904185577408
"3697","2019","세종","세종시","초등학교",2019-04-01,"남자",2576,1983,2337,354,239,593,0.178517397881997,0.102267864783911,0.29904185577408
"3698","2019","세종","세종시","초등학교",2019-04-01,"남자",2576,1983,2337,354,239,593,0.178517397881997,0.102267864783911,0.29904185577408
"3699","2019","세종","세종시","초등학교",2019-04-01,"남자",2576,1983,2337,354,239,593,0.178517397881997,0.102267864783911,0.29904185577408
"3700","2019","경기","수원시","초등학교",2019-04-01,"전체",12205,12347,12320,-27,-115,-142,-0.00218676601603628,-0.00933441558441558,-0.0115007694176723
"3701","2019","경기","수원시","초등학교",2019-04-01,"여자",5932,5956,5946,-10,-14,-24,-0.00167897918065816,-0.00235452404978137,-0.00402955003357958
"3702","2019","경기","수원시","초등학교",2019-04-01,"남자",6273,6391,6374,-17,-101,-118,-0.00265999061179784,-0.0158456228427989,-0.0184634642465968
"3703","2019","경기","성남시","초등학교",2019-04-01,"전체",7813,8603,8490,-113,-677,-790,-0.0131349529233988,-0.0797408716136631,-0.0918284319423457
"3704","2019","경기","성남시","초등학교",2019-04-01,"여자",3720,4110,4028,-82,-308,-390,-0.0199513381995134,-0.0764647467725919,-0.0948905109489051
"3705","2019","경기","성남시","초등학교",2019-04-01,"남자",4093,4493,4462,-31,-369,-400,-0.00689962163365235,-0.082698341550874,-0.0890273759180948
"3706","2019","경기","부천시","초등학교",2019-04-01,"전체",7059,7388,7461,73,-402,-329,0.00988088792636708,-0.0538801769199839,-0.044531672983216
"3707","2019","경기","부천시","초등학교",2019-04-01,"여자",3421,3565,3588,23,-167,-144,0.00645161290322581,-0.0465440356744705,-0.0403927068723703
"3708","2019","경기","부천시","초등학교",2019-04-01,"남자",3638,3823,3873,50,-235,-185,0.0130787339785509,-0.0606764781822876,-0.0483913157206382
"3709","2019","경기","안양시","초등학교",2019-04-01,"전체",4602,5008,4728,-280,-126,-406,-0.0559105431309904,-0.0266497461928934,-0.0810702875399361
"3710","2019","경기","안양시","초등학교",2019-04-01,"여자",2242,2407,2290,-117,-48,-165,-0.0486082260074782,-0.0209606986899563,-0.0685500623182385
"3711","2019","경기","안양시","초등학교",2019-04-01,"남자",2360,2601,2438,-163,-78,-241,-0.0626682045367166,-0.0319934372436423,-0.0926566705113418
"3712","2019","경기","과천시","초등학교",2019-04-01,"전체",466,455,451,-4,15,11,-0.00879120879120879,0.0332594235033259,0.0241758241758242
"3713","2019","경기","과천시","초등학교",2019-04-01,"여자",224,231,227,-4,-3,-7,-0.0173160173160173,-0.013215859030837,-0.0303030303030303
"3714","2019","경기","과천시","초등학교",2019-04-01,"남자",242,224,224,0,18,18,0,0.0803571428571429,0.0803571428571429
"3715","2019","경기","안산시","초등학교",2019-04-01,"전체",5611,5962,5532,-430,79,-351,-0.0721234485072123,0.0142805495300072,-0.0588728614558873
"3716","2019","경기","안산시","초등학교",2019-04-01,"여자",2796,2989,2733,-256,63,-193,-0.0856473737035798,0.0230515916575192,-0.0645700903312145
"3717","2019","경기","안산시","초등학교",2019-04-01,"남자",2815,2973,2799,-174,16,-158,-0.0585267406659939,0.00571632725973562,-0.0531449714093508
"3718","2019","경기","용인시","초등학교",2019-04-01,"전체",11990,11745,11916,171,74,245,0.0145593869731801,0.00621013763007721,0.0208599404001703
"3719","2019","경기","용인시","초등학교",2019-04-01,"여자",5899,5722,5809,87,90,177,0.0152044739601538,0.015493200206576,0.0309332401258301
"3720","2019","경기","용인시","초등학교",2019-04-01,"남자",6091,6023,6107,84,-16,68,0.0139465382699651,-0.00261994432618307,0.0112900547899718
"3721","2019","경기","군포시","초등학교",2019-04-01,"전체",2511,2824,2706,-118,-195,-313,-0.0417847025495751,-0.0720620842572062,-0.110835694050992
"3722","2019","경기","군포시","초등학교",2019-04-01,"여자",1220,1373,1309,-64,-89,-153,-0.0466132556445739,-0.067990832696715,-0.11143481427531
"3723","2019","경기","군포시","초등학교",2019-04-01,"남자",1291,1451,1397,-54,-106,-160,-0.0372157133011716,-0.0758768790264853,-0.11026878015162
"3724","2019","경기","의왕시","초등학교",2019-04-01,"전체",1313,1521,1474,-47,-161,-208,-0.0309007232084155,-0.109226594301221,-0.136752136752137
"3725","2019","경기","의왕시","초등학교",2019-04-01,"여자",627,726,703,-23,-76,-99,-0.0316804407713499,-0.108108108108108,-0.136363636363636
"3726","2019","경기","의왕시","초등학교",2019-04-01,"남자",686,795,771,-24,-85,-109,-0.030188679245283,-0.110246433203632,-0.137106918238994
"3727","2019","경기","시흥시","초등학교",2019-04-01,"전체",5317,4125,4600,475,717,1192,0.115151515151515,0.155869565217391,0.288969696969697
"3728","2019","경기","시흥시","초등학교",2019-04-01,"여자",2561,1982,2224,242,337,579,0.122098890010091,0.151528776978417,0.292129162462159
"3729","2019","경기","시흥시","초등학교",2019-04-01,"남자",2756,2143,2376,233,380,613,0.108726084927671,0.15993265993266,0.286047596826878
"3730","2019","경기","평택시","초등학교",2019-04-01,"전체",5410,5016,5092,76,318,394,0.0151515151515152,0.0624509033778476,0.078548644338118
"3731","2019","경기","평택시","초등학교",2019-04-01,"여자",2643,2452,2505,53,138,191,0.0216150081566069,0.0550898203592814,0.0778955954323002
"3732","2019","경기","평택시","초등학교",2019-04-01,"남자",2767,2564,2587,23,180,203,0.00897035881435257,0.0695786625434867,0.0791731669266771
"3733","2019","경기","화성시","초등학교",2019-04-01,"전체",11743,9888,10826,938,917,1855,0.0948624595469256,0.08470349159431,0.187601132686084
"3734","2019","경기","화성시","초등학교",2019-04-01,"여자",5822,4792,5283,491,539,1030,0.102462437395659,0.102025364376301,0.214941569282137
"3735","2019","경기","화성시","초등학교",2019-04-01,"남자",5921,5096,5543,447,378,825,0.0877158555729984,0.0681941187082807,0.161891679748823
"3736","2019","경기","오산시","초등학교",2019-04-01,"전체",2979,3001,3012,11,-33,-22,0.00366544485171609,-0.0109561752988048,-0.00733088970343219
"3737","2019","경기","오산시","초등학교",2019-04-01,"여자",1424,1432,1423,-9,1,-8,-0.00628491620111732,0.000702740688685875,-0.00558659217877095
"3738","2019","경기","오산시","초등학교",2019-04-01,"남자",1555,1569,1589,20,-34,-14,0.0127469725940089,-0.0213971050975456,-0.00892288081580625
"3739","2019","경기","광명시","초등학교",2019-04-01,"전체",3071,3311,3166,-145,-95,-240,-0.0437934158864391,-0.0300063171193936,-0.0724856538810027
"3740","2019","경기","광명시","초등학교",2019-04-01,"여자",1496,1626,1557,-69,-61,-130,-0.0424354243542435,-0.0391779062299294,-0.0799507995079951
"3741","2019","경기","광명시","초등학교",2019-04-01,"남자",1575,1685,1609,-76,-34,-110,-0.0451038575667656,-0.0211311373523928,-0.0652818991097923
"3742","2019","경기","광주시","초등학교",2019-04-01,"전체",3728,3768,3862,94,-134,-40,0.0249469214437367,-0.0346970481615743,-0.0106157112526539
"3743","2019","경기","광주시","초등학교",2019-04-01,"여자",1797,1836,1899,63,-102,-39,0.0343137254901961,-0.0537124802527646,-0.0212418300653595
"3744","2019","경기","광주시","초등학교",2019-04-01,"남자",1931,1932,1963,31,-32,-1,0.0160455486542443,-0.0163015792154865,-0.0005175983436853
"3745","2019","경기","하남시","초등학교",2019-04-01,"전체",3089,2772,3060,288,29,317,0.103896103896104,0.00947712418300654,0.114357864357864
"3746","2019","경기","하남시","초등학교",2019-04-01,"여자",1443,1313,1463,150,-20,130,0.114242193450114,-0.0136705399863295,0.099009900990099
"3747","2019","경기","하남시","초등학교",2019-04-01,"남자",1646,1459,1597,138,49,187,0.0945853324194654,0.0306825297432686,0.128169979437971
"3748","2019","경기","김포시","초등학교",2019-04-01,"전체",6010,5175,5649,474,361,835,0.0915942028985507,0.0639051159497256,0.161352657004831
"3749","2019","경기","김포시","초등학교",2019-04-01,"여자",2987,2570,2807,237,180,417,0.0922178988326848,0.0641254007837549,0.162256809338521
"3750","2019","경기","김포시","초등학교",2019-04-01,"남자",3023,2605,2842,237,181,418,0.090978886756238,0.0636875439831105,0.160460652591171
"3751","2019","경기","이천시","초등학교",2019-04-01,"전체",2291,2315,2326,11,-35,-24,0.00475161987041037,-0.0150472914875322,-0.0103671706263499
"3752","2019","경기","이천시","초등학교",2019-04-01,"여자",1128,1116,1110,-6,18,12,-0.00537634408602151,0.0162162162162162,0.010752688172043
"3753","2019","경기","이천시","초등학교",2019-04-01,"남자",1163,1199,1216,17,-53,-36,0.0141784820683903,-0.0435855263157895,-0.0300250208507089
"3754","2019","경기","안성시","초등학교",2019-04-01,"전체",1787,1838,1777,-61,10,-51,-0.0331882480957563,0.0056274620146314,-0.0277475516866159
"3755","2019","경기","안성시","초등학교",2019-04-01,"여자",890,874,854,-20,36,16,-0.022883295194508,0.0421545667447307,0.0183066361556064
"3756","2019","경기","안성시","초등학교",2019-04-01,"남자",897,964,923,-41,-26,-67,-0.0425311203319502,-0.028169014084507,-0.0695020746887967
"3757","2019","경기","여주시","초등학교",2019-04-01,"전체",868,945,919,-26,-51,-77,-0.0275132275132275,-0.0554951033732318,-0.0814814814814815
"3758","2019","경기","여주시","초등학교",2019-04-01,"여자",411,435,431,-4,-20,-24,-0.00919540229885057,-0.0464037122969838,-0.0551724137931034
"3759","2019","경기","여주시","초등학교",2019-04-01,"남자",457,510,488,-22,-31,-53,-0.0431372549019608,-0.0635245901639344,-0.103921568627451
"3760","2019","경기","양평군","초등학교",2019-04-01,"전체",840,823,837,14,3,17,0.0170109356014581,0.003584229390681,0.0206561360874848
"3761","2019","경기","양평군","초등학교",2019-04-01,"여자",402,387,400,13,2,15,0.0335917312661499,0.005,0.0387596899224806
"3762","2019","경기","양평군","초등학교",2019-04-01,"남자",438,436,437,1,1,2,0.00229357798165138,0.0022883295194508,0.00458715596330275
"3763","2019","경기","고양시","초등학교",2019-04-01,"전체",9283,9663,9617,-46,-334,-380,-0.00476042636862258,-0.0347301653322242,-0.0393252613060126
"3764","2019","경기","고양시","초등학교",2019-04-01,"여자",4496,4683,4655,-28,-159,-187,-0.00597907324364723,-0.034156820622986,-0.0399316677343583
"3765","2019","경기","고양시","초등학교",2019-04-01,"남자",4787,4980,4962,-18,-175,-193,-0.0036144578313253,-0.0352680370818218,-0.0387550200803213
"3766","2019","경기","남양주시","초등학교",2019-04-01,"전체",7734,7518,7746,228,-12,216,0.0303272146847566,-0.00154918667699458,0.028731045490822
"3767","2019","경기","남양주시","초등학교",2019-04-01,"여자",3787,3683,3824,141,-37,104,0.038284007602498,-0.00967573221757322,0.0282378495791474
"3768","2019","경기","남양주시","초등학교",2019-04-01,"남자",3947,3835,3922,87,25,112,0.0226857887874837,0.00637429882712902,0.0292046936114733
"3769","2019","경기","구리시","초등학교",2019-04-01,"전체",1806,1890,1961,71,-155,-84,0.0375661375661376,-0.0790413054563998,-0.0444444444444444
"3770","2019","경기","구리시","초등학교",2019-04-01,"여자",877,914,942,28,-65,-37,0.0306345733041575,-0.0690021231422505,-0.0404814004376368
"3771","2019","경기","구리시","초등학교",2019-04-01,"남자",929,976,1019,43,-90,-47,0.0440573770491803,-0.0883218842001963,-0.048155737704918
"3772","2019","경기","의정부시","초등학교",2019-04-01,"전체",3868,3843,3931,88,-63,25,0.0228987769971377,-0.0160264563724243,0.00650533437418683
"3773","2019","경기","의정부시","초등학교",2019-04-01,"여자",1901,1887,1928,41,-27,14,0.0217276099629041,-0.0140041493775934,0.00741918388977213
"3774","2019","경기","의정부시","초등학교",2019-04-01,"남자",1967,1956,2003,47,-36,11,0.0240286298568507,-0.017973040439341,0.00562372188139059
"3775","2019","경기","파주시","초등학교",2019-04-01,"전체",5245,5099,5109,10,136,146,0.00196116885663856,0.0266196907418281,0.0286330653069229
"3776","2019","경기","파주시","초등학교",2019-04-01,"여자",2556,2483,2497,14,59,73,0.00563834071687475,0.0236283540248298,0.0293999194522755
"3777","2019","경기","파주시","초등학교",2019-04-01,"남자",2689,2616,2612,-4,77,73,-0.00152905198776758,0.02947932618683,0.0279051987767584
"3778","2019","경기","동두천시","초등학교",2019-04-01,"전체",803,851,849,-2,-46,-48,-0.00235017626321974,-0.0541813898704358,-0.0564042303172738
"3779","2019","경기","동두천시","초등학교",2019-04-01,"여자",402,433,439,6,-37,-31,0.0138568129330254,-0.0842824601366743,-0.0715935334872979
"3780","2019","경기","동두천시","초등학교",2019-04-01,"남자",401,418,410,-8,-9,-17,-0.0191387559808612,-0.0219512195121951,-0.0406698564593301
"3781","2019","경기","양주시","초등학교",2019-04-01,"전체",2359,2216,2234,18,125,143,0.00812274368231047,0.0559534467323187,0.0645306859205776
"3782","2019","경기","양주시","초등학교",2019-04-01,"여자",1180,1124,1141,17,39,56,0.0151245551601423,0.0341805433829974,0.0498220640569395
"3783","2019","경기","양주시","초등학교",2019-04-01,"남자",1179,1092,1093,1,86,87,0.000915750915750916,0.0786825251601098,0.0796703296703297
"3784","2019","경기","포천시","초등학교",2019-04-01,"전체",1127,1178,1170,-8,-43,-51,-0.0067911714770798,-0.0367521367521368,-0.0432937181663837
"3785","2019","경기","포천시","초등학교",2019-04-01,"여자",574,591,597,6,-23,-17,0.0101522842639594,-0.0385259631490787,-0.0287648054145516
"3786","2019","경기","포천시","초등학교",2019-04-01,"남자",553,587,573,-14,-20,-34,-0.0238500851788756,-0.0349040139616056,-0.0579216354344123
"3787","2019","경기","가평군","초등학교",2019-04-01,"전체",436,413,420,7,16,23,0.0169491525423729,0.0380952380952381,0.0556900726392252
"3788","2019","경기","가평군","초등학교",2019-04-01,"여자",232,205,210,5,22,27,0.024390243902439,0.104761904761905,0.131707317073171
"3789","2019","경기","가평군","초등학교",2019-04-01,"남자",204,208,210,2,-6,-4,0.00961538461538462,-0.0285714285714286,-0.0192307692307692
"3790","2019","경기","연천군","초등학교",2019-04-01,"전체",286,393,364,-29,-78,-107,-0.0737913486005089,-0.214285714285714,-0.272264631043257
"3791","2019","경기","연천군","초등학교",2019-04-01,"여자",130,180,162,-18,-32,-50,-0.1,-0.197530864197531,-0.277777777777778
"3792","2019","경기","연천군","초등학교",2019-04-01,"남자",156,213,202,-11,-46,-57,-0.0516431924882629,-0.227722772277228,-0.267605633802817
"3793","2019","강원","춘천시","초등학교",2019-04-01,"전체",2544,2513,2565,52,-21,31,0.0206923995224831,-0.00818713450292398,0.0123358535614803
"3794","2019","강원","춘천시","초등학교",2019-04-01,"여자",1236,1209,1251,42,-15,27,0.0347394540942928,-0.0119904076738609,0.0223325062034739
"3795","2019","강원","춘천시","초등학교",2019-04-01,"남자",1308,1304,1314,10,-6,4,0.00766871165644172,-0.0045662100456621,0.00306748466257669
"3796","2019","강원","원주시","초등학교",2019-04-01,"전체",3303,3164,3188,24,115,139,0.00758533501896334,0.0360727728983689,0.0439317319848293
"3797","2019","강원","원주시","초등학교",2019-04-01,"여자",1669,1613,1623,10,46,56,0.00619962802231866,0.0283425754775108,0.0347179169249845
"3798","2019","강원","원주시","초등학교",2019-04-01,"남자",1634,1551,1565,14,69,83,0.00902643455834945,0.0440894568690096,0.0535138620245003
"3799","2019","강원","강릉시","초등학교",2019-04-01,"전체",1627,1572,1587,15,40,55,0.00954198473282443,0.0252047889098929,0.0349872773536896
"3800","2019","강원","강릉시","초등학교",2019-04-01,"여자",803,780,785,5,18,23,0.00641025641025641,0.0229299363057325,0.0294871794871795
"3801","2019","강원","강릉시","초등학교",2019-04-01,"남자",824,792,802,10,22,32,0.0126262626262626,0.027431421446384,0.0404040404040404
"3802","2019","강원","동해시","초등학교",2019-04-01,"전체",861,842,838,-4,23,19,-0.00475059382422803,0.0274463007159905,0.0225653206650831
"3803","2019","강원","동해시","초등학교",2019-04-01,"여자",422,401,404,3,18,21,0.00748129675810474,0.0445544554455446,0.0523690773067332
"3804","2019","강원","동해시","초등학교",2019-04-01,"남자",439,441,434,-7,5,-2,-0.0158730158730159,0.0115207373271889,-0.00453514739229025
"3805","2019","강원","태백시","초등학교",2019-04-01,"전체",360,375,374,-1,-14,-15,-0.00266666666666667,-0.0374331550802139,-0.04
"3806","2019","강원","태백시","초등학교",2019-04-01,"여자",181,195,195,0,-14,-14,0,-0.0717948717948718,-0.0717948717948718
"3807","2019","강원","태백시","초등학교",2019-04-01,"남자",179,180,179,-1,0,-1,-0.00555555555555556,0,-0.00555555555555556
"3808","2019","강원","속초시","초등학교",2019-04-01,"전체",663,667,674,7,-11,-4,0.0104947526236882,-0.0163204747774481,-0.00599700149925037
"3809","2019","강원","속초시","초등학교",2019-04-01,"여자",339,348,343,-5,-4,-9,-0.014367816091954,-0.0116618075801749,-0.0258620689655172
"3810","2019","강원","속초시","초등학교",2019-04-01,"남자",324,319,331,12,-7,5,0.0376175548589342,-0.0211480362537764,0.0156739811912226
"3811","2019","강원","삼척시","초등학교",2019-04-01,"전체",486,479,480,1,6,7,0.00208768267223382,0.0125,0.0146137787056367
"3812","2019","강원","삼척시","초등학교",2019-04-01,"여자",226,232,230,-2,-4,-6,-0.00862068965517241,-0.0173913043478261,-0.0258620689655172
"3813","2019","강원","삼척시","초등학교",2019-04-01,"남자",260,247,250,3,10,13,0.0121457489878543,0.04,0.0526315789473684
"3814","2019","강원","홍천군","초등학교",2019-04-01,"전체",443,484,462,-22,-19,-41,-0.0454545454545455,-0.0411255411255411,-0.0847107438016529
"3815","2019","강원","홍천군","초등학교",2019-04-01,"여자",223,242,230,-12,-7,-19,-0.0495867768595041,-0.0304347826086957,-0.0785123966942149
"3816","2019","강원","홍천군","초등학교",2019-04-01,"남자",220,242,232,-10,-12,-22,-0.0413223140495868,-0.0517241379310345,-0.0909090909090909
"3817","2019","강원","횡성군","초등학교",2019-04-01,"전체",265,249,255,6,10,16,0.0240963855421687,0.0392156862745098,0.0642570281124498
"3818","2019","강원","횡성군","초등학교",2019-04-01,"여자",133,131,134,3,-1,2,0.0229007633587786,-0.00746268656716418,0.0152671755725191
"3819","2019","강원","횡성군","초등학교",2019-04-01,"남자",132,118,121,3,11,14,0.0254237288135593,0.0909090909090909,0.11864406779661
"3820","2019","강원","영월군","초등학교",2019-04-01,"전체",198,207,200,-7,-2,-9,-0.0338164251207729,-0.01,-0.0434782608695652
"3821","2019","강원","영월군","초등학교",2019-04-01,"여자",81,94,86,-8,-5,-13,-0.0851063829787234,-0.0581395348837209,-0.138297872340426
"3822","2019","강원","영월군","초등학교",2019-04-01,"남자",117,113,114,1,3,4,0.00884955752212389,0.0263157894736842,0.0353982300884956
"3823","2019","강원","평창군","초등학교",2019-04-01,"전체",261,252,252,0,9,9,0,0.0357142857142857,0.0357142857142857
"3824","2019","강원","평창군","초등학교",2019-04-01,"여자",129,115,115,0,14,14,0,0.121739130434783,0.121739130434783
"3825","2019","강원","평창군","초등학교",2019-04-01,"남자",132,137,137,0,-5,-5,0,-0.0364963503649635,-0.0364963503649635
"3826","2019","강원","정선군","초등학교",2019-04-01,"전체",251,240,244,4,7,11,0.0166666666666667,0.0286885245901639,0.0458333333333333
"3827","2019","강원","정선군","초등학교",2019-04-01,"여자",115,121,120,-1,-5,-6,-0.00826446280991736,-0.0416666666666667,-0.0495867768595041
"3828","2019","강원","정선군","초등학교",2019-04-01,"남자",136,119,124,5,12,17,0.0420168067226891,0.0967741935483871,0.142857142857143
"3829","2019","강원","철원군","초등학교",2019-04-01,"전체",336,373,364,-9,-28,-37,-0.0241286863270777,-0.0769230769230769,-0.0991957104557641
"3830","2019","강원","철원군","초등학교",2019-04-01,"여자",176,187,188,1,-12,-11,0.0053475935828877,-0.0638297872340425,-0.0588235294117647
"3831","2019","강원","철원군","초등학교",2019-04-01,"남자",160,186,176,-10,-16,-26,-0.0537634408602151,-0.0909090909090909,-0.139784946236559
"3832","2019","강원","화천군","초등학교",2019-04-01,"전체",191,242,215,-27,-24,-51,-0.111570247933884,-0.111627906976744,-0.210743801652893
"3833","2019","강원","화천군","초등학교",2019-04-01,"여자",104,123,106,-17,-2,-19,-0.138211382113821,-0.0188679245283019,-0.154471544715447
"3834","2019","강원","화천군","초등학교",2019-04-01,"남자",87,119,109,-10,-22,-32,-0.0840336134453782,-0.201834862385321,-0.26890756302521
"3835","2019","강원","양구군","초등학교",2019-04-01,"전체",195,207,201,-6,-6,-12,-0.0289855072463768,-0.0298507462686567,-0.0579710144927536
"3836","2019","강원","양구군","초등학교",2019-04-01,"여자",98,109,104,-5,-6,-11,-0.0458715596330275,-0.0576923076923077,-0.100917431192661
"3837","2019","강원","양구군","초등학교",2019-04-01,"남자",97,98,97,-1,0,-1,-0.0102040816326531,0,-0.0102040816326531
"3838","2019","강원","인제군","초등학교",2019-04-01,"전체",274,313,311,-2,-37,-39,-0.00638977635782748,-0.118971061093248,-0.124600638977636
"3839","2019","강원","인제군","초등학교",2019-04-01,"여자",134,152,152,0,-18,-18,0,-0.118421052631579,-0.118421052631579
"3840","2019","강원","인제군","초등학교",2019-04-01,"남자",140,161,159,-2,-19,-21,-0.0124223602484472,-0.119496855345912,-0.130434782608696
"3841","2019","강원","고성군","초등학교",2019-04-01,"전체",155,144,146,2,9,11,0.0138888888888889,0.0616438356164384,0.0763888888888889
"3842","2019","강원","고성군","초등학교",2019-04-01,"여자",77,64,71,7,6,13,0.109375,0.0845070422535211,0.203125
"3843","2019","강원","고성군","초등학교",2019-04-01,"남자",78,80,75,-5,3,-2,-0.0625,0.04,-0.025
"3844","2019","강원","양양군","초등학교",2019-04-01,"전체",154,165,165,0,-11,-11,0,-0.0666666666666667,-0.0666666666666667
"3845","2019","강원","양양군","초등학교",2019-04-01,"여자",71,72,67,-5,4,-1,-0.0694444444444444,0.0597014925373134,-0.0138888888888889
"3846","2019","강원","양양군","초등학교",2019-04-01,"남자",83,93,98,5,-15,-10,0.0537634408602151,-0.153061224489796,-0.10752688172043
"3847","2019","충북","청주시","초등학교",2019-04-01,"전체",8854,8922,8782,-140,72,-68,-0.0156915489800493,0.00819858802095195,-0.00762160950459538
"3848","2019","충북","청주시","초등학교",2019-04-01,"여자",4343,4387,4320,-67,23,-44,-0.0152723957146114,0.00532407407407407,-0.0100296330066104
"3849","2019","충북","청주시","초등학교",2019-04-01,"남자",4511,4535,4462,-73,49,-24,-0.0160970231532525,0.0109816225907665,-0.00529217199558986
"3850","2019","충북","충주시","초등학교",2019-04-01,"전체",1682,1675,1713,38,-31,7,0.0226865671641791,-0.018096906012843,0.00417910447761194
"3851","2019","충북","충주시","초등학교",2019-04-01,"여자",854,829,850,21,4,25,0.0253317249698432,0.00470588235294118,0.0301568154402895
"3852","2019","충북","충주시","초등학교",2019-04-01,"남자",828,846,863,17,-35,-18,0.0200945626477541,-0.0405561993047509,-0.0212765957446809
"3853","2019","충북","제천시","초등학교",2019-04-01,"전체",1078,1015,1037,22,41,63,0.0216748768472906,0.0395371263259402,0.0620689655172414
"3854","2019","충북","제천시","초등학교",2019-04-01,"여자",542,498,505,7,37,44,0.0140562248995984,0.0732673267326733,0.0883534136546185
"3855","2019","충북","제천시","초등학교",2019-04-01,"남자",536,517,532,15,4,19,0.0290135396518375,0.0075187969924812,0.0367504835589942
"3856","2019","충북","보은군","초등학교",2019-04-01,"전체",184,196,193,-3,-9,-12,-0.0153061224489796,-0.0466321243523316,-0.0612244897959184
"3857","2019","충북","보은군","초등학교",2019-04-01,"여자",91,95,94,-1,-3,-4,-0.0105263157894737,-0.0319148936170213,-0.0421052631578947
"3858","2019","충북","보은군","초등학교",2019-04-01,"남자",93,101,99,-2,-6,-8,-0.0198019801980198,-0.0606060606060606,-0.0792079207920792
"3859","2019","충북","옥천군","초등학교",2019-04-01,"전체",334,320,336,16,-2,14,0.05,-0.00595238095238095,0.04375
"3860","2019","충북","옥천군","초등학교",2019-04-01,"여자",171,154,163,9,8,17,0.0584415584415584,0.049079754601227,0.11038961038961
"3861","2019","충북","옥천군","초등학교",2019-04-01,"남자",163,166,173,7,-10,-3,0.0421686746987952,-0.0578034682080925,-0.0180722891566265
"3862","2019","충북","영동군","초등학교",2019-04-01,"전체",266,261,259,-2,7,5,-0.00766283524904215,0.027027027027027,0.0191570881226054
"3863","2019","충북","영동군","초등학교",2019-04-01,"여자",134,137,138,1,-4,-3,0.0072992700729927,-0.0289855072463768,-0.0218978102189781
"3864","2019","충북","영동군","초등학교",2019-04-01,"남자",132,124,121,-3,11,8,-0.0241935483870968,0.0909090909090909,0.0645161290322581
"3865","2019","충북","진천군","초등학교",2019-04-01,"전체",904,718,802,84,102,186,0.116991643454039,0.127182044887781,0.259052924791086
"3866","2019","충북","진천군","초등학교",2019-04-01,"여자",449,351,396,45,53,98,0.128205128205128,0.133838383838384,0.279202279202279
"3867","2019","충북","진천군","초등학교",2019-04-01,"남자",455,367,406,39,49,88,0.106267029972752,0.120689655172414,0.239782016348774
"3868","2019","충북","괴산군","초등학교",2019-04-01,"전체",170,159,153,-6,17,11,-0.0377358490566038,0.111111111111111,0.0691823899371069
"3869","2019","충북","괴산군","초등학교",2019-04-01,"여자",74,72,67,-5,7,2,-0.0694444444444444,0.104477611940299,0.0277777777777778
"3870","2019","충북","괴산군","초등학교",2019-04-01,"남자",96,87,86,-1,10,9,-0.0114942528735632,0.116279069767442,0.103448275862069
"3871","2019","충북","음성군","초등학교",2019-04-01,"전체",756,857,813,-44,-57,-101,-0.0513418903150525,-0.0701107011070111,-0.117852975495916
"3872","2019","충북","음성군","초등학교",2019-04-01,"여자",345,394,374,-20,-29,-49,-0.050761421319797,-0.0775401069518717,-0.124365482233503
"3873","2019","충북","음성군","초등학교",2019-04-01,"남자",411,463,439,-24,-28,-52,-0.0518358531317495,-0.0637813211845103,-0.11231101511879
"3874","2019","충북","단양군","초등학교",2019-04-01,"전체",155,152,154,2,1,3,0.0131578947368421,0.00649350649350649,0.0197368421052632
"3875","2019","충북","단양군","초등학교",2019-04-01,"여자",77,68,73,5,4,9,0.0735294117647059,0.0547945205479452,0.132352941176471
"3876","2019","충북","단양군","초등학교",2019-04-01,"남자",78,84,81,-3,-3,-6,-0.0357142857142857,-0.037037037037037,-0.0714285714285714
"3877","2019","충북","증평군","초등학교",2019-04-01,"전체",369,427,425,-2,-56,-58,-0.00468384074941452,-0.131764705882353,-0.135831381733021
"3878","2019","충북","증평군","초등학교",2019-04-01,"여자",181,198,199,1,-18,-17,0.00505050505050505,-0.0904522613065327,-0.0858585858585859
"3879","2019","충북","증평군","초등학교",2019-04-01,"남자",188,229,226,-3,-38,-41,-0.0131004366812227,-0.168141592920354,-0.179039301310044
"3880","2019","충남","천안시","초등학교",2019-04-01,"전체",7491,7086,7215,129,276,405,0.0182049110922947,0.0382536382536383,0.0571549534292972
"3881","2019","충남","천안시","초등학교",2019-04-01,"여자",3740,3582,3633,51,107,158,0.0142378559463987,0.0294522433250757,0.0441094360692351
"3882","2019","충남","천안시","초등학교",2019-04-01,"남자",3751,3504,3582,78,169,247,0.0222602739726027,0.047180346175321,0.0704908675799087
"3883","2019","충남","공주시","초등학교",2019-04-01,"전체",734,767,752,-15,-18,-33,-0.0195567144719687,-0.023936170212766,-0.0430247718383312
"3884","2019","충남","공주시","초등학교",2019-04-01,"여자",345,352,339,-13,6,-7,-0.0369318181818182,0.0176991150442478,-0.0198863636363636
"3885","2019","충남","공주시","초등학교",2019-04-01,"남자",389,415,413,-2,-24,-26,-0.00481927710843374,-0.0581113801452785,-0.0626506024096386
"3886","2019","충남","보령시","초등학교",2019-04-01,"전체",726,745,752,7,-26,-19,0.00939597315436242,-0.0345744680851064,-0.025503355704698
"3887","2019","충남","보령시","초등학교",2019-04-01,"여자",352,352,356,4,-4,0,0.0113636363636364,-0.0112359550561798,0
"3888","2019","충남","보령시","초등학교",2019-04-01,"남자",374,393,396,3,-22,-19,0.00763358778625954,-0.0555555555555556,-0.0483460559796438
"3889","2019","충남","아산시","초등학교",2019-04-01,"전체",4141,4111,4111,0,30,30,0,0.0072974945268791,0.0072974945268791
"3890","2019","충남","아산시","초등학교",2019-04-01,"여자",2030,1954,1967,13,63,76,0.00665301944728762,0.0320284697508897,0.0388945752302968
"3891","2019","충남","아산시","초등학교",2019-04-01,"남자",2111,2157,2144,-13,-33,-46,-0.00602688919796013,-0.0153917910447761,-0.0213259156235512
"3892","2019","충남","서산시","초등학교",2019-04-01,"전체",1834,1807,1794,-13,40,27,-0.00719424460431655,0.0222965440356745,0.0149418926397344
"3893","2019","충남","서산시","초등학교",2019-04-01,"여자",886,884,879,-5,7,2,-0.00565610859728507,0.00796359499431172,0.00226244343891403
"3894","2019","충남","서산시","초등학교",2019-04-01,"남자",948,923,915,-8,33,25,-0.00866738894907909,0.0360655737704918,0.0270855904658722
"3895","2019","충남","논산시","초등학교",2019-04-01,"전체",905,893,896,3,9,12,0.00335946248600224,0.0100446428571429,0.013437849944009
"3896","2019","충남","논산시","초등학교",2019-04-01,"여자",439,449,451,2,-12,-10,0.0044543429844098,-0.0266075388026608,-0.022271714922049
"3897","2019","충남","논산시","초등학교",2019-04-01,"남자",466,444,445,1,21,22,0.00225225225225225,0.0471910112359551,0.0495495495495495
"3898","2019","충남","계룡시","초등학교",2019-04-01,"전체",475,507,532,25,-57,-32,0.0493096646942801,-0.107142857142857,-0.0631163708086785
"3899","2019","충남","계룡시","초등학교",2019-04-01,"여자",245,241,262,21,-17,4,0.0871369294605809,-0.0648854961832061,0.016597510373444
"3900","2019","충남","계룡시","초등학교",2019-04-01,"남자",230,266,270,4,-40,-36,0.0150375939849624,-0.148148148148148,-0.135338345864662
"3901","2019","충남","금산군","초등학교",2019-04-01,"전체",322,335,332,-3,-10,-13,-0.00895522388059702,-0.0301204819277108,-0.0388059701492537
"3902","2019","충남","금산군","초등학교",2019-04-01,"여자",143,148,147,-1,-4,-5,-0.00675675675675676,-0.0272108843537415,-0.0337837837837838
"3903","2019","충남","금산군","초등학교",2019-04-01,"남자",179,187,185,-2,-6,-8,-0.0106951871657754,-0.0324324324324324,-0.0427807486631016
"3904","2019","충남","부여군","초등학교",2019-04-01,"전체",370,377,381,4,-11,-7,0.0106100795755968,-0.0288713910761155,-0.0185676392572944
"3905","2019","충남","부여군","초등학교",2019-04-01,"여자",180,176,175,-1,5,4,-0.00568181818181818,0.0285714285714286,0.0227272727272727
"3906","2019","충남","부여군","초등학교",2019-04-01,"남자",190,201,206,5,-16,-11,0.0248756218905473,-0.0776699029126214,-0.054726368159204
"3907","2019","충남","서천군","초등학교",2019-04-01,"전체",266,314,309,-5,-43,-48,-0.0159235668789809,-0.13915857605178,-0.152866242038217
"3908","2019","충남","서천군","초등학교",2019-04-01,"여자",133,162,159,-3,-26,-29,-0.0185185185185185,-0.163522012578616,-0.179012345679012
"3909","2019","충남","서천군","초등학교",2019-04-01,"남자",133,152,150,-2,-17,-19,-0.0131578947368421,-0.113333333333333,-0.125
"3910","2019","충남","청양군","초등학교",2019-04-01,"전체",159,177,171,-6,-12,-18,-0.0338983050847458,-0.0701754385964912,-0.101694915254237
"3911","2019","충남","청양군","초등학교",2019-04-01,"여자",79,87,82,-5,-3,-8,-0.0574712643678161,-0.0365853658536585,-0.0919540229885057
"3912","2019","충남","청양군","초등학교",2019-04-01,"남자",80,90,89,-1,-9,-10,-0.0111111111111111,-0.101123595505618,-0.111111111111111
"3913","2019","충남","홍성군","초등학교",2019-04-01,"전체",943,933,968,35,-25,10,0.037513397642015,-0.0258264462809917,0.0107181136120043
"3914","2019","충남","홍성군","초등학교",2019-04-01,"여자",461,453,462,9,-1,8,0.0198675496688742,-0.00216450216450216,0.0176600441501104
"3915","2019","충남","홍성군","초등학교",2019-04-01,"남자",482,480,506,26,-24,2,0.0541666666666667,-0.0474308300395257,0.00416666666666667
"3916","2019","충남","예산군","초등학교",2019-04-01,"전체",486,451,460,9,26,35,0.0199556541019956,0.0565217391304348,0.0776053215077605
"3917","2019","충남","예산군","초등학교",2019-04-01,"여자",221,225,229,4,-8,-4,0.0177777777777778,-0.0349344978165939,-0.0177777777777778
"3918","2019","충남","예산군","초등학교",2019-04-01,"남자",265,226,231,5,34,39,0.0221238938053097,0.147186147186147,0.172566371681416
"3919","2019","충남","태안군","초등학교",2019-04-01,"전체",392,400,398,-2,-6,-8,-0.005,-0.0150753768844221,-0.02
"3920","2019","충남","태안군","초등학교",2019-04-01,"여자",206,202,203,1,3,4,0.00495049504950495,0.0147783251231527,0.0198019801980198
"3921","2019","충남","태안군","초등학교",2019-04-01,"남자",186,198,195,-3,-9,-12,-0.0151515151515152,-0.0461538461538462,-0.0606060606060606
"3922","2019","충남","당진시","초등학교",2019-04-01,"전체",1871,1860,1832,-28,39,11,-0.0150537634408602,0.0212882096069869,0.00591397849462366
"3923","2019","충남","당진시","초등학교",2019-04-01,"여자",896,905,905,0,-9,-9,0,-0.00994475138121547,-0.00994475138121547
"3924","2019","충남","당진시","초등학교",2019-04-01,"남자",975,955,927,-28,48,20,-0.0293193717277487,0.0517799352750809,0.0209424083769634
"3925","2019","전북","전주시","초등학교",2019-04-01,"전체",6708,6311,6421,110,287,397,0.0174298843289495,0.0446970876810466,0.0629060370781176
"3926","2019","전북","전주시","초등학교",2019-04-01,"여자",3273,3071,3121,50,152,202,0.0162813415825464,0.0487023389939122,0.0657766199934875
"3927","2019","전북","전주시","초등학교",2019-04-01,"남자",3435,3240,3300,60,135,195,0.0185185185185185,0.0409090909090909,0.0601851851851852
"3928","2019","전북","군산시","초등학교",2019-04-01,"전체",2706,2768,2760,-8,-54,-62,-0.00289017341040462,-0.0195652173913043,-0.0223988439306358
"3929","2019","전북","군산시","초등학교",2019-04-01,"여자",1290,1349,1344,-5,-54,-59,-0.00370644922164566,-0.0401785714285714,-0.0437361008154188
"3930","2019","전북","군산시","초등학교",2019-04-01,"남자",1416,1419,1416,-3,0,-3,-0.00211416490486258,0,-0.00211416490486258
"3931","2019","전북","익산시","초등학교",2019-04-01,"전체",2591,2647,2585,-62,6,-56,-0.0234227427276162,0.002321083172147,-0.0211560256894598
"3932","2019","전북","익산시","초등학교",2019-04-01,"여자",1269,1279,1263,-16,6,-10,-0.0125097732603597,0.00475059382422803,-0.00781860828772478
"3933","2019","전북","익산시","초등학교",2019-04-01,"남자",1322,1368,1322,-46,0,-46,-0.033625730994152,0,-0.033625730994152
"3934","2019","전북","정읍시","초등학교",2019-04-01,"전체",858,807,814,7,44,51,0.00867410161090459,0.0540540540540541,0.0631970260223048
"3935","2019","전북","정읍시","초등학교",2019-04-01,"여자",412,394,402,8,10,18,0.0203045685279188,0.0248756218905473,0.0456852791878173
"3936","2019","전북","정읍시","초등학교",2019-04-01,"남자",446,413,412,-1,34,33,-0.00242130750605327,0.0825242718446602,0.0799031476997579
"3937","2019","전북","남원시","초등학교",2019-04-01,"전체",572,612,608,-4,-36,-40,-0.0065359477124183,-0.0592105263157895,-0.065359477124183
"3938","2019","전북","남원시","초등학교",2019-04-01,"여자",262,293,286,-7,-24,-31,-0.0238907849829352,-0.0839160839160839,-0.10580204778157
"3939","2019","전북","남원시","초등학교",2019-04-01,"남자",310,319,322,3,-12,-9,0.00940438871473354,-0.0372670807453416,-0.0282131661442006
"3940","2019","전북","김제시","초등학교",2019-04-01,"전체",607,581,567,-14,40,26,-0.0240963855421687,0.0705467372134039,0.044750430292599
"3941","2019","전북","김제시","초등학교",2019-04-01,"여자",291,246,238,-8,53,45,-0.032520325203252,0.222689075630252,0.182926829268293
"3942","2019","전북","김제시","초등학교",2019-04-01,"남자",316,335,329,-6,-13,-19,-0.017910447761194,-0.0395136778115502,-0.0567164179104478
"3943","2019","전북","완주군","초등학교",2019-04-01,"전체",822,1046,994,-52,-172,-224,-0.0497131931166348,-0.173038229376258,-0.21414913957935
"3944","2019","전북","완주군","초등학교",2019-04-01,"여자",377,504,474,-30,-97,-127,-0.0595238095238095,-0.20464135021097,-0.251984126984127
"3945","2019","전북","완주군","초등학교",2019-04-01,"남자",445,542,520,-22,-75,-97,-0.040590405904059,-0.144230769230769,-0.178966789667897
"3946","2019","전북","진안군","초등학교",2019-04-01,"전체",148,174,170,-4,-22,-26,-0.0229885057471264,-0.129411764705882,-0.149425287356322
"3947","2019","전북","진안군","초등학교",2019-04-01,"여자",81,95,92,-3,-11,-14,-0.0315789473684211,-0.119565217391304,-0.147368421052632
"3948","2019","전북","진안군","초등학교",2019-04-01,"남자",67,79,78,-1,-11,-12,-0.0126582278481013,-0.141025641025641,-0.151898734177215
"3949","2019","전북","무주군","초등학교",2019-04-01,"전체",155,162,162,0,-7,-7,0,-0.0432098765432099,-0.0432098765432099
"3950","2019","전북","무주군","초등학교",2019-04-01,"여자",71,74,77,3,-6,-3,0.0405405405405405,-0.0779220779220779,-0.0405405405405405
"3951","2019","전북","무주군","초등학교",2019-04-01,"남자",84,88,85,-3,-1,-4,-0.0340909090909091,-0.0117647058823529,-0.0454545454545455
"3952","2019","전북","장수군","초등학교",2019-04-01,"전체",150,176,173,-3,-23,-26,-0.0170454545454545,-0.132947976878613,-0.147727272727273
"3953","2019","전북","장수군","초등학교",2019-04-01,"여자",74,82,83,1,-9,-8,0.0121951219512195,-0.108433734939759,-0.0975609756097561
"3954","2019","전북","장수군","초등학교",2019-04-01,"남자",76,94,90,-4,-14,-18,-0.0425531914893617,-0.155555555555556,-0.191489361702128
"3955","2019","전북","임실군","초등학교",2019-04-01,"전체",144,178,167,-11,-23,-34,-0.0617977528089888,-0.137724550898204,-0.191011235955056
"3956","2019","전북","임실군","초등학교",2019-04-01,"여자",75,85,91,6,-16,-10,0.0705882352941176,-0.175824175824176,-0.117647058823529
"3957","2019","전북","임실군","초등학교",2019-04-01,"남자",69,93,76,-17,-7,-24,-0.182795698924731,-0.0921052631578947,-0.258064516129032
"3958","2019","전북","순창군","초등학교",2019-04-01,"전체",153,194,195,1,-42,-41,0.00515463917525773,-0.215384615384615,-0.211340206185567
"3959","2019","전북","순창군","초등학교",2019-04-01,"여자",66,84,84,0,-18,-18,0,-0.214285714285714,-0.214285714285714
"3960","2019","전북","순창군","초등학교",2019-04-01,"남자",87,110,111,1,-24,-23,0.00909090909090909,-0.216216216216216,-0.209090909090909
"3961","2019","전북","고창군","초등학교",2019-04-01,"전체",324,331,331,0,-7,-7,0,-0.0211480362537764,-0.0211480362537764
"3962","2019","전북","고창군","초등학교",2019-04-01,"여자",153,157,157,0,-4,-4,0,-0.0254777070063694,-0.0254777070063694
"3963","2019","전북","고창군","초등학교",2019-04-01,"남자",171,174,174,0,-3,-3,0,-0.0172413793103448,-0.0172413793103448
"3964","2019","전북","부안군","초등학교",2019-04-01,"전체",306,331,329,-2,-23,-25,-0.00604229607250755,-0.0699088145896656,-0.0755287009063444
"3965","2019","전북","부안군","초등학교",2019-04-01,"여자",139,154,151,-3,-12,-15,-0.0194805194805195,-0.0794701986754967,-0.0974025974025974
"3966","2019","전북","부안군","초등학교",2019-04-01,"남자",167,177,178,1,-11,-10,0.00564971751412429,-0.0617977528089888,-0.0564971751412429
"3967","2019","전남","목포시","초등학교",2019-04-01,"전체",2762,2492,2514,22,248,270,0.00882825040128411,0.0986475735879077,0.108346709470305
"3968","2019","전남","목포시","초등학교",2019-04-01,"여자",1373,1224,1220,-4,153,149,-0.00326797385620915,0.125409836065574,0.121732026143791
"3969","2019","전남","목포시","초등학교",2019-04-01,"남자",1389,1268,1294,26,95,121,0.0205047318611987,0.0734157650695518,0.0954258675078864
"3970","2019","전남","여수시","초등학교",2019-04-01,"전체",2486,2454,2456,2,30,32,0.000814995925020375,0.012214983713355,0.013039934800326
"3971","2019","전남","여수시","초등학교",2019-04-01,"여자",1277,1228,1244,16,33,49,0.0130293159609121,0.0265273311897106,0.0399022801302932
"3972","2019","전남","여수시","초등학교",2019-04-01,"남자",1209,1226,1212,-14,-3,-17,-0.0114192495921697,-0.00247524752475248,-0.0138662316476346
"3973","2019","전남","순천시","초등학교",2019-04-01,"전체",2857,2684,2695,11,162,173,0.00409836065573771,0.0601113172541744,0.0644560357675112
"3974","2019","전남","순천시","초등학교",2019-04-01,"여자",1390,1346,1337,-9,53,44,-0.00668647845468053,0.0396409872849663,0.0326894502228826
"3975","2019","전남","순천시","초등학교",2019-04-01,"남자",1467,1338,1358,20,109,129,0.0149476831091181,0.0802650957290133,0.0964125560538117
"3976","2019","전남","나주시","초등학교",2019-04-01,"전체",1145,1113,1147,34,-2,32,0.0305480682839173,-0.001743679163034,0.0287511230907457
"3977","2019","전남","나주시","초등학교",2019-04-01,"여자",561,543,560,17,1,18,0.0313075506445672,0.00178571428571429,0.0331491712707182
"3978","2019","전남","나주시","초등학교",2019-04-01,"남자",584,570,587,17,-3,14,0.0298245614035088,-0.00511073253833049,0.0245614035087719
"3979","2019","전남","광양시","초등학교",2019-04-01,"전체",1648,1703,1692,-11,-44,-55,-0.00645918966529654,-0.0260047281323877,-0.0322959483264827
"3980","2019","전남","광양시","초등학교",2019-04-01,"여자",813,827,830,3,-17,-14,0.00362756952841596,-0.0204819277108434,-0.0169286577992745
"3981","2019","전남","광양시","초등학교",2019-04-01,"남자",835,876,862,-14,-27,-41,-0.0159817351598174,-0.031322505800464,-0.0468036529680365
"3982","2019","전남","담양군","초등학교",2019-04-01,"전체",242,288,276,-12,-34,-46,-0.0416666666666667,-0.123188405797101,-0.159722222222222
"3983","2019","전남","담양군","초등학교",2019-04-01,"여자",116,148,147,-1,-31,-32,-0.00675675675675676,-0.210884353741497,-0.216216216216216
"3984","2019","전남","담양군","초등학교",2019-04-01,"남자",126,140,129,-11,-3,-14,-0.0785714285714286,-0.0232558139534884,-0.1
"3985","2019","전남","곡성군","초등학교",2019-04-01,"전체",129,148,137,-11,-8,-19,-0.0743243243243243,-0.0583941605839416,-0.128378378378378
"3986","2019","전남","곡성군","초등학교",2019-04-01,"여자",59,64,60,-4,-1,-5,-0.0625,-0.0166666666666667,-0.078125
"3987","2019","전남","곡성군","초등학교",2019-04-01,"남자",70,84,77,-7,-7,-14,-0.0833333333333333,-0.0909090909090909,-0.166666666666667
"3988","2019","전남","구례군","초등학교",2019-04-01,"전체",136,165,155,-10,-19,-29,-0.0606060606060606,-0.12258064516129,-0.175757575757576
"3989","2019","전남","구례군","초등학교",2019-04-01,"여자",77,87,87,0,-10,-10,0,-0.114942528735632,-0.114942528735632
"3990","2019","전남","구례군","초등학교",2019-04-01,"남자",59,78,68,-10,-9,-19,-0.128205128205128,-0.132352941176471,-0.243589743589744
"3991","2019","전남","고흥군","초등학교",2019-04-01,"전체",310,320,319,-1,-9,-10,-0.003125,-0.0282131661442006,-0.03125
"3992","2019","전남","고흥군","초등학교",2019-04-01,"여자",162,164,166,2,-4,-2,0.0121951219512195,-0.0240963855421687,-0.0121951219512195
"3993","2019","전남","고흥군","초등학교",2019-04-01,"남자",148,156,153,-3,-5,-8,-0.0192307692307692,-0.0326797385620915,-0.0512820512820513
"3994","2019","전남","보성군","초등학교",2019-04-01,"전체",200,264,243,-21,-43,-64,-0.0795454545454545,-0.176954732510288,-0.242424242424242
"3995","2019","전남","보성군","초등학교",2019-04-01,"여자",90,118,103,-15,-13,-28,-0.127118644067797,-0.12621359223301,-0.23728813559322
"3996","2019","전남","보성군","초등학교",2019-04-01,"남자",110,146,140,-6,-30,-36,-0.0410958904109589,-0.214285714285714,-0.246575342465753
"3997","2019","전남","화순군","초등학교",2019-04-01,"전체",450,437,435,-2,15,13,-0.0045766590389016,0.0344827586206897,0.0297482837528604
"3998","2019","전남","화순군","초등학교",2019-04-01,"여자",224,215,208,-7,16,9,-0.0325581395348837,0.0769230769230769,0.0418604651162791
"3999","2019","전남","화순군","초등학교",2019-04-01,"남자",226,222,227,5,-1,4,0.0225225225225225,-0.00440528634361234,0.018018018018018
"4000","2019","전남","장흥군","초등학교",2019-04-01,"전체",245,248,245,-3,0,-3,-0.0120967741935484,0,-0.0120967741935484
"4001","2019","전남","장흥군","초등학교",2019-04-01,"여자",117,134,131,-3,-14,-17,-0.0223880597014925,-0.106870229007634,-0.126865671641791
"4002","2019","전남","장흥군","초등학교",2019-04-01,"남자",128,114,114,0,14,14,0,0.12280701754386,0.12280701754386
"4003","2019","전남","강진군","초등학교",2019-04-01,"전체",192,250,228,-22,-36,-58,-0.088,-0.157894736842105,-0.232
"4004","2019","전남","강진군","초등학교",2019-04-01,"여자",94,117,107,-10,-13,-23,-0.0854700854700855,-0.121495327102804,-0.196581196581197
"4005","2019","전남","강진군","초등학교",2019-04-01,"남자",98,133,121,-12,-23,-35,-0.0902255639097744,-0.190082644628099,-0.263157894736842
"4006","2019","전남","해남군","초등학교",2019-04-01,"전체",455,528,504,-24,-49,-73,-0.0454545454545455,-0.0972222222222222,-0.138257575757576
"4007","2019","전남","해남군","초등학교",2019-04-01,"여자",244,282,272,-10,-28,-38,-0.0354609929078014,-0.102941176470588,-0.134751773049645
"4008","2019","전남","해남군","초등학교",2019-04-01,"남자",211,246,232,-14,-21,-35,-0.0569105691056911,-0.0905172413793103,-0.142276422764228
"4009","2019","전남","영암군","초등학교",2019-04-01,"전체",414,491,464,-27,-50,-77,-0.054989816700611,-0.107758620689655,-0.156822810590631
"4010","2019","전남","영암군","초등학교",2019-04-01,"여자",202,236,230,-6,-28,-34,-0.0254237288135593,-0.121739130434783,-0.144067796610169
"4011","2019","전남","영암군","초등학교",2019-04-01,"남자",212,255,234,-21,-22,-43,-0.0823529411764706,-0.094017094017094,-0.168627450980392
"4012","2019","전남","무안군","초등학교",2019-04-01,"전체",827,906,924,18,-97,-79,0.0198675496688742,-0.104978354978355,-0.08719646799117
"4013","2019","전남","무안군","초등학교",2019-04-01,"여자",389,437,458,21,-69,-48,0.0480549199084668,-0.150655021834061,-0.109839816933638
"4014","2019","전남","무안군","초등학교",2019-04-01,"남자",438,469,466,-3,-28,-31,-0.00639658848614072,-0.0600858369098712,-0.0660980810234542
"4015","2019","전남","함평군","초등학교",2019-04-01,"전체",162,207,207,0,-45,-45,0,-0.217391304347826,-0.217391304347826
"4016","2019","전남","함평군","초등학교",2019-04-01,"여자",75,90,89,-1,-14,-15,-0.0111111111111111,-0.157303370786517,-0.166666666666667
"4017","2019","전남","함평군","초등학교",2019-04-01,"남자",87,117,118,1,-31,-30,0.00854700854700855,-0.26271186440678,-0.256410256410256
"4018","2019","전남","영광군","초등학교",2019-04-01,"전체",375,435,420,-15,-45,-60,-0.0344827586206897,-0.107142857142857,-0.137931034482759
"4019","2019","전남","영광군","초등학교",2019-04-01,"여자",182,219,210,-9,-28,-37,-0.0410958904109589,-0.133333333333333,-0.168949771689498
"4020","2019","전남","영광군","초등학교",2019-04-01,"남자",193,216,210,-6,-17,-23,-0.0277777777777778,-0.080952380952381,-0.106481481481481
"4021","2019","전남","장성군","초등학교",2019-04-01,"전체",322,329,319,-10,3,-7,-0.0303951367781155,0.00940438871473354,-0.0212765957446809
"4022","2019","전남","장성군","초등학교",2019-04-01,"여자",165,172,165,-7,0,-7,-0.0406976744186047,0,-0.0406976744186047
"4023","2019","전남","장성군","초등학교",2019-04-01,"남자",157,157,154,-3,3,0,-0.0191082802547771,0.0194805194805195,0
"4024","2019","전남","완도군","초등학교",2019-04-01,"전체",387,394,388,-6,-1,-7,-0.0152284263959391,-0.00257731958762887,-0.0177664974619289
"4025","2019","전남","완도군","초등학교",2019-04-01,"여자",196,196,192,-4,4,0,-0.0204081632653061,0.0208333333333333,0
"4026","2019","전남","완도군","초등학교",2019-04-01,"남자",191,198,196,-2,-5,-7,-0.0101010101010101,-0.0255102040816327,-0.0353535353535354
"4027","2019","전남","진도군","초등학교",2019-04-01,"전체",199,227,227,0,-28,-28,0,-0.123348017621145,-0.123348017621145
"4028","2019","전남","진도군","초등학교",2019-04-01,"여자",94,100,99,-1,-5,-6,-0.01,-0.0505050505050505,-0.06
"4029","2019","전남","진도군","초등학교",2019-04-01,"남자",105,127,128,1,-23,-22,0.0078740157480315,-0.1796875,-0.173228346456693
"4030","2019","전남","신안군","초등학교",2019-04-01,"전체",177,239,228,-11,-51,-62,-0.0460251046025105,-0.223684210526316,-0.259414225941423
"4031","2019","전남","신안군","초등학교",2019-04-01,"여자",90,127,115,-12,-25,-37,-0.094488188976378,-0.217391304347826,-0.291338582677165
"4032","2019","전남","신안군","초등학교",2019-04-01,"남자",87,112,113,1,-26,-25,0.00892857142857143,-0.230088495575221,-0.223214285714286
"4033","2019","경북","포항시","초등학교",2019-04-01,"전체",4866,4917,4898,-19,-32,-51,-0.00386414480374212,-0.00653327888934259,-0.0103721781574131
"4034","2019","경북","포항시","초등학교",2019-04-01,"여자",2307,2322,2323,1,-16,-15,0.000430663221360896,-0.00688764528626776,-0.00645994832041344
"4035","2019","경북","포항시","초등학교",2019-04-01,"남자",2559,2595,2575,-20,-16,-36,-0.00770712909441233,-0.00621359223300971,-0.0138728323699422
"4036","2019","경북","경주시","초등학교",2019-04-01,"전체",1984,1905,1911,6,73,79,0.0031496062992126,0.0381998953427525,0.0414698162729659
"4037","2019","경북","경주시","초등학교",2019-04-01,"여자",974,934,945,11,29,40,0.0117773019271949,0.0306878306878307,0.0428265524625268
"4038","2019","경북","경주시","초등학교",2019-04-01,"남자",1010,971,966,-5,44,39,-0.00514933058702369,0.0455486542443064,0.0401647785787848
"4039","2019","경북","김천시","초등학교",2019-04-01,"전체",1228,1247,1237,-10,-9,-19,-0.00801924619085806,-0.00727566693613581,-0.0152365677626303
"4040","2019","경북","김천시","초등학교",2019-04-01,"여자",598,612,604,-8,-6,-14,-0.0130718954248366,-0.00993377483443709,-0.0228758169934641
"4041","2019","경북","김천시","초등학교",2019-04-01,"남자",630,635,633,-2,-3,-5,-0.0031496062992126,-0.004739336492891,-0.0078740157480315
"4042","2019","경북","안동시","초등학교",2019-04-01,"전체",1424,1431,1347,-84,77,-7,-0.0587002096436059,0.0571640682999258,-0.00489168413696716
"4043","2019","경북","안동시","초등학교",2019-04-01,"여자",665,659,627,-32,38,6,-0.0485584218512898,0.0606060606060606,0.00910470409711684
"4044","2019","경북","안동시","초등학교",2019-04-01,"남자",759,772,720,-52,39,-13,-0.0673575129533679,0.0541666666666667,-0.016839378238342
"4045","2019","경북","구미시","초등학교",2019-04-01,"전체",5161,4942,4991,49,170,219,0.00991501416430595,0.0340613103586456,0.0443140428976123
"4046","2019","경북","구미시","초등학교",2019-04-01,"여자",2501,2373,2397,24,104,128,0.0101137800252845,0.0433875677930747,0.0539401601348504
"4047","2019","경북","구미시","초등학교",2019-04-01,"남자",2660,2569,2594,25,66,91,0.00973141300116777,0.0254433307632999,0.0354223433242507
"4048","2019","경북","영주시","초등학교",2019-04-01,"전체",845,800,802,2,43,45,0.0025,0.0536159600997506,0.05625
"4049","2019","경북","영주시","초등학교",2019-04-01,"여자",400,384,384,0,16,16,0,0.0416666666666667,0.0416666666666667
"4050","2019","경북","영주시","초등학교",2019-04-01,"남자",445,416,418,2,27,29,0.00480769230769231,0.0645933014354067,0.0697115384615385
"4051","2019","경북","영천시","초등학교",2019-04-01,"전체",610,644,641,-3,-31,-34,-0.0046583850931677,-0.0483619344773791,-0.0527950310559006
"4052","2019","경북","영천시","초등학교",2019-04-01,"여자",319,339,333,-6,-14,-20,-0.0176991150442478,-0.042042042042042,-0.0589970501474926
"4053","2019","경북","영천시","초등학교",2019-04-01,"남자",291,305,308,3,-17,-14,0.00983606557377049,-0.0551948051948052,-0.0459016393442623
"4054","2019","경북","상주시","초등학교",2019-04-01,"전체",606,628,630,2,-24,-22,0.00318471337579618,-0.0380952380952381,-0.035031847133758
"4055","2019","경북","상주시","초등학교",2019-04-01,"여자",286,294,294,0,-8,-8,0,-0.0272108843537415,-0.0272108843537415
"4056","2019","경북","상주시","초등학교",2019-04-01,"남자",320,334,336,2,-16,-14,0.00598802395209581,-0.0476190476190476,-0.0419161676646707
"4057","2019","경북","문경시","초등학교",2019-04-01,"전체",486,533,510,-23,-24,-47,-0.0431519699812383,-0.0470588235294118,-0.0881801125703565
"4058","2019","경북","문경시","초등학교",2019-04-01,"여자",230,247,237,-10,-7,-17,-0.0404858299595142,-0.029535864978903,-0.0688259109311741
"4059","2019","경북","문경시","초등학교",2019-04-01,"남자",256,286,273,-13,-17,-30,-0.0454545454545455,-0.0622710622710623,-0.104895104895105
"4060","2019","경북","경산시","초등학교",2019-04-01,"전체",2437,2462,2455,-7,-18,-25,-0.00284321689683184,-0.00733197556008147,-0.0101543460601137
"4061","2019","경북","경산시","초등학교",2019-04-01,"여자",1196,1230,1217,-13,-21,-34,-0.0105691056910569,-0.0172555464256368,-0.0276422764227642
"4062","2019","경북","경산시","초등학교",2019-04-01,"남자",1241,1232,1238,6,3,9,0.00487012987012987,0.0024232633279483,0.00730519480519481
"4063","2019","경북","군위군","초등학교",2019-04-01,"전체",87,93,91,-2,-4,-6,-0.021505376344086,-0.043956043956044,-0.0645161290322581
"4064","2019","경북","군위군","초등학교",2019-04-01,"여자",37,43,40,-3,-3,-6,-0.0697674418604651,-0.075,-0.13953488372093
"4065","2019","경북","군위군","초등학교",2019-04-01,"남자",50,50,51,1,-1,0,0.02,-0.0196078431372549,0
"4066","2019","경북","의성군","초등학교",2019-04-01,"전체",177,189,182,-7,-5,-12,-0.037037037037037,-0.0274725274725275,-0.0634920634920635
"4067","2019","경북","의성군","초등학교",2019-04-01,"여자",87,98,93,-5,-6,-11,-0.0510204081632653,-0.0645161290322581,-0.112244897959184
"4068","2019","경북","의성군","초등학교",2019-04-01,"남자",90,91,89,-2,1,-1,-0.021978021978022,0.0112359550561798,-0.010989010989011
"4069","2019","경북","청송군","초등학교",2019-04-01,"전체",115,133,131,-2,-16,-18,-0.0150375939849624,-0.122137404580153,-0.135338345864662
"4070","2019","경북","청송군","초등학교",2019-04-01,"여자",56,64,61,-3,-5,-8,-0.046875,-0.0819672131147541,-0.125
"4071","2019","경북","청송군","초등학교",2019-04-01,"남자",59,69,70,1,-11,-10,0.0144927536231884,-0.157142857142857,-0.144927536231884
"4072","2019","경북","영양군","초등학교",2019-04-01,"전체",70,89,83,-6,-13,-19,-0.0674157303370786,-0.156626506024096,-0.213483146067416
"4073","2019","경북","영양군","초등학교",2019-04-01,"여자",28,41,39,-2,-11,-13,-0.0487804878048781,-0.282051282051282,-0.317073170731707
"4074","2019","경북","영양군","초등학교",2019-04-01,"남자",42,48,44,-4,-2,-6,-0.0833333333333333,-0.0454545454545455,-0.125
"4075","2019","경북","영덕군","초등학교",2019-04-01,"전체",174,205,210,5,-36,-31,0.024390243902439,-0.171428571428571,-0.151219512195122
"4076","2019","경북","영덕군","초등학교",2019-04-01,"여자",87,98,99,1,-12,-11,0.0102040816326531,-0.121212121212121,-0.112244897959184
"4077","2019","경북","영덕군","초등학교",2019-04-01,"남자",87,107,111,4,-24,-20,0.0373831775700935,-0.216216216216216,-0.186915887850467
"4078","2019","경북","청도군","초등학교",2019-04-01,"전체",183,190,185,-5,-2,-7,-0.0263157894736842,-0.0108108108108108,-0.0368421052631579
"4079","2019","경북","청도군","초등학교",2019-04-01,"여자",85,84,83,-1,2,1,-0.0119047619047619,0.0240963855421687,0.0119047619047619
"4080","2019","경북","청도군","초등학교",2019-04-01,"남자",98,106,102,-4,-4,-8,-0.0377358490566038,-0.0392156862745098,-0.0754716981132075
"4081","2019","경북","고령군","초등학교",2019-04-01,"전체",188,227,211,-16,-23,-39,-0.0704845814977974,-0.109004739336493,-0.171806167400881
"4082","2019","경북","고령군","초등학교",2019-04-01,"여자",88,123,114,-9,-26,-35,-0.0731707317073171,-0.228070175438596,-0.284552845528455
"4083","2019","경북","고령군","초등학교",2019-04-01,"남자",100,104,97,-7,3,-4,-0.0673076923076923,0.0309278350515464,-0.0384615384615385
"4084","2019","경북","성주군","초등학교",2019-04-01,"전체",193,250,227,-23,-34,-57,-0.092,-0.149779735682819,-0.228
"4085","2019","경북","성주군","초등학교",2019-04-01,"여자",99,126,109,-17,-10,-27,-0.134920634920635,-0.0917431192660551,-0.214285714285714
"4086","2019","경북","성주군","초등학교",2019-04-01,"남자",94,124,118,-6,-24,-30,-0.0483870967741935,-0.203389830508475,-0.241935483870968
"4087","2019","경북","칠곡군","초등학교",2019-04-01,"전체",1244,1354,1311,-43,-67,-110,-0.0317577548005908,-0.0511060259344012,-0.0812407680945347
"4088","2019","경북","칠곡군","초등학교",2019-04-01,"여자",595,662,646,-16,-51,-67,-0.0241691842900302,-0.0789473684210526,-0.101208459214502
"4089","2019","경북","칠곡군","초등학교",2019-04-01,"남자",649,692,665,-27,-16,-43,-0.0390173410404624,-0.0240601503759399,-0.0621387283236994
"4090","2019","경북","예천군","초등학교",2019-04-01,"전체",367,306,435,129,-68,61,0.42156862745098,-0.15632183908046,0.199346405228758
"4091","2019","경북","예천군","초등학교",2019-04-01,"여자",157,136,206,70,-49,21,0.514705882352941,-0.237864077669903,0.154411764705882
"4092","2019","경북","예천군","초등학교",2019-04-01,"남자",210,170,229,59,-19,40,0.347058823529412,-0.0829694323144105,0.235294117647059
"4093","2019","경북","봉화군","초등학교",2019-04-01,"전체",141,196,187,-9,-46,-55,-0.0459183673469388,-0.245989304812834,-0.280612244897959
"4094","2019","경북","봉화군","초등학교",2019-04-01,"여자",63,90,86,-4,-23,-27,-0.0444444444444444,-0.267441860465116,-0.3
"4095","2019","경북","봉화군","초등학교",2019-04-01,"남자",78,106,101,-5,-23,-28,-0.0471698113207547,-0.227722772277228,-0.264150943396226
"4096","2019","경북","울진군","초등학교",2019-04-01,"전체",330,356,350,-6,-20,-26,-0.0168539325842697,-0.0571428571428571,-0.0730337078651685
"4097","2019","경북","울진군","초등학교",2019-04-01,"여자",145,159,158,-1,-13,-14,-0.00628930817610063,-0.0822784810126582,-0.0880503144654088
"4098","2019","경북","울진군","초등학교",2019-04-01,"남자",185,197,192,-5,-7,-12,-0.0253807106598985,-0.0364583333333333,-0.0609137055837563
"4099","2019","경북","울릉군","초등학교",2019-04-01,"전체",50,56,56,0,-6,-6,0,-0.107142857142857,-0.107142857142857
"4100","2019","경북","울릉군","초등학교",2019-04-01,"여자",30,32,34,2,-4,-2,0.0625,-0.117647058823529,-0.0625
"4101","2019","경북","울릉군","초등학교",2019-04-01,"남자",20,24,22,-2,-2,-4,-0.0833333333333333,-0.0909090909090909,-0.166666666666667
"4102","2019","경남","진주시","초등학교",2019-04-01,"전체",3444,3279,3304,25,140,165,0.00762427569380909,0.0423728813559322,0.05032021957914
"4103","2019","경남","진주시","초등학교",2019-04-01,"여자",1653,1582,1581,-1,72,71,-0.000632111251580278,0.0455407969639469,0.0448798988621998
"4104","2019","경남","진주시","초등학교",2019-04-01,"남자",1791,1697,1723,26,68,94,0.0153211549793754,0.0394660475914103,0.0553918680023571
"4105","2019","경남","통영시","초등학교",2019-04-01,"전체",1427,1443,1385,-58,42,-16,-0.0401940401940402,0.0303249097472924,-0.0110880110880111
"4106","2019","경남","통영시","초등학교",2019-04-01,"여자",685,697,668,-29,17,-12,-0.0416068866571019,0.0254491017964072,-0.0172166427546628
"4107","2019","경남","통영시","초등학교",2019-04-01,"남자",742,746,717,-29,25,-4,-0.0388739946380697,0.0348675034867503,-0.00536193029490617
"4108","2019","경남","사천시","초등학교",2019-04-01,"전체",1068,1071,1053,-18,15,-3,-0.0168067226890756,0.0142450142450142,-0.00280112044817927
"4109","2019","경남","사천시","초등학교",2019-04-01,"여자",517,489,487,-2,30,28,-0.00408997955010225,0.0616016427104723,0.0572597137014315
"4110","2019","경남","사천시","초등학교",2019-04-01,"남자",551,582,566,-16,-15,-31,-0.0274914089347079,-0.0265017667844523,-0.0532646048109966
"4111","2019","경남","김해시","초등학교",2019-04-01,"전체",6171,5883,5899,16,272,288,0.00271970083290838,0.0461095100864553,0.0489546149923508
"4112","2019","경남","김해시","초등학교",2019-04-01,"여자",3100,2964,2961,-3,139,136,-0.00101214574898785,0.0469436001350895,0.0458839406207827
"4113","2019","경남","김해시","초등학교",2019-04-01,"남자",3071,2919,2938,19,133,152,0.00650907845152449,0.0452688904016338,0.052072627612196
"4114","2019","경남","밀양시","초등학교",2019-04-01,"전체",673,707,702,-5,-29,-34,-0.00707213578500707,-0.0413105413105413,-0.0480905233380481
"4115","2019","경남","밀양시","초등학교",2019-04-01,"여자",314,340,341,1,-27,-26,0.00294117647058824,-0.0791788856304985,-0.0764705882352941
"4116","2019","경남","밀양시","초등학교",2019-04-01,"남자",359,367,361,-6,-2,-8,-0.0163487738419619,-0.00554016620498615,-0.0217983651226158
"4117","2019","경남","거제시","초등학교",2019-04-01,"전체",3412,3573,3483,-90,-71,-161,-0.0251889168765743,-0.0203847258110824,-0.0450601735236496
"4118","2019","경남","거제시","초등학교",2019-04-01,"여자",1621,1680,1627,-53,-6,-59,-0.031547619047619,-0.00368776889981561,-0.0351190476190476
"4119","2019","경남","거제시","초등학교",2019-04-01,"남자",1791,1893,1856,-37,-65,-102,-0.0195456946645536,-0.0350215517241379,-0.0538827258320127
"4120","2019","경남","양산시","초등학교",2019-04-01,"전체",4026,3653,3922,269,104,373,0.0736381056665754,0.0265170831208567,0.102107856556255
"4121","2019","경남","양산시","초등학교",2019-04-01,"여자",1938,1819,1969,150,-31,119,0.0824628916987356,-0.015744032503809,0.0654205607476635
"4122","2019","경남","양산시","초등학교",2019-04-01,"남자",2088,1834,1953,119,135,254,0.0648854961832061,0.0691244239631336,0.138495092693566
"4123","2019","경남","의령군","초등학교",2019-04-01,"전체",129,167,156,-11,-27,-38,-0.0658682634730539,-0.173076923076923,-0.227544910179641
"4124","2019","경남","의령군","초등학교",2019-04-01,"여자",50,75,69,-6,-19,-25,-0.08,-0.27536231884058,-0.333333333333333
"4125","2019","경남","의령군","초등학교",2019-04-01,"남자",79,92,87,-5,-8,-13,-0.0543478260869565,-0.0919540229885057,-0.141304347826087
"4126","2019","경남","함안군","초등학교",2019-04-01,"전체",592,594,585,-9,7,-2,-0.0151515151515152,0.011965811965812,-0.00336700336700337
"4127","2019","경남","함안군","초등학교",2019-04-01,"여자",288,282,271,-11,17,6,-0.0390070921985816,0.0627306273062731,0.0212765957446809
"4128","2019","경남","함안군","초등학교",2019-04-01,"남자",304,312,314,2,-10,-8,0.00641025641025641,-0.0318471337579618,-0.0256410256410256
"4129","2019","경남","창녕군","초등학교",2019-04-01,"전체",392,394,403,9,-11,-2,0.0228426395939086,-0.0272952853598015,-0.0050761421319797
"4130","2019","경남","창녕군","초등학교",2019-04-01,"여자",206,190,198,8,8,16,0.0421052631578947,0.0404040404040404,0.0842105263157895
"4131","2019","경남","창녕군","초등학교",2019-04-01,"남자",186,204,205,1,-19,-18,0.00490196078431373,-0.0926829268292683,-0.0882352941176471
"4132","2019","경남","고성군","초등학교",2019-04-01,"전체",382,419,403,-16,-21,-37,-0.0381861575178998,-0.0521091811414392,-0.0883054892601432
"4133","2019","경남","고성군","초등학교",2019-04-01,"여자",185,216,202,-14,-17,-31,-0.0648148148148148,-0.0841584158415842,-0.143518518518519
"4134","2019","경남","고성군","초등학교",2019-04-01,"남자",197,203,201,-2,-4,-6,-0.00985221674876847,-0.0199004975124378,-0.0295566502463054
"4135","2019","경남","남해군","초등학교",2019-04-01,"전체",183,187,196,9,-13,-4,0.0481283422459893,-0.0663265306122449,-0.0213903743315508
"4136","2019","경남","남해군","초등학교",2019-04-01,"여자",92,91,99,8,-7,1,0.0879120879120879,-0.0707070707070707,0.010989010989011
"4137","2019","경남","남해군","초등학교",2019-04-01,"남자",91,96,97,1,-6,-5,0.0104166666666667,-0.0618556701030928,-0.0520833333333333
"4138","2019","경남","하동군","초등학교",2019-04-01,"전체",214,242,234,-8,-20,-28,-0.0330578512396694,-0.0854700854700855,-0.115702479338843
"4139","2019","경남","하동군","초등학교",2019-04-01,"여자",101,111,106,-5,-5,-10,-0.045045045045045,-0.0471698113207547,-0.0900900900900901
"4140","2019","경남","하동군","초등학교",2019-04-01,"남자",113,131,128,-3,-15,-18,-0.0229007633587786,-0.1171875,-0.137404580152672
"4141","2019","경남","산청군","초등학교",2019-04-01,"전체",159,188,183,-5,-24,-29,-0.0265957446808511,-0.131147540983607,-0.154255319148936
"4142","2019","경남","산청군","초등학교",2019-04-01,"여자",69,96,92,-4,-23,-27,-0.0416666666666667,-0.25,-0.28125
"4143","2019","경남","산청군","초등학교",2019-04-01,"남자",90,92,91,-1,-1,-2,-0.0108695652173913,-0.010989010989011,-0.0217391304347826
"4144","2019","경남","함양군","초등학교",2019-04-01,"전체",222,229,232,3,-10,-7,0.0131004366812227,-0.0431034482758621,-0.0305676855895196
"4145","2019","경남","함양군","초등학교",2019-04-01,"여자",90,91,92,1,-2,-1,0.010989010989011,-0.0217391304347826,-0.010989010989011
"4146","2019","경남","함양군","초등학교",2019-04-01,"남자",132,138,140,2,-8,-6,0.0144927536231884,-0.0571428571428571,-0.0434782608695652
"4147","2019","경남","거창군","초등학교",2019-04-01,"전체",482,444,450,6,32,38,0.0135135135135135,0.0711111111111111,0.0855855855855856
"4148","2019","경남","거창군","초등학교",2019-04-01,"여자",227,218,219,1,8,9,0.00458715596330275,0.0365296803652968,0.0412844036697248
"4149","2019","경남","거창군","초등학교",2019-04-01,"남자",255,226,231,5,24,29,0.0221238938053097,0.103896103896104,0.128318584070796
"4150","2019","경남","합천군","초등학교",2019-04-01,"전체",177,226,220,-6,-43,-49,-0.0265486725663717,-0.195454545454545,-0.216814159292035
"4151","2019","경남","합천군","초등학교",2019-04-01,"여자",80,103,104,1,-24,-23,0.00970873786407767,-0.230769230769231,-0.223300970873786
"4152","2019","경남","합천군","초등학교",2019-04-01,"남자",97,123,116,-7,-19,-26,-0.0569105691056911,-0.163793103448276,-0.211382113821138
"4153","2019","제주","제주시","초등학교",2019-04-01,"전체",5533,5130,5311,181,222,403,0.0352826510721248,0.0418000376576916,0.0785575048732944
"4154","2019","제주","제주시","초등학교",2019-04-01,"여자",2712,2548,2645,97,67,164,0.0380690737833595,0.0253308128544423,0.0643642072213501
"4155","2019","제주","제주시","초등학교",2019-04-01,"남자",2821,2582,2666,84,155,239,0.0325329202168861,0.0581395348837209,0.092563903950426
"4156","2019","제주","서귀포시","초등학교",2019-04-01,"전체",1624,1561,1673,112,-49,63,0.0717488789237668,-0.0292887029288703,0.0403587443946188
"4157","2019","제주","서귀포시","초등학교",2019-04-01,"여자",796,769,818,49,-22,27,0.0637191157347204,-0.0268948655256724,0.035110533159948
"4158","2019","제주","서귀포시","초등학교",2019-04-01,"남자",828,792,855,63,-27,36,0.0795454545454545,-0.0315789473684211,0.0454545454545455
"4159","2020","서울","종로구","초등학교",2020-04-01,"전체",764,871,862,-9,-98,-107,-0.0103329506314581,-0.11368909512761,-0.12284730195178
"4160","2020","서울","종로구","초등학교",2020-04-01,"여자",383,428,439,11,-56,-45,0.0257009345794393,-0.127562642369021,-0.105140186915888
"4161","2020","서울","종로구","초등학교",2020-04-01,"남자",381,443,423,-20,-42,-62,-0.0451467268623025,-0.099290780141844,-0.139954853273138
"4162","2020","서울","중구","초등학교",2020-04-01,"전체",907,822,789,-33,118,85,-0.0401459854014599,0.149556400506971,0.103406326034063
"4163","2020","서울","중구","초등학교",2020-04-01,"여자",452,408,383,-25,69,44,-0.0612745098039216,0.180156657963446,0.107843137254902
"4164","2020","서울","중구","초등학교",2020-04-01,"남자",455,414,406,-8,49,41,-0.0193236714975845,0.120689655172414,0.0990338164251208
"4165","2020","서울","용산구","초등학교",2020-04-01,"전체",1090,1502,1456,-46,-366,-412,-0.0306258322237017,-0.251373626373626,-0.274300932090546
"4166","2020","서울","용산구","초등학교",2020-04-01,"여자",537,744,724,-20,-187,-207,-0.0268817204301075,-0.25828729281768,-0.278225806451613
"4167","2020","서울","용산구","초등학교",2020-04-01,"남자",553,758,732,-26,-179,-205,-0.0343007915567282,-0.244535519125683,-0.270448548812665
"4168","2020","서울","성동구","초등학교",2020-04-01,"전체",1891,2409,2276,-133,-385,-518,-0.0552096305520963,-0.169156414762742,-0.21502698215027
"4169","2020","서울","성동구","초등학교",2020-04-01,"여자",904,1184,1126,-58,-222,-280,-0.0489864864864865,-0.197158081705151,-0.236486486486486
"4170","2020","서울","성동구","초등학교",2020-04-01,"남자",987,1225,1150,-75,-163,-238,-0.0612244897959184,-0.141739130434783,-0.194285714285714
"4171","2020","서울","광진구","초등학교",2020-04-01,"전체",2244,2308,2273,-35,-29,-64,-0.0151646447140381,-0.012758468983722,-0.0277296360485269
"4172","2020","서울","광진구","초등학교",2020-04-01,"여자",1120,1085,1068,-17,52,35,-0.015668202764977,0.048689138576779,0.032258064516129
"4173","2020","서울","광진구","초등학교",2020-04-01,"남자",1124,1223,1205,-18,-81,-99,-0.0147179067865904,-0.0672199170124481,-0.0809484873262469
"4174","2020","서울","동대문구","초등학교",2020-04-01,"전체",2136,2266,2263,-3,-127,-130,-0.00132391879964696,-0.0561201944321697,-0.057369814651368
"4175","2020","서울","동대문구","초등학교",2020-04-01,"여자",1019,1103,1111,8,-92,-84,0.00725294650951949,-0.0828082808280828,-0.0761559383499547
"4176","2020","서울","동대문구","초등학교",2020-04-01,"남자",1117,1163,1152,-11,-35,-46,-0.00945829750644884,-0.0303819444444444,-0.0395528804815133
"4177","2020","서울","중랑구","초등학교",2020-04-01,"전체",2369,2834,2695,-139,-326,-465,-0.0490472829922371,-0.120964749536178,-0.164079040225829
"4178","2020","서울","중랑구","초등학교",2020-04-01,"여자",1151,1375,1302,-73,-151,-224,-0.0530909090909091,-0.115975422427035,-0.162909090909091
"4179","2020","서울","중랑구","초등학교",2020-04-01,"남자",1218,1459,1393,-66,-175,-241,-0.0452364633310487,-0.125628140703518,-0.165181631254284
"4180","2020","서울","성북구","초등학교",2020-04-01,"전체",3137,3269,3215,-54,-78,-132,-0.0165188130926889,-0.0242612752721617,-0.0403793208932395
"4181","2020","서울","성북구","초등학교",2020-04-01,"여자",1579,1598,1579,-19,0,-19,-0.0118898623279099,0,-0.0118898623279099
"4182","2020","서울","성북구","초등학교",2020-04-01,"남자",1558,1671,1636,-35,-78,-113,-0.0209455415918612,-0.0476772616136919,-0.0676241771394375
"4183","2020","서울","강북구","초등학교",2020-04-01,"전체",1528,1979,1869,-110,-341,-451,-0.0555836280949975,-0.182450508293205,-0.22789287518949
"4184","2020","서울","강북구","초등학교",2020-04-01,"여자",718,969,916,-53,-198,-251,-0.0546955624355005,-0.216157205240175,-0.259029927760578
"4185","2020","서울","강북구","초등학교",2020-04-01,"남자",810,1010,953,-57,-143,-200,-0.0564356435643564,-0.150052465897167,-0.198019801980198
"4186","2020","서울","도봉구","초등학교",2020-04-01,"전체",2214,2233,2144,-89,70,-19,-0.0398566950291088,0.0326492537313433,-0.00850873264666368
"4187","2020","서울","도봉구","초등학교",2020-04-01,"여자",1077,1078,1043,-35,34,-1,-0.0324675324675325,0.0325982742090125,-0.000927643784786642
"4188","2020","서울","도봉구","초등학교",2020-04-01,"남자",1137,1155,1101,-54,36,-18,-0.0467532467532468,0.0326975476839237,-0.0155844155844156
"4189","2020","서울","노원구","초등학교",2020-04-01,"전체",3821,3790,3653,-137,168,31,-0.0361477572559367,0.0459895975910211,0.00817941952506596
"4190","2020","서울","노원구","초등학교",2020-04-01,"여자",1842,1844,1754,-90,88,-2,-0.0488069414316703,0.0501710376282782,-0.00108459869848156
"4191","2020","서울","노원구","초등학교",2020-04-01,"남자",1979,1946,1899,-47,80,33,-0.0241521068859198,0.0421274354923644,0.0169578622816033
"4192","2020","서울","은평구","초등학교",2020-04-01,"전체",3150,3315,3246,-69,-96,-165,-0.020814479638009,-0.0295748613678373,-0.0497737556561086
"4193","2020","서울","은평구","초등학교",2020-04-01,"여자",1500,1555,1529,-26,-29,-55,-0.0167202572347267,-0.0189666448659254,-0.0353697749196141
"4194","2020","서울","은평구","초등학교",2020-04-01,"남자",1650,1760,1717,-43,-67,-110,-0.0244318181818182,-0.0390215492137449,-0.0625
"4195","2020","서울","서대문구","초등학교",2020-04-01,"전체",2179,2206,2188,-18,-9,-27,-0.00815956482320943,-0.00411334552102377,-0.0122393472348141
"4196","2020","서울","서대문구","초등학교",2020-04-01,"여자",1075,1097,1082,-15,-7,-22,-0.0136736554238833,-0.00646950092421442,-0.0200546946216955
"4197","2020","서울","서대문구","초등학교",2020-04-01,"남자",1104,1109,1106,-3,-2,-5,-0.00270513976555455,-0.00180831826401447,-0.00450856627592426
"4198","2020","서울","마포구","초등학교",2020-04-01,"전체",2211,2727,2675,-52,-464,-516,-0.0190685735240191,-0.173457943925234,-0.189218921892189
"4199","2020","서울","마포구","초등학교",2020-04-01,"여자",1119,1393,1367,-26,-248,-274,-0.018664752333094,-0.181419166057059,-0.196697774587222
"4200","2020","서울","마포구","초등학교",2020-04-01,"남자",1092,1334,1308,-26,-216,-242,-0.0194902548725637,-0.165137614678899,-0.181409295352324
"4201","2020","서울","양천구","초등학교",2020-04-01,"전체",3575,3471,3512,41,63,104,0.0118121578795736,0.0179384965831435,0.0299625468164794
"4202","2020","서울","양천구","초등학교",2020-04-01,"여자",1725,1686,1710,24,15,39,0.0142348754448399,0.0087719298245614,0.0231316725978648
"4203","2020","서울","양천구","초등학교",2020-04-01,"남자",1850,1785,1802,17,48,65,0.00952380952380952,0.0266370699223085,0.0364145658263305
"4204","2020","서울","강서구","초등학교",2020-04-01,"전체",4277,5076,4835,-241,-558,-799,-0.047478329393223,-0.11540847983454,-0.157407407407407
"4205","2020","서울","강서구","초등학교",2020-04-01,"여자",2097,2486,2349,-137,-252,-389,-0.0551086082059533,-0.10727969348659,-0.156476267095736
"4206","2020","서울","강서구","초등학교",2020-04-01,"남자",2180,2590,2486,-104,-306,-410,-0.0401544401544402,-0.123089300080451,-0.158301158301158
"4207","2020","서울","구로구","초등학교",2020-04-01,"전체",3014,3346,3216,-130,-202,-332,-0.0388523610280932,-0.0628109452736318,-0.0992229527794381
"4208","2020","서울","구로구","초등학교",2020-04-01,"여자",1463,1634,1556,-78,-93,-171,-0.0477356181150551,-0.0597686375321337,-0.104651162790698
"4209","2020","서울","구로구","초등학교",2020-04-01,"남자",1551,1712,1660,-52,-109,-161,-0.0303738317757009,-0.0656626506024096,-0.0940420560747664
"4210","2020","서울","금천구","초등학교",2020-04-01,"전체",1336,1485,1443,-42,-107,-149,-0.0282828282828283,-0.0741510741510742,-0.1003367003367
"4211","2020","서울","금천구","초등학교",2020-04-01,"여자",660,712,683,-29,-23,-52,-0.0407303370786517,-0.0336749633967789,-0.0730337078651685
"4212","2020","서울","금천구","초등학교",2020-04-01,"남자",676,773,760,-13,-84,-97,-0.0168175937904269,-0.110526315789474,-0.125485122897801
"4213","2020","서울","영등포구","초등학교",2020-04-01,"전체",2265,2665,2542,-123,-277,-400,-0.0461538461538462,-0.108969315499607,-0.150093808630394
"4214","2020","서울","영등포구","초등학교",2020-04-01,"여자",1097,1263,1220,-43,-123,-166,-0.0340459224069675,-0.100819672131148,-0.131433095803642
"4215","2020","서울","영등포구","초등학교",2020-04-01,"남자",1168,1402,1322,-80,-154,-234,-0.0570613409415121,-0.116490166414523,-0.166904422253923
"4216","2020","서울","동작구","초등학교",2020-04-01,"전체",2545,2772,2722,-50,-177,-227,-0.018037518037518,-0.065025716385011,-0.0818903318903319
"4217","2020","서울","동작구","초등학교",2020-04-01,"여자",1258,1365,1339,-26,-81,-107,-0.019047619047619,-0.0604929051530993,-0.0783882783882784
"4218","2020","서울","동작구","초등학교",2020-04-01,"남자",1287,1407,1383,-24,-96,-120,-0.0170575692963753,-0.06941431670282,-0.0852878464818763
"4219","2020","서울","관악구","초등학교",2020-04-01,"전체",2302,2804,2634,-170,-332,-502,-0.0606276747503566,-0.126044039483675,-0.179029957203994
"4220","2020","서울","관악구","초등학교",2020-04-01,"여자",1133,1372,1279,-93,-146,-239,-0.0677842565597668,-0.114151681000782,-0.174198250728863
"4221","2020","서울","관악구","초등학교",2020-04-01,"남자",1169,1432,1355,-77,-186,-263,-0.0537709497206704,-0.137269372693727,-0.183659217877095
"4222","2020","서울","서초구","초등학교",2020-04-01,"전체",3479,3807,3817,10,-338,-328,0.0026267402153927,-0.0885512182342154,-0.0861570790648805
"4223","2020","서울","서초구","초등학교",2020-04-01,"여자",1648,1832,1825,-7,-177,-184,-0.00382096069868996,-0.096986301369863,-0.100436681222707
"4224","2020","서울","서초구","초등학교",2020-04-01,"남자",1831,1975,1992,17,-161,-144,0.00860759493670886,-0.0808232931726908,-0.0729113924050633
"4225","2020","서울","강남구","초등학교",2020-04-01,"전체",3913,4013,4061,48,-148,-100,0.011961126339397,-0.0364442255602068,-0.024919013207077
"4226","2020","서울","강남구","초등학교",2020-04-01,"여자",1849,1922,1952,30,-103,-73,0.0156087408949011,-0.052766393442623,-0.0379812695109261
"4227","2020","서울","강남구","초등학교",2020-04-01,"남자",2064,2091,2109,18,-45,-27,0.00860832137733142,-0.0213371266002845,-0.0129124820659971
"4228","2020","서울","송파구","초등학교",2020-04-01,"전체",4926,5268,5402,134,-476,-342,0.0254365983295368,-0.088115512773047,-0.0649202733485194
"4229","2020","서울","송파구","초등학교",2020-04-01,"여자",2411,2575,2638,63,-227,-164,0.0244660194174757,-0.0860500379075057,-0.0636893203883495
"4230","2020","서울","송파구","초등학교",2020-04-01,"남자",2515,2693,2764,71,-249,-178,0.0263646490902339,-0.0900868306801737,-0.0660972892684738
"4231","2020","서울","강동구","초등학교",2020-04-01,"전체",3404,3293,3176,-117,228,111,-0.0355299119344063,0.0717884130982368,0.0337078651685393
"4232","2020","서울","강동구","초등학교",2020-04-01,"여자",1606,1581,1521,-60,85,25,-0.0379506641366224,0.0558842866535174,0.0158127767235927
"4233","2020","서울","강동구","초등학교",2020-04-01,"남자",1798,1712,1655,-57,143,86,-0.0332943925233645,0.086404833836858,0.0502336448598131
"4234","2020","부산","중구","초등학교",2020-04-01,"전체",209,183,170,-13,39,26,-0.0710382513661202,0.229411764705882,0.14207650273224
"4235","2020","부산","중구","초등학교",2020-04-01,"여자",95,84,75,-9,20,11,-0.107142857142857,0.266666666666667,0.130952380952381
"4236","2020","부산","중구","초등학교",2020-04-01,"남자",114,99,95,-4,19,15,-0.0404040404040404,0.2,0.151515151515152
"4237","2020","부산","서구","초등학교",2020-04-01,"전체",561,598,628,30,-67,-37,0.0501672240802676,-0.106687898089172,-0.0618729096989967
"4238","2020","부산","서구","초등학교",2020-04-01,"여자",239,279,295,16,-56,-40,0.0573476702508961,-0.189830508474576,-0.14336917562724
"4239","2020","부산","서구","초등학교",2020-04-01,"남자",322,319,333,14,-11,3,0.0438871473354232,-0.033033033033033,0.00940438871473354
"4240","2020","부산","동구","초등학교",2020-04-01,"전체",422,429,420,-9,2,-7,-0.020979020979021,0.00476190476190476,-0.0163170163170163
"4241","2020","부산","동구","초등학교",2020-04-01,"여자",198,209,202,-7,-4,-11,-0.0334928229665072,-0.0198019801980198,-0.0526315789473684
"4242","2020","부산","동구","초등학교",2020-04-01,"남자",224,220,218,-2,6,4,-0.00909090909090909,0.0275229357798165,0.0181818181818182
"4243","2020","부산","영도구","초등학교",2020-04-01,"전체",589,658,634,-24,-45,-69,-0.0364741641337386,-0.0709779179810726,-0.104863221884498
"4244","2020","부산","영도구","초등학교",2020-04-01,"여자",287,320,306,-14,-19,-33,-0.04375,-0.0620915032679739,-0.103125
"4245","2020","부산","영도구","초등학교",2020-04-01,"남자",302,338,328,-10,-26,-36,-0.029585798816568,-0.0792682926829268,-0.106508875739645
"4246","2020","부산","부산진구","초등학교",2020-04-01,"전체",2372,2412,2340,-72,32,-40,-0.0298507462686567,0.0136752136752137,-0.0165837479270315
"4247","2020","부산","부산진구","초등학교",2020-04-01,"여자",1192,1154,1126,-28,66,38,-0.024263431542461,0.0586145648312611,0.0329289428076256
"4248","2020","부산","부산진구","초등학교",2020-04-01,"남자",1180,1258,1214,-44,-34,-78,-0.0349761526232114,-0.028006589785832,-0.0620031796502385
"4249","2020","부산","동래구","초등학교",2020-04-01,"전체",2036,1872,1964,92,72,164,0.0491452991452991,0.0366598778004073,0.0876068376068376
"4250","2020","부산","동래구","초등학교",2020-04-01,"여자",956,886,932,46,24,70,0.0519187358916479,0.0257510729613734,0.0790067720090293
"4251","2020","부산","동래구","초등학교",2020-04-01,"남자",1080,986,1032,46,48,94,0.0466531440162272,0.0465116279069767,0.0953346855983773
"4252","2020","부산","남구","초등학교",2020-04-01,"전체",2013,1971,2144,173,-131,42,0.0877727042110604,-0.0611007462686567,0.0213089802130898
"4253","2020","부산","남구","초등학교",2020-04-01,"여자",979,974,1062,88,-83,5,0.0903490759753593,-0.0781544256120527,0.00513347022587269
"4254","2020","부산","남구","초등학교",2020-04-01,"남자",1034,997,1082,85,-48,37,0.0852557673019057,-0.044362292051756,0.037111334002006
"4255","2020","부산","북구","초등학교",2020-04-01,"전체",2038,2279,2190,-89,-152,-241,-0.0390522158841597,-0.0694063926940639,-0.105748135146994
"4256","2020","부산","북구","초등학교",2020-04-01,"여자",1009,1102,1062,-40,-53,-93,-0.0362976406533575,-0.0499058380414313,-0.0843920145190563
"4257","2020","부산","북구","초등학교",2020-04-01,"남자",1029,1177,1128,-49,-99,-148,-0.0416312659303314,-0.0877659574468085,-0.125743415463042
"4258","2020","부산","해운대구","초등학교",2020-04-01,"전체",3075,3142,3161,19,-86,-67,0.0060471037555697,-0.0272065801961405,-0.0213239974538511
"4259","2020","부산","해운대구","초등학교",2020-04-01,"여자",1477,1492,1495,3,-18,-15,0.00201072386058981,-0.0120401337792642,-0.0100536193029491
"4260","2020","부산","해운대구","초등학교",2020-04-01,"남자",1598,1650,1666,16,-68,-52,0.0096969696969697,-0.0408163265306122,-0.0315151515151515
"4261","2020","부산","사하구","초등학교",2020-04-01,"전체",2145,2417,2331,-86,-186,-272,-0.0355812991311543,-0.0797940797940798,-0.112536201903186
"4262","2020","부산","사하구","초등학교",2020-04-01,"여자",1051,1176,1123,-53,-72,-125,-0.0450680272108844,-0.0641139804096171,-0.106292517006803
"4263","2020","부산","사하구","초등학교",2020-04-01,"남자",1094,1241,1208,-33,-114,-147,-0.0265914585012087,-0.0943708609271523,-0.118452860596293
"4264","2020","부산","금정구","초등학교",2020-04-01,"전체",1527,1516,1506,-10,21,11,-0.00659630606860158,0.0139442231075697,0.00725593667546174
"4265","2020","부산","금정구","초등학교",2020-04-01,"여자",762,731,721,-10,41,31,-0.0136798905608755,0.0568654646324549,0.0424076607387141
"4266","2020","부산","금정구","초등학교",2020-04-01,"남자",765,785,785,0,-20,-20,0,-0.0254777070063694,-0.0254777070063694
"4267","2020","부산","강서구","초등학교",2020-04-01,"전체",1956,1962,2027,65,-71,-6,0.0331294597349643,-0.0350271336951159,-0.00305810397553517
"4268","2020","부산","강서구","초등학교",2020-04-01,"여자",942,957,993,36,-51,-15,0.0376175548589342,-0.0513595166163142,-0.0156739811912226
"4269","2020","부산","강서구","초등학교",2020-04-01,"남자",1014,1005,1034,29,-20,9,0.0288557213930348,-0.0193423597678917,0.00895522388059702
"4270","2020","부산","연제구","초등학교",2020-04-01,"전체",1564,1541,1607,66,-43,23,0.0428293316028553,-0.0267579340385812,0.0149253731343284
"4271","2020","부산","연제구","초등학교",2020-04-01,"여자",800,759,803,44,-3,41,0.0579710144927536,-0.0037359900373599,0.0540184453227932
"4272","2020","부산","연제구","초등학교",2020-04-01,"남자",764,782,804,22,-40,-18,0.0281329923273657,-0.0497512437810945,-0.0230179028132992
"4273","2020","부산","수영구","초등학교",2020-04-01,"전체",970,1100,1055,-45,-85,-130,-0.0409090909090909,-0.0805687203791469,-0.118181818181818
"4274","2020","부산","수영구","초등학교",2020-04-01,"여자",452,504,477,-27,-25,-52,-0.0535714285714286,-0.0524109014675052,-0.103174603174603
"4275","2020","부산","수영구","초등학교",2020-04-01,"남자",518,596,578,-18,-60,-78,-0.0302013422818792,-0.103806228373702,-0.130872483221477
"4276","2020","부산","사상구","초등학교",2020-04-01,"전체",1280,1577,1495,-82,-215,-297,-0.051997463538364,-0.1438127090301,-0.188332276474318
"4277","2020","부산","사상구","초등학교",2020-04-01,"여자",652,795,748,-47,-96,-143,-0.0591194968553459,-0.128342245989305,-0.179874213836478
"4278","2020","부산","사상구","초등학교",2020-04-01,"남자",628,782,747,-35,-119,-154,-0.0447570332480818,-0.159303882195448,-0.19693094629156
"4279","2020","부산","기장군","초등학교",2020-04-01,"전체",2038,2149,2134,-15,-96,-111,-0.00697999069334574,-0.0449859418931584,-0.0516519311307585
"4280","2020","부산","기장군","초등학교",2020-04-01,"여자",977,1037,1018,-19,-41,-60,-0.0183220829315333,-0.0402750491159136,-0.0578592092574735
"4281","2020","부산","기장군","초등학교",2020-04-01,"남자",1061,1112,1116,4,-55,-51,0.00359712230215827,-0.0492831541218638,-0.045863309352518
"4282","2020","대구","중구","초등학교",2020-04-01,"전체",717,581,559,-22,158,136,-0.0378657487091222,0.282647584973166,0.23407917383821
"4283","2020","대구","중구","초등학교",2020-04-01,"여자",356,288,273,-15,83,68,-0.0520833333333333,0.304029304029304,0.236111111111111
"4284","2020","대구","중구","초등학교",2020-04-01,"남자",361,293,286,-7,75,68,-0.0238907849829352,0.262237762237762,0.232081911262799
"4285","2020","대구","동구","초등학교",2020-04-01,"전체",2723,2925,2908,-17,-185,-202,-0.00581196581196581,-0.0636176066024759,-0.0690598290598291
"4286","2020","대구","동구","초등학교",2020-04-01,"여자",1362,1433,1420,-13,-58,-71,-0.00907187718073971,-0.0408450704225352,-0.049546406140963
"4287","2020","대구","동구","초등학교",2020-04-01,"남자",1361,1492,1488,-4,-127,-131,-0.00268096514745308,-0.0853494623655914,-0.0878016085790885
"4288","2020","대구","서구","초등학교",2020-04-01,"전체",869,1039,963,-76,-94,-170,-0.0731472569778633,-0.0976116303219107,-0.163618864292589
"4289","2020","대구","서구","초등학교",2020-04-01,"여자",445,498,461,-37,-16,-53,-0.0742971887550201,-0.03470715835141,-0.106425702811245
"4290","2020","대구","서구","초등학교",2020-04-01,"남자",424,541,502,-39,-78,-117,-0.0720887245841035,-0.155378486055777,-0.216266173752311
"4291","2020","대구","남구","초등학교",2020-04-01,"전체",720,827,783,-44,-63,-107,-0.0532043530834341,-0.0804597701149425,-0.129383313180169
"4292","2020","대구","남구","초등학교",2020-04-01,"여자",367,399,378,-21,-11,-32,-0.0526315789473684,-0.0291005291005291,-0.0802005012531328
"4293","2020","대구","남구","초등학교",2020-04-01,"남자",353,428,405,-23,-52,-75,-0.0537383177570093,-0.128395061728395,-0.175233644859813
"4294","2020","대구","북구","초등학교",2020-04-01,"전체",3458,3790,3738,-52,-280,-332,-0.0137203166226913,-0.0749063670411985,-0.087598944591029
"4295","2020","대구","북구","초등학교",2020-04-01,"여자",1704,1886,1856,-30,-152,-182,-0.0159066808059385,-0.0818965517241379,-0.0965005302226935
"4296","2020","대구","북구","초등학교",2020-04-01,"남자",1754,1904,1882,-22,-128,-150,-0.0115546218487395,-0.0680127523910733,-0.078781512605042
"4297","2020","대구","수성구","초등학교",2020-04-01,"전체",3323,3103,3288,185,35,220,0.0596197228488559,0.0106447688564477,0.0708991298743152
"4298","2020","대구","수성구","초등학교",2020-04-01,"여자",1634,1498,1585,87,49,136,0.0580774365821095,0.0309148264984227,0.0907877169559413
"4299","2020","대구","수성구","초등학교",2020-04-01,"남자",1689,1605,1703,98,-14,84,0.0610591900311526,-0.00822078684674104,0.0523364485981308
"4300","2020","대구","달서구","초등학교",2020-04-01,"전체",4632,4460,4519,59,113,172,0.0132286995515695,0.0250055321973888,0.0385650224215247
"4301","2020","대구","달서구","초등학교",2020-04-01,"여자",2268,2199,2225,26,43,69,0.0118235561618918,0.0193258426966292,0.0313778990450205
"4302","2020","대구","달서구","초등학교",2020-04-01,"남자",2364,2261,2294,33,70,103,0.0145953118089341,0.030514385353095,0.0455550641309155
"4303","2020","대구","달성군","초등학교",2020-04-01,"전체",2880,2966,2974,8,-94,-86,0.00269723533378287,-0.0316072629455279,-0.0289952798381659
"4304","2020","대구","달성군","초등학교",2020-04-01,"여자",1399,1475,1477,2,-78,-76,0.00135593220338983,-0.0528097494922139,-0.0515254237288136
"4305","2020","대구","달성군","초등학교",2020-04-01,"남자",1481,1491,1497,6,-16,-10,0.00402414486921529,-0.010688042752171,-0.00670690811535882
"4306","2020","인천","중구","초등학교",2020-04-01,"전체",1391,1096,1242,146,149,295,0.133211678832117,0.119967793880837,0.269160583941606
"4307","2020","인천","중구","초등학교",2020-04-01,"여자",677,543,619,76,58,134,0.139963167587477,0.0936995153473344,0.246777163904236
"4308","2020","인천","중구","초등학교",2020-04-01,"남자",714,553,623,70,91,161,0.126582278481013,0.146067415730337,0.291139240506329
"4309","2020","인천","동구","초등학교",2020-04-01,"전체",539,506,470,-36,69,33,-0.0711462450592885,0.146808510638298,0.0652173913043478
"4310","2020","인천","동구","초등학교",2020-04-01,"여자",253,247,219,-28,34,6,-0.11336032388664,0.155251141552511,0.0242914979757085
"4311","2020","인천","동구","초등학교",2020-04-01,"남자",286,259,251,-8,35,27,-0.0308880308880309,0.139442231075697,0.104247104247104
"4312","2020","인천","연수구","초등학교",2020-04-01,"전체",3979,3339,3592,253,387,640,0.0757711889787362,0.107739420935412,0.191674153938305
"4313","2020","인천","연수구","초등학교",2020-04-01,"여자",1954,1637,1732,95,222,317,0.0580329871716555,0.128175519630485,0.193646915088577
"4314","2020","인천","연수구","초등학교",2020-04-01,"남자",2025,1702,1860,158,165,323,0.0928319623971798,0.0887096774193548,0.189776733254994
"4315","2020","인천","미추홀구","초등학교",2020-04-01,"전체",2815,3262,3135,-127,-320,-447,-0.0389331698344574,-0.10207336523126,-0.137032495401594
"4316","2020","인천","미추홀구","초등학교",2020-04-01,"여자",1362,1608,1558,-50,-196,-246,-0.0310945273631841,-0.125802310654686,-0.152985074626866
"4317","2020","인천","미추홀구","초등학교",2020-04-01,"남자",1453,1654,1577,-77,-124,-201,-0.0465538089480048,-0.0786303107165504,-0.121523579201935
"4318","2020","인천","남동구","초등학교",2020-04-01,"전체",4656,5063,4898,-165,-242,-407,-0.0325893738889986,-0.0494079216006533,-0.0803871222595299
"4319","2020","인천","남동구","초등학교",2020-04-01,"여자",2318,2469,2407,-62,-89,-151,-0.0251113811259619,-0.0369754881595347,-0.061158363710004
"4320","2020","인천","남동구","초등학교",2020-04-01,"남자",2338,2594,2491,-103,-153,-256,-0.0397070161912105,-0.0614211160176636,-0.0986892829606785
"4321","2020","인천","부평구","초등학교",2020-04-01,"전체",3626,4157,3931,-226,-305,-531,-0.054366129420255,-0.0775883998982447,-0.127736348328121
"4322","2020","인천","부평구","초등학교",2020-04-01,"여자",1794,2044,1935,-109,-141,-250,-0.0533268101761252,-0.0728682170542636,-0.122309197651663
"4323","2020","인천","부평구","초등학교",2020-04-01,"남자",1832,2113,1996,-117,-164,-281,-0.0553715097018457,-0.0821643286573146,-0.132986275437766
"4324","2020","인천","계양구","초등학교",2020-04-01,"전체",2091,2326,2208,-118,-117,-235,-0.0507308684436801,-0.0529891304347826,-0.101031814273431
"4325","2020","인천","계양구","초등학교",2020-04-01,"여자",1006,1111,1065,-46,-59,-105,-0.0414041404140414,-0.0553990610328638,-0.0945094509450945
"4326","2020","인천","계양구","초등학교",2020-04-01,"남자",1085,1215,1143,-72,-58,-130,-0.0592592592592593,-0.0507436570428696,-0.106995884773663
"4327","2020","인천","서구","초등학교",2020-04-01,"전체",5318,5512,5596,84,-278,-194,0.0152394775036284,-0.0496783416726233,-0.0351959361393324
"4328","2020","인천","서구","초등학교",2020-04-01,"여자",2613,2675,2720,45,-107,-62,0.0168224299065421,-0.0393382352941176,-0.0231775700934579
"4329","2020","인천","서구","초등학교",2020-04-01,"남자",2705,2837,2876,39,-171,-132,0.0137469157560804,-0.0594575799721836,-0.0465280225590412
"4330","2020","인천","강화군","초등학교",2020-04-01,"전체",334,305,301,-4,33,29,-0.0131147540983607,0.109634551495017,0.0950819672131148
"4331","2020","인천","강화군","초등학교",2020-04-01,"여자",168,155,156,1,12,13,0.00645161290322581,0.0769230769230769,0.0838709677419355
"4332","2020","인천","강화군","초등학교",2020-04-01,"남자",166,150,145,-5,21,16,-0.0333333333333333,0.144827586206897,0.106666666666667
"4333","2020","인천","옹진군","초등학교",2020-04-01,"전체",97,116,109,-7,-12,-19,-0.0603448275862069,-0.110091743119266,-0.163793103448276
"4334","2020","인천","옹진군","초등학교",2020-04-01,"여자",45,52,53,1,-8,-7,0.0192307692307692,-0.150943396226415,-0.134615384615385
"4335","2020","인천","옹진군","초등학교",2020-04-01,"남자",52,64,56,-8,-4,-12,-0.125,-0.0714285714285714,-0.1875
"4336","2020","광주","동구","초등학교",2020-04-01,"전체",571,636,636,0,-65,-65,0,-0.102201257861635,-0.102201257861635
"4337","2020","광주","동구","초등학교",2020-04-01,"여자",276,307,308,1,-32,-31,0.00325732899022801,-0.103896103896104,-0.100977198697068
"4338","2020","광주","동구","초등학교",2020-04-01,"남자",295,329,328,-1,-33,-34,-0.00303951367781155,-0.100609756097561,-0.103343465045593
"4339","2020","광주","서구","초등학교",2020-04-01,"전체",2547,2565,2557,-8,-10,-18,-0.00311890838206628,-0.00391083300743058,-0.00701754385964912
"4340","2020","광주","서구","초등학교",2020-04-01,"여자",1234,1260,1243,-17,-9,-26,-0.0134920634920635,-0.00724054706355591,-0.0206349206349206
"4341","2020","광주","서구","초등학교",2020-04-01,"남자",1313,1305,1314,9,-1,8,0.00689655172413793,-0.00076103500761035,0.00613026819923372
"4342","2020","광주","남구","초등학교",2020-04-01,"전체",2173,1867,1925,58,248,306,0.031065881092662,0.128831168831169,0.163899303695769
"4343","2020","광주","남구","초등학교",2020-04-01,"여자",1072,921,940,19,132,151,0.0206297502714441,0.140425531914894,0.163952225841477
"4344","2020","광주","남구","초등학교",2020-04-01,"남자",1101,946,985,39,116,155,0.0412262156448203,0.117766497461929,0.16384778012685
"4345","2020","광주","북구","초등학교",2020-04-01,"전체",3635,3839,3827,-12,-192,-204,-0.00312581401406616,-0.0501698458322446,-0.0531388382391248
"4346","2020","광주","북구","초등학교",2020-04-01,"여자",1731,1883,1876,-7,-145,-152,-0.00371747211895911,-0.0772921108742004,-0.0807222517259692
"4347","2020","광주","북구","초등학교",2020-04-01,"남자",1904,1956,1951,-5,-47,-52,-0.00255623721881391,-0.0240902101486417,-0.0265848670756646
"4348","2020","광주","광산구","초등학교",2020-04-01,"전체",4616,4489,4543,54,73,127,0.0120294052127423,0.0160686770856262,0.0282913789262642
"4349","2020","광주","광산구","초등학교",2020-04-01,"여자",2279,2219,2242,23,37,60,0.0103650292924741,0.0165031222123104,0.0270392068499324
"4350","2020","광주","광산구","초등학교",2020-04-01,"남자",2337,2270,2301,31,36,67,0.0136563876651982,0.015645371577575,0.0295154185022026
"4351","2020","대전","동구","초등학교",2020-04-01,"전체",1637,1826,1810,-16,-173,-189,-0.00876232201533406,-0.0955801104972376,-0.103504928806134
"4352","2020","대전","동구","초등학교",2020-04-01,"여자",834,901,883,-18,-49,-67,-0.0199778024417314,-0.0554926387315968,-0.074361820199778
"4353","2020","대전","동구","초등학교",2020-04-01,"남자",803,925,927,2,-124,-122,0.00216216216216216,-0.133764832793959,-0.131891891891892
"4354","2020","대전","중구","초등학교",2020-04-01,"전체",1788,1851,1830,-21,-42,-63,-0.0113452188006483,-0.0229508196721311,-0.0340356564019449
"4355","2020","대전","중구","초등학교",2020-04-01,"여자",868,885,871,-14,-3,-17,-0.015819209039548,-0.0034443168771527,-0.0192090395480226
"4356","2020","대전","중구","초등학교",2020-04-01,"남자",920,966,959,-7,-39,-46,-0.0072463768115942,-0.040667361835245,-0.0476190476190476
"4357","2020","대전","서구","초등학교",2020-04-01,"전체",4192,4303,4275,-28,-83,-111,-0.00650708807808506,-0.0194152046783626,-0.0257959563095515
"4358","2020","대전","서구","초등학교",2020-04-01,"여자",2021,2092,2114,22,-93,-71,0.0105162523900574,-0.04399243140965,-0.0339388145315488
"4359","2020","대전","서구","초등학교",2020-04-01,"남자",2171,2211,2161,-50,10,-40,-0.0226142017186793,0.00462748727441,-0.0180913613749435
"4360","2020","대전","유성구","초등학교",2020-04-01,"전체",3737,3923,3911,-12,-174,-186,-0.00305888350751976,-0.044489900281258,-0.0474126943665562
"4361","2020","대전","유성구","초등학교",2020-04-01,"여자",1863,1888,1895,7,-32,-25,0.00370762711864407,-0.0168865435356201,-0.0132415254237288
"4362","2020","대전","유성구","초등학교",2020-04-01,"남자",1874,2035,2016,-19,-142,-161,-0.00933660933660934,-0.0704365079365079,-0.0791154791154791
"4363","2020","대전","대덕구","초등학교",2020-04-01,"전체",1269,1406,1325,-81,-56,-137,-0.0576102418207681,-0.0422641509433962,-0.0974395448079659
"4364","2020","대전","대덕구","초등학교",2020-04-01,"여자",608,692,646,-46,-38,-84,-0.0664739884393064,-0.0588235294117647,-0.121387283236994
"4365","2020","대전","대덕구","초등학교",2020-04-01,"남자",661,714,679,-35,-18,-53,-0.0490196078431373,-0.0265095729013255,-0.0742296918767507
"4366","2020","울산","중구","초등학교",2020-04-01,"전체",1911,2108,1994,-114,-83,-197,-0.0540796963946869,-0.0416248746238716,-0.0934535104364326
"4367","2020","울산","중구","초등학교",2020-04-01,"여자",937,1031,972,-59,-35,-94,-0.0572259941804074,-0.0360082304526749,-0.0911736178467507
"4368","2020","울산","중구","초등학교",2020-04-01,"남자",974,1077,1022,-55,-48,-103,-0.0510677808727948,-0.0469667318982387,-0.095636025998143
"4369","2020","울산","남구","초등학교",2020-04-01,"전체",2519,2708,2688,-20,-169,-189,-0.00738552437223043,-0.0628720238095238,-0.0697932053175775
"4370","2020","울산","남구","초등학교",2020-04-01,"여자",1249,1301,1313,12,-64,-52,0.00922367409684858,-0.0487433358720487,-0.0399692544196772
"4371","2020","울산","남구","초등학교",2020-04-01,"남자",1270,1407,1375,-32,-105,-137,-0.0227434257285004,-0.0763636363636364,-0.0973702914001422
"4372","2020","울산","동구","초등학교",2020-04-01,"전체",1680,1887,1811,-76,-131,-207,-0.0402755696873344,-0.0723357261181668,-0.109697933227345
"4373","2020","울산","동구","초등학교",2020-04-01,"여자",813,951,915,-36,-102,-138,-0.0378548895899054,-0.111475409836066,-0.145110410094637
"4374","2020","울산","동구","초등학교",2020-04-01,"남자",867,936,896,-40,-29,-69,-0.0427350427350427,-0.0323660714285714,-0.0737179487179487
"4375","2020","울산","북구","초등학교",2020-04-01,"전체",2713,2582,2721,139,-8,131,0.0538342370255616,-0.00294009555310548,0.0507358636715724
"4376","2020","울산","북구","초등학교",2020-04-01,"여자",1317,1235,1305,70,12,82,0.0566801619433198,0.00919540229885057,0.0663967611336032
"4377","2020","울산","북구","초등학교",2020-04-01,"남자",1396,1347,1416,69,-20,49,0.0512249443207127,-0.0141242937853107,0.03637713437268
"4378","2020","울산","울주군","초등학교",2020-04-01,"전체",2032,2017,2008,-9,24,15,-0.0044620723847298,0.0119521912350598,0.00743678730788299
"4379","2020","울산","울주군","초등학교",2020-04-01,"여자",1016,1005,998,-7,18,11,-0.00696517412935323,0.0180360721442886,0.0109452736318408
"4380","2020","울산","울주군","초등학교",2020-04-01,"남자",1016,1012,1010,-2,6,4,-0.00197628458498024,0.00594059405940594,0.00395256916996047
"4381","2020","세종","세종시","초등학교",2020-04-01,"전체",4879,4231,4649,418,230,648,0.0987946112030253,0.0494730049473005,0.15315528243914
"4382","2020","세종","세종시","초등학교",2020-04-01,"전체",4879,4231,4649,418,230,648,0.0987946112030253,0.0494730049473005,0.15315528243914
"4383","2020","세종","세종시","초등학교",2020-04-01,"전체",4879,4231,4649,418,230,648,0.0987946112030253,0.0494730049473005,0.15315528243914
"4384","2020","세종","세종시","초등학교",2020-04-01,"전체",4879,4231,4649,418,230,648,0.0987946112030253,0.0494730049473005,0.15315528243914
"4385","2020","세종","세종시","초등학교",2020-04-01,"여자",2390,2122,2318,196,72,268,0.0923656927426956,0.0310612597066437,0.126295947219604
"4386","2020","세종","세종시","초등학교",2020-04-01,"여자",2390,2122,2318,196,72,268,0.0923656927426956,0.0310612597066437,0.126295947219604
"4387","2020","세종","세종시","초등학교",2020-04-01,"여자",2390,2122,2318,196,72,268,0.0923656927426956,0.0310612597066437,0.126295947219604
"4388","2020","세종","세종시","초등학교",2020-04-01,"여자",2390,2122,2318,196,72,268,0.0923656927426956,0.0310612597066437,0.126295947219604
"4389","2020","세종","세종시","초등학교",2020-04-01,"남자",2489,2109,2331,222,158,380,0.105263157894737,0.0677820677820678,0.18018018018018
"4390","2020","세종","세종시","초등학교",2020-04-01,"남자",2489,2109,2331,222,158,380,0.105263157894737,0.0677820677820678,0.18018018018018
"4391","2020","세종","세종시","초등학교",2020-04-01,"남자",2489,2109,2331,222,158,380,0.105263157894737,0.0677820677820678,0.18018018018018
"4392","2020","세종","세종시","초등학교",2020-04-01,"남자",2489,2109,2331,222,158,380,0.105263157894737,0.0677820677820678,0.18018018018018
"4393","2020","경기","수원시","초등학교",2020-04-01,"전체",10731,11209,10968,-241,-237,-478,-0.0215005798911589,-0.0216083150984683,-0.0426443036845392
"4394","2020","경기","수원시","초등학교",2020-04-01,"여자",5210,5476,5328,-148,-118,-266,-0.027027027027027,-0.0221471471471471,-0.0485756026296567
"4395","2020","경기","수원시","초등학교",2020-04-01,"남자",5521,5733,5640,-93,-119,-212,-0.0162218733647305,-0.0210992907801418,-0.0369788941217513
"4396","2020","경기","성남시","초등학교",2020-04-01,"전체",7248,7793,7571,-222,-323,-545,-0.0284871038111125,-0.0426627922335227,-0.0699345566534069
"4397","2020","경기","성남시","초등학교",2020-04-01,"여자",3544,3841,3731,-110,-187,-297,-0.0286383754230669,-0.0501206110962209,-0.0773236136422807
"4398","2020","경기","성남시","초등학교",2020-04-01,"남자",3704,3952,3840,-112,-136,-248,-0.0283400809716599,-0.0354166666666667,-0.062753036437247
"4399","2020","경기","부천시","초등학교",2020-04-01,"전체",6172,6768,6540,-228,-368,-596,-0.0336879432624113,-0.0562691131498471,-0.0880614657210402
"4400","2020","경기","부천시","초등학교",2020-04-01,"여자",2974,3331,3224,-107,-250,-357,-0.032122485740018,-0.0775434243176179,-0.107175022515761
"4401","2020","경기","부천시","초등학교",2020-04-01,"남자",3198,3437,3316,-121,-118,-239,-0.0352051207448356,-0.0355850422195416,-0.0695373872563282
"4402","2020","경기","안양시","초등학교",2020-04-01,"전체",4147,4609,4453,-156,-306,-462,-0.0338468214363202,-0.0687177183920952,-0.100238663484487
"4403","2020","경기","안양시","초등학교",2020-04-01,"여자",2002,2278,2184,-94,-182,-276,-0.0412642669007902,-0.0833333333333333,-0.121158911325724
"4404","2020","경기","안양시","초등학교",2020-04-01,"남자",2145,2331,2269,-62,-124,-186,-0.0265980265980266,-0.0546496253856324,-0.0797940797940798
"4405","2020","경기","과천시","초등학교",2020-04-01,"전체",483,444,496,52,-13,39,0.117117117117117,-0.0262096774193548,0.0878378378378378
"4406","2020","경기","과천시","초등학교",2020-04-01,"여자",230,209,231,22,-1,21,0.105263157894737,-0.00432900432900433,0.100478468899522
"4407","2020","경기","과천시","초등학교",2020-04-01,"남자",253,235,265,30,-12,18,0.127659574468085,-0.0452830188679245,0.0765957446808511
"4408","2020","경기","안산시","초등학교",2020-04-01,"전체",5094,5032,4936,-96,158,62,-0.0190779014308426,0.0320097244732577,0.0123211446740859
"4409","2020","경기","안산시","초등학교",2020-04-01,"여자",2484,2442,2408,-34,76,42,-0.0139230139230139,0.0315614617940199,0.0171990171990172
"4410","2020","경기","안산시","초등학교",2020-04-01,"남자",2610,2590,2528,-62,82,20,-0.0239382239382239,0.0324367088607595,0.00772200772200772
"4411","2020","경기","용인시","초등학교",2020-04-01,"전체",10958,10784,11214,430,-256,174,0.0398738872403561,-0.02282860709827,0.0161350148367953
"4412","2020","경기","용인시","초등학교",2020-04-01,"여자",5379,5299,5535,236,-156,80,0.0445367050386865,-0.0281842818428184,0.0150971881487073
"4413","2020","경기","용인시","초등학교",2020-04-01,"남자",5579,5485,5679,194,-100,94,0.0353691886964448,-0.0176087339320303,0.0171376481312671
"4414","2020","경기","군포시","초등학교",2020-04-01,"전체",2338,2455,2359,-96,-21,-117,-0.0391038696537678,-0.00890207715133531,-0.0476578411405295
"4415","2020","경기","군포시","초등학교",2020-04-01,"여자",1153,1189,1138,-51,15,-36,-0.0428931875525652,0.0131810193321617,-0.0302775441547519
"4416","2020","경기","군포시","초등학교",2020-04-01,"남자",1185,1266,1221,-45,-36,-81,-0.0355450236966825,-0.0294840294840295,-0.0639810426540284
"4417","2020","경기","의왕시","초등학교",2020-04-01,"전체",1257,1352,1362,10,-105,-95,0.00739644970414201,-0.0770925110132159,-0.0702662721893491
"4418","2020","경기","의왕시","초등학교",2020-04-01,"여자",667,692,699,7,-32,-25,0.0101156069364162,-0.0457796852646638,-0.0361271676300578
"4419","2020","경기","의왕시","초등학교",2020-04-01,"남자",590,660,663,3,-73,-70,0.00454545454545455,-0.110105580693816,-0.106060606060606
"4420","2020","경기","시흥시","초등학교",2020-04-01,"전체",4959,4170,4562,392,397,789,0.0940047961630695,0.0870232354230601,0.189208633093525
"4421","2020","경기","시흥시","초등학교",2020-04-01,"여자",2422,2053,2246,193,176,369,0.0940087676570872,0.0783615316117542,0.179736970287384
"4422","2020","경기","시흥시","초등학교",2020-04-01,"남자",2537,2117,2316,199,221,420,0.0940009447331129,0.0954231433506045,0.198393953708077
"4423","2020","경기","평택시","초등학교",2020-04-01,"전체",5066,4686,4870,184,196,380,0.039265898420828,0.0402464065708419,0.0810926163038839
"4424","2020","경기","평택시","초등학교",2020-04-01,"여자",2551,2334,2416,82,135,217,0.0351328191945159,0.0558774834437086,0.0929734361610968
"4425","2020","경기","평택시","초등학교",2020-04-01,"남자",2515,2352,2454,102,61,163,0.0433673469387755,0.0248573757131214,0.0693027210884354
"4426","2020","경기","화성시","초등학교",2020-04-01,"전체",11118,9928,10749,821,369,1190,0.0826954069298952,0.034328774769746,0.11986301369863
"4427","2020","경기","화성시","초등학교",2020-04-01,"여자",5377,4886,5320,434,57,491,0.0888252148997135,0.0107142857142857,0.100491199345068
"4428","2020","경기","화성시","초등학교",2020-04-01,"남자",5741,5042,5429,387,312,699,0.0767552558508528,0.0574691471725916,0.138635462118207
"4429","2020","경기","오산시","초등학교",2020-04-01,"전체",2677,2763,2714,-49,-37,-86,-0.0177343467245747,-0.0136330140014738,-0.0311255881288455
"4430","2020","경기","오산시","초등학교",2020-04-01,"여자",1299,1381,1337,-44,-38,-82,-0.0318609703113686,-0.0284218399401645,-0.0593772628530051
"4431","2020","경기","오산시","초등학교",2020-04-01,"남자",1378,1382,1377,-5,1,-4,-0.00361794500723589,0.000726216412490922,-0.00289435600578871
"4432","2020","경기","광명시","초등학교",2020-04-01,"전체",2623,2848,2743,-105,-120,-225,-0.0368679775280899,-0.04374772147284,-0.0790028089887641
"4433","2020","경기","광명시","초등학교",2020-04-01,"여자",1268,1391,1339,-52,-71,-123,-0.0373831775700935,-0.053024645257655,-0.0884255930984903
"4434","2020","경기","광명시","초등학교",2020-04-01,"남자",1355,1457,1404,-53,-49,-102,-0.0363761153054221,-0.0349002849002849,-0.0700068634179822
"4435","2020","경기","광주시","초등학교",2020-04-01,"전체",3312,3686,3742,56,-430,-374,0.0151926207270754,-0.114911811865313,-0.101465002712968
"4436","2020","경기","광주시","초등학교",2020-04-01,"여자",1632,1785,1811,26,-179,-153,0.0145658263305322,-0.0988404196576477,-0.0857142857142857
"4437","2020","경기","광주시","초등학교",2020-04-01,"남자",1680,1901,1931,30,-251,-221,0.0157811678064177,-0.129984464008286,-0.11625460284061
"4438","2020","경기","하남시","초등학교",2020-04-01,"전체",3027,2845,3103,258,-76,182,0.0906854130052724,-0.0244924266838543,0.0639718804920914
"4439","2020","경기","하남시","초등학교",2020-04-01,"여자",1505,1379,1520,141,-15,126,0.102248005801305,-0.00986842105263158,0.0913705583756345
"4440","2020","경기","하남시","초등학교",2020-04-01,"남자",1522,1466,1583,117,-61,56,0.0798090040927694,-0.0385344283006949,0.0381991814461119
"4441","2020","경기","김포시","초등학교",2020-04-01,"전체",5412,5037,5398,361,14,375,0.0716696446297399,0.00259355316783994,0.0744490768314473
"4442","2020","경기","김포시","초등학교",2020-04-01,"여자",2656,2443,2597,154,59,213,0.0630372492836676,0.0227185213708125,0.0871878837494883
"4443","2020","경기","김포시","초등학교",2020-04-01,"남자",2756,2594,2801,207,-45,162,0.0797995373939861,-0.0160656908247055,0.0624518118735544
"4444","2020","경기","이천시","초등학교",2020-04-01,"전체",2035,2072,2041,-31,-6,-37,-0.01496138996139,-0.00293973542381186,-0.0178571428571429
"4445","2020","경기","이천시","초등학교",2020-04-01,"여자",1019,1023,1003,-20,16,-4,-0.0195503421309873,0.0159521435692921,-0.00391006842619746
"4446","2020","경기","이천시","초등학교",2020-04-01,"남자",1016,1049,1038,-11,-22,-33,-0.0104861773117255,-0.0211946050096339,-0.0314585319351764
"4447","2020","경기","안성시","초등학교",2020-04-01,"전체",1681,1623,1597,-26,84,58,-0.0160197165742452,0.0525986224170319,0.0357362908194701
"4448","2020","경기","안성시","초등학교",2020-04-01,"여자",795,791,782,-9,13,4,-0.011378002528445,0.0166240409207161,0.00505689001264223
"4449","2020","경기","안성시","초등학교",2020-04-01,"남자",886,832,815,-17,71,54,-0.0204326923076923,0.0871165644171779,0.0649038461538462
"4450","2020","경기","여주시","초등학교",2020-04-01,"전체",804,863,845,-18,-41,-59,-0.0208574739281576,-0.0485207100591716,-0.0683661645422943
"4451","2020","경기","여주시","초등학교",2020-04-01,"여자",376,396,389,-7,-13,-20,-0.0176767676767677,-0.0334190231362468,-0.0505050505050505
"4452","2020","경기","여주시","초등학교",2020-04-01,"남자",428,467,456,-11,-28,-39,-0.0235546038543897,-0.0614035087719298,-0.0835117773019272
"4453","2020","경기","양평군","초등학교",2020-04-01,"전체",746,811,817,6,-71,-65,0.00739827373612824,-0.0869033047735618,-0.0801479654747226
"4454","2020","경기","양평군","초등학교",2020-04-01,"여자",373,399,403,4,-30,-26,0.0100250626566416,-0.0744416873449131,-0.0651629072681704
"4455","2020","경기","양평군","초등학교",2020-04-01,"남자",373,412,414,2,-41,-39,0.00485436893203883,-0.0990338164251208,-0.0946601941747573
"4456","2020","경기","고양시","초등학교",2020-04-01,"전체",8550,8602,8644,42,-94,-52,0.00488258544524529,-0.0108745950948635,-0.00604510578935131
"4457","2020","경기","고양시","초등학교",2020-04-01,"여자",4245,4207,4240,33,5,38,0.00784406940812931,0.00117924528301887,0.00903256477299738
"4458","2020","경기","고양시","초등학교",2020-04-01,"남자",4305,4395,4404,9,-99,-90,0.00204778156996587,-0.0224795640326975,-0.0204778156996587
"4459","2020","경기","남양주시","초등학교",2020-04-01,"전체",7055,6860,7131,271,-76,195,0.0395043731778426,-0.0106576917683354,0.0284256559766764
"4460","2020","경기","남양주시","초등학교",2020-04-01,"여자",3421,3315,3441,126,-20,106,0.0380090497737557,-0.00581226387678001,0.0319758672699849
"4461","2020","경기","남양주시","초등학교",2020-04-01,"남자",3634,3545,3690,145,-56,89,0.0409026798307475,-0.0151761517615176,0.0251057827926657
"4462","2020","경기","구리시","초등학교",2020-04-01,"전체",1598,1751,1769,18,-171,-153,0.0102798400913764,-0.0966647823629169,-0.087378640776699
"4463","2020","경기","구리시","초등학교",2020-04-01,"여자",753,805,815,10,-62,-52,0.0124223602484472,-0.0760736196319018,-0.0645962732919255
"4464","2020","경기","구리시","초등학교",2020-04-01,"남자",845,946,954,8,-109,-101,0.00845665961945032,-0.114255765199161,-0.10676532769556
"4465","2020","경기","의정부시","초등학교",2020-04-01,"전체",3502,3658,3780,122,-278,-156,0.0333515582285402,-0.0735449735449735,-0.042646254784035
"4466","2020","경기","의정부시","초등학교",2020-04-01,"여자",1690,1731,1790,59,-100,-41,0.0340843443096476,-0.0558659217877095,-0.02368573079145
"4467","2020","경기","의정부시","초등학교",2020-04-01,"남자",1812,1927,1990,63,-178,-115,0.0326933056564608,-0.0894472361809045,-0.0596782563570317
"4468","2020","경기","파주시","초등학교",2020-04-01,"전체",4595,4725,4875,150,-280,-130,0.0317460317460317,-0.0574358974358974,-0.0275132275132275
"4469","2020","경기","파주시","초등학교",2020-04-01,"여자",2262,2327,2386,59,-124,-65,0.025354533734422,-0.0519698239731769,-0.0279329608938547
"4470","2020","경기","파주시","초등학교",2020-04-01,"남자",2333,2398,2489,91,-156,-65,0.0379482902418682,-0.0626757734029731,-0.0271059216013344
"4471","2020","경기","동두천시","초등학교",2020-04-01,"전체",733,799,775,-24,-42,-66,-0.0300375469336671,-0.0541935483870968,-0.0826032540675845
"4472","2020","경기","동두천시","초등학교",2020-04-01,"여자",356,384,367,-17,-11,-28,-0.0442708333333333,-0.0299727520435967,-0.0729166666666667
"4473","2020","경기","동두천시","초등학교",2020-04-01,"남자",377,415,408,-7,-31,-38,-0.0168674698795181,-0.0759803921568627,-0.091566265060241
"4474","2020","경기","양주시","초등학교",2020-04-01,"전체",2065,1942,2073,131,-8,123,0.0674562306900103,-0.00385914134105162,0.0633367662203913
"4475","2020","경기","양주시","초등학교",2020-04-01,"여자",1030,953,1018,65,12,77,0.068205666316894,0.0117878192534381,0.080797481636936
"4476","2020","경기","양주시","초등학교",2020-04-01,"남자",1035,989,1055,66,-20,46,0.0667340748230536,-0.018957345971564,0.0465116279069767
"4477","2020","경기","포천시","초등학교",2020-04-01,"전체",922,1024,973,-51,-51,-102,-0.0498046875,-0.052415210688592,-0.099609375
"4478","2020","경기","포천시","초등학교",2020-04-01,"여자",436,492,470,-22,-34,-56,-0.0447154471544715,-0.0723404255319149,-0.113821138211382
"4479","2020","경기","포천시","초등학교",2020-04-01,"남자",486,532,503,-29,-17,-46,-0.0545112781954887,-0.0337972166998012,-0.0864661654135338
"4480","2020","경기","가평군","초등학교",2020-04-01,"전체",357,365,367,2,-10,-8,0.00547945205479452,-0.0272479564032698,-0.0219178082191781
"4481","2020","경기","가평군","초등학교",2020-04-01,"여자",168,172,176,4,-8,-4,0.0232558139534884,-0.0454545454545455,-0.0232558139534884
"4482","2020","경기","가평군","초등학교",2020-04-01,"남자",189,193,191,-2,-2,-4,-0.0103626943005181,-0.0104712041884817,-0.0207253886010363
"4483","2020","경기","연천군","초등학교",2020-04-01,"전체",284,335,308,-27,-24,-51,-0.0805970149253731,-0.0779220779220779,-0.152238805970149
"4484","2020","경기","연천군","초등학교",2020-04-01,"여자",141,179,167,-12,-26,-38,-0.0670391061452514,-0.155688622754491,-0.212290502793296
"4485","2020","경기","연천군","초등학교",2020-04-01,"남자",143,156,141,-15,2,-13,-0.0961538461538462,0.0141843971631206,-0.0833333333333333
"4486","2020","강원","춘천시","초등학교",2020-04-01,"전체",2377,2343,2349,6,28,34,0.00256081946222791,0.0119199659429544,0.0145113102859582
"4487","2020","강원","춘천시","초등학교",2020-04-01,"여자",1165,1136,1123,-13,42,29,-0.011443661971831,0.03739982190561,0.0255281690140845
"4488","2020","강원","춘천시","초등학교",2020-04-01,"남자",1212,1207,1226,19,-14,5,0.0157415078707539,-0.0114192495921697,0.00414250207125104
"4489","2020","강원","원주시","초등학교",2020-04-01,"전체",3008,2854,2888,34,120,154,0.0119131044148563,0.0415512465373961,0.0539593552908199
"4490","2020","강원","원주시","초등학교",2020-04-01,"여자",1471,1401,1411,10,60,70,0.00713775874375446,0.0425230333097094,0.0499643112062812
"4491","2020","강원","원주시","초등학교",2020-04-01,"남자",1537,1453,1477,24,60,84,0.0165175498967653,0.04062288422478,0.0578114246386786
"4492","2020","강원","강릉시","초등학교",2020-04-01,"전체",1451,1440,1488,48,-37,11,0.0333333333333333,-0.0248655913978495,0.00763888888888889
"4493","2020","강원","강릉시","초등학교",2020-04-01,"여자",681,651,673,22,8,30,0.0337941628264209,0.011887072808321,0.0460829493087558
"4494","2020","강원","강릉시","초등학교",2020-04-01,"남자",770,789,815,26,-45,-19,0.0329531051964512,-0.0552147239263804,-0.0240811153358682
"4495","2020","강원","동해시","초등학교",2020-04-01,"전체",756,764,765,1,-9,-8,0.00130890052356021,-0.0117647058823529,-0.0104712041884817
"4496","2020","강원","동해시","초등학교",2020-04-01,"여자",370,368,380,12,-10,2,0.0326086956521739,-0.0263157894736842,0.00543478260869565
"4497","2020","강원","동해시","초등학교",2020-04-01,"남자",386,396,385,-11,1,-10,-0.0277777777777778,0.0025974025974026,-0.0252525252525253
"4498","2020","강원","태백시","초등학교",2020-04-01,"전체",284,300,287,-13,-3,-16,-0.0433333333333333,-0.0104529616724739,-0.0533333333333333
"4499","2020","강원","태백시","초등학교",2020-04-01,"여자",132,136,130,-6,2,-4,-0.0441176470588235,0.0153846153846154,-0.0294117647058824
"4500","2020","강원","태백시","초등학교",2020-04-01,"남자",152,164,157,-7,-5,-12,-0.0426829268292683,-0.0318471337579618,-0.0731707317073171
"4501","2020","강원","속초시","초등학교",2020-04-01,"전체",579,580,584,4,-5,-1,0.00689655172413793,-0.00856164383561644,-0.00172413793103448
"4502","2020","강원","속초시","초등학교",2020-04-01,"여자",305,304,306,2,-1,1,0.00657894736842105,-0.00326797385620915,0.00328947368421053
"4503","2020","강원","속초시","초등학교",2020-04-01,"남자",274,276,278,2,-4,-2,0.0072463768115942,-0.0143884892086331,-0.0072463768115942
"4504","2020","강원","삼척시","초등학교",2020-04-01,"전체",400,428,427,-1,-27,-28,-0.00233644859813084,-0.063231850117096,-0.0654205607476635
"4505","2020","강원","삼척시","초등학교",2020-04-01,"여자",201,216,211,-5,-10,-15,-0.0231481481481481,-0.0473933649289099,-0.0694444444444444
"4506","2020","강원","삼척시","초등학교",2020-04-01,"남자",199,212,216,4,-17,-13,0.0188679245283019,-0.0787037037037037,-0.0613207547169811
"4507","2020","강원","홍천군","초등학교",2020-04-01,"전체",384,432,429,-3,-45,-48,-0.00694444444444444,-0.104895104895105,-0.111111111111111
"4508","2020","강원","홍천군","초등학교",2020-04-01,"여자",189,226,212,-14,-23,-37,-0.0619469026548673,-0.108490566037736,-0.163716814159292
"4509","2020","강원","홍천군","초등학교",2020-04-01,"남자",195,206,217,11,-22,-11,0.0533980582524272,-0.101382488479263,-0.0533980582524272
"4510","2020","강원","횡성군","초등학교",2020-04-01,"전체",221,226,227,1,-6,-5,0.00442477876106195,-0.026431718061674,-0.0221238938053097
"4511","2020","강원","횡성군","초등학교",2020-04-01,"여자",107,107,110,3,-3,0,0.0280373831775701,-0.0272727272727273,0
"4512","2020","강원","횡성군","초등학교",2020-04-01,"남자",114,119,117,-2,-3,-5,-0.0168067226890756,-0.0256410256410256,-0.0420168067226891
"4513","2020","강원","영월군","초등학교",2020-04-01,"전체",168,174,176,2,-8,-6,0.0114942528735632,-0.0454545454545455,-0.0344827586206897
"4514","2020","강원","영월군","초등학교",2020-04-01,"여자",80,83,87,4,-7,-3,0.0481927710843374,-0.0804597701149425,-0.036144578313253
"4515","2020","강원","영월군","초등학교",2020-04-01,"남자",88,91,89,-2,-1,-3,-0.021978021978022,-0.0112359550561798,-0.032967032967033
"4516","2020","강원","평창군","초등학교",2020-04-01,"전체",213,217,206,-11,7,-4,-0.0506912442396313,0.0339805825242718,-0.0184331797235023
"4517","2020","강원","평창군","초등학교",2020-04-01,"여자",94,106,104,-2,-10,-12,-0.0188679245283019,-0.0961538461538462,-0.113207547169811
"4518","2020","강원","평창군","초등학교",2020-04-01,"남자",119,111,102,-9,17,8,-0.0810810810810811,0.166666666666667,0.0720720720720721
"4519","2020","강원","정선군","초등학교",2020-04-01,"전체",187,201,204,3,-17,-14,0.0149253731343284,-0.0833333333333333,-0.0696517412935323
"4520","2020","강원","정선군","초등학교",2020-04-01,"여자",92,103,105,2,-13,-11,0.0194174757281553,-0.123809523809524,-0.106796116504854
"4521","2020","강원","정선군","초등학교",2020-04-01,"남자",95,98,99,1,-4,-3,0.0102040816326531,-0.0404040404040404,-0.0306122448979592
"4522","2020","강원","철원군","초등학교",2020-04-01,"전체",301,326,328,2,-27,-25,0.00613496932515337,-0.0823170731707317,-0.0766871165644172
"4523","2020","강원","철원군","초등학교",2020-04-01,"여자",160,160,158,-2,2,0,-0.0125,0.0126582278481013,0
"4524","2020","강원","철원군","초등학교",2020-04-01,"남자",141,166,170,4,-29,-25,0.0240963855421687,-0.170588235294118,-0.150602409638554
"4525","2020","강원","화천군","초등학교",2020-04-01,"전체",180,200,199,-1,-19,-20,-0.005,-0.0954773869346734,-0.1
"4526","2020","강원","화천군","초등학교",2020-04-01,"여자",86,96,94,-2,-8,-10,-0.0208333333333333,-0.0851063829787234,-0.104166666666667
"4527","2020","강원","화천군","초등학교",2020-04-01,"남자",94,104,105,1,-11,-10,0.00961538461538462,-0.104761904761905,-0.0961538461538462
"4528","2020","강원","양구군","초등학교",2020-04-01,"전체",166,182,193,11,-27,-16,0.0604395604395604,-0.139896373056995,-0.0879120879120879
"4529","2020","강원","양구군","초등학교",2020-04-01,"여자",83,89,93,4,-10,-6,0.0449438202247191,-0.10752688172043,-0.0674157303370786
"4530","2020","강원","양구군","초등학교",2020-04-01,"남자",83,93,100,7,-17,-10,0.0752688172043011,-0.17,-0.10752688172043
"4531","2020","강원","인제군","초등학교",2020-04-01,"전체",251,269,245,-24,6,-18,-0.0892193308550186,0.0244897959183673,-0.0669144981412639
"4532","2020","강원","인제군","초등학교",2020-04-01,"여자",128,126,118,-8,10,2,-0.0634920634920635,0.0847457627118644,0.0158730158730159
"4533","2020","강원","인제군","초등학교",2020-04-01,"남자",123,143,127,-16,-4,-20,-0.111888111888112,-0.031496062992126,-0.13986013986014
"4534","2020","강원","고성군","초등학교",2020-04-01,"전체",150,133,131,-2,19,17,-0.0150375939849624,0.145038167938931,0.12781954887218
"4535","2020","강원","고성군","초등학교",2020-04-01,"여자",74,66,69,3,5,8,0.0454545454545455,0.072463768115942,0.121212121212121
"4536","2020","강원","고성군","초등학교",2020-04-01,"남자",76,67,62,-5,14,9,-0.0746268656716418,0.225806451612903,0.134328358208955
"4537","2020","강원","양양군","초등학교",2020-04-01,"전체",141,113,117,4,24,28,0.0353982300884956,0.205128205128205,0.247787610619469
"4538","2020","강원","양양군","초등학교",2020-04-01,"여자",65,52,51,-1,14,13,-0.0192307692307692,0.274509803921569,0.25
"4539","2020","강원","양양군","초등학교",2020-04-01,"남자",76,61,66,5,10,15,0.0819672131147541,0.151515151515152,0.245901639344262
"4540","2020","충북","청주시","초등학교",2020-04-01,"전체",8056,8027,8028,1,28,29,0.000124579544038869,0.00348779272546089,0.0036128067771272
"4541","2020","충북","청주시","초등학교",2020-04-01,"여자",3938,3938,3924,-14,14,0,-0.00355510411376333,0.0035677879714577,0
"4542","2020","충북","청주시","초등학교",2020-04-01,"남자",4118,4089,4104,15,14,29,0.00366837857666911,0.00341130604288499,0.00709219858156028
"4543","2020","충북","충주시","초등학교",2020-04-01,"전체",1598,1562,1585,23,13,36,0.0147247119078105,0.0082018927444795,0.0230473751600512
"4544","2020","충북","충주시","초등학교",2020-04-01,"여자",792,800,811,11,-19,-8,0.01375,-0.0234278668310728,-0.01
"4545","2020","충북","충주시","초등학교",2020-04-01,"남자",806,762,774,12,32,44,0.015748031496063,0.041343669250646,0.057742782152231
"4546","2020","충북","제천시","초등학교",2020-04-01,"전체",931,1003,988,-15,-57,-72,-0.0149551345962114,-0.0576923076923077,-0.0717846460618146
"4547","2020","충북","제천시","초등학교",2020-04-01,"여자",454,498,490,-8,-36,-44,-0.0160642570281124,-0.073469387755102,-0.0883534136546185
"4548","2020","충북","제천시","초등학교",2020-04-01,"남자",477,505,498,-7,-21,-28,-0.0138613861386139,-0.0421686746987952,-0.0554455445544554
"4549","2020","충북","보은군","초등학교",2020-04-01,"전체",146,157,149,-8,-3,-11,-0.0509554140127389,-0.0201342281879195,-0.0700636942675159
"4550","2020","충북","보은군","초등학교",2020-04-01,"여자",79,83,78,-5,1,-4,-0.0602409638554217,0.0128205128205128,-0.0481927710843374
"4551","2020","충북","보은군","초등학교",2020-04-01,"남자",67,74,71,-3,-4,-7,-0.0405405405405405,-0.0563380281690141,-0.0945945945945946
"4552","2020","충북","옥천군","초등학교",2020-04-01,"전체",272,297,289,-8,-17,-25,-0.0269360269360269,-0.0588235294117647,-0.0841750841750842
"4553","2020","충북","옥천군","초등학교",2020-04-01,"여자",124,154,149,-5,-25,-30,-0.0324675324675325,-0.167785234899329,-0.194805194805195
"4554","2020","충북","옥천군","초등학교",2020-04-01,"남자",148,143,140,-3,8,5,-0.020979020979021,0.0571428571428571,0.034965034965035
"4555","2020","충북","영동군","초등학교",2020-04-01,"전체",224,293,273,-20,-49,-69,-0.068259385665529,-0.179487179487179,-0.235494880546075
"4556","2020","충북","영동군","초등학교",2020-04-01,"여자",111,145,134,-11,-23,-34,-0.0758620689655172,-0.171641791044776,-0.23448275862069
"4557","2020","충북","영동군","초등학교",2020-04-01,"남자",113,148,139,-9,-26,-35,-0.0608108108108108,-0.18705035971223,-0.236486486486486
"4558","2020","충북","진천군","초등학교",2020-04-01,"전체",837,704,760,56,77,133,0.0795454545454545,0.101315789473684,0.188920454545455
"4559","2020","충북","진천군","초등학교",2020-04-01,"여자",422,342,371,29,51,80,0.0847953216374269,0.137466307277628,0.233918128654971
"4560","2020","충북","진천군","초등학교",2020-04-01,"남자",415,362,389,27,26,53,0.074585635359116,0.0668380462724936,0.146408839779006
"4561","2020","충북","괴산군","초등학교",2020-04-01,"전체",143,159,169,10,-26,-16,0.0628930817610063,-0.153846153846154,-0.10062893081761
"4562","2020","충북","괴산군","초등학교",2020-04-01,"여자",81,91,96,5,-15,-10,0.0549450549450549,-0.15625,-0.10989010989011
"4563","2020","충북","괴산군","초등학교",2020-04-01,"남자",62,68,73,5,-11,-6,0.0735294117647059,-0.150684931506849,-0.0882352941176471
"4564","2020","충북","음성군","초등학교",2020-04-01,"전체",670,756,703,-53,-33,-86,-0.0701058201058201,-0.0469416785206259,-0.113756613756614
"4565","2020","충북","음성군","초등학교",2020-04-01,"여자",330,382,348,-34,-18,-52,-0.0890052356020942,-0.0517241379310345,-0.136125654450262
"4566","2020","충북","음성군","초등학교",2020-04-01,"남자",340,374,355,-19,-15,-34,-0.0508021390374332,-0.0422535211267606,-0.0909090909090909
"4567","2020","충북","단양군","초등학교",2020-04-01,"전체",117,125,124,-1,-7,-8,-0.008,-0.0564516129032258,-0.064
"4568","2020","충북","단양군","초등학교",2020-04-01,"여자",57,57,60,3,-3,0,0.0526315789473684,-0.05,0
"4569","2020","충북","단양군","초등학교",2020-04-01,"남자",60,68,64,-4,-4,-8,-0.0588235294117647,-0.0625,-0.117647058823529
"4570","2020","충북","증평군","초등학교",2020-04-01,"전체",355,421,394,-27,-39,-66,-0.0641330166270784,-0.0989847715736041,-0.156769596199525
"4571","2020","충북","증평군","초등학교",2020-04-01,"여자",171,202,189,-13,-18,-31,-0.0643564356435644,-0.0952380952380952,-0.153465346534653
"4572","2020","충북","증평군","초등학교",2020-04-01,"남자",184,219,205,-14,-21,-35,-0.0639269406392694,-0.102439024390244,-0.159817351598174
"4573","2020","충남","천안시","초등학교",2020-04-01,"전체",6790,6577,6708,131,82,213,0.0199178956971263,0.0122242098986285,0.0323855861334955
"4574","2020","충남","천안시","초등학교",2020-04-01,"여자",3332,3160,3248,88,84,172,0.0278481012658228,0.0258620689655172,0.0544303797468354
"4575","2020","충남","천안시","초등학교",2020-04-01,"남자",3458,3417,3460,43,-2,41,0.0125841381328651,-0.000578034682080925,0.0119988293824993
"4576","2020","충남","공주시","초등학교",2020-04-01,"전체",670,636,639,3,31,34,0.00471698113207547,0.0485133020344288,0.0534591194968553
"4577","2020","충남","공주시","초등학교",2020-04-01,"여자",317,278,288,10,29,39,0.0359712230215827,0.100694444444444,0.140287769784173
"4578","2020","충남","공주시","초등학교",2020-04-01,"남자",353,358,351,-7,2,-5,-0.0195530726256983,0.0056980056980057,-0.0139664804469274
"4579","2020","충남","보령시","초등학교",2020-04-01,"전체",644,678,664,-14,-20,-34,-0.0206489675516224,-0.0301204819277108,-0.0501474926253687
"4580","2020","충남","보령시","초등학교",2020-04-01,"여자",303,336,330,-6,-27,-33,-0.0178571428571429,-0.0818181818181818,-0.0982142857142857
"4581","2020","충남","보령시","초등학교",2020-04-01,"남자",341,342,334,-8,7,-1,-0.0233918128654971,0.0209580838323353,-0.00292397660818713
"4582","2020","충남","아산시","초등학교",2020-04-01,"전체",3646,3862,3756,-106,-110,-216,-0.0274469186949767,-0.0292864749733759,-0.0559295701708959
"4583","2020","충남","아산시","초등학교",2020-04-01,"여자",1751,1843,1788,-55,-37,-92,-0.0298426478567553,-0.0206935123042506,-0.0499186109603907
"4584","2020","충남","아산시","초등학교",2020-04-01,"남자",1895,2019,1968,-51,-73,-124,-0.025260029717682,-0.0370934959349594,-0.0614165428429916
"4585","2020","충남","서산시","초등학교",2020-04-01,"전체",1655,1681,1708,27,-53,-26,0.0160618679357525,-0.0310304449648712,-0.0154669839381321
"4586","2020","충남","서산시","초등학교",2020-04-01,"여자",839,825,843,18,-4,14,0.0218181818181818,-0.00474495848161329,0.016969696969697
"4587","2020","충남","서산시","초등학교",2020-04-01,"남자",816,856,865,9,-49,-40,0.0105140186915888,-0.0566473988439306,-0.0467289719626168
"4588","2020","충남","논산시","초등학교",2020-04-01,"전체",794,780,764,-16,30,14,-0.0205128205128205,0.0392670157068063,0.0179487179487179
"4589","2020","충남","논산시","초등학교",2020-04-01,"여자",385,387,375,-12,10,-2,-0.0310077519379845,0.0266666666666667,-0.00516795865633075
"4590","2020","충남","논산시","초등학교",2020-04-01,"남자",409,393,389,-4,20,16,-0.0101781170483461,0.051413881748072,0.0407124681933842
"4591","2020","충남","계룡시","초등학교",2020-04-01,"전체",419,442,462,20,-43,-23,0.0452488687782805,-0.0930735930735931,-0.0520361990950226
"4592","2020","충남","계룡시","초등학교",2020-04-01,"여자",225,205,230,25,-5,20,0.121951219512195,-0.0217391304347826,0.0975609756097561
"4593","2020","충남","계룡시","초등학교",2020-04-01,"남자",194,237,232,-5,-38,-43,-0.0210970464135021,-0.163793103448276,-0.181434599156118
"4594","2020","충남","금산군","초등학교",2020-04-01,"전체",298,309,310,1,-12,-11,0.00323624595469256,-0.0387096774193548,-0.0355987055016181
"4595","2020","충남","금산군","초등학교",2020-04-01,"여자",131,150,144,-6,-13,-19,-0.04,-0.0902777777777778,-0.126666666666667
"4596","2020","충남","금산군","초등학교",2020-04-01,"남자",167,159,166,7,1,8,0.0440251572327044,0.00602409638554217,0.050314465408805
"4597","2020","충남","부여군","초등학교",2020-04-01,"전체",314,336,343,7,-29,-22,0.0208333333333333,-0.0845481049562682,-0.0654761904761905
"4598","2020","충남","부여군","초등학교",2020-04-01,"여자",138,161,162,1,-24,-23,0.0062111801242236,-0.148148148148148,-0.142857142857143
"4599","2020","충남","부여군","초등학교",2020-04-01,"남자",176,175,181,6,-5,1,0.0342857142857143,-0.0276243093922652,0.00571428571428571
"4600","2020","충남","서천군","초등학교",2020-04-01,"전체",261,268,265,-3,-4,-7,-0.0111940298507463,-0.0150943396226415,-0.0261194029850746
"4601","2020","충남","서천군","초등학교",2020-04-01,"여자",134,136,137,1,-3,-2,0.00735294117647059,-0.0218978102189781,-0.0147058823529412
"4602","2020","충남","서천군","초등학교",2020-04-01,"남자",127,132,128,-4,-1,-5,-0.0303030303030303,-0.0078125,-0.0378787878787879
"4603","2020","충남","청양군","초등학교",2020-04-01,"전체",143,157,152,-5,-9,-14,-0.0318471337579618,-0.0592105263157895,-0.089171974522293
"4604","2020","충남","청양군","초등학교",2020-04-01,"여자",69,82,78,-4,-9,-13,-0.0487804878048781,-0.115384615384615,-0.158536585365854
"4605","2020","충남","청양군","초등학교",2020-04-01,"남자",74,75,74,-1,0,-1,-0.0133333333333333,0,-0.0133333333333333
"4606","2020","충남","홍성군","초등학교",2020-04-01,"전체",865,824,824,0,41,41,0,0.0497572815533981,0.0497572815533981
"4607","2020","충남","홍성군","초등학교",2020-04-01,"여자",403,387,373,-14,30,16,-0.0361757105943152,0.0804289544235925,0.041343669250646
"4608","2020","충남","홍성군","초등학교",2020-04-01,"남자",462,437,451,14,11,25,0.0320366132723112,0.024390243902439,0.05720823798627
"4609","2020","충남","예산군","초등학교",2020-04-01,"전체",441,408,418,10,23,33,0.0245098039215686,0.0550239234449761,0.0808823529411765
"4610","2020","충남","예산군","초등학교",2020-04-01,"여자",212,200,209,9,3,12,0.045,0.0143540669856459,0.06
"4611","2020","충남","예산군","초등학교",2020-04-01,"남자",229,208,209,1,20,21,0.00480769230769231,0.0956937799043062,0.100961538461538
"4612","2020","충남","태안군","초등학교",2020-04-01,"전체",356,369,359,-10,-3,-13,-0.02710027100271,-0.00835654596100279,-0.035230352303523
"4613","2020","충남","태안군","초등학교",2020-04-01,"여자",182,183,186,3,-4,-1,0.0163934426229508,-0.021505376344086,-0.00546448087431694
"4614","2020","충남","태안군","초등학교",2020-04-01,"남자",174,186,173,-13,1,-12,-0.0698924731182796,0.00578034682080925,-0.0645161290322581
"4615","2020","충남","당진시","초등학교",2020-04-01,"전체",1703,1830,1798,-32,-95,-127,-0.0174863387978142,-0.0528364849833148,-0.0693989071038251
"4616","2020","충남","당진시","초등학교",2020-04-01,"여자",853,909,894,-15,-41,-56,-0.0165016501650165,-0.0458612975391499,-0.0616061606160616
"4617","2020","충남","당진시","초등학교",2020-04-01,"남자",850,921,904,-17,-54,-71,-0.0184581976112921,-0.0597345132743363,-0.0770901194353963
"4618","2020","전북","전주시","초등학교",2020-04-01,"전체",6166,5849,5959,110,207,317,0.0188066336125833,0.034737372042289,0.0541972986835356
"4619","2020","전북","전주시","초등학교",2020-04-01,"여자",3009,2857,2927,70,82,152,0.0245012250612531,0.02801503245644,0.0532026601330067
"4620","2020","전북","전주시","초등학교",2020-04-01,"남자",3157,2992,3032,40,125,165,0.0133689839572193,0.0412269129287599,0.0551470588235294
"4621","2020","전북","군산시","초등학교",2020-04-01,"전체",2503,2551,2542,-9,-39,-48,-0.00352802822422579,-0.0153422501966955,-0.0188161505292042
"4622","2020","전북","군산시","초등학교",2020-04-01,"여자",1226,1240,1236,-4,-10,-14,-0.0032258064516129,-0.00809061488673139,-0.0112903225806452
"4623","2020","전북","군산시","초등학교",2020-04-01,"남자",1277,1311,1306,-5,-29,-34,-0.003813882532418,-0.0222052067381317,-0.0259344012204424
"4624","2020","전북","익산시","초등학교",2020-04-01,"전체",2153,2268,2208,-60,-55,-115,-0.0264550264550265,-0.0249094202898551,-0.050705467372134
"4625","2020","전북","익산시","초등학교",2020-04-01,"여자",1004,1093,1065,-28,-61,-89,-0.0256175663311985,-0.0572769953051643,-0.0814272644098811
"4626","2020","전북","익산시","초등학교",2020-04-01,"남자",1149,1175,1143,-32,6,-26,-0.0272340425531915,0.005249343832021,-0.0221276595744681
"4627","2020","전북","정읍시","초등학교",2020-04-01,"전체",698,734,738,4,-40,-36,0.00544959128065395,-0.0542005420054201,-0.0490463215258856
"4628","2020","전북","정읍시","초등학교",2020-04-01,"여자",333,351,348,-3,-15,-18,-0.00854700854700855,-0.0431034482758621,-0.0512820512820513
"4629","2020","전북","정읍시","초등학교",2020-04-01,"남자",365,383,390,7,-25,-18,0.0182767624020888,-0.0641025641025641,-0.0469973890339426
"4630","2020","전북","남원시","초등학교",2020-04-01,"전체",531,528,519,-9,12,3,-0.0170454545454545,0.023121387283237,0.00568181818181818
"4631","2020","전북","남원시","초등학교",2020-04-01,"여자",255,250,251,1,4,5,0.004,0.0159362549800797,0.02
"4632","2020","전북","남원시","초등학교",2020-04-01,"남자",276,278,268,-10,8,-2,-0.0359712230215827,0.0298507462686567,-0.00719424460431655
"4633","2020","전북","김제시","초등학교",2020-04-01,"전체",490,520,514,-6,-24,-30,-0.0115384615384615,-0.0466926070038911,-0.0576923076923077
"4634","2020","전북","김제시","초등학교",2020-04-01,"여자",222,247,245,-2,-23,-25,-0.00809716599190283,-0.0938775510204082,-0.101214574898785
"4635","2020","전북","김제시","초등학교",2020-04-01,"남자",268,273,269,-4,-1,-5,-0.0146520146520147,-0.00371747211895911,-0.0183150183150183
"4636","2020","전북","완주군","초등학교",2020-04-01,"전체",702,904,875,-29,-173,-202,-0.0320796460176991,-0.197714285714286,-0.223451327433628
"4637","2020","전북","완주군","초등학교",2020-04-01,"여자",359,462,439,-23,-80,-103,-0.0497835497835498,-0.182232346241458,-0.222943722943723
"4638","2020","전북","완주군","초등학교",2020-04-01,"남자",343,442,436,-6,-93,-99,-0.0135746606334842,-0.213302752293578,-0.223981900452489
"4639","2020","전북","진안군","초등학교",2020-04-01,"전체",116,148,141,-7,-25,-32,-0.0472972972972973,-0.177304964539007,-0.216216216216216
"4640","2020","전북","진안군","초등학교",2020-04-01,"여자",66,82,80,-2,-14,-16,-0.024390243902439,-0.175,-0.195121951219512
"4641","2020","전북","진안군","초등학교",2020-04-01,"남자",50,66,61,-5,-11,-16,-0.0757575757575758,-0.180327868852459,-0.242424242424242
"4642","2020","전북","무주군","초등학교",2020-04-01,"전체",123,139,139,0,-16,-16,0,-0.115107913669065,-0.115107913669065
"4643","2020","전북","무주군","초등학교",2020-04-01,"여자",58,66,67,1,-9,-8,0.0151515151515152,-0.134328358208955,-0.121212121212121
"4644","2020","전북","무주군","초등학교",2020-04-01,"남자",65,73,72,-1,-7,-8,-0.0136986301369863,-0.0972222222222222,-0.10958904109589
"4645","2020","전북","장수군","초등학교",2020-04-01,"전체",136,144,148,4,-12,-8,0.0277777777777778,-0.0810810810810811,-0.0555555555555556
"4646","2020","전북","장수군","초등학교",2020-04-01,"여자",61,70,70,0,-9,-9,0,-0.128571428571429,-0.128571428571429
"4647","2020","전북","장수군","초등학교",2020-04-01,"남자",75,74,78,4,-3,1,0.0540540540540541,-0.0384615384615385,0.0135135135135135
"4648","2020","전북","임실군","초등학교",2020-04-01,"전체",139,157,146,-11,-7,-18,-0.0700636942675159,-0.0479452054794521,-0.114649681528662
"4649","2020","전북","임실군","초등학교",2020-04-01,"여자",75,79,74,-5,1,-4,-0.0632911392405063,0.0135135135135135,-0.0506329113924051
"4650","2020","전북","임실군","초등학교",2020-04-01,"남자",64,78,72,-6,-8,-14,-0.0769230769230769,-0.111111111111111,-0.179487179487179
"4651","2020","전북","순창군","초등학교",2020-04-01,"전체",133,159,154,-5,-21,-26,-0.0314465408805031,-0.136363636363636,-0.163522012578616
"4652","2020","전북","순창군","초등학교",2020-04-01,"여자",59,80,75,-5,-16,-21,-0.0625,-0.213333333333333,-0.2625
"4653","2020","전북","순창군","초등학교",2020-04-01,"남자",74,79,79,0,-5,-5,0,-0.0632911392405063,-0.0632911392405063
"4654","2020","전북","고창군","초등학교",2020-04-01,"전체",273,324,321,-3,-48,-51,-0.00925925925925926,-0.149532710280374,-0.157407407407407
"4655","2020","전북","고창군","초등학교",2020-04-01,"여자",127,143,143,0,-16,-16,0,-0.111888111888112,-0.111888111888112
"4656","2020","전북","고창군","초등학교",2020-04-01,"남자",146,181,178,-3,-32,-35,-0.0165745856353591,-0.179775280898876,-0.193370165745856
"4657","2020","전북","부안군","초등학교",2020-04-01,"전체",279,321,310,-11,-31,-42,-0.0342679127725857,-0.1,-0.130841121495327
"4658","2020","전북","부안군","초등학교",2020-04-01,"여자",133,169,163,-6,-30,-36,-0.0355029585798817,-0.184049079754601,-0.21301775147929
"4659","2020","전북","부안군","초등학교",2020-04-01,"남자",146,152,147,-5,-1,-6,-0.0328947368421053,-0.00680272108843537,-0.0394736842105263
"4660","2020","전남","목포시","초등학교",2020-04-01,"전체",2389,2164,2169,5,220,225,0.00231053604436229,0.101429230059935,0.103974121996303
"4661","2020","전남","목포시","초등학교",2020-04-01,"여자",1179,1049,1059,10,120,130,0.00953288846520496,0.113314447592068,0.123927550047664
"4662","2020","전남","목포시","초등학교",2020-04-01,"남자",1210,1115,1110,-5,100,95,-0.00448430493273543,0.0900900900900901,0.0852017937219731
"4663","2020","전남","여수시","초등학교",2020-04-01,"전체",2306,2366,2322,-44,-16,-60,-0.0185967878275571,-0.00689061154177433,-0.0253592561284869
"4664","2020","전남","여수시","초등학교",2020-04-01,"여자",1104,1110,1082,-28,22,-6,-0.0252252252252252,0.0203327171903882,-0.00540540540540541
"4665","2020","전남","여수시","초등학교",2020-04-01,"남자",1202,1256,1240,-16,-38,-54,-0.0127388535031847,-0.0306451612903226,-0.0429936305732484
"4666","2020","전남","순천시","초등학교",2020-04-01,"전체",2627,2480,2548,68,79,147,0.0274193548387097,0.0310047095761381,0.0592741935483871
"4667","2020","전남","순천시","초등학교",2020-04-01,"여자",1297,1230,1272,42,25,67,0.0341463414634146,0.0196540880503145,0.0544715447154472
"4668","2020","전남","순천시","초등학교",2020-04-01,"남자",1330,1250,1276,26,54,80,0.0208,0.0423197492163009,0.064
"4669","2020","전남","나주시","초등학교",2020-04-01,"전체",989,1067,1088,21,-99,-78,0.0196813495782568,-0.0909926470588235,-0.0731021555763824
"4670","2020","전남","나주시","초등학교",2020-04-01,"여자",469,490,501,11,-32,-21,0.0224489795918367,-0.063872255489022,-0.0428571428571429
"4671","2020","전남","나주시","초등학교",2020-04-01,"남자",520,577,587,10,-67,-57,0.0173310225303293,-0.114139693356048,-0.0987868284228769
"4672","2020","전남","광양시","초등학교",2020-04-01,"전체",1444,1541,1486,-55,-42,-97,-0.0356911096690461,-0.0282637954239569,-0.0629461388708631
"4673","2020","전남","광양시","초등학교",2020-04-01,"여자",711,793,762,-31,-51,-82,-0.0390920554854981,-0.0669291338582677,-0.103404791929382
"4674","2020","전남","광양시","초등학교",2020-04-01,"남자",733,748,724,-24,9,-15,-0.0320855614973262,0.0124309392265193,-0.0200534759358289
"4675","2020","전남","담양군","초등학교",2020-04-01,"전체",198,236,231,-5,-33,-38,-0.0211864406779661,-0.142857142857143,-0.161016949152542
"4676","2020","전남","담양군","초등학교",2020-04-01,"여자",100,106,108,2,-8,-6,0.0188679245283019,-0.0740740740740741,-0.0566037735849057
"4677","2020","전남","담양군","초등학교",2020-04-01,"남자",98,130,123,-7,-25,-32,-0.0538461538461538,-0.203252032520325,-0.246153846153846
"4678","2020","전남","곡성군","초등학교",2020-04-01,"전체",113,129,121,-8,-8,-16,-0.062015503875969,-0.0661157024793388,-0.124031007751938
"4679","2020","전남","곡성군","초등학교",2020-04-01,"여자",48,64,60,-4,-12,-16,-0.0625,-0.2,-0.25
"4680","2020","전남","곡성군","초등학교",2020-04-01,"남자",65,65,61,-4,4,0,-0.0615384615384615,0.0655737704918033,0
"4681","2020","전남","구례군","초등학교",2020-04-01,"전체",139,131,139,8,0,8,0.0610687022900763,0,0.0610687022900763
"4682","2020","전남","구례군","초등학교",2020-04-01,"여자",69,65,65,0,4,4,0,0.0615384615384615,0.0615384615384615
"4683","2020","전남","구례군","초등학교",2020-04-01,"남자",70,66,74,8,-4,4,0.121212121212121,-0.0540540540540541,0.0606060606060606
"4684","2020","전남","고흥군","초등학교",2020-04-01,"전체",260,274,266,-8,-6,-14,-0.0291970802919708,-0.0225563909774436,-0.0510948905109489
"4685","2020","전남","고흥군","초등학교",2020-04-01,"여자",115,129,127,-2,-12,-14,-0.0155038759689922,-0.094488188976378,-0.108527131782946
"4686","2020","전남","고흥군","초등학교",2020-04-01,"남자",145,145,139,-6,6,0,-0.0413793103448276,0.0431654676258993,0
"4687","2020","전남","보성군","초등학교",2020-04-01,"전체",170,232,212,-20,-42,-62,-0.0862068965517241,-0.19811320754717,-0.267241379310345
"4688","2020","전남","보성군","초등학교",2020-04-01,"여자",85,116,105,-11,-20,-31,-0.0948275862068965,-0.19047619047619,-0.267241379310345
"4689","2020","전남","보성군","초등학교",2020-04-01,"남자",85,116,107,-9,-22,-31,-0.0775862068965517,-0.205607476635514,-0.267241379310345
"4690","2020","전남","화순군","초등학교",2020-04-01,"전체",378,408,397,-11,-19,-30,-0.0269607843137255,-0.0478589420654912,-0.0735294117647059
"4691","2020","전남","화순군","초등학교",2020-04-01,"여자",179,202,198,-4,-19,-23,-0.0198019801980198,-0.095959595959596,-0.113861386138614
"4692","2020","전남","화순군","초등학교",2020-04-01,"남자",199,206,199,-7,0,-7,-0.0339805825242718,0,-0.0339805825242718
"4693","2020","전남","장흥군","초등학교",2020-04-01,"전체",221,220,225,5,-4,1,0.0227272727272727,-0.0177777777777778,0.00454545454545455
"4694","2020","전남","장흥군","초등학교",2020-04-01,"여자",121,105,107,2,14,16,0.019047619047619,0.130841121495327,0.152380952380952
"4695","2020","전남","장흥군","초등학교",2020-04-01,"남자",100,115,118,3,-18,-15,0.0260869565217391,-0.152542372881356,-0.130434782608696
"4696","2020","전남","강진군","초등학교",2020-04-01,"전체",181,221,204,-17,-23,-40,-0.0769230769230769,-0.112745098039216,-0.180995475113122
"4697","2020","전남","강진군","초등학교",2020-04-01,"여자",86,104,99,-5,-13,-18,-0.0480769230769231,-0.131313131313131,-0.173076923076923
"4698","2020","전남","강진군","초등학교",2020-04-01,"남자",95,117,105,-12,-10,-22,-0.102564102564103,-0.0952380952380952,-0.188034188034188
"4699","2020","전남","해남군","초등학교",2020-04-01,"전체",376,450,420,-30,-44,-74,-0.0666666666666667,-0.104761904761905,-0.164444444444444
"4700","2020","전남","해남군","초등학교",2020-04-01,"여자",203,246,218,-28,-15,-43,-0.113821138211382,-0.0688073394495413,-0.17479674796748
"4701","2020","전남","해남군","초등학교",2020-04-01,"남자",173,204,202,-2,-29,-31,-0.00980392156862745,-0.143564356435644,-0.151960784313725
"4702","2020","전남","영암군","초등학교",2020-04-01,"전체",412,434,414,-20,-2,-22,-0.0460829493087558,-0.00483091787439614,-0.0506912442396313
"4703","2020","전남","영암군","초등학교",2020-04-01,"여자",208,218,210,-8,-2,-10,-0.036697247706422,-0.00952380952380952,-0.0458715596330275
"4704","2020","전남","영암군","초등학교",2020-04-01,"남자",204,216,204,-12,0,-12,-0.0555555555555556,0,-0.0555555555555556
"4705","2020","전남","무안군","초등학교",2020-04-01,"전체",702,797,804,7,-102,-95,0.00878293601003764,-0.126865671641791,-0.119196988707654
"4706","2020","전남","무안군","초등학교",2020-04-01,"여자",340,394,392,-2,-52,-54,-0.0050761421319797,-0.13265306122449,-0.137055837563452
"4707","2020","전남","무안군","초등학교",2020-04-01,"남자",362,403,412,9,-50,-41,0.0223325062034739,-0.121359223300971,-0.101736972704715
"4708","2020","전남","함평군","초등학교",2020-04-01,"전체",152,185,171,-14,-19,-33,-0.0756756756756757,-0.111111111111111,-0.178378378378378
"4709","2020","전남","함평군","초등학교",2020-04-01,"여자",74,91,86,-5,-12,-17,-0.0549450549450549,-0.13953488372093,-0.186813186813187
"4710","2020","전남","함평군","초등학교",2020-04-01,"남자",78,94,85,-9,-7,-16,-0.0957446808510638,-0.0823529411764706,-0.170212765957447
"4711","2020","전남","영광군","초등학교",2020-04-01,"전체",312,325,330,5,-18,-13,0.0153846153846154,-0.0545454545454545,-0.04
"4712","2020","전남","영광군","초등학교",2020-04-01,"여자",160,172,177,5,-17,-12,0.0290697674418605,-0.096045197740113,-0.0697674418604651
"4713","2020","전남","영광군","초등학교",2020-04-01,"남자",152,153,153,0,-1,-1,0,-0.0065359477124183,-0.0065359477124183
"4714","2020","전남","장성군","초등학교",2020-04-01,"전체",271,331,317,-14,-46,-60,-0.0422960725075529,-0.145110410094637,-0.181268882175227
"4715","2020","전남","장성군","초등학교",2020-04-01,"여자",133,155,147,-8,-14,-22,-0.0516129032258065,-0.0952380952380952,-0.141935483870968
"4716","2020","전남","장성군","초등학교",2020-04-01,"남자",138,176,170,-6,-32,-38,-0.0340909090909091,-0.188235294117647,-0.215909090909091
"4717","2020","전남","완도군","초등학교",2020-04-01,"전체",315,390,367,-23,-52,-75,-0.058974358974359,-0.141689373297003,-0.192307692307692
"4718","2020","전남","완도군","초등학교",2020-04-01,"여자",153,196,186,-10,-33,-43,-0.0510204081632653,-0.17741935483871,-0.219387755102041
"4719","2020","전남","완도군","초등학교",2020-04-01,"남자",162,194,181,-13,-19,-32,-0.0670103092783505,-0.104972375690608,-0.164948453608247
"4720","2020","전남","진도군","초등학교",2020-04-01,"전체",171,175,175,0,-4,-4,0,-0.0228571428571429,-0.0228571428571429
"4721","2020","전남","진도군","초등학교",2020-04-01,"여자",78,94,95,1,-17,-16,0.0106382978723404,-0.178947368421053,-0.170212765957447
"4722","2020","전남","진도군","초등학교",2020-04-01,"남자",93,81,80,-1,13,12,-0.0123456790123457,0.1625,0.148148148148148
"4723","2020","전남","신안군","초등학교",2020-04-01,"전체",143,205,185,-20,-42,-62,-0.0975609756097561,-0.227027027027027,-0.302439024390244
"4724","2020","전남","신안군","초등학교",2020-04-01,"여자",67,99,89,-10,-22,-32,-0.101010101010101,-0.247191011235955,-0.323232323232323
"4725","2020","전남","신안군","초등학교",2020-04-01,"남자",76,106,96,-10,-20,-30,-0.0943396226415094,-0.208333333333333,-0.283018867924528
"4726","2020","경북","포항시","초등학교",2020-04-01,"전체",4488,4540,4583,43,-95,-52,0.00947136563876652,-0.0207287802749291,-0.0114537444933921
"4727","2020","경북","포항시","초등학교",2020-04-01,"여자",2190,2179,2221,42,-31,11,0.0192748967416246,-0.0139576767221972,0.00504818724185406
"4728","2020","경북","포항시","초등학교",2020-04-01,"남자",2298,2361,2362,1,-64,-63,0.000423549343498518,-0.0270956816257409,-0.0266836086404066
"4729","2020","경북","경주시","초등학교",2020-04-01,"전체",1768,1784,1806,22,-38,-16,0.0123318385650224,-0.0210409745293466,-0.00896860986547085
"4730","2020","경북","경주시","초등학교",2020-04-01,"여자",827,856,869,13,-42,-29,0.0151869158878505,-0.048331415420023,-0.0338785046728972
"4731","2020","경북","경주시","초등학교",2020-04-01,"남자",941,928,937,9,4,13,0.00969827586206897,0.00426894343649947,0.0140086206896552
"4732","2020","경북","김천시","초등학교",2020-04-01,"전체",1118,1182,1163,-19,-45,-64,-0.0160744500846024,-0.0386930352536543,-0.0541455160744501
"4733","2020","경북","김천시","초등학교",2020-04-01,"여자",516,571,561,-10,-45,-55,-0.0175131348511384,-0.0802139037433155,-0.0963222416812609
"4734","2020","경북","김천시","초등학교",2020-04-01,"남자",602,611,602,-9,0,-9,-0.0147299509001637,0,-0.0147299509001637
"4735","2020","경북","안동시","초등학교",2020-04-01,"전체",1315,1212,1199,-13,116,103,-0.0107260726072607,0.0967472894078399,0.084983498349835
"4736","2020","경북","안동시","초등학교",2020-04-01,"여자",629,601,581,-20,48,28,-0.0332778702163062,0.0826161790017212,0.0465890183028286
"4737","2020","경북","안동시","초등학교",2020-04-01,"남자",686,611,618,7,68,75,0.0114566284779051,0.110032362459547,0.122749590834697
"4738","2020","경북","구미시","초등학교",2020-04-01,"전체",4552,4663,4638,-25,-86,-111,-0.00536135535063264,-0.0185424752048297,-0.0238044177568089
"4739","2020","경북","구미시","초등학교",2020-04-01,"여자",2190,2228,2217,-11,-27,-38,-0.00493716337522442,-0.0121786197564276,-0.0170556552962298
"4740","2020","경북","구미시","초등학교",2020-04-01,"남자",2362,2435,2421,-14,-59,-73,-0.00574948665297741,-0.0243700950020653,-0.0299794661190965
"4741","2020","경북","영주시","초등학교",2020-04-01,"전체",666,719,713,-6,-47,-53,-0.00834492350486787,-0.0659186535764376,-0.0737134909596662
"4742","2020","경북","영주시","초등학교",2020-04-01,"여자",333,333,330,-3,3,0,-0.00900900900900901,0.00909090909090909,0
"4743","2020","경북","영주시","초등학교",2020-04-01,"남자",333,386,383,-3,-50,-53,-0.0077720207253886,-0.130548302872063,-0.137305699481865
"4744","2020","경북","영천시","초등학교",2020-04-01,"전체",542,620,601,-19,-59,-78,-0.0306451612903226,-0.0981697171381032,-0.125806451612903
"4745","2020","경북","영천시","초등학교",2020-04-01,"여자",271,289,283,-6,-12,-18,-0.0207612456747405,-0.0424028268551237,-0.0622837370242214
"4746","2020","경북","영천시","초등학교",2020-04-01,"남자",271,331,318,-13,-47,-60,-0.0392749244712991,-0.147798742138365,-0.181268882175227
"4747","2020","경북","상주시","초등학교",2020-04-01,"전체",564,553,544,-9,20,11,-0.0162748643761302,0.0367647058823529,0.0198915009041591
"4748","2020","경북","상주시","초등학교",2020-04-01,"여자",276,269,264,-5,12,7,-0.0185873605947955,0.0454545454545455,0.0260223048327138
"4749","2020","경북","상주시","초등학교",2020-04-01,"남자",288,284,280,-4,8,4,-0.0140845070422535,0.0285714285714286,0.0140845070422535
"4750","2020","경북","문경시","초등학교",2020-04-01,"전체",415,455,444,-11,-29,-40,-0.0241758241758242,-0.0653153153153153,-0.0879120879120879
"4751","2020","경북","문경시","초등학교",2020-04-01,"여자",192,217,216,-1,-24,-25,-0.00460829493087558,-0.111111111111111,-0.115207373271889
"4752","2020","경북","문경시","초등학교",2020-04-01,"남자",223,238,228,-10,-5,-15,-0.0420168067226891,-0.0219298245614035,-0.0630252100840336
"4753","2020","경북","경산시","초등학교",2020-04-01,"전체",2228,2359,2365,6,-137,-131,0.00254345061466723,-0.0579281183932347,-0.0555320050869012
"4754","2020","경북","경산시","초등학교",2020-04-01,"여자",1098,1173,1194,21,-96,-75,0.0179028132992327,-0.0804020100502513,-0.0639386189258312
"4755","2020","경북","경산시","초등학교",2020-04-01,"남자",1130,1186,1171,-15,-41,-56,-0.0126475548060708,-0.0350128095644748,-0.0472175379426644
"4756","2020","경북","군위군","초등학교",2020-04-01,"전체",66,82,73,-9,-7,-16,-0.109756097560976,-0.0958904109589041,-0.195121951219512
"4757","2020","경북","군위군","초등학교",2020-04-01,"여자",22,41,36,-5,-14,-19,-0.121951219512195,-0.388888888888889,-0.463414634146341
"4758","2020","경북","군위군","초등학교",2020-04-01,"남자",44,41,37,-4,7,3,-0.0975609756097561,0.189189189189189,0.0731707317073171
"4759","2020","경북","의성군","초등학교",2020-04-01,"전체",162,221,210,-11,-48,-59,-0.0497737556561086,-0.228571428571429,-0.266968325791855
"4760","2020","경북","의성군","초등학교",2020-04-01,"여자",79,104,99,-5,-20,-25,-0.0480769230769231,-0.202020202020202,-0.240384615384615
"4761","2020","경북","의성군","초등학교",2020-04-01,"남자",83,117,111,-6,-28,-34,-0.0512820512820513,-0.252252252252252,-0.290598290598291
"4762","2020","경북","청송군","초등학교",2020-04-01,"전체",104,125,117,-8,-13,-21,-0.064,-0.111111111111111,-0.168
"4763","2020","경북","청송군","초등학교",2020-04-01,"여자",59,62,62,0,-3,-3,0,-0.0483870967741935,-0.0483870967741935
"4764","2020","경북","청송군","초등학교",2020-04-01,"남자",45,63,55,-8,-10,-18,-0.126984126984127,-0.181818181818182,-0.285714285714286
"4765","2020","경북","영양군","초등학교",2020-04-01,"전체",77,83,77,-6,0,-6,-0.072289156626506,0,-0.072289156626506
"4766","2020","경북","영양군","초등학교",2020-04-01,"여자",31,32,28,-4,3,-1,-0.125,0.107142857142857,-0.03125
"4767","2020","경북","영양군","초등학교",2020-04-01,"남자",46,51,49,-2,-3,-5,-0.0392156862745098,-0.0612244897959184,-0.0980392156862745
"4768","2020","경북","영덕군","초등학교",2020-04-01,"전체",169,204,201,-3,-32,-35,-0.0147058823529412,-0.159203980099502,-0.17156862745098
"4769","2020","경북","영덕군","초등학교",2020-04-01,"여자",81,98,92,-6,-11,-17,-0.0612244897959184,-0.119565217391304,-0.173469387755102
"4770","2020","경북","영덕군","초등학교",2020-04-01,"남자",88,106,109,3,-21,-18,0.0283018867924528,-0.192660550458716,-0.169811320754717
"4771","2020","경북","청도군","초등학교",2020-04-01,"전체",145,170,168,-2,-23,-25,-0.0117647058823529,-0.136904761904762,-0.147058823529412
"4772","2020","경북","청도군","초등학교",2020-04-01,"여자",71,91,90,-1,-19,-20,-0.010989010989011,-0.211111111111111,-0.21978021978022
"4773","2020","경북","청도군","초등학교",2020-04-01,"남자",74,79,78,-1,-4,-5,-0.0126582278481013,-0.0512820512820513,-0.0632911392405063
"4774","2020","경북","고령군","초등학교",2020-04-01,"전체",153,206,185,-21,-32,-53,-0.101941747572816,-0.172972972972973,-0.257281553398058
"4775","2020","경북","고령군","초등학교",2020-04-01,"여자",77,96,85,-11,-8,-19,-0.114583333333333,-0.0941176470588235,-0.197916666666667
"4776","2020","경북","고령군","초등학교",2020-04-01,"남자",76,110,100,-10,-24,-34,-0.0909090909090909,-0.24,-0.309090909090909
"4777","2020","경북","성주군","초등학교",2020-04-01,"전체",162,198,188,-10,-26,-36,-0.0505050505050505,-0.138297872340426,-0.181818181818182
"4778","2020","경북","성주군","초등학교",2020-04-01,"여자",82,102,98,-4,-16,-20,-0.0392156862745098,-0.163265306122449,-0.196078431372549
"4779","2020","경북","성주군","초등학교",2020-04-01,"남자",80,96,90,-6,-10,-16,-0.0625,-0.111111111111111,-0.166666666666667
"4780","2020","경북","칠곡군","초등학교",2020-04-01,"전체",1123,1156,1133,-23,-10,-33,-0.0198961937716263,-0.0088261253309797,-0.0285467128027682
"4781","2020","경북","칠곡군","초등학교",2020-04-01,"여자",523,530,523,-7,0,-7,-0.0132075471698113,0,-0.0132075471698113
"4782","2020","경북","칠곡군","초등학교",2020-04-01,"남자",600,626,610,-16,-10,-26,-0.0255591054313099,-0.0163934426229508,-0.0415335463258786
"4783","2020","경북","예천군","초등학교",2020-04-01,"전체",394,430,486,56,-92,-36,0.130232558139535,-0.189300411522634,-0.0837209302325581
"4784","2020","경북","예천군","초등학교",2020-04-01,"여자",190,214,249,35,-59,-24,0.163551401869159,-0.236947791164659,-0.11214953271028
"4785","2020","경북","예천군","초등학교",2020-04-01,"남자",204,216,237,21,-33,-12,0.0972222222222222,-0.139240506329114,-0.0555555555555556
"4786","2020","경북","봉화군","초등학교",2020-04-01,"전체",132,166,153,-13,-21,-34,-0.0783132530120482,-0.137254901960784,-0.204819277108434
"4787","2020","경북","봉화군","초등학교",2020-04-01,"여자",63,79,71,-8,-8,-16,-0.10126582278481,-0.112676056338028,-0.20253164556962
"4788","2020","경북","봉화군","초등학교",2020-04-01,"남자",69,87,82,-5,-13,-18,-0.0574712643678161,-0.158536585365854,-0.206896551724138
"4789","2020","경북","울진군","초등학교",2020-04-01,"전체",299,342,328,-14,-29,-43,-0.0409356725146199,-0.0884146341463415,-0.125730994152047
"4790","2020","경북","울진군","초등학교",2020-04-01,"여자",151,179,172,-7,-21,-28,-0.0391061452513966,-0.122093023255814,-0.156424581005587
"4791","2020","경북","울진군","초등학교",2020-04-01,"남자",148,163,156,-7,-8,-15,-0.0429447852760736,-0.0512820512820513,-0.0920245398773006
"4792","2020","경북","울릉군","초등학교",2020-04-01,"전체",50,50,53,3,-3,0,0.06,-0.0566037735849057,0
"4793","2020","경북","울릉군","초등학교",2020-04-01,"여자",28,31,30,-1,-2,-3,-0.032258064516129,-0.0666666666666667,-0.0967741935483871
"4794","2020","경북","울릉군","초등학교",2020-04-01,"남자",22,19,23,4,-1,3,0.210526315789474,-0.0434782608695652,0.157894736842105
"4795","2020","경남","진주시","초등학교",2020-04-01,"전체",3121,3091,3162,71,-41,30,0.022969912649628,-0.012966476913346,0.00970559689420899
"4796","2020","경남","진주시","초등학교",2020-04-01,"여자",1451,1455,1492,37,-41,-4,0.0254295532646048,-0.0274798927613941,-0.00274914089347079
"4797","2020","경남","진주시","초등학교",2020-04-01,"남자",1670,1636,1670,34,0,34,0.0207823960880196,0,0.0207823960880196
"4798","2020","경남","통영시","초등학교",2020-04-01,"전체",1103,1197,1179,-18,-76,-94,-0.0150375939849624,-0.0644614079728583,-0.0785296574770259
"4799","2020","경남","통영시","초등학교",2020-04-01,"여자",534,591,580,-11,-46,-57,-0.0186125211505922,-0.0793103448275862,-0.0964467005076142
"4800","2020","경남","통영시","초등학교",2020-04-01,"남자",569,606,599,-7,-30,-37,-0.0115511551155116,-0.0500834724540902,-0.0610561056105611
"4801","2020","경남","사천시","초등학교",2020-04-01,"전체",904,1013,1001,-12,-97,-109,-0.0118460019743337,-0.0969030969030969,-0.107601184600197
"4802","2020","경남","사천시","초등학교",2020-04-01,"여자",423,517,510,-7,-87,-94,-0.0135396518375242,-0.170588235294118,-0.181818181818182
"4803","2020","경남","사천시","초등학교",2020-04-01,"남자",481,496,491,-5,-10,-15,-0.0100806451612903,-0.0203665987780041,-0.030241935483871
"4804","2020","경남","김해시","초등학교",2020-04-01,"전체",5602,5431,5500,69,102,171,0.012704842570429,0.0185454545454545,0.0314859141962806
"4805","2020","경남","김해시","초등학교",2020-04-01,"여자",2773,2700,2734,34,39,73,0.0125925925925926,0.0142648134601317,0.027037037037037
"4806","2020","경남","김해시","초등학교",2020-04-01,"남자",2829,2731,2766,35,63,98,0.0128158183815452,0.0227765726681128,0.0358842914683266
"4807","2020","경남","밀양시","초등학교",2020-04-01,"전체",607,603,599,-4,8,4,-0.0066334991708126,0.013355592654424,0.0066334991708126
"4808","2020","경남","밀양시","초등학교",2020-04-01,"여자",309,302,300,-2,9,7,-0.00662251655629139,0.03,0.0231788079470199
"4809","2020","경남","밀양시","초등학교",2020-04-01,"남자",298,301,299,-2,-1,-3,-0.00664451827242525,-0.00334448160535117,-0.00996677740863787
"4810","2020","경남","거제시","초등학교",2020-04-01,"전체",3038,3225,3151,-74,-113,-187,-0.0229457364341085,-0.0358616312281815,-0.057984496124031
"4811","2020","경남","거제시","초등학교",2020-04-01,"여자",1465,1594,1558,-36,-93,-129,-0.0225846925972397,-0.0596919127086008,-0.0809284818067754
"4812","2020","경남","거제시","초등학교",2020-04-01,"남자",1573,1631,1593,-38,-20,-58,-0.023298589822195,-0.0125549278091651,-0.0355610055180871
"4813","2020","경남","양산시","초등학교",2020-04-01,"전체",3713,3882,3861,-21,-148,-169,-0.00540958268933539,-0.0383320383320383,-0.0435342606903658
"4814","2020","경남","양산시","초등학교",2020-04-01,"여자",1851,1905,1892,-13,-41,-54,-0.0068241469816273,-0.0216701902748414,-0.0283464566929134
"4815","2020","경남","양산시","초등학교",2020-04-01,"남자",1862,1977,1969,-8,-107,-115,-0.00404653515427415,-0.0543423057389538,-0.0581689428426909
"4816","2020","경남","의령군","초등학교",2020-04-01,"전체",96,129,123,-6,-27,-33,-0.0465116279069767,-0.219512195121951,-0.255813953488372
"4817","2020","경남","의령군","초등학교",2020-04-01,"여자",44,51,51,0,-7,-7,0,-0.137254901960784,-0.137254901960784
"4818","2020","경남","의령군","초등학교",2020-04-01,"남자",52,78,72,-6,-20,-26,-0.0769230769230769,-0.277777777777778,-0.333333333333333
"4819","2020","경남","함안군","초등학교",2020-04-01,"전체",502,540,532,-8,-30,-38,-0.0148148148148148,-0.056390977443609,-0.0703703703703704
"4820","2020","경남","함안군","초등학교",2020-04-01,"여자",257,282,275,-7,-18,-25,-0.024822695035461,-0.0654545454545455,-0.0886524822695035
"4821","2020","경남","함안군","초등학교",2020-04-01,"남자",245,258,257,-1,-12,-13,-0.00387596899224806,-0.0466926070038911,-0.0503875968992248
"4822","2020","경남","창녕군","초등학교",2020-04-01,"전체",354,418,405,-13,-51,-64,-0.0311004784688995,-0.125925925925926,-0.15311004784689
"4823","2020","경남","창녕군","초등학교",2020-04-01,"여자",161,193,191,-2,-30,-32,-0.0103626943005181,-0.157068062827225,-0.16580310880829
"4824","2020","경남","창녕군","초등학교",2020-04-01,"남자",193,225,214,-11,-21,-32,-0.0488888888888889,-0.0981308411214953,-0.142222222222222
"4825","2020","경남","고성군","초등학교",2020-04-01,"전체",309,334,327,-7,-18,-25,-0.0209580838323353,-0.055045871559633,-0.0748502994011976
"4826","2020","경남","고성군","초등학교",2020-04-01,"여자",167,185,181,-4,-14,-18,-0.0216216216216216,-0.0773480662983425,-0.0972972972972973
"4827","2020","경남","고성군","초등학교",2020-04-01,"남자",142,149,146,-3,-4,-7,-0.0201342281879195,-0.0273972602739726,-0.0469798657718121
"4828","2020","경남","남해군","초등학교",2020-04-01,"전체",152,161,168,7,-16,-9,0.0434782608695652,-0.0952380952380952,-0.0559006211180124
"4829","2020","경남","남해군","초등학교",2020-04-01,"여자",81,78,80,2,1,3,0.0256410256410256,0.0125,0.0384615384615385
"4830","2020","경남","남해군","초등학교",2020-04-01,"남자",71,83,88,5,-17,-12,0.0602409638554217,-0.193181818181818,-0.144578313253012
"4831","2020","경남","하동군","초등학교",2020-04-01,"전체",171,188,180,-8,-9,-17,-0.0425531914893617,-0.05,-0.0904255319148936
"4832","2020","경남","하동군","초등학교",2020-04-01,"여자",75,77,76,-1,-1,-2,-0.012987012987013,-0.0131578947368421,-0.025974025974026
"4833","2020","경남","하동군","초등학교",2020-04-01,"남자",96,111,104,-7,-8,-15,-0.0630630630630631,-0.0769230769230769,-0.135135135135135
"4834","2020","경남","산청군","초등학교",2020-04-01,"전체",139,164,150,-14,-11,-25,-0.0853658536585366,-0.0733333333333333,-0.152439024390244
"4835","2020","경남","산청군","초등학교",2020-04-01,"여자",62,71,70,-1,-8,-9,-0.0140845070422535,-0.114285714285714,-0.126760563380282
"4836","2020","경남","산청군","초등학교",2020-04-01,"남자",77,93,80,-13,-3,-16,-0.139784946236559,-0.0375,-0.172043010752688
"4837","2020","경남","함양군","초등학교",2020-04-01,"전체",216,219,223,4,-7,-3,0.0182648401826484,-0.031390134529148,-0.0136986301369863
"4838","2020","경남","함양군","초등학교",2020-04-01,"여자",111,109,111,2,0,2,0.018348623853211,0,0.018348623853211
"4839","2020","경남","함양군","초등학교",2020-04-01,"남자",105,110,112,2,-7,-5,0.0181818181818182,-0.0625,-0.0454545454545455
"4840","2020","경남","거창군","초등학교",2020-04-01,"전체",427,455,458,3,-31,-28,0.00659340659340659,-0.0676855895196507,-0.0615384615384615
"4841","2020","경남","거창군","초등학교",2020-04-01,"여자",208,223,227,4,-19,-15,0.0179372197309417,-0.0837004405286344,-0.0672645739910314
"4842","2020","경남","거창군","초등학교",2020-04-01,"남자",219,232,231,-1,-12,-13,-0.00431034482758621,-0.051948051948052,-0.0560344827586207
"4843","2020","경남","합천군","초등학교",2020-04-01,"전체",183,213,207,-6,-24,-30,-0.028169014084507,-0.115942028985507,-0.140845070422535
"4844","2020","경남","합천군","초등학교",2020-04-01,"여자",88,108,108,0,-20,-20,0,-0.185185185185185,-0.185185185185185
"4845","2020","경남","합천군","초등학교",2020-04-01,"남자",95,105,99,-6,-4,-10,-0.0571428571428571,-0.0404040404040404,-0.0952380952380952
"4846","2020","제주","제주시","초등학교",2020-04-01,"전체",4989,4883,5005,122,-16,106,0.0249846405898014,-0.0031968031968032,0.0217079664140897
"4847","2020","제주","제주시","초등학교",2020-04-01,"여자",2422,2392,2463,71,-41,30,0.0296822742474916,-0.0166463662200568,0.0125418060200669
"4848","2020","제주","제주시","초등학교",2020-04-01,"남자",2567,2491,2542,51,25,76,0.0204737053392212,0.00983477576711251,0.0305098354074669
"4849","2020","제주","서귀포시","초등학교",2020-04-01,"전체",1437,1543,1542,-1,-105,-106,-0.000648088139987038,-0.0680933852140078,-0.0686973428386261
"4850","2020","제주","서귀포시","초등학교",2020-04-01,"여자",731,769,779,10,-48,-38,0.0130039011703511,-0.061617458279846,-0.0494148244473342
"4851","2020","제주","서귀포시","초등학교",2020-04-01,"남자",706,774,763,-11,-57,-68,-0.0142118863049096,-0.0747051114023591,-0.0878552971576227
"4852","2013","서울","종로구","초등학교",2013-04-01,"전체",988,1059,1047,-12,-59,-71,-0.0113314447592068,-0.0563514804202483,-0.0670443814919736
"4853","2013","서울","종로구","초등학교",2013-04-01,"여자",460,514,519,5,-59,-54,0.00972762645914397,-0.113680154142582,-0.105058365758755
"4854","2013","서울","종로구","초등학교",2013-04-01,"남자",528,545,528,-17,0,-17,-0.0311926605504587,0,-0.0311926605504587
"4855","2013","서울","중구","초등학교",2013-04-01,"전체",951,912,914,2,37,39,0.00219298245614035,0.0404814004376368,0.0427631578947368
"4856","2013","서울","중구","초등학교",2013-04-01,"여자",482,429,429,0,53,53,0,0.123543123543124,0.123543123543124
"4857","2013","서울","중구","초등학교",2013-04-01,"남자",469,483,485,2,-16,-14,0.0041407867494824,-0.0329896907216495,-0.0289855072463768
"4858","2013","서울","용산구","초등학교",2013-04-01,"전체",1386,1848,1848,0,-462,-462,0,-0.25,-0.25
"4859","2013","서울","용산구","초등학교",2013-04-01,"여자",659,908,899,-9,-240,-249,-0.00991189427312775,-0.266963292547275,-0.274229074889868
"4860","2013","서울","용산구","초등학교",2013-04-01,"남자",727,940,949,9,-222,-213,0.00957446808510638,-0.233930453108535,-0.226595744680851
"4861","2013","서울","성동구","초등학교",2013-04-01,"전체",2223,2527,2395,-132,-172,-304,-0.0522358527898694,-0.0718162839248434,-0.120300751879699
"4862","2013","서울","성동구","초등학교",2013-04-01,"여자",1068,1229,1160,-69,-92,-161,-0.0561432058584215,-0.0793103448275862,-0.13100081366965
"4863","2013","서울","성동구","초등학교",2013-04-01,"남자",1155,1298,1235,-63,-80,-143,-0.0485362095531587,-0.0647773279352227,-0.110169491525424
"4864","2013","서울","광진구","초등학교",2013-04-01,"전체",2689,2769,2676,-93,13,-80,-0.0335861321776815,0.00485799701046338,-0.0288912964969303
"4865","2013","서울","광진구","초등학교",2013-04-01,"여자",1348,1420,1376,-44,-28,-72,-0.0309859154929577,-0.0203488372093023,-0.0507042253521127
"4866","2013","서울","광진구","초등학교",2013-04-01,"남자",1341,1349,1300,-49,41,-8,-0.0363232023721275,0.0315384615384615,-0.00593031875463306
"4867","2013","서울","동대문구","초등학교",2013-04-01,"전체",2501,2764,2682,-82,-181,-263,-0.0296671490593343,-0.0674869500372856,-0.0951519536903039
"4868","2013","서울","동대문구","초등학교",2013-04-01,"여자",1241,1415,1358,-57,-117,-174,-0.0402826855123675,-0.0861561119293078,-0.122968197879859
"4869","2013","서울","동대문구","초등학교",2013-04-01,"남자",1260,1349,1324,-25,-64,-89,-0.0185322461082283,-0.0483383685800604,-0.0659747961452928
"4870","2013","서울","중랑구","초등학교",2013-04-01,"전체",2747,3203,3133,-70,-386,-456,-0.0218545113955667,-0.123204596233642,-0.142366531376834
"4871","2013","서울","중랑구","초등학교",2013-04-01,"여자",1295,1500,1503,3,-208,-205,0.002,-0.138389886892881,-0.136666666666667
"4872","2013","서울","중랑구","초등학교",2013-04-01,"남자",1452,1703,1630,-73,-178,-251,-0.0428655314151497,-0.10920245398773,-0.147386964180857
"4873","2013","서울","성북구","초등학교",2013-04-01,"전체",4035,4441,4295,-146,-260,-406,-0.0328754784958343,-0.0605355064027939,-0.0914208511596487
"4874","2013","서울","성북구","초등학교",2013-04-01,"여자",1966,2158,2095,-63,-129,-192,-0.0291936978683967,-0.0615751789976134,-0.0889712696941613
"4875","2013","서울","성북구","초등학교",2013-04-01,"남자",2069,2283,2200,-83,-131,-214,-0.0363556723609286,-0.0595454545454545,-0.093736311870346
"4876","2013","서울","강북구","초등학교",2013-04-01,"전체",1972,2536,2504,-32,-532,-564,-0.0126182965299685,-0.212460063897764,-0.222397476340694
"4877","2013","서울","강북구","초등학교",2013-04-01,"여자",960,1251,1236,-15,-276,-291,-0.0119904076738609,-0.223300970873786,-0.232613908872902
"4878","2013","서울","강북구","초등학교",2013-04-01,"남자",1012,1285,1268,-17,-256,-273,-0.0132295719844358,-0.201892744479495,-0.212451361867704
"4879","2013","서울","도봉구","초등학교",2013-04-01,"전체",2891,2795,2799,4,92,96,0.00143112701252236,0.0328688817434798,0.0343470483005367
"4880","2013","서울","도봉구","초등학교",2013-04-01,"여자",1374,1369,1370,1,4,5,0.000730460189919649,0.00291970802919708,0.00365230094959825
"4881","2013","서울","도봉구","초등학교",2013-04-01,"남자",1517,1426,1429,3,88,91,0.00210378681626928,0.0615815255423373,0.0638148667601683
"4882","2013","서울","노원구","초등학교",2013-04-01,"전체",4883,4997,4988,-9,-105,-114,-0.00180108064838903,-0.0210505212510024,-0.0228136882129278
"4883","2013","서울","노원구","초등학교",2013-04-01,"여자",2351,2405,2416,11,-65,-54,0.00457380457380457,-0.0269039735099338,-0.0224532224532225
"4884","2013","서울","노원구","초등학교",2013-04-01,"남자",2532,2592,2572,-20,-40,-60,-0.00771604938271605,-0.015552099533437,-0.0231481481481481
"4885","2013","서울","은평구","초등학교",2013-04-01,"전체",4137,4177,4217,40,-80,-40,0.00957625089777352,-0.0189708323452692,-0.00957625089777352
"4886","2013","서울","은평구","초등학교",2013-04-01,"여자",2010,2025,2052,27,-42,-15,0.0133333333333333,-0.0204678362573099,-0.00740740740740741
"4887","2013","서울","은평구","초등학교",2013-04-01,"남자",2127,2152,2165,13,-38,-25,0.00604089219330855,-0.0175519630484988,-0.0116171003717472
"4888","2013","서울","서대문구","초등학교",2013-04-01,"전체",2272,2405,2301,-104,-29,-133,-0.0432432432432432,-0.0126032159930465,-0.0553014553014553
"4889","2013","서울","서대문구","초등학교",2013-04-01,"여자",1120,1203,1141,-62,-21,-83,-0.0515378221113882,-0.0184049079754601,-0.0689941812136326
"4890","2013","서울","서대문구","초등학교",2013-04-01,"남자",1152,1202,1160,-42,-8,-50,-0.0349417637271215,-0.00689655172413793,-0.0415973377703827
"4891","2013","서울","마포구","초등학교",2013-04-01,"전체",2813,3358,3225,-133,-412,-545,-0.03960690887433,-0.127751937984496,-0.162298987492555
"4892","2013","서울","마포구","초등학교",2013-04-01,"여자",1374,1622,1552,-70,-178,-248,-0.0431565967940814,-0.114690721649485,-0.152897657213317
"4893","2013","서울","마포구","초등학교",2013-04-01,"남자",1439,1736,1673,-63,-234,-297,-0.0362903225806452,-0.139868499701136,-0.171082949308756
"4894","2013","서울","양천구","초등학교",2013-04-01,"전체",3764,3916,4071,155,-307,-152,0.0395812053115424,-0.0754114468189634,-0.0388151174668029
"4895","2013","서울","양천구","초등학교",2013-04-01,"여자",1887,1982,2074,92,-187,-95,0.0464177598385469,-0.0901639344262295,-0.0479313824419778
"4896","2013","서울","양천구","초등학교",2013-04-01,"남자",1877,1934,1997,63,-120,-57,0.0325749741468459,-0.0600901352028042,-0.0294725956566701
"4897","2013","서울","강서구","초등학교",2013-04-01,"전체",4427,4962,4738,-224,-311,-535,-0.045143087464732,-0.0656395103419164,-0.107819427650141
"4898","2013","서울","강서구","초등학교",2013-04-01,"여자",2103,2381,2289,-92,-186,-278,-0.0386392272154557,-0.0812581913499345,-0.116757664846703
"4899","2013","서울","강서구","초등학교",2013-04-01,"남자",2324,2581,2449,-132,-125,-257,-0.0511429678419217,-0.051041241322989,-0.0995738086013173
"4900","2013","서울","구로구","초등학교",2013-04-01,"전체",3371,3866,3834,-32,-463,-495,-0.008277289187791,-0.1207616066771,-0.128039317123642
"4901","2013","서울","구로구","초등학교",2013-04-01,"여자",1645,1890,1873,-17,-228,-245,-0.00899470899470899,-0.121729845168179,-0.12962962962963
"4902","2013","서울","구로구","초등학교",2013-04-01,"남자",1726,1976,1961,-15,-235,-250,-0.00759109311740891,-0.119836817950026,-0.126518218623482
"4903","2013","서울","금천구","초등학교",2013-04-01,"전체",1661,1868,1793,-75,-132,-207,-0.0401498929336188,-0.0736196319018405,-0.110813704496788
"4904","2013","서울","금천구","초등학교",2013-04-01,"여자",811,939,898,-41,-87,-128,-0.0436634717784878,-0.0968819599109131,-0.136315228966986
"4905","2013","서울","금천구","초등학교",2013-04-01,"남자",850,929,895,-34,-45,-79,-0.0365984930032293,-0.0502793296089385,-0.085037674919268
"4906","2013","서울","영등포구","초등학교",2013-04-01,"전체",2660,3488,3267,-221,-607,-828,-0.0633600917431193,-0.185797367615549,-0.237385321100917
"4907","2013","서울","영등포구","초등학교",2013-04-01,"여자",1263,1709,1596,-113,-333,-446,-0.0661205383265067,-0.208646616541353,-0.260971328262142
"4908","2013","서울","영등포구","초등학교",2013-04-01,"남자",1397,1779,1671,-108,-274,-382,-0.06070826306914,-0.163973668461999,-0.214727374929736
"4909","2013","서울","동작구","초등학교",2013-04-01,"전체",3028,3212,3110,-102,-82,-184,-0.0317559153175592,-0.0263665594855305,-0.0572851805728518
"4910","2013","서울","동작구","초등학교",2013-04-01,"여자",1476,1563,1522,-41,-46,-87,-0.0262316058861164,-0.0302233902759527,-0.0556621880998081
"4911","2013","서울","동작구","초등학교",2013-04-01,"남자",1552,1649,1588,-61,-36,-97,-0.0369921164342025,-0.0226700251889169,-0.0588235294117647
"4912","2013","서울","관악구","초등학교",2013-04-01,"전체",3029,3929,3757,-172,-728,-900,-0.0437770425044541,-0.193771626297578,-0.229065920081446
"4913","2013","서울","관악구","초등학교",2013-04-01,"여자",1423,1902,1815,-87,-392,-479,-0.0457413249211356,-0.215977961432507,-0.251840168243954
"4914","2013","서울","관악구","초등학교",2013-04-01,"남자",1606,2027,1942,-85,-336,-421,-0.0419338924518994,-0.173017507723996,-0.207696102614702
"4915","2013","서울","서초구","초등학교",2013-04-01,"전체",3547,3598,3717,119,-170,-51,0.0330739299610895,-0.0457358084476729,-0.0141745414118955
"4916","2013","서울","서초구","초등학교",2013-04-01,"여자",1743,1725,1775,50,-32,18,0.0289855072463768,-0.0180281690140845,0.0104347826086957
"4917","2013","서울","서초구","초등학교",2013-04-01,"남자",1804,1873,1942,69,-138,-69,0.0368392952482648,-0.0710607621009269,-0.0368392952482648
"4918","2013","서울","강남구","초등학교",2013-04-01,"전체",3320,3924,3927,3,-607,-604,0.000764525993883792,-0.154570919276802,-0.153924566768603
"4919","2013","서울","강남구","초등학교",2013-04-01,"여자",1622,1947,1948,1,-326,-325,0.000513610683102209,-0.16735112936345,-0.166923472008218
"4920","2013","서울","강남구","초등학교",2013-04-01,"남자",1698,1977,1979,2,-281,-279,0.00101163378856854,-0.141990904497221,-0.141122913505311
"4921","2013","서울","송파구","초등학교",2013-04-01,"전체",5184,5662,5690,28,-506,-478,0.0049452490286118,-0.0889279437609842,-0.0844224655598728
"4922","2013","서울","송파구","초등학교",2013-04-01,"여자",2485,2733,2769,36,-284,-248,0.013172338090011,-0.102564102564103,-0.0907427735089645
"4923","2013","서울","송파구","초등학교",2013-04-01,"남자",2699,2929,2921,-8,-222,-230,-0.00273130761351997,-0.0760013693940431,-0.0785250938886992
"4924","2013","서울","강동구","초등학교",2013-04-01,"전체",3587,4053,3982,-71,-395,-466,-0.0175178879842092,-0.0991963837267705,-0.114976560572415
"4925","2013","서울","강동구","초등학교",2013-04-01,"여자",1714,1914,1862,-52,-148,-200,-0.0271682340647858,-0.079484425349087,-0.104493207941484
"4926","2013","서울","강동구","초등학교",2013-04-01,"남자",1873,2139,2120,-19,-247,-266,-0.00888265544647031,-0.116509433962264,-0.124357176250584
"4927","2013","부산","중구","초등학교",2013-04-01,"전체",275,246,236,-10,39,29,-0.040650406504065,0.165254237288136,0.117886178861789
"4928","2013","부산","중구","초등학교",2013-04-01,"여자",133,119,115,-4,18,14,-0.0336134453781513,0.156521739130435,0.117647058823529
"4929","2013","부산","중구","초등학교",2013-04-01,"남자",142,127,121,-6,21,15,-0.047244094488189,0.173553719008264,0.118110236220472
"4930","2013","부산","서구","초등학교",2013-04-01,"전체",626,715,693,-22,-67,-89,-0.0307692307692308,-0.0966810966810967,-0.124475524475524
"4931","2013","부산","서구","초등학교",2013-04-01,"여자",310,355,345,-10,-35,-45,-0.028169014084507,-0.101449275362319,-0.126760563380282
"4932","2013","부산","서구","초등학교",2013-04-01,"남자",316,360,348,-12,-32,-44,-0.0333333333333333,-0.0919540229885057,-0.122222222222222
"4933","2013","부산","동구","초등학교",2013-04-01,"전체",454,537,540,3,-86,-83,0.00558659217877095,-0.159259259259259,-0.154562383612663
"4934","2013","부산","동구","초등학교",2013-04-01,"여자",238,268,271,3,-33,-30,0.0111940298507463,-0.121771217712177,-0.111940298507463
"4935","2013","부산","동구","초등학교",2013-04-01,"남자",216,269,269,0,-53,-53,0,-0.197026022304833,-0.197026022304833
"4936","2013","부산","영도구","초등학교",2013-04-01,"전체",746,840,829,-11,-83,-94,-0.0130952380952381,-0.100120627261761,-0.111904761904762
"4937","2013","부산","영도구","초등학교",2013-04-01,"여자",369,382,384,2,-15,-13,0.00523560209424084,-0.0390625,-0.0340314136125654
"4938","2013","부산","영도구","초등학교",2013-04-01,"남자",377,458,445,-13,-68,-81,-0.0283842794759825,-0.152808988764045,-0.176855895196507
"4939","2013","부산","부산진구","초등학교",2013-04-01,"전체",2738,2737,2764,27,-26,1,0.00986481549141396,-0.00940665701881331,0.000365363536719035
"4940","2013","부산","부산진구","초등학교",2013-04-01,"여자",1334,1352,1376,24,-42,-18,0.0177514792899408,-0.0305232558139535,-0.0133136094674556
"4941","2013","부산","부산진구","초등학교",2013-04-01,"남자",1404,1385,1388,3,16,19,0.00216606498194946,0.0115273775216138,0.0137184115523466
"4942","2013","부산","동래구","초등학교",2013-04-01,"전체",1857,1947,1964,17,-107,-90,0.00873138161273754,-0.0544806517311609,-0.0462249614791988
"4943","2013","부산","동래구","초등학교",2013-04-01,"여자",907,966,955,-11,-48,-59,-0.0113871635610766,-0.050261780104712,-0.0610766045548654
"4944","2013","부산","동래구","초등학교",2013-04-01,"남자",950,981,1009,28,-59,-31,0.0285423037716616,-0.0584737363726462,-0.0316004077471967
"4945","2013","부산","남구","초등학교",2013-04-01,"전체",1895,2173,2127,-46,-232,-278,-0.0211688909341924,-0.109073812881993,-0.12793373216751
"4946","2013","부산","남구","초등학교",2013-04-01,"여자",927,1032,1017,-15,-90,-105,-0.0145348837209302,-0.0884955752212389,-0.101744186046512
"4947","2013","부산","남구","초등학교",2013-04-01,"남자",968,1141,1110,-31,-142,-173,-0.0271691498685364,-0.127927927927928,-0.151621384750219
"4948","2013","부산","북구","초등학교",2013-04-01,"전체",2273,2215,2206,-9,67,58,-0.00406320541760722,0.0303717135086129,0.0261851015801354
"4949","2013","부산","북구","초등학교",2013-04-01,"여자",1054,1042,1052,10,2,12,0.00959692898272553,0.00190114068441065,0.0115163147792706
"4950","2013","부산","북구","초등학교",2013-04-01,"남자",1219,1173,1154,-19,65,46,-0.0161977834612106,0.0563258232235702,0.0392156862745098
"4951","2013","부산","해운대구","초등학교",2013-04-01,"전체",3499,3537,3632,95,-133,-38,0.026858919988691,-0.0366189427312775,-0.0107435679954764
"4952","2013","부산","해운대구","초등학교",2013-04-01,"여자",1710,1739,1781,42,-71,-29,0.0241518113858539,-0.0398652442448063,-0.0166762507188039
"4953","2013","부산","해운대구","초등학교",2013-04-01,"남자",1789,1798,1851,53,-62,-9,0.0294771968854283,-0.0334954078876283,-0.0050055617352614
"4954","2013","부산","사하구","초등학교",2013-04-01,"전체",2520,2707,2642,-65,-122,-187,-0.0240118212042852,-0.0461771385314156,-0.0690801625415589
"4955","2013","부산","사하구","초등학교",2013-04-01,"여자",1240,1297,1263,-34,-23,-57,-0.0262143407864302,-0.0182106096595408,-0.0439475713184271
"4956","2013","부산","사하구","초등학교",2013-04-01,"남자",1280,1410,1379,-31,-99,-130,-0.0219858156028369,-0.0717911530094271,-0.0921985815602837
"4957","2013","부산","금정구","초등학교",2013-04-01,"전체",1625,1585,1602,17,23,40,0.0107255520504732,0.0143570536828964,0.0252365930599369
"4958","2013","부산","금정구","초등학교",2013-04-01,"여자",759,766,777,11,-18,-7,0.0143603133159269,-0.0231660231660232,-0.00913838120104439
"4959","2013","부산","금정구","초등학교",2013-04-01,"남자",866,819,825,6,41,47,0.00732600732600733,0.0496969696969697,0.0573870573870574
"4960","2013","부산","강서구","초등학교",2013-04-01,"전체",474,468,505,37,-31,6,0.0790598290598291,-0.0613861386138614,0.0128205128205128
"4961","2013","부산","강서구","초등학교",2013-04-01,"여자",241,230,258,28,-17,11,0.121739130434783,-0.0658914728682171,0.0478260869565217
"4962","2013","부산","강서구","초등학교",2013-04-01,"남자",233,238,247,9,-14,-5,0.0378151260504202,-0.0566801619433198,-0.0210084033613445
"4963","2013","부산","연제구","초등학교",2013-04-01,"전체",1552,1606,1599,-7,-47,-54,-0.00435865504358655,-0.0293933708567855,-0.0336239103362391
"4964","2013","부산","연제구","초등학교",2013-04-01,"여자",734,753,744,-9,-10,-19,-0.0119521912350598,-0.0134408602150538,-0.0252324037184595
"4965","2013","부산","연제구","초등학교",2013-04-01,"남자",818,853,855,2,-37,-35,0.00234466588511137,-0.0432748538011696,-0.041031652989449
"4966","2013","부산","수영구","초등학교",2013-04-01,"전체",1010,1183,1142,-41,-132,-173,-0.0346576500422654,-0.115586690017513,-0.146238377007608
"4967","2013","부산","수영구","초등학교",2013-04-01,"여자",465,553,533,-20,-68,-88,-0.0361663652802893,-0.127579737335835,-0.159132007233273
"4968","2013","부산","수영구","초등학교",2013-04-01,"남자",545,630,609,-21,-64,-85,-0.0333333333333333,-0.105090311986864,-0.134920634920635
"4969","2013","부산","사상구","초등학교",2013-04-01,"전체",1526,1818,1757,-61,-231,-292,-0.0335533553355336,-0.131474103585657,-0.160616061606161
"4970","2013","부산","사상구","초등학교",2013-04-01,"여자",742,873,833,-40,-91,-131,-0.0458190148911798,-0.109243697478992,-0.150057273768614
"4971","2013","부산","사상구","초등학교",2013-04-01,"남자",784,945,924,-21,-140,-161,-0.0222222222222222,-0.151515151515152,-0.17037037037037
"4972","2013","부산","기장군","초등학교",2013-04-01,"전체",1207,1022,1104,82,103,185,0.0802348336594912,0.0932971014492754,0.181017612524462
"4973","2013","부산","기장군","초등학교",2013-04-01,"여자",579,480,535,55,44,99,0.114583333333333,0.0822429906542056,0.20625
"4974","2013","부산","기장군","초등학교",2013-04-01,"남자",628,542,569,27,59,86,0.0498154981549815,0.103690685413005,0.158671586715867
"4975","2013","대구","중구","초등학교",2013-04-01,"전체",701,519,494,-25,207,182,-0.0481695568400771,0.419028340080972,0.350674373795761
"4976","2013","대구","중구","초등학교",2013-04-01,"여자",355,250,239,-11,116,105,-0.044,0.485355648535565,0.42
"4977","2013","대구","중구","초등학교",2013-04-01,"남자",346,269,255,-14,91,77,-0.0520446096654275,0.356862745098039,0.286245353159851
"4978","2013","대구","동구","초등학교",2013-04-01,"전체",2592,2803,2796,-7,-204,-211,-0.00249732429539779,-0.0729613733905579,-0.0752764894755619
"4979","2013","대구","동구","초등학교",2013-04-01,"여자",1207,1332,1322,-10,-115,-125,-0.00750750750750751,-0.0869894099848714,-0.0938438438438438
"4980","2013","대구","동구","초등학교",2013-04-01,"남자",1385,1471,1474,3,-89,-86,0.00203942895989123,-0.0603799185888738,-0.0584636301835486
"4981","2013","대구","서구","초등학교",2013-04-01,"전체",1136,1300,1289,-11,-153,-164,-0.00846153846153846,-0.118696664080683,-0.126153846153846
"4982","2013","대구","서구","초등학교",2013-04-01,"여자",566,653,663,10,-97,-87,0.0153139356814701,-0.14630467571644,-0.13323124042879
"4983","2013","대구","서구","초등학교",2013-04-01,"남자",570,647,626,-21,-56,-77,-0.0324574961360124,-0.0894568690095847,-0.119010819165379
"4984","2013","대구","남구","초등학교",2013-04-01,"전체",857,982,987,5,-130,-125,0.00509164969450102,-0.131712259371834,-0.127291242362525
"4985","2013","대구","남구","초등학교",2013-04-01,"여자",382,460,448,-12,-66,-78,-0.0260869565217391,-0.147321428571429,-0.169565217391304
"4986","2013","대구","남구","초등학교",2013-04-01,"남자",475,522,539,17,-64,-47,0.0325670498084291,-0.11873840445269,-0.0900383141762452
"4987","2013","대구","북구","초등학교",2013-04-01,"전체",4109,4496,4456,-40,-347,-387,-0.00889679715302491,-0.0778725314183124,-0.086076512455516
"4988","2013","대구","북구","초등학교",2013-04-01,"여자",1988,2153,2132,-21,-144,-165,-0.00975383186251742,-0.0675422138836773,-0.0766372503483511
"4989","2013","대구","북구","초등학교",2013-04-01,"남자",2121,2343,2324,-19,-203,-222,-0.00810926163038839,-0.0873493975903614,-0.0947503201024328
"4990","2013","대구","수성구","초등학교",2013-04-01,"전체",3735,3607,3809,202,-74,128,0.0560022179096202,-0.0194276713048044,0.0354865539229276
"4991","2013","대구","수성구","초등학교",2013-04-01,"여자",1753,1751,1850,99,-97,2,0.05653912050257,-0.0524324324324324,0.00114220445459737
"4992","2013","대구","수성구","초등학교",2013-04-01,"남자",1982,1856,1959,103,23,126,0.0554956896551724,0.0117406840224604,0.0678879310344828
"4993","2013","대구","달서구","초등학교",2013-04-01,"전체",5330,5157,5198,41,132,173,0.00795035873569905,0.0253943824547903,0.0335466356408765
"4994","2013","대구","달서구","초등학교",2013-04-01,"여자",2584,2496,2527,31,57,88,0.0124198717948718,0.0225563909774436,0.0352564102564103
"4995","2013","대구","달서구","초등학교",2013-04-01,"남자",2746,2661,2671,10,75,85,0.00375798571965427,0.0280793710220891,0.0319428786170613
"4996","2013","대구","달성군","초등학교",2013-04-01,"전체",1761,1923,1910,-13,-149,-162,-0.00676027041081643,-0.0780104712041885,-0.0842433697347894
"4997","2013","대구","달성군","초등학교",2013-04-01,"여자",844,927,918,-9,-74,-83,-0.00970873786407767,-0.0806100217864924,-0.0895361380798274
"4998","2013","대구","달성군","초등학교",2013-04-01,"남자",917,996,992,-4,-75,-79,-0.00401606425702811,-0.0756048387096774,-0.0793172690763052
"4999","2013","인천","중구","초등학교",2013-04-01,"전체",1066,865,883,18,183,201,0.0208092485549133,0.207248018120045,0.232369942196532
"5000","2013","인천","중구","초등학교",2013-04-01,"여자",494,407,426,19,68,87,0.0466830466830467,0.15962441314554,0.213759213759214
"5001","2013","인천","중구","초등학교",2013-04-01,"남자",572,458,457,-1,115,114,-0.00218340611353712,0.25164113785558,0.248908296943231
"5002","2013","인천","동구","초등학교",2013-04-01,"전체",747,740,711,-29,36,7,-0.0391891891891892,0.0506329113924051,0.00945945945945946
"5003","2013","인천","동구","초등학교",2013-04-01,"여자",353,360,343,-17,10,-7,-0.0472222222222222,0.0291545189504373,-0.0194444444444444
"5004","2013","인천","동구","초등학교",2013-04-01,"남자",394,380,368,-12,26,14,-0.0315789473684211,0.0706521739130435,0.0368421052631579
"5005","2013","인천","남구","초등학교",2013-04-01,"전체",2839,3393,3317,-76,-478,-554,-0.0223990568818155,-0.144106119987941,-0.163277335691129
"5006","2013","인천","남구","초등학교",2013-04-01,"여자",1391,1607,1572,-35,-181,-216,-0.0217797137523335,-0.115139949109415,-0.134411947728687
"5007","2013","인천","남구","초등학교",2013-04-01,"남자",1448,1786,1745,-41,-297,-338,-0.022956326987682,-0.170200573065903,-0.189249720044793
"5008","2013","인천","연수구","초등학교",2013-04-01,"전체",2738,2461,2629,168,109,277,0.0682649329540837,0.0414606314187904,0.112555871596912
"5009","2013","인천","연수구","초등학교",2013-04-01,"여자",1329,1195,1265,70,64,134,0.0585774058577406,0.0505928853754941,0.112133891213389
"5010","2013","인천","연수구","초등학교",2013-04-01,"남자",1409,1266,1364,98,45,143,0.0774091627172196,0.0329912023460411,0.112954186413902
"5011","2013","인천","남동구","초등학교",2013-04-01,"전체",4671,4921,5107,186,-436,-250,0.0377971956919325,-0.0853730174270609,-0.0508026823816298
"5012","2013","인천","남동구","초등학교",2013-04-01,"여자",2174,2344,2447,103,-273,-170,0.0439419795221843,-0.111565181855333,-0.0725255972696246
"5013","2013","인천","남동구","초등학교",2013-04-01,"남자",2497,2577,2660,83,-163,-80,0.0322079937912301,-0.0612781954887218,-0.0310438494373302
"5014","2013","인천","부평구","초등학교",2013-04-01,"전체",4448,5138,5033,-105,-585,-690,-0.0204359673024523,-0.116232863103517,-0.134293499416115
"5015","2013","인천","부평구","초등학교",2013-04-01,"여자",2119,2491,2430,-61,-311,-372,-0.0244881573665195,-0.12798353909465,-0.149337615415496
"5016","2013","인천","부평구","초등학교",2013-04-01,"남자",2329,2647,2603,-44,-274,-318,-0.016622591613147,-0.105263157894737,-0.120136003022289
"5017","2013","인천","계양구","초등학교",2013-04-01,"전체",2919,3232,3130,-102,-211,-313,-0.0315594059405941,-0.0674121405750799,-0.0968440594059406
"5018","2013","인천","계양구","초등학교",2013-04-01,"여자",1407,1575,1532,-43,-125,-168,-0.0273015873015873,-0.0815926892950392,-0.106666666666667
"5019","2013","인천","계양구","초등학교",2013-04-01,"남자",1512,1657,1598,-59,-86,-145,-0.0356065178032589,-0.0538172715894869,-0.0875075437537719
"5020","2013","인천","서구","초등학교",2013-04-01,"전체",5127,4686,5091,405,36,441,0.0864276568501921,0.00707130229817325,0.0941101152368758
"5021","2013","인천","서구","초등학교",2013-04-01,"여자",2485,2278,2485,207,0,207,0.0908691834942932,0,0.0908691834942932
"5022","2013","인천","서구","초등학교",2013-04-01,"남자",2642,2408,2606,198,36,234,0.0822259136212625,0.0138142747505756,0.0971760797342193
"5023","2013","인천","강화군","초등학교",2013-04-01,"전체",377,344,366,22,11,33,0.063953488372093,0.0300546448087432,0.0959302325581395
"5024","2013","인천","강화군","초등학교",2013-04-01,"여자",194,179,188,9,6,15,0.0502793296089385,0.0319148936170213,0.0837988826815642
"5025","2013","인천","강화군","초등학교",2013-04-01,"남자",183,165,178,13,5,18,0.0787878787878788,0.0280898876404494,0.109090909090909
"5026","2013","인천","옹진군","초등학교",2013-04-01,"전체",122,164,151,-13,-29,-42,-0.0792682926829268,-0.19205298013245,-0.25609756097561
"5027","2013","인천","옹진군","초등학교",2013-04-01,"여자",65,88,80,-8,-15,-23,-0.0909090909090909,-0.1875,-0.261363636363636
"5028","2013","인천","옹진군","초등학교",2013-04-01,"남자",57,76,71,-5,-14,-19,-0.0657894736842105,-0.197183098591549,-0.25
"5029","2013","광주","동구","초등학교",2013-04-01,"전체",673,611,662,51,11,62,0.0834697217675941,0.0166163141993958,0.101472995090016
"5030","2013","광주","동구","초등학교",2013-04-01,"여자",323,292,312,20,11,31,0.0684931506849315,0.0352564102564103,0.106164383561644
"5031","2013","광주","동구","초등학교",2013-04-01,"남자",350,319,350,31,0,31,0.0971786833855799,0,0.0971786833855799
"5032","2013","광주","서구","초등학교",2013-04-01,"전체",2924,2897,3237,340,-313,27,0.117362789092164,-0.0966944701884461,0.00931998619261305
"5033","2013","광주","서구","초등학교",2013-04-01,"여자",1404,1380,1568,188,-164,24,0.136231884057971,-0.104591836734694,0.0173913043478261
"5034","2013","광주","서구","초등학교",2013-04-01,"남자",1520,1517,1669,152,-149,3,0.100197758734344,-0.0892750149790294,0.001977587343441
"5035","2013","광주","남구","초등학교",2013-04-01,"전체",1941,1716,1743,27,198,225,0.0157342657342657,0.113597246127367,0.131118881118881
"5036","2013","광주","남구","초등학교",2013-04-01,"여자",951,828,849,21,102,123,0.0253623188405797,0.120141342756184,0.148550724637681
"5037","2013","광주","남구","초등학교",2013-04-01,"남자",990,888,894,6,96,102,0.00675675675675676,0.10738255033557,0.114864864864865
"5038","2013","광주","북구","초등학교",2013-04-01,"전체",3856,4487,4073,-414,-217,-631,-0.0922665478047693,-0.0532776822980604,-0.140628482282148
"5039","2013","광주","북구","초등학교",2013-04-01,"여자",1853,2174,1964,-210,-111,-321,-0.0965961361545538,-0.0565173116089613,-0.147654093836247
"5040","2013","광주","북구","초등학교",2013-04-01,"남자",2003,2313,2109,-204,-106,-310,-0.0881971465629053,-0.0502607871028924,-0.134025075659317
"5041","2013","광주","광산구","초등학교",2013-04-01,"전체",5131,5045,5186,141,-55,86,0.0279484638255699,-0.0106054762822985,0.0170465807730426
"5042","2013","광주","광산구","초등학교",2013-04-01,"여자",2449,2424,2494,70,-45,25,0.0288778877887789,-0.0180433039294306,0.0103135313531353
"5043","2013","광주","광산구","초등학교",2013-04-01,"남자",2682,2621,2692,71,-10,61,0.027088897367417,-0.0037147102526003,0.0232735597100343
"5044","2013","대전","동구","초등학교",2013-04-01,"전체",2170,2370,2427,57,-257,-200,0.0240506329113924,-0.105892047795632,-0.0843881856540084
"5045","2013","대전","동구","초등학교",2013-04-01,"여자",1055,1158,1191,33,-136,-103,0.0284974093264249,-0.114189756507137,-0.0889464594127807
"5046","2013","대전","동구","초등학교",2013-04-01,"남자",1115,1212,1236,24,-121,-97,0.0198019801980198,-0.0978964401294498,-0.08003300330033
"5047","2013","대전","중구","초등학교",2013-04-01,"전체",2339,2315,2323,8,16,24,0.00345572354211663,0.00688764528626776,0.0103671706263499
"5048","2013","대전","중구","초등학교",2013-04-01,"여자",1148,1120,1120,0,28,28,0,0.025,0.025
"5049","2013","대전","중구","초등학교",2013-04-01,"남자",1191,1195,1203,8,-12,-4,0.00669456066945607,-0.00997506234413965,-0.00334728033472803
"5050","2013","대전","서구","초등학교",2013-04-01,"전체",4487,4627,4649,22,-162,-140,0.00475470066998055,-0.0348462034846203,-0.0302571860816944
"5051","2013","대전","서구","초등학교",2013-04-01,"여자",2155,2206,2217,11,-62,-51,0.00498640072529465,-0.0279657194406856,-0.0231187669990934
"5052","2013","대전","서구","초등학교",2013-04-01,"남자",2332,2421,2432,11,-100,-89,0.00454357703428335,-0.0411184210526316,-0.036761668731929
"5053","2013","대전","유성구","초등학교",2013-04-01,"전체",3957,3723,3919,196,38,234,0.0526457158205748,0.00969635110997704,0.0628525382755842
"5054","2013","대전","유성구","초등학교",2013-04-01,"여자",1870,1851,1964,113,-94,19,0.0610480821177742,-0.0478615071283096,0.0102647217720151
"5055","2013","대전","유성구","초등학교",2013-04-01,"남자",2087,1872,1955,83,132,215,0.0443376068376068,0.0675191815856778,0.114850427350427
"5056","2013","대전","대덕구","초등학교",2013-04-01,"전체",1763,1905,1863,-42,-100,-142,-0.0220472440944882,-0.0536768652710682,-0.0745406824146982
"5057","2013","대전","대덕구","초등학교",2013-04-01,"여자",836,925,885,-40,-49,-89,-0.0432432432432432,-0.0553672316384181,-0.0962162162162162
"5058","2013","대전","대덕구","초등학교",2013-04-01,"남자",927,980,978,-2,-51,-53,-0.00204081632653061,-0.0521472392638037,-0.0540816326530612
"5059","2013","울산","중구","초등학교",2013-04-01,"전체",1774,1859,1850,-9,-76,-85,-0.00484131253362023,-0.0410810810810811,-0.0457235072619688
"5060","2013","울산","중구","초등학교",2013-04-01,"여자",825,858,860,2,-35,-33,0.00233100233100233,-0.0406976744186047,-0.0384615384615385
"5061","2013","울산","중구","초등학교",2013-04-01,"남자",949,1001,990,-11,-41,-52,-0.010989010989011,-0.0414141414141414,-0.051948051948052
"5062","2013","울산","남구","초등학교",2013-04-01,"전체",2734,2918,2962,44,-228,-184,0.0150788211103496,-0.0769750168804862,-0.0630568882796436
"5063","2013","울산","남구","초등학교",2013-04-01,"여자",1351,1379,1401,22,-50,-28,0.0159535895576505,-0.0356887937187723,-0.0203045685279188
"5064","2013","울산","남구","초등학교",2013-04-01,"남자",1383,1539,1561,22,-178,-156,0.0142949967511371,-0.114029468289558,-0.101364522417154
"5065","2013","울산","동구","초등학교",2013-04-01,"전체",1650,1646,1673,27,-23,4,0.0164034021871203,-0.013747758517633,0.00243013365735115
"5066","2013","울산","동구","초등학교",2013-04-01,"여자",767,762,784,22,-17,5,0.0288713910761155,-0.0216836734693878,0.00656167979002625
"5067","2013","울산","동구","초등학교",2013-04-01,"남자",883,884,889,5,-6,-1,0.00565610859728507,-0.00674915635545557,-0.00113122171945701
"5068","2013","울산","북구","초등학교",2013-04-01,"전체",2248,2446,2430,-16,-182,-198,-0.00654129190515127,-0.0748971193415638,-0.0809484873262469
"5069","2013","울산","북구","초등학교",2013-04-01,"여자",1096,1212,1188,-24,-92,-116,-0.0198019801980198,-0.0774410774410774,-0.0957095709570957
"5070","2013","울산","북구","초등학교",2013-04-01,"남자",1152,1234,1242,8,-90,-82,0.00648298217179903,-0.072463768115942,-0.06645056726094
"5071","2013","울산","울주군","초등학교",2013-04-01,"전체",2145,2127,2133,6,12,18,0.00282087447108604,0.00562587904360056,0.00846262341325811
"5072","2013","울산","울주군","초등학교",2013-04-01,"여자",985,1017,1028,11,-43,-32,0.0108161258603736,-0.0418287937743191,-0.0314650934119961
"5073","2013","울산","울주군","초등학교",2013-04-01,"남자",1160,1110,1105,-5,55,50,-0.0045045045045045,0.0497737556561086,0.045045045045045
"5074","2013","경기","수원시","초등학교",2013-04-01,"전체",11042,10721,10948,227,94,321,0.0211733980039175,0.00858604311289733,0.029941236824923
"5075","2013","경기","수원시","초등학교",2013-04-01,"여자",5411,5188,5288,100,123,223,0.0192752505782575,0.0232602118003026,0.0429838087895143
"5076","2013","경기","수원시","초등학교",2013-04-01,"남자",5631,5533,5660,127,-29,98,0.0229531899512019,-0.00512367491166078,0.0177119103560455
"5077","2013","경기","성남시","초등학교",2013-04-01,"전체",7917,8649,8641,-8,-724,-732,-0.000924962423401549,-0.0837865987732901,-0.0846340617412418
"5078","2013","경기","성남시","초등학교",2013-04-01,"여자",3841,4260,4253,-7,-412,-419,-0.00164319248826291,-0.0968727956736421,-0.0983568075117371
"5079","2013","경기","성남시","초등학교",2013-04-01,"남자",4076,4389,4388,-1,-312,-313,-0.000227842333105491,-0.0711030082041933,-0.0713146502620187
"5080","2013","경기","부천시","초등학교",2013-04-01,"전체",7249,8035,7880,-155,-631,-786,-0.0192906036092097,-0.0800761421319797,-0.0978220286247666
"5081","2013","경기","부천시","초등학교",2013-04-01,"여자",3494,3786,3724,-62,-230,-292,-0.0163761225567882,-0.0617615467239527,-0.0771262546222927
"5082","2013","경기","부천시","초등학교",2013-04-01,"남자",3755,4249,4156,-93,-401,-494,-0.0218875029418687,-0.0964870067372473,-0.116262650035302
"5083","2013","경기","안양시","초등학교",2013-04-01,"전체",5291,5466,5356,-110,-65,-175,-0.0201244054152945,-0.0121359223300971,-0.0320160995243322
"5084","2013","경기","안양시","초등학교",2013-04-01,"여자",2603,2674,2630,-44,-27,-71,-0.0164547494390426,-0.0102661596958175,-0.0265519820493642
"5085","2013","경기","안양시","초등학교",2013-04-01,"남자",2688,2792,2726,-66,-38,-104,-0.0236389684813754,-0.0139398385913426,-0.0372492836676218
"5086","2013","경기","과천시","초등학교",2013-04-01,"전체",590,629,628,-1,-38,-39,-0.00158982511923688,-0.0605095541401274,-0.0620031796502385
"5087","2013","경기","과천시","초등학교",2013-04-01,"여자",259,278,274,-4,-15,-19,-0.0143884892086331,-0.0547445255474453,-0.0683453237410072
"5088","2013","경기","과천시","초등학교",2013-04-01,"남자",331,351,354,3,-23,-20,0.00854700854700855,-0.0649717514124294,-0.056980056980057
"5089","2013","경기","안산시","초등학교",2013-04-01,"전체",6424,6954,6833,-121,-409,-530,-0.0174000575208513,-0.0598565783696766,-0.0762151279838942
"5090","2013","경기","안산시","초등학교",2013-04-01,"여자",3126,3418,3376,-42,-250,-292,-0.0122878876535986,-0.0740521327014218,-0.0854300760678759
"5091","2013","경기","안산시","초등학교",2013-04-01,"남자",3298,3536,3457,-79,-159,-238,-0.022341628959276,-0.0459936361006653,-0.0673076923076923
"5092","2013","경기","용인시","초등학교",2013-04-01,"전체",11055,11778,11928,150,-873,-723,0.0127356087620988,-0.0731891348088531,-0.0613856342333164
"5093","2013","경기","용인시","초등학교",2013-04-01,"여자",5317,5702,5748,46,-431,-385,0.0080673447913013,-0.0749826026443981,-0.0675201683619783
"5094","2013","경기","용인시","초등학교",2013-04-01,"남자",5738,6076,6180,104,-442,-338,0.0171165240289664,-0.0715210355987055,-0.0556287030941409
"5095","2013","경기","군포시","초등학교",2013-04-01,"전체",2838,3177,3077,-100,-239,-339,-0.0314762354422411,-0.0776730581735457,-0.106704438149197
"5096","2013","경기","군포시","초등학교",2013-04-01,"여자",1375,1510,1463,-47,-88,-135,-0.0311258278145695,-0.0601503759398496,-0.0894039735099338
"5097","2013","경기","군포시","초등학교",2013-04-01,"남자",1463,1667,1614,-53,-151,-204,-0.0317936412717457,-0.0935563816604709,-0.122375524895021
"5098","2013","경기","의왕시","초등학교",2013-04-01,"전체",1407,1514,1512,-2,-105,-107,-0.00132100396301189,-0.0694444444444444,-0.0706737120211361
"5099","2013","경기","의왕시","초등학교",2013-04-01,"여자",686,770,757,-13,-71,-84,-0.0168831168831169,-0.0937912813738441,-0.109090909090909
"5100","2013","경기","의왕시","초등학교",2013-04-01,"남자",721,744,755,11,-34,-23,0.0147849462365591,-0.0450331125827815,-0.0309139784946237
"5101","2013","경기","시흥시","초등학교",2013-04-01,"전체",4245,4503,4423,-80,-178,-258,-0.0177659338218965,-0.0402441781596202,-0.0572951365756163
"5102","2013","경기","시흥시","초등학교",2013-04-01,"여자",2123,2239,2175,-64,-52,-116,-0.0285841893702546,-0.0239080459770115,-0.0518088432335864
"5103","2013","경기","시흥시","초등학교",2013-04-01,"남자",2122,2264,2248,-16,-126,-142,-0.00706713780918728,-0.0560498220640569,-0.0627208480565371
"5104","2013","경기","평택시","초등학교",2013-04-01,"전체",4508,4659,4747,88,-239,-151,0.0188881734277742,-0.0503475879502844,-0.0324103884953853
"5105","2013","경기","평택시","초등학교",2013-04-01,"여자",2190,2301,2332,31,-142,-111,0.0134724033029118,-0.0608919382504288,-0.0482398956975228
"5106","2013","경기","평택시","초등학교",2013-04-01,"남자",2318,2358,2415,57,-97,-40,0.0241730279898219,-0.0401656314699793,-0.0169635284139101
"5107","2013","경기","화성시","초등학교",2013-04-01,"전체",7351,7976,7823,-153,-472,-625,-0.0191825476429288,-0.0603349098811198,-0.0783600802407222
"5108","2013","경기","화성시","초등학교",2013-04-01,"여자",3589,3873,3821,-52,-232,-284,-0.013426284533953,-0.0607170897670767,-0.0733281693777433
"5109","2013","경기","화성시","초등학교",2013-04-01,"남자",3762,4103,4002,-101,-240,-341,-0.0246161345357056,-0.0599700149925037,-0.0831099195710456
"5110","2013","경기","오산시","초등학교",2013-04-01,"전체",2583,2700,2792,92,-209,-117,0.0340740740740741,-0.0748567335243553,-0.0433333333333333
"5111","2013","경기","오산시","초등학교",2013-04-01,"여자",1307,1320,1354,34,-47,-13,0.0257575757575758,-0.034711964549483,-0.00984848484848485
"5112","2013","경기","오산시","초등학교",2013-04-01,"남자",1276,1380,1438,58,-162,-104,0.0420289855072464,-0.112656467315716,-0.0753623188405797
"5113","2013","경기","광명시","초등학교",2013-04-01,"전체",3595,3811,3773,-38,-178,-216,-0.00997113618472842,-0.0471773124834349,-0.0566780372605615
"5114","2013","경기","광명시","초등학교",2013-04-01,"여자",1736,1862,1834,-28,-98,-126,-0.0150375939849624,-0.0534351145038168,-0.0676691729323308
"5115","2013","경기","광명시","초등학교",2013-04-01,"남자",1859,1949,1939,-10,-80,-90,-0.00513083632632119,-0.0412583806085611,-0.0461775269368907
"5116","2013","경기","광주시","초등학교",2013-04-01,"전체",2725,2884,2974,90,-249,-159,0.0312066574202497,-0.0837256220578346,-0.0551317614424411
"5117","2013","경기","광주시","초등학교",2013-04-01,"여자",1320,1396,1444,48,-124,-76,0.0343839541547278,-0.0858725761772853,-0.0544412607449857
"5118","2013","경기","광주시","초등학교",2013-04-01,"남자",1405,1488,1530,42,-125,-83,0.0282258064516129,-0.0816993464052288,-0.0557795698924731
"5119","2013","경기","하남시","초등학교",2013-04-01,"전체",1189,1393,1348,-45,-159,-204,-0.0323043790380474,-0.117952522255193,-0.146446518305815
"5120","2013","경기","하남시","초등학교",2013-04-01,"여자",565,661,637,-24,-72,-96,-0.0363086232980333,-0.113029827315542,-0.145234493192133
"5121","2013","경기","하남시","초등학교",2013-04-01,"남자",624,732,711,-21,-87,-108,-0.0286885245901639,-0.122362869198312,-0.147540983606557
"5122","2013","경기","김포시","초등학교",2013-04-01,"전체",3302,2627,2969,342,333,675,0.130186524552722,0.112158976086224,0.256947087933003
"5123","2013","경기","김포시","초등학교",2013-04-01,"여자",1583,1295,1454,159,129,288,0.122779922779923,0.0887207702888583,0.222393822393822
"5124","2013","경기","김포시","초등학교",2013-04-01,"남자",1719,1332,1515,183,204,387,0.137387387387387,0.134653465346535,0.290540540540541
"5125","2013","경기","이천시","초등학교",2013-04-01,"전체",2165,2287,2288,1,-123,-122,0.000437254044599913,-0.0537587412587413,-0.0533449934411893
"5126","2013","경기","이천시","초등학교",2013-04-01,"여자",1023,1090,1104,14,-81,-67,0.0128440366972477,-0.0733695652173913,-0.0614678899082569
"5127","2013","경기","이천시","초등학교",2013-04-01,"남자",1142,1197,1184,-13,-42,-55,-0.0108604845446951,-0.035472972972973,-0.0459482038429407
"5128","2013","경기","안성시","초등학교",2013-04-01,"전체",1813,1938,1932,-6,-119,-125,-0.00309597523219814,-0.0615942028985507,-0.064499484004128
"5129","2013","경기","안성시","초등학교",2013-04-01,"여자",847,921,921,0,-74,-74,0,-0.0803474484256243,-0.0803474484256243
"5130","2013","경기","안성시","초등학교",2013-04-01,"남자",966,1017,1011,-6,-45,-51,-0.00589970501474926,-0.0445103857566766,-0.0501474926253687
"5131","2013","경기","여주군","초등학교",2013-04-01,"전체",891,952,965,13,-74,-61,0.0136554621848739,-0.0766839378238342,-0.0640756302521008
"5132","2013","경기","여주군","초등학교",2013-04-01,"여자",446,477,478,1,-32,-31,0.00209643605870021,-0.0669456066945607,-0.0649895178197065
"5133","2013","경기","여주군","초등학교",2013-04-01,"남자",445,475,487,12,-42,-30,0.0252631578947368,-0.0862422997946612,-0.0631578947368421
"5134","2013","경기","양평군","초등학교",2013-04-01,"전체",776,772,819,47,-43,4,0.060880829015544,-0.0525030525030525,0.00518134715025907
"5135","2013","경기","양평군","초등학교",2013-04-01,"여자",386,374,400,26,-14,12,0.0695187165775401,-0.035,0.0320855614973262
"5136","2013","경기","양평군","초등학교",2013-04-01,"남자",390,398,419,21,-29,-8,0.0527638190954774,-0.0692124105011933,-0.0201005025125628
"5137","2013","경기","고양시","초등학교",2013-04-01,"전체",8587,8987,9081,94,-494,-400,0.0104595526872149,-0.0543992952318027,-0.0445087348392122
"5138","2013","경기","고양시","초등학교",2013-04-01,"여자",4200,4352,4412,60,-212,-152,0.0137867647058824,-0.0480507706255666,-0.0349264705882353
"5139","2013","경기","고양시","초등학교",2013-04-01,"남자",4387,4635,4669,34,-282,-248,0.00733549083063646,-0.0603983722424502,-0.0535059331175836
"5140","2013","경기","남양주시","초등학교",2013-04-01,"전체",6846,7159,7200,41,-354,-313,0.00572705685151557,-0.0491666666666667,-0.0437211901103506
"5141","2013","경기","남양주시","초등학교",2013-04-01,"여자",3302,3444,3457,13,-155,-142,0.0037746806039489,-0.0448365634943593,-0.0412311265969803
"5142","2013","경기","남양주시","초등학교",2013-04-01,"남자",3544,3715,3743,28,-199,-171,0.00753701211305518,-0.0531659096981031,-0.0460296096904441
"5143","2013","경기","구리시","초등학교",2013-04-01,"전체",1736,1933,1895,-38,-159,-197,-0.0196585618210036,-0.0839050131926121,-0.101914123124677
"5144","2013","경기","구리시","초등학교",2013-04-01,"여자",790,954,923,-31,-133,-164,-0.0324947589098532,-0.14409534127844,-0.171907756813417
"5145","2013","경기","구리시","초등학교",2013-04-01,"남자",946,979,972,-7,-26,-33,-0.00715015321756895,-0.0267489711934156,-0.0337078651685393
"5146","2013","경기","의정부시","초등학교",2013-04-01,"전체",3720,4157,4079,-78,-359,-437,-0.0187635313928314,-0.0880117675900956,-0.105123887418812
"5147","2013","경기","의정부시","초등학교",2013-04-01,"여자",1847,2016,2009,-7,-162,-169,-0.00347222222222222,-0.0806371329019413,-0.0838293650793651
"5148","2013","경기","의정부시","초등학교",2013-04-01,"남자",1873,2141,2070,-71,-197,-268,-0.033162073797291,-0.0951690821256039,-0.125175151798225
"5149","2013","경기","파주시","초등학교",2013-04-01,"전체",4441,4237,4501,264,-60,204,0.0623082369601133,-0.0133303710286603,0.048147274014633
"5150","2013","경기","파주시","초등학교",2013-04-01,"여자",2198,2082,2211,129,-13,116,0.0619596541786743,-0.00587969244685663,0.0557156580211335
"5151","2013","경기","파주시","초등학교",2013-04-01,"남자",2243,2155,2290,135,-47,88,0.0626450116009281,-0.0205240174672489,0.0408352668213457
"5152","2013","경기","동두천시","초등학교",2013-04-01,"전체",896,981,984,3,-88,-85,0.00305810397553517,-0.0894308943089431,-0.0866462793068298
"5153","2013","경기","동두천시","초등학교",2013-04-01,"여자",436,465,468,3,-32,-29,0.00645161290322581,-0.0683760683760684,-0.0623655913978495
"5154","2013","경기","동두천시","초등학교",2013-04-01,"남자",460,516,516,0,-56,-56,0,-0.108527131782946,-0.108527131782946
"5155","2013","경기","양주시","초등학교",2013-04-01,"전체",2158,2343,2265,-78,-107,-185,-0.0332906530089629,-0.0472406181015453,-0.0789586000853607
"5156","2013","경기","양주시","초등학교",2013-04-01,"여자",1014,1148,1114,-34,-100,-134,-0.029616724738676,-0.0897666068222621,-0.116724738675958
"5157","2013","경기","양주시","초등학교",2013-04-01,"남자",1144,1195,1151,-44,-7,-51,-0.0368200836820084,-0.00608166811468288,-0.0426778242677824
"5158","2013","경기","포천시","초등학교",2013-04-01,"전체",1322,1396,1390,-6,-68,-74,-0.00429799426934097,-0.0489208633093525,-0.0530085959885387
"5159","2013","경기","포천시","초등학교",2013-04-01,"여자",633,654,648,-6,-15,-21,-0.00917431192660551,-0.0231481481481481,-0.0321100917431193
"5160","2013","경기","포천시","초등학교",2013-04-01,"남자",689,742,742,0,-53,-53,0,-0.0714285714285714,-0.0714285714285714
"5161","2013","경기","가평군","초등학교",2013-04-01,"전체",440,424,434,10,6,16,0.0235849056603774,0.0138248847926267,0.0377358490566038
"5162","2013","경기","가평군","초등학교",2013-04-01,"여자",207,196,205,9,2,11,0.0459183673469388,0.00975609756097561,0.0561224489795918
"5163","2013","경기","가평군","초등학교",2013-04-01,"남자",233,228,229,1,4,5,0.0043859649122807,0.0174672489082969,0.0219298245614035
"5164","2013","경기","연천군","초등학교",2013-04-01,"전체",281,324,302,-22,-21,-43,-0.0679012345679012,-0.0695364238410596,-0.132716049382716
"5165","2013","경기","연천군","초등학교",2013-04-01,"여자",134,149,131,-18,3,-15,-0.120805369127517,0.0229007633587786,-0.100671140939597
"5166","2013","경기","연천군","초등학교",2013-04-01,"남자",147,175,171,-4,-24,-28,-0.0228571428571429,-0.140350877192982,-0.16
"5167","2013","강원","춘천시","초등학교",2013-04-01,"전체",2271,2358,2359,1,-88,-87,0.000424088210347752,-0.0373039423484527,-0.0368956743002544
"5168","2013","강원","춘천시","초등학교",2013-04-01,"여자",1072,1140,1118,-22,-46,-68,-0.0192982456140351,-0.0411449016100179,-0.0596491228070175
"5169","2013","강원","춘천시","초등학교",2013-04-01,"남자",1199,1218,1241,23,-42,-19,0.0188834154351396,-0.0338436744560838,-0.0155993431855501
"5170","2013","강원","원주시","초등학교",2013-04-01,"전체",3061,3053,3090,37,-29,8,0.0121192269898461,-0.00938511326860841,0.00262037340320996
"5171","2013","강원","원주시","초등학교",2013-04-01,"여자",1485,1499,1526,27,-41,-14,0.0180120080053369,-0.026867627785059,-0.00933955970647098
"5172","2013","강원","원주시","초등학교",2013-04-01,"남자",1576,1554,1564,10,12,22,0.00643500643500643,0.00767263427109974,0.0141570141570142
"5173","2013","강원","강릉시","초등학교",2013-04-01,"전체",1704,1722,1733,11,-29,-18,0.00638792102206736,-0.016733987305251,-0.0104529616724739
"5174","2013","강원","강릉시","초등학교",2013-04-01,"여자",781,759,773,14,8,22,0.0184453227931489,0.0103492884864166,0.0289855072463768
"5175","2013","강원","강릉시","초등학교",2013-04-01,"남자",923,963,960,-3,-37,-40,-0.00311526479750779,-0.0385416666666667,-0.0415368639667705
"5176","2013","강원","동해시","초등학교",2013-04-01,"전체",845,806,822,16,23,39,0.0198511166253102,0.0279805352798054,0.0483870967741935
"5177","2013","강원","동해시","초등학교",2013-04-01,"여자",400,397,410,13,-10,3,0.0327455919395466,-0.024390243902439,0.00755667506297229
"5178","2013","강원","동해시","초등학교",2013-04-01,"남자",445,409,412,3,33,36,0.00733496332518337,0.0800970873786408,0.0880195599022005
"5179","2013","강원","태백시","초등학교",2013-04-01,"전체",415,443,436,-7,-21,-28,-0.0158013544018059,-0.0481651376146789,-0.0632054176072235
"5180","2013","강원","태백시","초등학교",2013-04-01,"여자",219,223,220,-3,-1,-4,-0.0134529147982063,-0.00454545454545455,-0.0179372197309417
"5181","2013","강원","태백시","초등학교",2013-04-01,"남자",196,220,216,-4,-20,-24,-0.0181818181818182,-0.0925925925925926,-0.109090909090909
"5182","2013","강원","속초시","초등학교",2013-04-01,"전체",680,701,701,0,-21,-21,0,-0.0299572039942939,-0.0299572039942939
"5183","2013","강원","속초시","초등학교",2013-04-01,"여자",340,334,334,0,6,6,0,0.0179640718562874,0.0179640718562874
"5184","2013","강원","속초시","초등학교",2013-04-01,"남자",340,367,367,0,-27,-27,0,-0.0735694822888283,-0.0735694822888283
"5185","2013","강원","삼척시","초등학교",2013-04-01,"전체",464,514,510,-4,-46,-50,-0.00778210116731518,-0.0901960784313725,-0.0972762645914397
"5186","2013","강원","삼척시","초등학교",2013-04-01,"여자",208,231,232,1,-24,-23,0.00432900432900433,-0.103448275862069,-0.0995670995670996
"5187","2013","강원","삼척시","초등학교",2013-04-01,"남자",256,283,278,-5,-22,-27,-0.0176678445229682,-0.079136690647482,-0.0954063604240283
"5188","2013","강원","홍천군","초등학교",2013-04-01,"전체",456,493,473,-20,-17,-37,-0.0405679513184584,-0.0359408033826638,-0.0750507099391481
"5189","2013","강원","홍천군","초등학교",2013-04-01,"여자",216,224,208,-16,8,-8,-0.0714285714285714,0.0384615384615385,-0.0357142857142857
"5190","2013","강원","홍천군","초등학교",2013-04-01,"남자",240,269,265,-4,-25,-29,-0.0148698884758364,-0.0943396226415094,-0.107806691449814
"5191","2013","강원","횡성군","초등학교",2013-04-01,"전체",292,299,313,14,-21,-7,0.0468227424749164,-0.0670926517571885,-0.0234113712374582
"5192","2013","강원","횡성군","초등학교",2013-04-01,"여자",136,148,152,4,-16,-12,0.027027027027027,-0.105263157894737,-0.0810810810810811
"5193","2013","강원","횡성군","초등학교",2013-04-01,"남자",156,151,161,10,-5,5,0.0662251655629139,-0.031055900621118,0.033112582781457
"5194","2013","강원","영월군","초등학교",2013-04-01,"전체",253,236,255,19,-2,17,0.0805084745762712,-0.00784313725490196,0.0720338983050847
"5195","2013","강원","영월군","초등학교",2013-04-01,"여자",116,114,115,1,1,2,0.0087719298245614,0.00869565217391304,0.0175438596491228
"5196","2013","강원","영월군","초등학교",2013-04-01,"남자",137,122,140,18,-3,15,0.147540983606557,-0.0214285714285714,0.122950819672131
"5197","2013","강원","평창군","초등학교",2013-04-01,"전체",286,283,299,16,-13,3,0.0565371024734982,-0.0434782608695652,0.0106007067137809
"5198","2013","강원","평창군","초등학교",2013-04-01,"여자",140,125,127,2,13,15,0.016,0.102362204724409,0.12
"5199","2013","강원","평창군","초등학교",2013-04-01,"남자",146,158,172,14,-26,-12,0.0886075949367089,-0.151162790697674,-0.0759493670886076
"5200","2013","강원","정선군","초등학교",2013-04-01,"전체",227,246,246,0,-19,-19,0,-0.0772357723577236,-0.0772357723577236
"5201","2013","강원","정선군","초등학교",2013-04-01,"여자",115,122,123,1,-8,-7,0.00819672131147541,-0.0650406504065041,-0.0573770491803279
"5202","2013","강원","정선군","초등학교",2013-04-01,"남자",112,124,123,-1,-11,-12,-0.00806451612903226,-0.0894308943089431,-0.0967741935483871
"5203","2013","강원","철원군","초등학교",2013-04-01,"전체",441,466,458,-8,-17,-25,-0.0171673819742489,-0.037117903930131,-0.0536480686695279
"5204","2013","강원","철원군","초등학교",2013-04-01,"여자",216,215,216,1,0,1,0.00465116279069767,0,0.00465116279069767
"5205","2013","강원","철원군","초등학교",2013-04-01,"남자",225,251,242,-9,-17,-26,-0.0358565737051793,-0.0702479338842975,-0.103585657370518
"5206","2013","강원","화천군","초등학교",2013-04-01,"전체",190,216,218,2,-28,-26,0.00925925925925926,-0.128440366972477,-0.12037037037037
"5207","2013","강원","화천군","초등학교",2013-04-01,"여자",97,110,115,5,-18,-13,0.0454545454545455,-0.156521739130435,-0.118181818181818
"5208","2013","강원","화천군","초등학교",2013-04-01,"남자",93,106,103,-3,-10,-13,-0.0283018867924528,-0.0970873786407767,-0.122641509433962
"5209","2013","강원","양구군","초등학교",2013-04-01,"전체",199,202,207,5,-8,-3,0.0247524752475248,-0.0386473429951691,-0.0148514851485149
"5210","2013","강원","양구군","초등학교",2013-04-01,"여자",89,94,91,-3,-2,-5,-0.0319148936170213,-0.021978021978022,-0.0531914893617021
"5211","2013","강원","양구군","초등학교",2013-04-01,"남자",110,108,116,8,-6,2,0.0740740740740741,-0.0517241379310345,0.0185185185185185
"5212","2013","강원","인제군","초등학교",2013-04-01,"전체",291,323,305,-18,-14,-32,-0.0557275541795666,-0.0459016393442623,-0.0990712074303406
"5213","2013","강원","인제군","초등학교",2013-04-01,"여자",151,159,147,-12,4,-8,-0.0754716981132075,0.0272108843537415,-0.050314465408805
"5214","2013","강원","인제군","초등학교",2013-04-01,"남자",140,164,158,-6,-18,-24,-0.0365853658536585,-0.113924050632911,-0.146341463414634
"5215","2013","강원","고성군","초등학교",2013-04-01,"전체",181,183,183,0,-2,-2,0,-0.0109289617486339,-0.0109289617486339
"5216","2013","강원","고성군","초등학교",2013-04-01,"여자",82,84,86,2,-4,-2,0.0238095238095238,-0.0465116279069767,-0.0238095238095238
"5217","2013","강원","고성군","초등학교",2013-04-01,"남자",99,99,97,-2,2,0,-0.0202020202020202,0.0206185567010309,0
"5218","2013","강원","양양군","초등학교",2013-04-01,"전체",168,194,191,-3,-23,-26,-0.0154639175257732,-0.120418848167539,-0.134020618556701
"5219","2013","강원","양양군","초등학교",2013-04-01,"여자",86,95,90,-5,-4,-9,-0.0526315789473684,-0.0444444444444444,-0.0947368421052632
"5220","2013","강원","양양군","초등학교",2013-04-01,"남자",82,99,101,2,-19,-17,0.0202020202020202,-0.188118811881188,-0.171717171717172
"5221","2013","충북","청주시","초등학교",2013-04-01,"전체",6508,6700,6677,-23,-169,-192,-0.00343283582089552,-0.0253107683091209,-0.0286567164179104
"5222","2013","충북","청주시","초등학교",2013-04-01,"여자",3218,3291,3278,-13,-60,-73,-0.00395016712245518,-0.0183038438071995,-0.0221817076876329
"5223","2013","충북","청주시","초등학교",2013-04-01,"남자",3290,3409,3399,-10,-109,-119,-0.00293341155764154,-0.0320682553692262,-0.0349075975359343
"5224","2013","충북","충주시","초등학교",2013-04-01,"전체",1676,1738,1747,9,-71,-62,0.00517836593785961,-0.0406410990269033,-0.0356731875719217
"5225","2013","충북","충주시","초등학교",2013-04-01,"여자",811,816,810,-6,1,-5,-0.00735294117647059,0.00123456790123457,-0.00612745098039216
"5226","2013","충북","충주시","초등학교",2013-04-01,"남자",865,922,937,15,-72,-57,0.0162689804772234,-0.0768409818569904,-0.061822125813449
"5227","2013","충북","제천시","초등학교",2013-04-01,"전체",1082,1074,1083,9,-1,8,0.00837988826815642,-0.000923361034164358,0.0074487895716946
"5228","2013","충북","제천시","초등학교",2013-04-01,"여자",520,528,535,7,-15,-8,0.0132575757575758,-0.0280373831775701,-0.0151515151515152
"5229","2013","충북","제천시","초등학교",2013-04-01,"남자",562,546,548,2,14,16,0.00366300366300366,0.0255474452554745,0.0293040293040293
"5230","2013","충북","청원군","초등학교",2013-04-01,"전체",1618,1717,1781,64,-163,-99,0.0372743156668608,-0.0915216170690623,-0.0576587070471753
"5231","2013","충북","청원군","초등학교",2013-04-01,"여자",793,848,871,23,-78,-55,0.027122641509434,-0.0895522388059701,-0.0648584905660377
"5232","2013","충북","청원군","초등학교",2013-04-01,"남자",825,869,910,41,-85,-44,0.047180667433832,-0.0934065934065934,-0.0506329113924051
"5233","2013","충북","보은군","초등학교",2013-04-01,"전체",188,188,187,-1,1,0,-0.00531914893617021,0.0053475935828877,0
"5234","2013","충북","보은군","초등학교",2013-04-01,"여자",85,86,83,-3,2,-1,-0.0348837209302326,0.0240963855421687,-0.0116279069767442
"5235","2013","충북","보은군","초등학교",2013-04-01,"남자",103,102,104,2,-1,1,0.0196078431372549,-0.00961538461538462,0.00980392156862745
"5236","2013","충북","옥천군","초등학교",2013-04-01,"전체",374,401,394,-7,-20,-27,-0.0174563591022444,-0.050761421319797,-0.0673316708229426
"5237","2013","충북","옥천군","초등학교",2013-04-01,"여자",176,206,198,-8,-22,-30,-0.0388349514563107,-0.111111111111111,-0.145631067961165
"5238","2013","충북","옥천군","초등학교",2013-04-01,"남자",198,195,196,1,2,3,0.00512820512820513,0.0102040816326531,0.0153846153846154
"5239","2013","충북","영동군","초등학교",2013-04-01,"전체",296,310,326,16,-30,-14,0.0516129032258065,-0.0920245398773006,-0.0451612903225806
"5240","2013","충북","영동군","초등학교",2013-04-01,"여자",146,157,161,4,-15,-11,0.0254777070063694,-0.093167701863354,-0.0700636942675159
"5241","2013","충북","영동군","초등학교",2013-04-01,"남자",150,153,165,12,-15,-3,0.0784313725490196,-0.0909090909090909,-0.0196078431372549
"5242","2013","충북","진천군","초등학교",2013-04-01,"전체",564,600,602,2,-38,-36,0.00333333333333333,-0.0631229235880399,-0.06
"5243","2013","충북","진천군","초등학교",2013-04-01,"여자",264,288,293,5,-29,-24,0.0173611111111111,-0.0989761092150171,-0.0833333333333333
"5244","2013","충북","진천군","초등학교",2013-04-01,"남자",300,312,309,-3,-9,-12,-0.00961538461538462,-0.029126213592233,-0.0384615384615385
"5245","2013","충북","괴산군","초등학교",2013-04-01,"전체",166,163,173,10,-7,3,0.0613496932515337,-0.0404624277456647,0.0184049079754601
"5246","2013","충북","괴산군","초등학교",2013-04-01,"여자",83,88,94,6,-11,-5,0.0681818181818182,-0.117021276595745,-0.0568181818181818
"5247","2013","충북","괴산군","초등학교",2013-04-01,"남자",83,75,79,4,4,8,0.0533333333333333,0.0506329113924051,0.106666666666667
"5248","2013","충북","음성군","초등학교",2013-04-01,"전체",727,792,799,7,-72,-65,0.00883838383838384,-0.0901126408010012,-0.0820707070707071
"5249","2013","충북","음성군","초등학교",2013-04-01,"여자",378,394,404,10,-26,-16,0.0253807106598985,-0.0643564356435644,-0.0406091370558376
"5250","2013","충북","음성군","초등학교",2013-04-01,"남자",349,398,395,-3,-46,-49,-0.00753768844221105,-0.116455696202532,-0.123115577889447
"5251","2013","충북","단양군","초등학교",2013-04-01,"전체",184,204,196,-8,-12,-20,-0.0392156862745098,-0.0612244897959184,-0.0980392156862745
"5252","2013","충북","단양군","초등학교",2013-04-01,"여자",89,104,97,-7,-8,-15,-0.0673076923076923,-0.0824742268041237,-0.144230769230769
"5253","2013","충북","단양군","초등학교",2013-04-01,"남자",95,100,99,-1,-4,-5,-0.01,-0.0404040404040404,-0.05
"5254","2013","충북","증평군","초등학교",2013-04-01,"전체",323,329,335,6,-12,-6,0.0182370820668693,-0.0358208955223881,-0.0182370820668693
"5255","2013","충북","증평군","초등학교",2013-04-01,"여자",151,147,153,6,-2,4,0.0408163265306122,-0.0130718954248366,0.0272108843537415
"5256","2013","충북","증평군","초등학교",2013-04-01,"남자",172,182,182,0,-10,-10,0,-0.0549450549450549,-0.0549450549450549
"5257","2013","충남","천안시","초등학교",2013-04-01,"전체",6104,6226,6274,48,-170,-122,0.00770960488274976,-0.0270959515460631,-0.0195952457436556
"5258","2013","충남","천안시","초등학교",2013-04-01,"여자",2914,3028,3065,37,-151,-114,0.01221928665786,-0.0492659053833605,-0.0376486129458388
"5259","2013","충남","천안시","초등학교",2013-04-01,"남자",3190,3198,3209,11,-19,-8,0.0034396497811132,-0.00592084761607978,-0.00250156347717323
"5260","2013","충남","공주시","초등학교",2013-04-01,"전체",887,918,939,21,-52,-31,0.0228758169934641,-0.0553780617678381,-0.0337690631808279
"5261","2013","충남","공주시","초등학교",2013-04-01,"여자",451,447,462,15,-11,4,0.0335570469798658,-0.0238095238095238,0.00894854586129754
"5262","2013","충남","공주시","초등학교",2013-04-01,"남자",436,471,477,6,-41,-35,0.0127388535031847,-0.0859538784067086,-0.0743099787685775
"5263","2013","충남","보령시","초등학교",2013-04-01,"전체",813,844,842,-2,-29,-31,-0.0023696682464455,-0.0344418052256532,-0.0367298578199052
"5264","2013","충남","보령시","초등학교",2013-04-01,"여자",379,386,384,-2,-5,-7,-0.00518134715025907,-0.0130208333333333,-0.0181347150259067
"5265","2013","충남","보령시","초등학교",2013-04-01,"남자",434,458,458,0,-24,-24,0,-0.0524017467248908,-0.0524017467248908
"5266","2013","충남","아산시","초등학교",2013-04-01,"전체",3235,3425,3426,1,-191,-190,0.000291970802919708,-0.0557501459427904,-0.0554744525547445
"5267","2013","충남","아산시","초등학교",2013-04-01,"여자",1573,1697,1685,-12,-112,-124,-0.00707130229817325,-0.0664688427299703,-0.0730701237477902
"5268","2013","충남","아산시","초등학교",2013-04-01,"남자",1662,1728,1741,13,-79,-66,0.00752314814814815,-0.0453762205628949,-0.0381944444444444
"5269","2013","충남","서산시","초등학교",2013-04-01,"전체",1599,1665,1673,8,-74,-66,0.0048048048048048,-0.0442319187089062,-0.0396396396396396
"5270","2013","충남","서산시","초등학교",2013-04-01,"여자",768,813,812,-1,-44,-45,-0.001230012300123,-0.0541871921182266,-0.0553505535055351
"5271","2013","충남","서산시","초등학교",2013-04-01,"남자",831,852,861,9,-30,-21,0.0105633802816901,-0.0348432055749129,-0.0246478873239437
"5272","2013","충남","논산시","초등학교",2013-04-01,"전체",999,987,1001,14,-2,12,0.0141843971631206,-0.001998001998002,0.0121580547112462
"5273","2013","충남","논산시","초등학교",2013-04-01,"여자",481,469,469,0,12,12,0,0.0255863539445629,0.0255863539445629
"5274","2013","충남","논산시","초등학교",2013-04-01,"남자",518,518,532,14,-14,0,0.027027027027027,-0.0263157894736842,0
"5275","2013","충남","계룡시","초등학교",2013-04-01,"전체",532,549,524,-25,8,-17,-0.0455373406193078,0.0152671755725191,-0.0309653916211293
"5276","2013","충남","계룡시","초등학교",2013-04-01,"여자",257,267,253,-14,4,-10,-0.052434456928839,0.0158102766798419,-0.0374531835205993
"5277","2013","충남","계룡시","초등학교",2013-04-01,"남자",275,282,271,-11,4,-7,-0.0390070921985816,0.014760147601476,-0.024822695035461
"5278","2013","충남","금산군","초등학교",2013-04-01,"전체",377,429,427,-2,-50,-52,-0.00466200466200466,-0.117096018735363,-0.121212121212121
"5279","2013","충남","금산군","초등학교",2013-04-01,"여자",176,209,208,-1,-32,-33,-0.00478468899521531,-0.153846153846154,-0.157894736842105
"5280","2013","충남","금산군","초등학교",2013-04-01,"남자",201,220,219,-1,-18,-19,-0.00454545454545455,-0.0821917808219178,-0.0863636363636364
"5281","2013","충남","부여군","초등학교",2013-04-01,"전체",455,428,438,10,17,27,0.0233644859813084,0.0388127853881279,0.0630841121495327
"5282","2013","충남","부여군","초등학교",2013-04-01,"여자",212,195,194,-1,18,17,-0.00512820512820513,0.0927835051546392,0.0871794871794872
"5283","2013","충남","부여군","초등학교",2013-04-01,"남자",243,233,244,11,-1,10,0.0472103004291846,-0.00409836065573771,0.0429184549356223
"5284","2013","충남","서천군","초등학교",2013-04-01,"전체",310,332,324,-8,-14,-22,-0.0240963855421687,-0.0432098765432099,-0.0662650602409639
"5285","2013","충남","서천군","초등학교",2013-04-01,"여자",150,173,166,-7,-16,-23,-0.0404624277456647,-0.0963855421686747,-0.132947976878613
"5286","2013","충남","서천군","초등학교",2013-04-01,"남자",160,159,158,-1,2,1,-0.00628930817610063,0.0126582278481013,0.00628930817610063
"5287","2013","충남","청양군","초등학교",2013-04-01,"전체",173,184,183,-1,-10,-11,-0.00543478260869565,-0.0546448087431694,-0.0597826086956522
"5288","2013","충남","청양군","초등학교",2013-04-01,"여자",85,92,93,1,-8,-7,0.0108695652173913,-0.0860215053763441,-0.0760869565217391
"5289","2013","충남","청양군","초등학교",2013-04-01,"남자",88,92,90,-2,-2,-4,-0.0217391304347826,-0.0222222222222222,-0.0434782608695652
"5290","2013","충남","홍성군","초등학교",2013-04-01,"전체",716,661,662,1,54,55,0.00151285930408472,0.081570996978852,0.0832072617246596
"5291","2013","충남","홍성군","초등학교",2013-04-01,"여자",338,322,314,-8,24,16,-0.0248447204968944,0.0764331210191083,0.0496894409937888
"5292","2013","충남","홍성군","초등학교",2013-04-01,"남자",378,339,348,9,30,39,0.0265486725663717,0.0862068965517241,0.115044247787611
"5293","2013","충남","예산군","초등학교",2013-04-01,"전체",557,594,603,9,-46,-37,0.0151515151515152,-0.0762852404643449,-0.0622895622895623
"5294","2013","충남","예산군","초등학교",2013-04-01,"여자",286,283,285,2,1,3,0.00706713780918728,0.00350877192982456,0.0106007067137809
"5295","2013","충남","예산군","초등학교",2013-04-01,"남자",271,311,318,7,-47,-40,0.022508038585209,-0.147798742138365,-0.128617363344051
"5296","2013","충남","태안군","초등학교",2013-04-01,"전체",429,442,437,-5,-8,-13,-0.0113122171945701,-0.0183066361556064,-0.0294117647058824
"5297","2013","충남","태안군","초등학교",2013-04-01,"여자",217,218,219,1,-2,-1,0.00458715596330275,-0.0091324200913242,-0.00458715596330275
"5298","2013","충남","태안군","초등학교",2013-04-01,"남자",212,224,218,-6,-6,-12,-0.0267857142857143,-0.0275229357798165,-0.0535714285714286
"5299","2013","전북","전주시","초등학교",2013-04-01,"전체",5965,6169,6256,87,-291,-204,0.0141027719241368,-0.0465153452685422,-0.0330685686497001
"5300","2013","전북","전주시","초등학교",2013-04-01,"여자",2867,2913,2972,59,-105,-46,0.0202540336422932,-0.0353297442799462,-0.0157912804668726
"5301","2013","전북","전주시","초등학교",2013-04-01,"남자",3098,3256,3284,28,-186,-158,0.0085995085995086,-0.0566382460414129,-0.0485257985257985
"5302","2013","전북","군산시","초등학교",2013-04-01,"전체",2525,2609,2644,35,-119,-84,0.0134151015714833,-0.0450075642965204,-0.03219624377156
"5303","2013","전북","군산시","초등학교",2013-04-01,"여자",1223,1280,1309,29,-86,-57,0.02265625,-0.0656990068754775,-0.04453125
"5304","2013","전북","군산시","초등학교",2013-04-01,"남자",1302,1329,1335,6,-33,-27,0.00451467268623025,-0.0247191011235955,-0.0203160270880361
"5305","2013","전북","익산시","초등학교",2013-04-01,"전체",2643,2697,2713,16,-70,-54,0.00593251761216166,-0.0258016955399926,-0.0200222469410456
"5306","2013","전북","익산시","초등학교",2013-04-01,"여자",1314,1334,1351,17,-37,-20,0.012743628185907,-0.0273871206513694,-0.0149925037481259
"5307","2013","전북","익산시","초등학교",2013-04-01,"남자",1329,1363,1362,-1,-33,-34,-0.000733675715333822,-0.0242290748898678,-0.02494497432135
"5308","2013","전북","정읍시","초등학교",2013-04-01,"전체",855,936,930,-6,-75,-81,-0.00641025641025641,-0.0806451612903226,-0.0865384615384615
"5309","2013","전북","정읍시","초등학교",2013-04-01,"여자",402,469,466,-3,-64,-67,-0.00639658848614072,-0.137339055793991,-0.142857142857143
"5310","2013","전북","정읍시","초등학교",2013-04-01,"남자",453,467,464,-3,-11,-14,-0.00642398286937901,-0.0237068965517241,-0.0299785867237687
"5311","2013","전북","남원시","초등학교",2013-04-01,"전체",697,731,743,12,-46,-34,0.0164158686730506,-0.0619111709286676,-0.0465116279069767
"5312","2013","전북","남원시","초등학교",2013-04-01,"여자",343,367,376,9,-33,-24,0.0245231607629428,-0.0877659574468085,-0.0653950953678474
"5313","2013","전북","남원시","초등학교",2013-04-01,"남자",354,364,367,3,-13,-10,0.00824175824175824,-0.0354223433242507,-0.0274725274725275
"5314","2013","전북","김제시","초등학교",2013-04-01,"전체",645,629,641,12,4,16,0.0190779014308426,0.0062402496099844,0.0254372019077901
"5315","2013","전북","김제시","초등학교",2013-04-01,"여자",298,300,303,3,-5,-2,0.01,-0.0165016501650165,-0.00666666666666667
"5316","2013","전북","김제시","초등학교",2013-04-01,"남자",347,329,338,9,9,18,0.027355623100304,0.0266272189349112,0.0547112462006079
"5317","2013","전북","완주군","초등학교",2013-04-01,"전체",871,881,874,-7,-3,-10,-0.00794551645856981,-0.0034324942791762,-0.0113507377979569
"5318","2013","전북","완주군","초등학교",2013-04-01,"여자",427,435,422,-13,5,-8,-0.0298850574712644,0.0118483412322275,-0.0183908045977011
"5319","2013","전북","완주군","초등학교",2013-04-01,"남자",444,446,452,6,-8,-2,0.0134529147982063,-0.0176991150442478,-0.00448430493273543
"5320","2013","전북","진안군","초등학교",2013-04-01,"전체",169,171,179,8,-10,-2,0.0467836257309941,-0.0558659217877095,-0.0116959064327485
"5321","2013","전북","진안군","초등학교",2013-04-01,"여자",81,77,84,7,-3,4,0.0909090909090909,-0.0357142857142857,0.051948051948052
"5322","2013","전북","진안군","초등학교",2013-04-01,"남자",88,94,95,1,-7,-6,0.0106382978723404,-0.0736842105263158,-0.0638297872340425
"5323","2013","전북","무주군","초등학교",2013-04-01,"전체",170,196,193,-3,-23,-26,-0.0153061224489796,-0.119170984455959,-0.13265306122449
"5324","2013","전북","무주군","초등학교",2013-04-01,"여자",81,101,97,-4,-16,-20,-0.0396039603960396,-0.164948453608247,-0.198019801980198
"5325","2013","전북","무주군","초등학교",2013-04-01,"남자",89,95,96,1,-7,-6,0.0105263157894737,-0.0729166666666667,-0.0631578947368421
"5326","2013","전북","장수군","초등학교",2013-04-01,"전체",134,155,152,-3,-18,-21,-0.0193548387096774,-0.118421052631579,-0.135483870967742
"5327","2013","전북","장수군","초등학교",2013-04-01,"여자",63,80,77,-3,-14,-17,-0.0375,-0.181818181818182,-0.2125
"5328","2013","전북","장수군","초등학교",2013-04-01,"남자",71,75,75,0,-4,-4,0,-0.0533333333333333,-0.0533333333333333
"5329","2013","전북","임실군","초등학교",2013-04-01,"전체",166,189,188,-1,-22,-23,-0.00529100529100529,-0.117021276595745,-0.121693121693122
"5330","2013","전북","임실군","초등학교",2013-04-01,"여자",84,86,83,-3,1,-2,-0.0348837209302326,0.0120481927710843,-0.0232558139534884
"5331","2013","전북","임실군","초등학교",2013-04-01,"남자",82,103,105,2,-23,-21,0.0194174757281553,-0.219047619047619,-0.203883495145631
"5332","2013","전북","순창군","초등학교",2013-04-01,"전체",177,199,195,-4,-18,-22,-0.0201005025125628,-0.0923076923076923,-0.110552763819095
"5333","2013","전북","순창군","초등학교",2013-04-01,"여자",81,93,92,-1,-11,-12,-0.010752688172043,-0.119565217391304,-0.129032258064516
"5334","2013","전북","순창군","초등학교",2013-04-01,"남자",96,106,103,-3,-7,-10,-0.0283018867924528,-0.0679611650485437,-0.0943396226415094
"5335","2013","전북","고창군","초등학교",2013-04-01,"전체",335,339,334,-5,1,-4,-0.0147492625368732,0.0029940119760479,-0.0117994100294985
"5336","2013","전북","고창군","초등학교",2013-04-01,"여자",159,148,144,-4,15,11,-0.027027027027027,0.104166666666667,0.0743243243243243
"5337","2013","전북","고창군","초등학교",2013-04-01,"남자",176,191,190,-1,-14,-15,-0.00523560209424084,-0.0736842105263158,-0.0785340314136126
"5338","2013","전북","부안군","초등학교",2013-04-01,"전체",313,322,312,-10,1,-9,-0.031055900621118,0.00320512820512821,-0.0279503105590062
"5339","2013","전북","부안군","초등학교",2013-04-01,"여자",147,146,145,-1,2,1,-0.00684931506849315,0.0137931034482759,0.00684931506849315
"5340","2013","전북","부안군","초등학교",2013-04-01,"남자",166,176,167,-9,-1,-10,-0.0511363636363636,-0.00598802395209581,-0.0568181818181818
"5341","2013","전남","목포시","초등학교",2013-04-01,"전체",2638,2539,2538,-1,100,99,-0.000393855848759354,0.0394011032308905,0.0389917290271761
"5342","2013","전남","목포시","초등학교",2013-04-01,"여자",1288,1221,1213,-8,75,67,-0.00655200655200655,0.0618301731244848,0.0548730548730549
"5343","2013","전남","목포시","초등학교",2013-04-01,"남자",1350,1318,1325,7,25,32,0.00531107738998483,0.0188679245283019,0.0242792109256449
"5344","2013","전남","여수시","초등학교",2013-04-01,"전체",2482,2556,2600,44,-118,-74,0.0172143974960876,-0.0453846153846154,-0.0289514866979656
"5345","2013","전남","여수시","초등학교",2013-04-01,"여자",1206,1240,1252,12,-46,-34,0.00967741935483871,-0.036741214057508,-0.0274193548387097
"5346","2013","전남","여수시","초등학교",2013-04-01,"남자",1276,1316,1348,32,-72,-40,0.0243161094224924,-0.0534124629080119,-0.0303951367781155
"5347","2013","전남","순천시","초등학교",2013-04-01,"전체",2593,2560,2603,43,-10,33,0.016796875,-0.00384172109104879,0.012890625
"5348","2013","전남","순천시","초등학교",2013-04-01,"여자",1279,1244,1280,36,-1,35,0.0289389067524116,-0.00078125,0.0281350482315113
"5349","2013","전남","순천시","초등학교",2013-04-01,"남자",1314,1316,1323,7,-9,-2,0.00531914893617021,-0.00680272108843537,-0.00151975683890578
"5350","2013","전남","나주시","초등학교",2013-04-01,"전체",552,567,571,4,-19,-15,0.00705467372134039,-0.0332749562171629,-0.0264550264550265
"5351","2013","전남","나주시","초등학교",2013-04-01,"여자",262,271,263,-8,-1,-9,-0.029520295202952,-0.00380228136882129,-0.033210332103321
"5352","2013","전남","나주시","초등학교",2013-04-01,"남자",290,296,308,12,-18,-6,0.0405405405405405,-0.0584415584415584,-0.0202702702702703
"5353","2013","전남","광양시","초등학교",2013-04-01,"전체",1462,1472,1508,36,-46,-10,0.0244565217391304,-0.0305039787798408,-0.00679347826086957
"5354","2013","전남","광양시","초등학교",2013-04-01,"여자",732,727,737,10,-5,5,0.0137551581843191,-0.0067842605156038,0.00687757909215956
"5355","2013","전남","광양시","초등학교",2013-04-01,"남자",730,745,771,26,-41,-15,0.0348993288590604,-0.053177691309987,-0.0201342281879195
"5356","2013","전남","담양군","초등학교",2013-04-01,"전체",212,271,255,-16,-43,-59,-0.0590405904059041,-0.168627450980392,-0.217712177121771
"5357","2013","전남","담양군","초등학교",2013-04-01,"여자",99,122,117,-5,-18,-23,-0.040983606557377,-0.153846153846154,-0.188524590163934
"5358","2013","전남","담양군","초등학교",2013-04-01,"남자",113,149,138,-11,-25,-36,-0.0738255033557047,-0.181159420289855,-0.241610738255034
"5359","2013","전남","곡성군","초등학교",2013-04-01,"전체",177,204,193,-11,-16,-27,-0.053921568627451,-0.0829015544041451,-0.132352941176471
"5360","2013","전남","곡성군","초등학교",2013-04-01,"여자",75,92,89,-3,-14,-17,-0.0326086956521739,-0.157303370786517,-0.184782608695652
"5361","2013","전남","곡성군","초등학교",2013-04-01,"남자",102,112,104,-8,-2,-10,-0.0714285714285714,-0.0192307692307692,-0.0892857142857143
"5362","2013","전남","구례군","초등학교",2013-04-01,"전체",162,180,182,2,-20,-18,0.0111111111111111,-0.10989010989011,-0.1
"5363","2013","전남","구례군","초등학교",2013-04-01,"여자",79,84,85,1,-6,-5,0.0119047619047619,-0.0705882352941176,-0.0595238095238095
"5364","2013","전남","구례군","초등학교",2013-04-01,"남자",83,96,97,1,-14,-13,0.0104166666666667,-0.144329896907216,-0.135416666666667
"5365","2013","전남","고흥군","초등학교",2013-04-01,"전체",350,383,365,-18,-15,-33,-0.0469973890339426,-0.0410958904109589,-0.0861618798955614
"5366","2013","전남","고흥군","초등학교",2013-04-01,"여자",171,189,183,-6,-12,-18,-0.0317460317460317,-0.0655737704918033,-0.0952380952380952
"5367","2013","전남","고흥군","초등학교",2013-04-01,"남자",179,194,182,-12,-3,-15,-0.0618556701030928,-0.0164835164835165,-0.077319587628866
"5368","2013","전남","보성군","초등학교",2013-04-01,"전체",252,344,309,-35,-57,-92,-0.101744186046512,-0.184466019417476,-0.267441860465116
"5369","2013","전남","보성군","초등학교",2013-04-01,"여자",116,168,139,-29,-23,-52,-0.172619047619048,-0.165467625899281,-0.30952380952381
"5370","2013","전남","보성군","초등학교",2013-04-01,"남자",136,176,170,-6,-34,-40,-0.0340909090909091,-0.2,-0.227272727272727
"5371","2013","전남","화순군","초등학교",2013-04-01,"전체",513,597,568,-29,-55,-84,-0.0485762144053601,-0.096830985915493,-0.14070351758794
"5372","2013","전남","화순군","초등학교",2013-04-01,"여자",244,282,268,-14,-24,-38,-0.049645390070922,-0.0895522388059701,-0.134751773049645
"5373","2013","전남","화순군","초등학교",2013-04-01,"남자",269,315,300,-15,-31,-46,-0.0476190476190476,-0.103333333333333,-0.146031746031746
"5374","2013","전남","장흥군","초등학교",2013-04-01,"전체",246,258,253,-5,-7,-12,-0.0193798449612403,-0.0276679841897233,-0.0465116279069767
"5375","2013","전남","장흥군","초등학교",2013-04-01,"여자",99,117,114,-3,-15,-18,-0.0256410256410256,-0.131578947368421,-0.153846153846154
"5376","2013","전남","장흥군","초등학교",2013-04-01,"남자",147,141,139,-2,8,6,-0.0141843971631206,0.0575539568345324,0.0425531914893617
"5377","2013","전남","강진군","초등학교",2013-04-01,"전체",223,313,299,-14,-76,-90,-0.0447284345047923,-0.254180602006689,-0.287539936102236
"5378","2013","전남","강진군","초등학교",2013-04-01,"여자",106,170,156,-14,-50,-64,-0.0823529411764706,-0.320512820512821,-0.376470588235294
"5379","2013","전남","강진군","초등학교",2013-04-01,"남자",117,143,143,0,-26,-26,0,-0.181818181818182,-0.181818181818182
"5380","2013","전남","해남군","초등학교",2013-04-01,"전체",495,497,506,9,-11,-2,0.0181086519114688,-0.0217391304347826,-0.00402414486921529
"5381","2013","전남","해남군","초등학교",2013-04-01,"여자",240,238,242,4,-2,2,0.0168067226890756,-0.00826446280991736,0.00840336134453781
"5382","2013","전남","해남군","초등학교",2013-04-01,"남자",255,259,264,5,-9,-4,0.0193050193050193,-0.0340909090909091,-0.0154440154440154
"5383","2013","전남","영암군","초등학교",2013-04-01,"전체",471,539,525,-14,-54,-68,-0.025974025974026,-0.102857142857143,-0.126159554730983
"5384","2013","전남","영암군","초등학교",2013-04-01,"여자",219,259,248,-11,-29,-40,-0.0424710424710425,-0.116935483870968,-0.154440154440154
"5385","2013","전남","영암군","초등학교",2013-04-01,"남자",252,280,277,-3,-25,-28,-0.0107142857142857,-0.0902527075812274,-0.1
"5386","2013","전남","무안군","초등학교",2013-04-01,"전체",577,658,686,28,-109,-81,0.0425531914893617,-0.158892128279883,-0.123100303951368
"5387","2013","전남","무안군","초등학교",2013-04-01,"여자",284,336,345,9,-61,-52,0.0267857142857143,-0.176811594202899,-0.154761904761905
"5388","2013","전남","무안군","초등학교",2013-04-01,"남자",293,322,341,19,-48,-29,0.0590062111801242,-0.140762463343109,-0.0900621118012422
"5389","2013","전남","함평군","초등학교",2013-04-01,"전체",165,215,208,-7,-43,-50,-0.0325581395348837,-0.206730769230769,-0.232558139534884
"5390","2013","전남","함평군","초등학교",2013-04-01,"여자",88,107,102,-5,-14,-19,-0.0467289719626168,-0.137254901960784,-0.177570093457944
"5391","2013","전남","함평군","초등학교",2013-04-01,"남자",77,108,106,-2,-29,-31,-0.0185185185185185,-0.273584905660377,-0.287037037037037
"5392","2013","전남","영광군","초등학교",2013-04-01,"전체",373,404,400,-4,-27,-31,-0.0099009900990099,-0.0675,-0.0767326732673267
"5393","2013","전남","영광군","초등학교",2013-04-01,"여자",190,201,196,-5,-6,-11,-0.0248756218905473,-0.0306122448979592,-0.054726368159204
"5394","2013","전남","영광군","초등학교",2013-04-01,"남자",183,203,204,1,-21,-20,0.00492610837438424,-0.102941176470588,-0.0985221674876847
"5395","2013","전남","장성군","초등학교",2013-04-01,"전체",343,335,335,0,8,8,0,0.0238805970149254,0.0238805970149254
"5396","2013","전남","장성군","초등학교",2013-04-01,"여자",168,158,156,-2,12,10,-0.0126582278481013,0.0769230769230769,0.0632911392405063
"5397","2013","전남","장성군","초등학교",2013-04-01,"남자",175,177,179,2,-4,-2,0.0112994350282486,-0.0223463687150838,-0.0112994350282486
"5398","2013","전남","완도군","초등학교",2013-04-01,"전체",369,367,373,6,-4,2,0.0163487738419619,-0.0107238605898123,0.00544959128065395
"5399","2013","전남","완도군","초등학교",2013-04-01,"여자",169,169,167,-2,2,0,-0.0118343195266272,0.0119760479041916,0
"5400","2013","전남","완도군","초등학교",2013-04-01,"남자",200,198,206,8,-6,2,0.0404040404040404,-0.029126213592233,0.0101010101010101
"5401","2013","전남","진도군","초등학교",2013-04-01,"전체",201,250,250,0,-49,-49,0,-0.196,-0.196
"5402","2013","전남","진도군","초등학교",2013-04-01,"여자",90,110,110,0,-20,-20,0,-0.181818181818182,-0.181818181818182
"5403","2013","전남","진도군","초등학교",2013-04-01,"남자",111,140,140,0,-29,-29,0,-0.207142857142857,-0.207142857142857
"5404","2013","전남","신안군","초등학교",2013-04-01,"전체",145,206,196,-10,-51,-61,-0.0485436893203883,-0.260204081632653,-0.296116504854369
"5405","2013","전남","신안군","초등학교",2013-04-01,"여자",83,108,102,-6,-19,-25,-0.0555555555555556,-0.186274509803922,-0.231481481481481
"5406","2013","전남","신안군","초등학교",2013-04-01,"남자",62,98,94,-4,-32,-36,-0.0408163265306122,-0.340425531914894,-0.36734693877551
"5407","2013","경북","포항시","초등학교",2013-04-01,"전체",4337,4375,4440,65,-103,-38,0.0148571428571429,-0.0231981981981982,-0.00868571428571429
"5408","2013","경북","포항시","초등학교",2013-04-01,"여자",2066,2118,2156,38,-90,-52,0.0179414542020774,-0.0417439703153989,-0.0245514636449481
"5409","2013","경북","포항시","초등학교",2013-04-01,"남자",2271,2257,2284,27,-13,14,0.0119627824545857,-0.00569176882661997,0.00620292423571112
"5410","2013","경북","경주시","초등학교",2013-04-01,"전체",2046,2188,2173,-15,-127,-142,-0.00685557586837294,-0.058444546709618,-0.0648994515539305
"5411","2013","경북","경주시","초등학교",2013-04-01,"여자",985,1088,1073,-15,-88,-103,-0.0137867647058824,-0.0820130475302889,-0.0946691176470588
"5412","2013","경북","경주시","초등학교",2013-04-01,"남자",1061,1100,1100,0,-39,-39,0,-0.0354545454545455,-0.0354545454545455
"5413","2013","경북","김천시","초등학교",2013-04-01,"전체",884,988,979,-9,-95,-104,-0.00910931174089069,-0.0970377936670072,-0.105263157894737
"5414","2013","경북","김천시","초등학교",2013-04-01,"여자",381,438,427,-11,-46,-57,-0.0251141552511416,-0.107728337236534,-0.13013698630137
"5415","2013","경북","김천시","초등학교",2013-04-01,"남자",503,550,552,2,-49,-47,0.00363636363636364,-0.088768115942029,-0.0854545454545454
"5416","2013","경북","안동시","초등학교",2013-04-01,"전체",1244,1314,1292,-22,-48,-70,-0.0167427701674277,-0.0371517027863777,-0.0532724505327245
"5417","2013","경북","안동시","초등학교",2013-04-01,"여자",609,637,628,-9,-19,-28,-0.0141287284144427,-0.0302547770700637,-0.043956043956044
"5418","2013","경북","안동시","초등학교",2013-04-01,"남자",635,677,664,-13,-29,-42,-0.0192023633677991,-0.0436746987951807,-0.0620384047267356
"5419","2013","경북","구미시","초등학교",2013-04-01,"전체",4506,4636,4615,-21,-109,-130,-0.0045297670405522,-0.0236186348862405,-0.0280414150129422
"5420","2013","경북","구미시","초등학교",2013-04-01,"여자",2160,2188,2180,-8,-20,-28,-0.0036563071297989,-0.00917431192660551,-0.0127970749542962
"5421","2013","경북","구미시","초등학교",2013-04-01,"남자",2346,2448,2435,-13,-89,-102,-0.00531045751633987,-0.0365503080082136,-0.0416666666666667
"5422","2013","경북","영주시","초등학교",2013-04-01,"전체",826,822,812,-10,14,4,-0.0121654501216545,0.0172413793103448,0.0048661800486618
"5423","2013","경북","영주시","초등학교",2013-04-01,"여자",386,404,397,-7,-11,-18,-0.0173267326732673,-0.0277078085642317,-0.0445544554455446
"5424","2013","경북","영주시","초등학교",2013-04-01,"남자",440,418,415,-3,25,22,-0.00717703349282297,0.0602409638554217,0.0526315789473684
"5425","2013","경북","영천시","초등학교",2013-04-01,"전체",568,685,667,-18,-99,-117,-0.0262773722627737,-0.148425787106447,-0.170802919708029
"5426","2013","경북","영천시","초등학교",2013-04-01,"여자",276,337,332,-5,-56,-61,-0.0148367952522255,-0.168674698795181,-0.181008902077151
"5427","2013","경북","영천시","초등학교",2013-04-01,"남자",292,348,335,-13,-43,-56,-0.0373563218390805,-0.128358208955224,-0.160919540229885
"5428","2013","경북","상주시","초등학교",2013-04-01,"전체",619,654,655,1,-36,-35,0.00152905198776758,-0.0549618320610687,-0.0535168195718654
"5429","2013","경북","상주시","초등학교",2013-04-01,"여자",288,309,303,-6,-15,-21,-0.0194174757281553,-0.0495049504950495,-0.0679611650485437
"5430","2013","경북","상주시","초등학교",2013-04-01,"남자",331,345,352,7,-21,-14,0.0202898550724638,-0.0596590909090909,-0.0405797101449275
"5431","2013","경북","문경시","초등학교",2013-04-01,"전체",464,469,481,12,-17,-5,0.0255863539445629,-0.0353430353430353,-0.0106609808102345
"5432","2013","경북","문경시","초등학교",2013-04-01,"여자",207,213,220,7,-13,-6,0.0328638497652582,-0.0590909090909091,-0.028169014084507
"5433","2013","경북","문경시","초등학교",2013-04-01,"남자",257,256,261,5,-4,1,0.01953125,-0.0153256704980843,0.00390625
"5434","2013","경북","경산시","초등학교",2013-04-01,"전체",2128,2275,2227,-48,-99,-147,-0.0210989010989011,-0.0444544229905703,-0.0646153846153846
"5435","2013","경북","경산시","초등학교",2013-04-01,"여자",989,1062,1041,-21,-52,-73,-0.019774011299435,-0.0499519692603266,-0.0687382297551789
"5436","2013","경북","경산시","초등학교",2013-04-01,"남자",1139,1213,1186,-27,-47,-74,-0.0222588623248145,-0.0396290050590219,-0.0610057708161583
"5437","2013","경북","군위군","초등학교",2013-04-01,"전체",77,103,96,-7,-19,-26,-0.0679611650485437,-0.197916666666667,-0.252427184466019
"5438","2013","경북","군위군","초등학교",2013-04-01,"여자",40,53,48,-5,-8,-13,-0.0943396226415094,-0.166666666666667,-0.245283018867925
"5439","2013","경북","군위군","초등학교",2013-04-01,"남자",37,50,48,-2,-11,-13,-0.04,-0.229166666666667,-0.26
"5440","2013","경북","의성군","초등학교",2013-04-01,"전체",217,225,226,1,-9,-8,0.00444444444444444,-0.0398230088495575,-0.0355555555555556
"5441","2013","경북","의성군","초등학교",2013-04-01,"여자",107,125,125,0,-18,-18,0,-0.144,-0.144
"5442","2013","경북","의성군","초등학교",2013-04-01,"남자",110,100,101,1,9,10,0.01,0.0891089108910891,0.1
"5443","2013","경북","청송군","초등학교",2013-04-01,"전체",118,124,121,-3,-3,-6,-0.0241935483870968,-0.0247933884297521,-0.0483870967741935
"5444","2013","경북","청송군","초등학교",2013-04-01,"여자",60,64,62,-2,-2,-4,-0.03125,-0.032258064516129,-0.0625
"5445","2013","경북","청송군","초등학교",2013-04-01,"남자",58,60,59,-1,-1,-2,-0.0166666666666667,-0.0169491525423729,-0.0333333333333333
"5446","2013","경북","영양군","초등학교",2013-04-01,"전체",87,94,105,11,-18,-7,0.117021276595745,-0.171428571428571,-0.074468085106383
"5447","2013","경북","영양군","초등학교",2013-04-01,"여자",42,45,50,5,-8,-3,0.111111111111111,-0.16,-0.0666666666666667
"5448","2013","경북","영양군","초등학교",2013-04-01,"남자",45,49,55,6,-10,-4,0.122448979591837,-0.181818181818182,-0.0816326530612245
"5449","2013","경북","영덕군","초등학교",2013-04-01,"전체",205,230,227,-3,-22,-25,-0.0130434782608696,-0.0969162995594714,-0.108695652173913
"5450","2013","경북","영덕군","초등학교",2013-04-01,"여자",106,106,101,-5,5,0,-0.0471698113207547,0.0495049504950495,0
"5451","2013","경북","영덕군","초등학교",2013-04-01,"남자",99,124,126,2,-27,-25,0.0161290322580645,-0.214285714285714,-0.201612903225806
"5452","2013","경북","청도군","초등학교",2013-04-01,"전체",184,206,207,1,-23,-22,0.00485436893203883,-0.111111111111111,-0.106796116504854
"5453","2013","경북","청도군","초등학교",2013-04-01,"여자",86,111,111,0,-25,-25,0,-0.225225225225225,-0.225225225225225
"5454","2013","경북","청도군","초등학교",2013-04-01,"남자",98,95,96,1,2,3,0.0105263157894737,0.0208333333333333,0.0315789473684211
"5455","2013","경북","고령군","초등학교",2013-04-01,"전체",230,249,252,3,-22,-19,0.0120481927710843,-0.0873015873015873,-0.0763052208835341
"5456","2013","경북","고령군","초등학교",2013-04-01,"여자",118,118,115,-3,3,0,-0.0254237288135593,0.0260869565217391,0
"5457","2013","경북","고령군","초등학교",2013-04-01,"남자",112,131,137,6,-25,-19,0.0458015267175573,-0.182481751824818,-0.145038167938931
"5458","2013","경북","성주군","초등학교",2013-04-01,"전체",207,212,209,-3,-2,-5,-0.0141509433962264,-0.00956937799043062,-0.0235849056603774
"5459","2013","경북","성주군","초등학교",2013-04-01,"여자",89,95,89,-6,0,-6,-0.0631578947368421,0,-0.0631578947368421
"5460","2013","경북","성주군","초등학교",2013-04-01,"남자",118,117,120,3,-2,1,0.0256410256410256,-0.0166666666666667,0.00854700854700855
"5461","2013","경북","칠곡군","초등학교",2013-04-01,"전체",1214,1405,1340,-65,-126,-191,-0.0462633451957295,-0.0940298507462687,-0.135943060498221
"5462","2013","경북","칠곡군","초등학교",2013-04-01,"여자",581,675,636,-39,-55,-94,-0.0577777777777778,-0.0864779874213836,-0.139259259259259
"5463","2013","경북","칠곡군","초등학교",2013-04-01,"남자",633,730,704,-26,-71,-97,-0.0356164383561644,-0.100852272727273,-0.132876712328767
"5464","2013","경북","예천군","초등학교",2013-04-01,"전체",253,271,271,0,-18,-18,0,-0.0664206642066421,-0.0664206642066421
"5465","2013","경북","예천군","초등학교",2013-04-01,"여자",114,126,127,1,-13,-12,0.00793650793650794,-0.102362204724409,-0.0952380952380952
"5466","2013","경북","예천군","초등학교",2013-04-01,"남자",139,145,144,-1,-5,-6,-0.00689655172413793,-0.0347222222222222,-0.0413793103448276
"5467","2013","경북","봉화군","초등학교",2013-04-01,"전체",171,184,192,8,-21,-13,0.0434782608695652,-0.109375,-0.0706521739130435
"5468","2013","경북","봉화군","초등학교",2013-04-01,"여자",83,92,98,6,-15,-9,0.0652173913043478,-0.153061224489796,-0.0978260869565217
"5469","2013","경북","봉화군","초등학교",2013-04-01,"남자",88,92,94,2,-6,-4,0.0217391304347826,-0.0638297872340425,-0.0434782608695652
"5470","2013","경북","울진군","초등학교",2013-04-01,"전체",362,407,398,-9,-36,-45,-0.0221130221130221,-0.0904522613065327,-0.110565110565111
"5471","2013","경북","울진군","초등학교",2013-04-01,"여자",166,177,175,-2,-9,-11,-0.0112994350282486,-0.0514285714285714,-0.0621468926553672
"5472","2013","경북","울진군","초등학교",2013-04-01,"남자",196,230,223,-7,-27,-34,-0.0304347826086957,-0.121076233183857,-0.147826086956522
"5473","2013","경북","울릉군","초등학교",2013-04-01,"전체",51,65,67,2,-16,-14,0.0307692307692308,-0.238805970149254,-0.215384615384615
"5474","2013","경북","울릉군","초등학교",2013-04-01,"여자",26,30,34,4,-8,-4,0.133333333333333,-0.235294117647059,-0.133333333333333
"5475","2013","경북","울릉군","초등학교",2013-04-01,"남자",25,35,33,-2,-8,-10,-0.0571428571428571,-0.242424242424242,-0.285714285714286
"5476","2013","경남","진주시","초등학교",2013-04-01,"전체",3054,2967,3034,67,20,87,0.0225817323896191,0.00659195781147001,0.0293225480283114
"5477","2013","경남","진주시","초등학교",2013-04-01,"여자",1460,1417,1444,27,16,43,0.0190543401552576,0.0110803324099723,0.0303458009880028
"5478","2013","경남","진주시","초등학교",2013-04-01,"남자",1594,1550,1590,40,4,44,0.0258064516129032,0.00251572327044025,0.0283870967741936
"5479","2013","경남","통영시","초등학교",2013-04-01,"전체",1254,1311,1296,-15,-42,-57,-0.011441647597254,-0.0324074074074074,-0.0434782608695652
"5480","2013","경남","통영시","초등학교",2013-04-01,"여자",617,626,620,-6,-3,-9,-0.00958466453674121,-0.00483870967741936,-0.0143769968051118
"5481","2013","경남","통영시","초등학교",2013-04-01,"남자",637,685,676,-9,-39,-48,-0.0131386861313869,-0.0576923076923077,-0.0700729927007299
"5482","2013","경남","사천시","초등학교",2013-04-01,"전체",1065,1081,1085,4,-20,-16,0.00370027752081406,-0.0184331797235023,-0.0148011100832562
"5483","2013","경남","사천시","초등학교",2013-04-01,"여자",510,532,530,-2,-20,-22,-0.0037593984962406,-0.0377358490566038,-0.0413533834586466
"5484","2013","경남","사천시","초등학교",2013-04-01,"남자",555,549,555,6,0,6,0.0109289617486339,0,0.0109289617486339
"5485","2013","경남","김해시","초등학교",2013-04-01,"전체",5830,6015,5978,-37,-148,-185,-0.00615128844555278,-0.024757443961191,-0.0307564422277639
"5486","2013","경남","김해시","초등학교",2013-04-01,"여자",2815,2944,2927,-17,-112,-129,-0.00577445652173913,-0.0382644345746498,-0.0438179347826087
"5487","2013","경남","김해시","초등학교",2013-04-01,"남자",3015,3071,3051,-20,-36,-56,-0.00651253663301856,-0.0117994100294985,-0.018235102572452
"5488","2013","경남","밀양시","초등학교",2013-04-01,"전체",667,702,684,-18,-17,-35,-0.0256410256410256,-0.0248538011695906,-0.0498575498575499
"5489","2013","경남","밀양시","초등학교",2013-04-01,"여자",323,338,326,-12,-3,-15,-0.0355029585798817,-0.00920245398773006,-0.0443786982248521
"5490","2013","경남","밀양시","초등학교",2013-04-01,"남자",344,364,358,-6,-14,-20,-0.0164835164835165,-0.0391061452513966,-0.0549450549450549
"5491","2013","경남","거제시","초등학교",2013-04-01,"전체",2643,2763,2735,-28,-92,-120,-0.0101339124140427,-0.0336380255941499,-0.0434310532030402
"5492","2013","경남","거제시","초등학교",2013-04-01,"여자",1294,1314,1307,-7,-13,-20,-0.00532724505327245,-0.00994644223412395,-0.015220700152207
"5493","2013","경남","거제시","초등학교",2013-04-01,"남자",1349,1449,1428,-21,-79,-100,-0.0144927536231884,-0.0553221288515406,-0.0690131124913734
"5494","2013","경남","양산시","초등학교",2013-04-01,"전체",2741,2843,2846,3,-105,-102,0.00105522335561027,-0.0368938861560084,-0.0358775940907492
"5495","2013","경남","양산시","초등학교",2013-04-01,"여자",1347,1377,1368,-9,-21,-30,-0.0065359477124183,-0.0153508771929825,-0.0217864923747277
"5496","2013","경남","양산시","초등학교",2013-04-01,"남자",1394,1466,1478,12,-84,-72,0.00818553888130969,-0.0568335588633288,-0.0491132332878581
"5497","2013","경남","의령군","초등학교",2013-04-01,"전체",129,148,143,-5,-14,-19,-0.0337837837837838,-0.0979020979020979,-0.128378378378378
"5498","2013","경남","의령군","초등학교",2013-04-01,"여자",63,74,74,0,-11,-11,0,-0.148648648648649,-0.148648648648649
"5499","2013","경남","의령군","초등학교",2013-04-01,"남자",66,74,69,-5,-3,-8,-0.0675675675675676,-0.0434782608695652,-0.108108108108108
"5500","2013","경남","함안군","초등학교",2013-04-01,"전체",547,616,600,-16,-53,-69,-0.025974025974026,-0.0883333333333333,-0.112012987012987
"5501","2013","경남","함안군","초등학교",2013-04-01,"여자",254,307,302,-5,-48,-53,-0.0162866449511401,-0.158940397350993,-0.172638436482085
"5502","2013","경남","함안군","초등학교",2013-04-01,"남자",293,309,298,-11,-5,-16,-0.0355987055016181,-0.0167785234899329,-0.0517799352750809
"5503","2013","경남","창녕군","초등학교",2013-04-01,"전체",369,326,356,30,13,43,0.0920245398773006,0.0365168539325843,0.131901840490798
"5504","2013","경남","창녕군","초등학교",2013-04-01,"여자",172,154,174,20,-2,18,0.12987012987013,-0.0114942528735632,0.116883116883117
"5505","2013","경남","창녕군","초등학교",2013-04-01,"남자",197,172,182,10,15,25,0.0581395348837209,0.0824175824175824,0.145348837209302
"5506","2013","경남","고성군","초등학교",2013-04-01,"전체",374,368,391,23,-17,6,0.0625,-0.0434782608695652,0.016304347826087
"5507","2013","경남","고성군","초등학교",2013-04-01,"여자",181,171,173,2,8,10,0.0116959064327485,0.046242774566474,0.0584795321637427
"5508","2013","경남","고성군","초등학교",2013-04-01,"남자",193,197,218,21,-25,-4,0.106598984771574,-0.114678899082569,-0.0203045685279188
"5509","2013","경남","남해군","초등학교",2013-04-01,"전체",218,234,234,0,-16,-16,0,-0.0683760683760684,-0.0683760683760684
"5510","2013","경남","남해군","초등학교",2013-04-01,"여자",98,110,114,4,-16,-12,0.0363636363636364,-0.140350877192982,-0.109090909090909
"5511","2013","경남","남해군","초등학교",2013-04-01,"남자",120,124,120,-4,0,-4,-0.032258064516129,0,-0.032258064516129
"5512","2013","경남","하동군","초등학교",2013-04-01,"전체",261,313,300,-13,-39,-52,-0.0415335463258786,-0.13,-0.166134185303514
"5513","2013","경남","하동군","초등학교",2013-04-01,"여자",131,160,152,-8,-21,-29,-0.05,-0.138157894736842,-0.18125
"5514","2013","경남","하동군","초등학교",2013-04-01,"남자",130,153,148,-5,-18,-23,-0.0326797385620915,-0.121621621621622,-0.150326797385621
"5515","2013","경남","산청군","초등학교",2013-04-01,"전체",181,225,208,-17,-27,-44,-0.0755555555555556,-0.129807692307692,-0.195555555555556
"5516","2013","경남","산청군","초등학교",2013-04-01,"여자",89,110,103,-7,-14,-21,-0.0636363636363636,-0.135922330097087,-0.190909090909091
"5517","2013","경남","산청군","초등학교",2013-04-01,"남자",92,115,105,-10,-13,-23,-0.0869565217391304,-0.123809523809524,-0.2
"5518","2013","경남","함양군","초등학교",2013-04-01,"전체",283,288,284,-4,-1,-5,-0.0138888888888889,-0.00352112676056338,-0.0173611111111111
"5519","2013","경남","함양군","초등학교",2013-04-01,"여자",134,134,131,-3,3,0,-0.0223880597014925,0.0229007633587786,0
"5520","2013","경남","함양군","초등학교",2013-04-01,"남자",149,154,153,-1,-4,-5,-0.00649350649350649,-0.0261437908496732,-0.0324675324675325
"5521","2013","경남","거창군","초등학교",2013-04-01,"전체",428,469,479,10,-51,-41,0.0213219616204691,-0.106471816283925,-0.0874200426439232
"5522","2013","경남","거창군","초등학교",2013-04-01,"여자",212,225,227,2,-15,-13,0.00888888888888889,-0.066079295154185,-0.0577777777777778
"5523","2013","경남","거창군","초등학교",2013-04-01,"남자",216,244,252,8,-36,-28,0.0327868852459016,-0.142857142857143,-0.114754098360656
"5524","2013","경남","합천군","초등학교",2013-04-01,"전체",205,280,273,-7,-68,-75,-0.025,-0.249084249084249,-0.267857142857143
"5525","2013","경남","합천군","초등학교",2013-04-01,"여자",98,132,127,-5,-29,-34,-0.0378787878787879,-0.228346456692913,-0.257575757575758
"5526","2013","경남","합천군","초등학교",2013-04-01,"남자",107,148,146,-2,-39,-41,-0.0135135135135135,-0.267123287671233,-0.277027027027027
"5527","2013","제주","제주시","초등학교",2013-04-01,"전체",4623,4592,4678,86,-55,31,0.0187282229965157,-0.0117571611799914,0.00675087108013937
"5528","2013","제주","제주시","초등학교",2013-04-01,"여자",2220,2218,2253,35,-33,2,0.0157799819657349,-0.014647137150466,0.000901713255184851
"5529","2013","제주","제주시","초등학교",2013-04-01,"남자",2403,2374,2425,51,-22,29,0.0214827295703454,-0.00907216494845361,0.0122156697556866
"5530","2013","제주","서귀포시","초등학교",2013-04-01,"전체",1314,1452,1447,-5,-133,-138,-0.0034435261707989,-0.0919143054595715,-0.0950413223140496
"5531","2013","제주","서귀포시","초등학교",2013-04-01,"여자",611,678,687,9,-76,-67,0.0132743362831858,-0.110625909752547,-0.0988200589970502
"5532","2013","제주","서귀포시","초등학교",2013-04-01,"남자",703,774,760,-14,-57,-71,-0.0180878552971576,-0.075,-0.0917312661498708
"5533","2014","서울","종로구","초등학교",2014-04-01,"전체",1009,1085,1069,-16,-60,-76,-0.0147465437788018,-0.0561272217025257,-0.0700460829493088
"5534","2014","서울","종로구","초등학교",2014-04-01,"여자",489,513,512,-1,-23,-24,-0.00194931773879142,-0.044921875,-0.0467836257309941
"5535","2014","서울","종로구","초등학교",2014-04-01,"남자",520,572,557,-15,-37,-52,-0.0262237762237762,-0.066427289048474,-0.0909090909090909
"5536","2014","서울","중구","초등학교",2014-04-01,"전체",1089,1112,1031,-81,58,-23,-0.072841726618705,0.0562560620756547,-0.0206834532374101
"5537","2014","서울","중구","초등학교",2014-04-01,"여자",558,549,519,-30,39,9,-0.0546448087431694,0.0751445086705202,0.0163934426229508
"5538","2014","서울","중구","초등학교",2014-04-01,"남자",531,563,512,-51,19,-32,-0.0905861456483126,0.037109375,-0.0568383658969805
"5539","2014","서울","용산구","초등학교",2014-04-01,"전체",1593,1977,1925,-52,-332,-384,-0.026302478502782,-0.172467532467532,-0.194233687405159
"5540","2014","서울","용산구","초등학교",2014-04-01,"여자",816,996,978,-18,-162,-180,-0.0180722891566265,-0.165644171779141,-0.180722891566265
"5541","2014","서울","용산구","초등학교",2014-04-01,"남자",777,981,947,-34,-170,-204,-0.0346585117227319,-0.179514255543823,-0.207951070336391
"5542","2014","서울","성동구","초등학교",2014-04-01,"전체",2396,2720,2659,-61,-263,-324,-0.0224264705882353,-0.0989093644227153,-0.119117647058824
"5543","2014","서울","성동구","초등학교",2014-04-01,"여자",1210,1325,1300,-25,-90,-115,-0.0188679245283019,-0.0692307692307692,-0.0867924528301887
"5544","2014","서울","성동구","초등학교",2014-04-01,"남자",1186,1395,1359,-36,-173,-209,-0.0258064516129032,-0.127299484915379,-0.149820788530466
"5545","2014","서울","광진구","초등학교",2014-04-01,"전체",2817,2968,2920,-48,-103,-151,-0.0161725067385445,-0.0352739726027397,-0.0508760107816712
"5546","2014","서울","광진구","초등학교",2014-04-01,"여자",1401,1402,1386,-16,15,-1,-0.0114122681883024,0.0108225108225108,-0.000713266761768902
"5547","2014","서울","광진구","초등학교",2014-04-01,"남자",1416,1566,1534,-32,-118,-150,-0.0204342273307791,-0.0769230769230769,-0.0957854406130268
"5548","2014","서울","동대문구","초등학교",2014-04-01,"전체",2693,2974,2878,-96,-185,-281,-0.0322797579018157,-0.0642807505211953,-0.0944855413584398
"5549","2014","서울","동대문구","초등학교",2014-04-01,"여자",1263,1408,1357,-51,-94,-145,-0.0362215909090909,-0.0692704495210022,-0.102982954545455
"5550","2014","서울","동대문구","초등학교",2014-04-01,"남자",1430,1566,1521,-45,-91,-136,-0.028735632183908,-0.0598290598290598,-0.086845466155811
"5551","2014","서울","중랑구","초등학교",2014-04-01,"전체",2883,3287,3163,-124,-280,-404,-0.0377243687252814,-0.0885235535883655,-0.122908427137207
"5552","2014","서울","중랑구","초등학교",2014-04-01,"여자",1402,1619,1543,-76,-141,-217,-0.0469425571340334,-0.0913804277381724,-0.134033353922174
"5553","2014","서울","중랑구","초등학교",2014-04-01,"남자",1481,1668,1620,-48,-139,-187,-0.0287769784172662,-0.0858024691358025,-0.1121103117506
"5554","2014","서울","성북구","초등학교",2014-04-01,"전체",4256,4487,4361,-126,-105,-231,-0.0280811232449298,-0.0240770465489567,-0.0514820592823713
"5555","2014","서울","성북구","초등학교",2014-04-01,"여자",2085,2188,2105,-83,-20,-103,-0.0379341864716636,-0.00950118764845606,-0.0470749542961609
"5556","2014","서울","성북구","초등학교",2014-04-01,"남자",2171,2299,2256,-43,-85,-128,-0.0187037842540235,-0.037677304964539,-0.0556763810352327
"5557","2014","서울","강북구","초등학교",2014-04-01,"전체",2041,2660,2575,-85,-534,-619,-0.0319548872180451,-0.207378640776699,-0.232706766917293
"5558","2014","서울","강북구","초등학교",2014-04-01,"여자",979,1278,1234,-44,-255,-299,-0.0344287949921753,-0.206645056726094,-0.2339593114241
"5559","2014","서울","강북구","초등학교",2014-04-01,"남자",1062,1382,1341,-41,-279,-320,-0.0296671490593343,-0.208053691275168,-0.231548480463097
"5560","2014","서울","도봉구","초등학교",2014-04-01,"전체",3151,2909,2889,-20,262,242,-0.00687521485046408,0.0906888196607823,0.0831900996906153
"5561","2014","서울","도봉구","초등학교",2014-04-01,"여자",1532,1366,1347,-19,185,166,-0.013909224011713,0.137342242019302,0.121522693997072
"5562","2014","서울","도봉구","초등학교",2014-04-01,"남자",1619,1543,1542,-1,77,76,-0.000648088139987038,0.049935149156939,0.0492546986390149
"5563","2014","서울","노원구","초등학교",2014-04-01,"전체",5183,5271,5201,-70,-18,-88,-0.0132802124833997,-0.00346087290905595,-0.0166951242648454
"5564","2014","서울","노원구","초등학교",2014-04-01,"여자",2519,2525,2493,-32,26,-6,-0.0126732673267327,0.0104292017649418,-0.00237623762376238
"5565","2014","서울","노원구","초등학교",2014-04-01,"남자",2664,2746,2708,-38,-44,-82,-0.0138383102694829,-0.0162481536189069,-0.0298616168973052
"5566","2014","서울","은평구","초등학교",2014-04-01,"전체",4359,4509,4487,-22,-128,-150,-0.00487913062763362,-0.0285268553599287,-0.0332667997338656
"5567","2014","서울","은평구","초등학교",2014-04-01,"여자",2089,2177,2163,-14,-74,-88,-0.00643086816720257,-0.034211742949607,-0.0404225999081305
"5568","2014","서울","은평구","초등학교",2014-04-01,"남자",2270,2332,2324,-8,-54,-62,-0.00343053173241852,-0.0232358003442341,-0.0265866209262436
"5569","2014","서울","서대문구","초등학교",2014-04-01,"전체",2204,2344,2326,-18,-122,-140,-0.00767918088737201,-0.0524505588993981,-0.0597269624573379
"5570","2014","서울","서대문구","초등학교",2014-04-01,"여자",1102,1133,1129,-4,-27,-31,-0.00353045013239188,-0.0239149689991143,-0.0273609885260371
"5571","2014","서울","서대문구","초등학교",2014-04-01,"남자",1102,1211,1197,-14,-95,-109,-0.0115606936416185,-0.0793650793650794,-0.0900082576383154
"5572","2014","서울","마포구","초등학교",2014-04-01,"전체",3100,3594,3489,-105,-389,-494,-0.0292153589315526,-0.111493264545715,-0.137451307735114
"5573","2014","서울","마포구","초등학교",2014-04-01,"여자",1517,1732,1671,-61,-154,-215,-0.0352193995381062,-0.0921603830041891,-0.124133949191686
"5574","2014","서울","마포구","초등학교",2014-04-01,"남자",1583,1862,1818,-44,-235,-279,-0.0236305048335124,-0.129262926292629,-0.14983888292159
"5575","2014","서울","양천구","초등학교",2014-04-01,"전체",4100,4275,4362,87,-262,-175,0.0203508771929825,-0.0600641907381935,-0.0409356725146199
"5576","2014","서울","양천구","초등학교",2014-04-01,"여자",1989,2038,2067,29,-78,-49,0.0142296368989205,-0.0377358490566038,-0.0240431795878312
"5577","2014","서울","양천구","초등학교",2014-04-01,"남자",2111,2237,2295,58,-184,-126,0.0259275815824765,-0.0801742919389978,-0.0563254358515869
"5578","2014","서울","강서구","초등학교",2014-04-01,"전체",4807,5253,5118,-135,-311,-446,-0.0256996002284409,-0.0607659241891364,-0.0849038644584047
"5579","2014","서울","강서구","초등학교",2014-04-01,"여자",2365,2565,2530,-35,-165,-200,-0.01364522417154,-0.0652173913043478,-0.0779727095516569
"5580","2014","서울","강서구","초등학교",2014-04-01,"남자",2442,2688,2588,-100,-146,-246,-0.037202380952381,-0.0564142194744977,-0.0915178571428571
"5581","2014","서울","구로구","초등학교",2014-04-01,"전체",3665,4229,4085,-144,-420,-564,-0.0340506029794278,-0.10281517747858,-0.133364861669425
"5582","2014","서울","구로구","초등학교",2014-04-01,"여자",1798,2068,1984,-84,-186,-270,-0.0406189555125725,-0.09375,-0.130560928433269
"5583","2014","서울","구로구","초등학교",2014-04-01,"남자",1867,2161,2101,-60,-234,-294,-0.02776492364646,-0.111375535459305,-0.136048125867654
"5584","2014","서울","금천구","초등학교",2014-04-01,"전체",1715,1849,1752,-97,-37,-134,-0.0524607896160087,-0.0211187214611872,-0.0724716062736614
"5585","2014","서울","금천구","초등학교",2014-04-01,"여자",855,931,878,-53,-23,-76,-0.0569280343716434,-0.0261958997722096,-0.0816326530612245
"5586","2014","서울","금천구","초등학교",2014-04-01,"남자",860,918,874,-44,-14,-58,-0.0479302832244009,-0.0160183066361556,-0.0631808278867102
"5587","2014","서울","영등포구","초등학교",2014-04-01,"전체",2848,3631,3398,-233,-550,-783,-0.0641696502340953,-0.161859917598587,-0.215643073533462
"5588","2014","서울","영등포구","초등학교",2014-04-01,"여자",1350,1738,1621,-117,-271,-388,-0.0673187571921749,-0.167180752621838,-0.223245109321059
"5589","2014","서울","영등포구","초등학교",2014-04-01,"남자",1498,1893,1777,-116,-279,-395,-0.0612783940834654,-0.157006190208216,-0.208663497094559
"5590","2014","서울","동작구","초등학교",2014-04-01,"전체",3176,3387,3337,-50,-161,-211,-0.0147623265426631,-0.0482469283787833,-0.0622970180100384
"5591","2014","서울","동작구","초등학교",2014-04-01,"여자",1458,1607,1566,-41,-108,-149,-0.0255133789670193,-0.0689655172413793,-0.0927193528313628
"5592","2014","서울","동작구","초등학교",2014-04-01,"남자",1718,1780,1771,-9,-53,-62,-0.0050561797752809,-0.0299265951439864,-0.0348314606741573
"5593","2014","서울","관악구","초등학교",2014-04-01,"전체",3225,3989,3802,-187,-577,-764,-0.04687891702181,-0.15176223040505,-0.191526698420657
"5594","2014","서울","관악구","초등학교",2014-04-01,"여자",1602,1985,1898,-87,-296,-383,-0.0438287153652393,-0.15595363540569,-0.192947103274559
"5595","2014","서울","관악구","초등학교",2014-04-01,"남자",1623,2004,1904,-100,-281,-381,-0.0499001996007984,-0.147584033613445,-0.190119760479042
"5596","2014","서울","서초구","초등학교",2014-04-01,"전체",3840,3952,4150,198,-310,-112,0.0501012145748988,-0.0746987951807229,-0.0283400809716599
"5597","2014","서울","서초구","초등학교",2014-04-01,"여자",1858,1913,2015,102,-157,-55,0.0533193936225823,-0.0779156327543424,-0.0287506534239415
"5598","2014","서울","서초구","초등학교",2014-04-01,"남자",1982,2039,2135,96,-153,-57,0.0470819028935753,-0.0716627634660422,-0.0279548798430603
"5599","2014","서울","강남구","초등학교",2014-04-01,"전체",3846,4332,4375,43,-529,-486,0.00992613111726685,-0.120914285714286,-0.11218836565097
"5600","2014","서울","강남구","초등학교",2014-04-01,"여자",1843,2145,2159,14,-316,-302,0.00652680652680653,-0.146364057433997,-0.140792540792541
"5601","2014","서울","강남구","초등학교",2014-04-01,"남자",2003,2187,2216,29,-213,-184,0.0132601737540009,-0.0961191335740072,-0.0841335162322817
"5602","2014","서울","송파구","초등학교",2014-04-01,"전체",5697,6043,5965,-78,-268,-346,-0.0129074962766838,-0.0449287510477787,-0.0572563296375972
"5603","2014","서울","송파구","초등학교",2014-04-01,"여자",2755,2919,2907,-12,-152,-164,-0.00411099691675231,-0.0522875816993464,-0.0561836245289483
"5604","2014","서울","송파구","초등학교",2014-04-01,"남자",2942,3124,3058,-66,-116,-182,-0.0211267605633803,-0.0379332897318509,-0.058258642765685
"5605","2014","서울","강동구","초등학교",2014-04-01,"전체",3845,4356,4223,-133,-378,-511,-0.0305325987144169,-0.0895098271371063,-0.117309458218549
"5606","2014","서울","강동구","초등학교",2014-04-01,"여자",1813,2017,1964,-53,-151,-204,-0.0262766484878532,-0.0768839103869654,-0.101140307387209
"5607","2014","서울","강동구","초등학교",2014-04-01,"남자",2032,2339,2259,-80,-227,-307,-0.0342026507054297,-0.100486941124391,-0.131252672082086
"5608","2014","부산","중구","초등학교",2014-04-01,"전체",280,266,271,5,9,14,0.018796992481203,0.033210332103321,0.0526315789473684
"5609","2014","부산","중구","초등학교",2014-04-01,"여자",145,145,147,2,-2,0,0.0137931034482759,-0.0136054421768707,0
"5610","2014","부산","중구","초등학교",2014-04-01,"남자",135,121,124,3,11,14,0.0247933884297521,0.0887096774193548,0.115702479338843
"5611","2014","부산","서구","초등학교",2014-04-01,"전체",688,698,667,-31,21,-10,-0.0444126074498567,0.0314842578710645,-0.0143266475644699
"5612","2014","부산","서구","초등학교",2014-04-01,"여자",334,345,322,-23,12,-11,-0.0666666666666667,0.0372670807453416,-0.0318840579710145
"5613","2014","부산","서구","초등학교",2014-04-01,"남자",354,353,345,-8,9,1,-0.0226628895184136,0.0260869565217391,0.0028328611898017
"5614","2014","부산","동구","초등학교",2014-04-01,"전체",507,594,569,-25,-62,-87,-0.0420875420875421,-0.10896309314587,-0.146464646464646
"5615","2014","부산","동구","초등학교",2014-04-01,"여자",251,294,275,-19,-24,-43,-0.0646258503401361,-0.0872727272727273,-0.146258503401361
"5616","2014","부산","동구","초등학교",2014-04-01,"남자",256,300,294,-6,-38,-44,-0.02,-0.129251700680272,-0.146666666666667
"5617","2014","부산","영도구","초등학교",2014-04-01,"전체",776,867,848,-19,-72,-91,-0.0219146482122261,-0.0849056603773585,-0.104959630911188
"5618","2014","부산","영도구","초등학교",2014-04-01,"여자",372,437,429,-8,-57,-65,-0.0183066361556064,-0.132867132867133,-0.148741418764302
"5619","2014","부산","영도구","초등학교",2014-04-01,"남자",404,430,419,-11,-15,-26,-0.0255813953488372,-0.035799522673031,-0.0604651162790698
"5620","2014","부산","부산진구","초등학교",2014-04-01,"전체",2900,2955,2910,-45,-10,-55,-0.0152284263959391,-0.00343642611683849,-0.0186125211505922
"5621","2014","부산","부산진구","초등학교",2014-04-01,"여자",1446,1458,1438,-20,8,-12,-0.0137174211248285,0.00556328233657858,-0.00823045267489712
"5622","2014","부산","부산진구","초등학교",2014-04-01,"남자",1454,1497,1472,-25,-18,-43,-0.0167000668002672,-0.0122282608695652,-0.0287241148964596
"5623","2014","부산","동래구","초등학교",2014-04-01,"전체",2140,2143,2127,-16,13,-3,-0.00746616892207186,0.00611189468735308,-0.00139990667288847
"5624","2014","부산","동래구","초등학교",2014-04-01,"여자",1001,993,1005,12,-4,8,0.0120845921450151,-0.00398009950248756,0.0080563947633434
"5625","2014","부산","동래구","초등학교",2014-04-01,"남자",1139,1150,1122,-28,17,-11,-0.0243478260869565,0.0151515151515152,-0.00956521739130435
"5626","2014","부산","남구","초등학교",2014-04-01,"전체",2222,2332,2305,-27,-83,-110,-0.0115780445969125,-0.0360086767895878,-0.0471698113207547
"5627","2014","부산","남구","초등학교",2014-04-01,"여자",1039,1121,1100,-21,-61,-82,-0.0187332738626227,-0.0554545454545455,-0.0731489741302409
"5628","2014","부산","남구","초등학교",2014-04-01,"남자",1183,1211,1205,-6,-22,-28,-0.00495458298926507,-0.0182572614107884,-0.023121387283237
"5629","2014","부산","북구","초등학교",2014-04-01,"전체",2304,2385,2470,85,-166,-81,0.0356394129979036,-0.0672064777327935,-0.0339622641509434
"5630","2014","부산","북구","초등학교",2014-04-01,"여자",1120,1178,1226,48,-106,-58,0.0407470288624788,-0.0864600326264274,-0.0492359932088285
"5631","2014","부산","북구","초등학교",2014-04-01,"남자",1184,1207,1244,37,-60,-23,0.0306545153272577,-0.0482315112540193,-0.0190555095277548
"5632","2014","부산","해운대구","초등학교",2014-04-01,"전체",3694,3897,3965,68,-271,-203,0.0174493199897357,-0.0683480453972257,-0.0520913523222992
"5633","2014","부산","해운대구","초등학교",2014-04-01,"여자",1820,1938,1964,26,-144,-118,0.0134158926728586,-0.0733197556008147,-0.0608875128998968
"5634","2014","부산","해운대구","초등학교",2014-04-01,"남자",1874,1959,2001,42,-127,-85,0.0214395099540582,-0.0634682658670665,-0.0433894844308321
"5635","2014","부산","사하구","초등학교",2014-04-01,"전체",2714,2992,2951,-41,-237,-278,-0.0137032085561497,-0.0803117587258556,-0.0929144385026738
"5636","2014","부산","사하구","초등학교",2014-04-01,"여자",1294,1447,1434,-13,-140,-153,-0.00898410504492052,-0.097629009762901,-0.10573600552868
"5637","2014","부산","사하구","초등학교",2014-04-01,"남자",1420,1545,1517,-28,-97,-125,-0.0181229773462783,-0.0639419907712591,-0.0809061488673139
"5638","2014","부산","금정구","초등학교",2014-04-01,"전체",1782,1675,1780,105,2,107,0.0626865671641791,0.00112359550561798,0.0638805970149254
"5639","2014","부산","금정구","초등학교",2014-04-01,"여자",859,810,846,36,13,49,0.0444444444444444,0.0153664302600473,0.0604938271604938
"5640","2014","부산","금정구","초등학교",2014-04-01,"남자",923,865,934,69,-11,58,0.0797687861271676,-0.0117773019271949,0.0670520231213873
"5641","2014","부산","강서구","초등학교",2014-04-01,"전체",692,648,661,13,31,44,0.0200617283950617,0.0468986384266263,0.0679012345679012
"5642","2014","부산","강서구","초등학교",2014-04-01,"여자",336,314,321,7,15,22,0.0222929936305732,0.0467289719626168,0.0700636942675159
"5643","2014","부산","강서구","초등학교",2014-04-01,"남자",356,334,340,6,16,22,0.0179640718562874,0.0470588235294118,0.0658682634730539
"5644","2014","부산","연제구","초등학교",2014-04-01,"전체",1657,1751,1702,-49,-45,-94,-0.0279840091376356,-0.0264394829612221,-0.0536836093660765
"5645","2014","부산","연제구","초등학교",2014-04-01,"여자",775,848,824,-24,-49,-73,-0.0283018867924528,-0.0594660194174757,-0.0860849056603774
"5646","2014","부산","연제구","초등학교",2014-04-01,"남자",882,903,878,-25,4,-21,-0.0276854928017719,0.00455580865603645,-0.0232558139534884
"5647","2014","부산","수영구","초등학교",2014-04-01,"전체",1098,1283,1262,-21,-164,-185,-0.0163678877630553,-0.129952456418384,-0.144193296960249
"5648","2014","부산","수영구","초등학교",2014-04-01,"여자",548,637,636,-1,-88,-89,-0.00156985871271586,-0.138364779874214,-0.139717425431711
"5649","2014","부산","수영구","초등학교",2014-04-01,"남자",550,646,626,-20,-76,-96,-0.0309597523219814,-0.121405750798722,-0.148606811145511
"5650","2014","부산","사상구","초등학교",2014-04-01,"전체",1660,1963,1902,-61,-242,-303,-0.0310748853795211,-0.127234490010515,-0.154355578196638
"5651","2014","부산","사상구","초등학교",2014-04-01,"여자",783,936,912,-24,-129,-153,-0.0256410256410256,-0.141447368421053,-0.163461538461538
"5652","2014","부산","사상구","초등학교",2014-04-01,"남자",877,1027,990,-37,-113,-150,-0.0360272638753651,-0.114141414141414,-0.146056475170399
"5653","2014","부산","기장군","초등학교",2014-04-01,"전체",1702,1265,1454,189,248,437,0.149407114624506,0.170563961485557,0.345454545454545
"5654","2014","부산","기장군","초등학교",2014-04-01,"여자",814,618,704,86,110,196,0.13915857605178,0.15625,0.317152103559871
"5655","2014","부산","기장군","초등학교",2014-04-01,"남자",888,647,750,103,138,241,0.15919629057187,0.184,0.372488408037094
"5656","2014","대구","중구","초등학교",2014-04-01,"전체",735,499,486,-13,249,236,-0.0260521042084168,0.512345679012346,0.472945891783567
"5657","2014","대구","중구","초등학교",2014-04-01,"여자",344,215,216,1,128,129,0.00465116279069767,0.592592592592593,0.6
"5658","2014","대구","중구","초등학교",2014-04-01,"남자",391,284,270,-14,121,107,-0.0492957746478873,0.448148148148148,0.376760563380282
"5659","2014","대구","동구","초등학교",2014-04-01,"전체",3072,3069,3071,2,1,3,0.00065167807103291,0.000325626831650928,0.000977517106549365
"5660","2014","대구","동구","초등학교",2014-04-01,"여자",1548,1521,1530,9,18,27,0.00591715976331361,0.0117647058823529,0.0177514792899408
"5661","2014","대구","동구","초등학교",2014-04-01,"남자",1524,1548,1541,-7,-17,-24,-0.00452196382428941,-0.0110317975340688,-0.0155038759689922
"5662","2014","대구","서구","초등학교",2014-04-01,"전체",1204,1378,1336,-42,-132,-174,-0.0304789550072569,-0.0988023952095808,-0.126269956458636
"5663","2014","대구","서구","초등학교",2014-04-01,"여자",604,664,644,-20,-40,-60,-0.0301204819277108,-0.062111801242236,-0.0903614457831325
"5664","2014","대구","서구","초등학교",2014-04-01,"남자",600,714,692,-22,-92,-114,-0.030812324929972,-0.132947976878613,-0.159663865546218
"5665","2014","대구","남구","초등학교",2014-04-01,"전체",938,1087,1098,11,-160,-149,0.0101195952161914,-0.145719489981785,-0.137074517019319
"5666","2014","대구","남구","초등학교",2014-04-01,"여자",443,548,539,-9,-96,-105,-0.0164233576642336,-0.178107606679035,-0.191605839416058
"5667","2014","대구","남구","초등학교",2014-04-01,"남자",495,539,559,20,-64,-44,0.0371057513914657,-0.114490161001789,-0.0816326530612245
"5668","2014","대구","북구","초등학교",2014-04-01,"전체",4452,4876,4817,-59,-365,-424,-0.0121000820344545,-0.0757733028856135,-0.0869565217391304
"5669","2014","대구","북구","초등학교",2014-04-01,"여자",2149,2340,2301,-39,-152,-191,-0.0166666666666667,-0.066058235549761,-0.0816239316239316
"5670","2014","대구","북구","초등학교",2014-04-01,"남자",2303,2536,2516,-20,-213,-233,-0.00788643533123028,-0.0846581875993641,-0.0918769716088328
"5671","2014","대구","수성구","초등학교",2014-04-01,"전체",4119,3904,4118,214,1,215,0.0548155737704918,0.000242836328314716,0.0550717213114754
"5672","2014","대구","수성구","초등학교",2014-04-01,"여자",1973,1937,2034,97,-61,36,0.0500774393391843,-0.0299901671583087,0.0185854414042333
"5673","2014","대구","수성구","초등학교",2014-04-01,"남자",2146,1967,2084,117,62,179,0.0594814438230808,0.0297504798464491,0.0910015251652262
"5674","2014","대구","달서구","초등학교",2014-04-01,"전체",5906,5655,5688,33,218,251,0.00583554376657825,0.0383263009845288,0.0443854995579133
"5675","2014","대구","달서구","초등학교",2014-04-01,"여자",2928,2734,2756,22,172,194,0.00804681784930505,0.0624092888243832,0.0709583028529627
"5676","2014","대구","달서구","초등학교",2014-04-01,"남자",2978,2921,2932,11,46,57,0.00376583361862376,0.0156889495225102,0.0195138651146868
"5677","2014","대구","달성군","초등학교",2014-04-01,"전체",1921,2086,2059,-27,-138,-165,-0.0129434324065197,-0.0670228266148616,-0.0790987535953979
"5678","2014","대구","달성군","초등학교",2014-04-01,"여자",935,1005,1000,-5,-65,-70,-0.00497512437810945,-0.065,-0.0696517412935323
"5679","2014","대구","달성군","초등학교",2014-04-01,"남자",986,1081,1059,-22,-73,-95,-0.0203515263644773,-0.068932955618508,-0.087881591119334
"5680","2014","인천","중구","초등학교",2014-04-01,"전체",1343,971,1131,160,212,372,0.164778578784758,0.187444739168877,0.383110195674562
"5681","2014","인천","중구","초등학교",2014-04-01,"여자",675,473,549,76,126,202,0.160676532769556,0.229508196721311,0.427061310782241
"5682","2014","인천","중구","초등학교",2014-04-01,"남자",668,498,582,84,86,170,0.168674698795181,0.147766323024055,0.34136546184739
"5683","2014","인천","동구","초등학교",2014-04-01,"전체",839,804,753,-51,86,35,-0.0634328358208955,0.114209827357238,0.0435323383084577
"5684","2014","인천","동구","초등학교",2014-04-01,"여자",424,401,378,-23,46,23,-0.057356608478803,0.121693121693122,0.057356608478803
"5685","2014","인천","동구","초등학교",2014-04-01,"남자",415,403,375,-28,40,12,-0.0694789081885856,0.106666666666667,0.0297766749379653
"5686","2014","인천","남구","초등학교",2014-04-01,"전체",3190,3765,3663,-102,-473,-575,-0.0270916334661355,-0.129129129129129,-0.152722443559097
"5687","2014","인천","남구","초등학교",2014-04-01,"여자",1478,1824,1765,-59,-287,-346,-0.0323464912280702,-0.162606232294618,-0.18969298245614
"5688","2014","인천","남구","초등학교",2014-04-01,"남자",1712,1941,1898,-43,-186,-229,-0.0221535291087069,-0.0979978925184405,-0.117980422462648
"5689","2014","인천","연수구","초등학교",2014-04-01,"전체",3203,2811,3004,193,199,392,0.0686588402703664,0.0662450066577896,0.139452152258983
"5690","2014","인천","연수구","초등학교",2014-04-01,"여자",1530,1373,1477,104,53,157,0.0757465404224326,0.035883547731889,0.114348142753095
"5691","2014","인천","연수구","초등학교",2014-04-01,"남자",1673,1438,1527,89,146,235,0.0618915159944367,0.0956123117223314,0.163421418636996
"5692","2014","인천","남동구","초등학교",2014-04-01,"전체",5134,5430,5415,-15,-281,-296,-0.00276243093922652,-0.0518928901200369,-0.05451197053407
"5693","2014","인천","남동구","초등학교",2014-04-01,"여자",2510,2686,2654,-32,-144,-176,-0.0119136262099777,-0.054257724189902,-0.0655249441548771
"5694","2014","인천","남동구","초등학교",2014-04-01,"남자",2624,2744,2761,17,-137,-120,0.00619533527696793,-0.0496197030061572,-0.043731778425656
"5695","2014","인천","부평구","초등학교",2014-04-01,"전체",5006,5332,5182,-150,-176,-326,-0.0281320330082521,-0.033963720571208,-0.0611402850712678
"5696","2014","인천","부평구","초등학교",2014-04-01,"여자",2416,2550,2480,-70,-64,-134,-0.0274509803921569,-0.0258064516129032,-0.0525490196078431
"5697","2014","인천","부평구","초등학교",2014-04-01,"남자",2590,2782,2702,-80,-112,-192,-0.0287562904385334,-0.0414507772020725,-0.0690150970524802
"5698","2014","인천","계양구","초등학교",2014-04-01,"전체",3228,3461,3359,-102,-131,-233,-0.0294712510835019,-0.0389997022923489,-0.0673215833574111
"5699","2014","인천","계양구","초등학교",2014-04-01,"여자",1582,1668,1637,-31,-55,-86,-0.0185851318944844,-0.0335980452046426,-0.0515587529976019
"5700","2014","인천","계양구","초등학교",2014-04-01,"남자",1646,1793,1722,-71,-76,-147,-0.0395984383714445,-0.0441347270615563,-0.0819854991634133
"5701","2014","인천","서구","초등학교",2014-04-01,"전체",5649,5354,5753,399,-104,295,0.0745237205827419,-0.0180775247696854,0.0550989914082929
"5702","2014","인천","서구","초등학교",2014-04-01,"여자",2795,2618,2819,201,-24,177,0.0767761650114591,-0.00851365732529266,0.0676088617265088
"5703","2014","인천","서구","초등학교",2014-04-01,"남자",2854,2736,2934,198,-80,118,0.0723684210526316,-0.027266530334015,0.0431286549707602
"5704","2014","인천","강화군","초등학교",2014-04-01,"전체",422,447,438,-9,-16,-25,-0.0201342281879195,-0.0365296803652968,-0.0559284116331096
"5705","2014","인천","강화군","초등학교",2014-04-01,"여자",205,227,220,-7,-15,-22,-0.0308370044052863,-0.0681818181818182,-0.0969162995594714
"5706","2014","인천","강화군","초등학교",2014-04-01,"남자",217,220,218,-2,-1,-3,-0.00909090909090909,-0.00458715596330275,-0.0136363636363636
"5707","2014","인천","옹진군","초등학교",2014-04-01,"전체",118,134,132,-2,-14,-16,-0.0149253731343284,-0.106060606060606,-0.119402985074627
"5708","2014","인천","옹진군","초등학교",2014-04-01,"여자",68,74,75,1,-7,-6,0.0135135135135135,-0.0933333333333333,-0.0810810810810811
"5709","2014","인천","옹진군","초등학교",2014-04-01,"남자",50,60,57,-3,-7,-10,-0.05,-0.12280701754386,-0.166666666666667
"5710","2014","광주","동구","초등학교",2014-04-01,"전체",608,682,670,-12,-62,-74,-0.0175953079178886,-0.0925373134328358,-0.108504398826979
"5711","2014","광주","동구","초등학교",2014-04-01,"여자",305,327,318,-9,-13,-22,-0.0275229357798165,-0.0408805031446541,-0.0672782874617737
"5712","2014","광주","동구","초등학교",2014-04-01,"남자",303,355,352,-3,-49,-52,-0.00845070422535211,-0.139204545454545,-0.146478873239437
"5713","2014","광주","서구","초등학교",2014-04-01,"전체",3174,3215,3219,4,-45,-41,0.00124416796267496,-0.0139794967381174,-0.0127527216174184
"5714","2014","광주","서구","초등학교",2014-04-01,"여자",1509,1525,1529,4,-20,-16,0.00262295081967213,-0.013080444735121,-0.0104918032786885
"5715","2014","광주","서구","초등학교",2014-04-01,"남자",1665,1690,1690,0,-25,-25,0,-0.014792899408284,-0.014792899408284
"5716","2014","광주","남구","초등학교",2014-04-01,"전체",2074,1905,1941,36,133,169,0.0188976377952756,0.0685213807315817,0.0887139107611549
"5717","2014","광주","남구","초등학교",2014-04-01,"여자",1020,912,942,30,78,108,0.0328947368421053,0.0828025477707006,0.118421052631579
"5718","2014","광주","남구","초등학교",2014-04-01,"남자",1054,993,999,6,55,61,0.00604229607250755,0.0550550550550551,0.0614300100704935
"5719","2014","광주","북구","초등학교",2014-04-01,"전체",4308,4305,4290,-15,18,3,-0.00348432055749129,0.0041958041958042,0.000696864111498258
"5720","2014","광주","북구","초등학교",2014-04-01,"여자",2003,2026,2013,-13,-10,-23,-0.00641658440276407,-0.00496770988574267,-0.0113524185587364
"5721","2014","광주","북구","초등학교",2014-04-01,"남자",2305,2279,2277,-2,28,26,-0.000877577885037297,0.0122968818620993,0.0114085125054849
"5722","2014","광주","광산구","초등학교",2014-04-01,"전체",5817,5677,5758,81,59,140,0.0142680993482473,0.0102466134074331,0.0246609124537608
"5723","2014","광주","광산구","초등학교",2014-04-01,"여자",2778,2719,2758,39,20,59,0.0143435086428834,0.00725163161711385,0.0216991541007723
"5724","2014","광주","광산구","초등학교",2014-04-01,"남자",3039,2958,3000,42,39,81,0.0141987829614604,0.013,0.0273833671399594
"5725","2014","대전","동구","초등학교",2014-04-01,"전체",2378,2619,2606,-13,-228,-241,-0.00496372661321115,-0.0874904067536454,-0.0920198549064528
"5726","2014","대전","동구","초등학교",2014-04-01,"여자",1154,1272,1266,-6,-112,-118,-0.00471698113207547,-0.0884676145339652,-0.0927672955974843
"5727","2014","대전","동구","초등학교",2014-04-01,"남자",1224,1347,1340,-7,-116,-123,-0.00519673348181143,-0.0865671641791045,-0.0913140311804009
"5728","2014","대전","중구","초등학교",2014-04-01,"전체",2546,2606,2620,14,-74,-60,0.00537221795855718,-0.0282442748091603,-0.0230237912509593
"5729","2014","대전","중구","초등학교",2014-04-01,"여자",1217,1274,1278,4,-61,-57,0.00313971742543171,-0.0477308294209703,-0.0447409733124019
"5730","2014","대전","중구","초등학교",2014-04-01,"남자",1329,1332,1342,10,-13,-3,0.00750750750750751,-0.00968703427719821,-0.00225225225225225
"5731","2014","대전","서구","초등학교",2014-04-01,"전체",4873,4845,4888,43,-15,28,0.00887512899896801,-0.00306873977086743,0.00577915376676987
"5732","2014","대전","서구","초등학교",2014-04-01,"여자",2445,2404,2430,26,15,41,0.0108153078202995,0.00617283950617284,0.0170549084858569
"5733","2014","대전","서구","초등학교",2014-04-01,"남자",2428,2441,2458,17,-30,-13,0.00696435886931585,-0.0122050447518308,-0.00532568619418271
"5734","2014","대전","유성구","초등학교",2014-04-01,"전체",4268,4088,4215,127,53,180,0.0310665362035225,0.0125741399762752,0.0440313111545988
"5735","2014","대전","유성구","초등학교",2014-04-01,"여자",2075,1953,1998,45,77,122,0.0230414746543779,0.0385385385385385,0.0624679979518689
"5736","2014","대전","유성구","초등학교",2014-04-01,"남자",2193,2135,2217,82,-24,58,0.0384074941451991,-0.0108254397834912,0.0271662763466042
"5737","2014","대전","대덕구","초등학교",2014-04-01,"전체",1929,1975,1950,-25,-21,-46,-0.0126582278481013,-0.0107692307692308,-0.0232911392405063
"5738","2014","대전","대덕구","초등학교",2014-04-01,"여자",932,974,963,-11,-31,-42,-0.0112936344969199,-0.0321910695742471,-0.0431211498973306
"5739","2014","대전","대덕구","초등학교",2014-04-01,"남자",997,1001,987,-14,10,-4,-0.013986013986014,0.0101317122593718,-0.003996003996004
"5740","2014","울산","중구","초등학교",2014-04-01,"전체",2023,1974,1988,14,35,49,0.00709219858156028,0.0176056338028169,0.024822695035461
"5741","2014","울산","중구","초등학교",2014-04-01,"여자",975,956,954,-2,21,19,-0.00209205020920502,0.0220125786163522,0.0198744769874477
"5742","2014","울산","중구","초등학교",2014-04-01,"남자",1048,1018,1034,16,14,30,0.0157170923379175,0.0135396518375242,0.0294695481335953
"5743","2014","울산","남구","초등학교",2014-04-01,"전체",2968,3094,3144,50,-176,-126,0.0161603102779573,-0.0559796437659033,-0.0407239819004525
"5744","2014","울산","남구","초등학교",2014-04-01,"여자",1405,1471,1489,18,-84,-66,0.0122365737593474,-0.0564137004701142,-0.0448674371176071
"5745","2014","울산","남구","초등학교",2014-04-01,"남자",1563,1623,1655,32,-92,-60,0.0197165742452249,-0.0555891238670695,-0.0369685767097967
"5746","2014","울산","동구","초등학교",2014-04-01,"전체",1879,1923,1954,31,-75,-44,0.016120644825793,-0.0383828045035824,-0.0228809152366095
"5747","2014","울산","동구","초등학교",2014-04-01,"여자",929,940,956,16,-27,-11,0.0170212765957447,-0.0282426778242678,-0.0117021276595745
"5748","2014","울산","동구","초등학교",2014-04-01,"남자",950,983,998,15,-48,-33,0.0152594099694812,-0.0480961923847695,-0.0335707019328586
"5749","2014","울산","북구","초등학교",2014-04-01,"전체",2526,2584,2540,-44,-14,-58,-0.0170278637770898,-0.00551181102362205,-0.0224458204334365
"5750","2014","울산","북구","초등학교",2014-04-01,"여자",1242,1281,1260,-21,-18,-39,-0.0163934426229508,-0.0142857142857143,-0.0304449648711944
"5751","2014","울산","북구","초등학교",2014-04-01,"남자",1284,1303,1280,-23,4,-19,-0.0176515732924021,0.003125,-0.0145817344589409
"5752","2014","울산","울주군","초등학교",2014-04-01,"전체",2461,2430,2396,-34,65,31,-0.0139917695473251,0.0271285475792988,0.0127572016460905
"5753","2014","울산","울주군","초등학교",2014-04-01,"여자",1218,1155,1144,-11,74,63,-0.00952380952380952,0.0646853146853147,0.0545454545454545
"5754","2014","울산","울주군","초등학교",2014-04-01,"남자",1243,1275,1252,-23,-9,-32,-0.0180392156862745,-0.00718849840255591,-0.0250980392156863
"5755","2014","경기","수원시","초등학교",2014-04-01,"전체",12350,11862,12181,319,169,488,0.0268925982127803,0.0138740661686233,0.0411397740684539
"5756","2014","경기","수원시","초등학교",2014-04-01,"여자",5934,5731,5874,143,60,203,0.0249520153550864,0.0102145045965271,0.0354213924271506
"5757","2014","경기","수원시","초등학교",2014-04-01,"남자",6416,6131,6307,176,109,285,0.0287065731528299,0.017282384651974,0.0464850758440711
"5758","2014","경기","성남시","초등학교",2014-04-01,"전체",8606,9084,9018,-66,-412,-478,-0.00726552179656539,-0.0456864049678421,-0.0526199911933069
"5759","2014","경기","성남시","초등학교",2014-04-01,"여자",4179,4398,4387,-11,-208,-219,-0.00250113688040018,-0.0474128105767039,-0.0497953615279673
"5760","2014","경기","성남시","초등학교",2014-04-01,"남자",4427,4686,4631,-55,-204,-259,-0.0117370892018779,-0.044050960915569,-0.0552710200597525
"5761","2014","경기","부천시","초등학교",2014-04-01,"전체",7777,8423,8235,-188,-458,-646,-0.0223198385373382,-0.0556162720097146,-0.0766947643357474
"5762","2014","경기","부천시","초등학교",2014-04-01,"여자",3798,4133,4032,-101,-234,-335,-0.0244374546334382,-0.0580357142857143,-0.0810549237841761
"5763","2014","경기","부천시","초등학교",2014-04-01,"남자",3979,4290,4203,-87,-224,-311,-0.0202797202797203,-0.0532952652867,-0.0724941724941725
"5764","2014","경기","안양시","초등학교",2014-04-01,"전체",5378,5777,5792,15,-414,-399,0.00259650337545439,-0.0714779005524862,-0.0690669897870867
"5765","2014","경기","안양시","초등학교",2014-04-01,"여자",2533,2763,2763,0,-230,-230,0,-0.0832428519724937,-0.0832428519724937
"5766","2014","경기","안양시","초등학교",2014-04-01,"남자",2845,3014,3029,15,-184,-169,0.00497677504976775,-0.0607461208319577,-0.0560716655607167
"5767","2014","경기","과천시","초등학교",2014-04-01,"전체",578,693,721,28,-143,-115,0.0404040404040404,-0.198335644937587,-0.165945165945166
"5768","2014","경기","과천시","초등학교",2014-04-01,"여자",274,319,336,17,-62,-45,0.0532915360501567,-0.18452380952381,-0.141065830721003
"5769","2014","경기","과천시","초등학교",2014-04-01,"남자",304,374,385,11,-81,-70,0.0294117647058824,-0.21038961038961,-0.18716577540107
"5770","2014","경기","안산시","초등학교",2014-04-01,"전체",7139,7519,7379,-140,-240,-380,-0.0186194972735736,-0.0325247323485567,-0.0505386354568427
"5771","2014","경기","안산시","초등학교",2014-04-01,"여자",3471,3625,3564,-61,-93,-154,-0.0168275862068966,-0.0260942760942761,-0.0424827586206897
"5772","2014","경기","안산시","초등학교",2014-04-01,"남자",3668,3894,3815,-79,-147,-226,-0.0202876219825372,-0.0385321100917431,-0.0580380071905496
"5773","2014","경기","용인시","초등학교",2014-04-01,"전체",12253,12530,12845,315,-592,-277,0.0251396648044693,-0.0460879719735306,-0.0221069433359936
"5774","2014","경기","용인시","초등학교",2014-04-01,"여자",6012,6058,6210,152,-198,-46,0.0250907890392869,-0.0318840579710145,-0.00759326510399472
"5775","2014","경기","용인시","초등학교",2014-04-01,"남자",6241,6472,6635,163,-394,-231,0.025185414091471,-0.0593820648078372,-0.0356922126081582
"5776","2014","경기","군포시","초등학교",2014-04-01,"전체",2995,3236,3137,-99,-142,-241,-0.030593325092707,-0.0452661778769525,-0.0744746600741656
"5777","2014","경기","군포시","초등학교",2014-04-01,"여자",1444,1575,1512,-63,-68,-131,-0.04,-0.044973544973545,-0.0831746031746032
"5778","2014","경기","군포시","초등학교",2014-04-01,"남자",1551,1661,1625,-36,-74,-110,-0.0216736905478627,-0.0455384615384615,-0.0662251655629139
"5779","2014","경기","의왕시","초등학교",2014-04-01,"전체",1503,1668,1732,64,-229,-165,0.0383693045563549,-0.132217090069284,-0.0989208633093525
"5780","2014","경기","의왕시","초등학교",2014-04-01,"여자",736,805,852,47,-116,-69,0.0583850931677019,-0.136150234741784,-0.0857142857142857
"5781","2014","경기","의왕시","초등학교",2014-04-01,"남자",767,863,880,17,-113,-96,0.0196987253765933,-0.128409090909091,-0.111239860950174
"5782","2014","경기","시흥시","초등학교",2014-04-01,"전체",4395,4667,4585,-82,-190,-272,-0.0175701735590315,-0.0414394765539804,-0.058281551317763
"5783","2014","경기","시흥시","초등학교",2014-04-01,"여자",2196,2346,2279,-67,-83,-150,-0.0285592497868713,-0.0364194822290478,-0.0639386189258312
"5784","2014","경기","시흥시","초등학교",2014-04-01,"남자",2199,2321,2306,-15,-107,-122,-0.00646273158121499,-0.0464006938421509,-0.0525635501938819
"5785","2014","경기","평택시","초등학교",2014-04-01,"전체",4946,4912,4934,22,12,34,0.00447882736156352,0.00243210376976084,0.00692182410423453
"5786","2014","경기","평택시","초등학교",2014-04-01,"여자",2405,2387,2388,1,17,18,0.000418935902806871,0.00711892797319933,0.00754084625052367
"5787","2014","경기","평택시","초등학교",2014-04-01,"남자",2541,2525,2546,21,-5,16,0.00831683168316832,-0.00196386488609584,0.00633663366336634
"5788","2014","경기","화성시","초등학교",2014-04-01,"전체",8041,8571,8436,-135,-395,-530,-0.015750787539377,-0.0468231389284021,-0.0618364251545911
"5789","2014","경기","화성시","초등학교",2014-04-01,"여자",3977,4240,4155,-85,-178,-263,-0.0200471698113208,-0.0428399518652226,-0.0620283018867925
"5790","2014","경기","화성시","초등학교",2014-04-01,"남자",4064,4331,4281,-50,-217,-267,-0.0115446779034865,-0.0506890913338005,-0.0616485800046179
"5791","2014","경기","오산시","초등학교",2014-04-01,"전체",2993,3128,3102,-26,-109,-135,-0.00831202046035806,-0.0351386202450032,-0.0431585677749361
"5792","2014","경기","오산시","초등학교",2014-04-01,"여자",1439,1509,1484,-25,-45,-70,-0.0165672630881378,-0.0303234501347709,-0.046388336646786
"5793","2014","경기","오산시","초등학교",2014-04-01,"남자",1554,1619,1618,-1,-64,-65,-0.000617665225447807,-0.0395550061804697,-0.0401482396541075
"5794","2014","경기","광명시","초등학교",2014-04-01,"전체",3800,4106,4005,-101,-205,-306,-0.0245981490501705,-0.0511860174781523,-0.0745250852411106
"5795","2014","경기","광명시","초등학교",2014-04-01,"여자",1923,2038,1984,-54,-61,-115,-0.0264965652600589,-0.0307459677419355,-0.0564278704612365
"5796","2014","경기","광명시","초등학교",2014-04-01,"남자",1877,2068,2021,-47,-144,-191,-0.0227272727272727,-0.0712518555170708,-0.0923597678916828
"5797","2014","경기","광주시","초등학교",2014-04-01,"전체",3122,3259,3335,76,-213,-137,0.0233200368211108,-0.0638680659670165,-0.0420374347959497
"5798","2014","경기","광주시","초등학교",2014-04-01,"여자",1587,1690,1742,52,-155,-103,0.0307692307692308,-0.0889781859931114,-0.0609467455621302
"5799","2014","경기","광주시","초등학교",2014-04-01,"남자",1535,1569,1593,24,-58,-34,0.0152963671128107,-0.0364092906465788,-0.0216698534098152
"5800","2014","경기","하남시","초등학교",2014-04-01,"전체",1328,1527,1462,-65,-134,-199,-0.0425671250818599,-0.0916552667578659,-0.130320890635232
"5801","2014","경기","하남시","초등학교",2014-04-01,"여자",629,715,691,-24,-62,-86,-0.0335664335664336,-0.0897250361794501,-0.12027972027972
"5802","2014","경기","하남시","초등학교",2014-04-01,"남자",699,812,771,-41,-72,-113,-0.0504926108374384,-0.0933852140077821,-0.139162561576355
"5803","2014","경기","김포시","초등학교",2014-04-01,"전체",3827,3094,3630,536,197,733,0.173238526179703,0.0542699724517906,0.236910148674855
"5804","2014","경기","김포시","초등학교",2014-04-01,"여자",1889,1503,1753,250,136,386,0.166333998669328,0.0775812892184826,0.256819693945442
"5805","2014","경기","김포시","초등학교",2014-04-01,"남자",1938,1591,1877,286,61,347,0.179761156505343,0.0324986680873735,0.218101822752986
"5806","2014","경기","이천시","초등학교",2014-04-01,"전체",2377,2484,2464,-20,-87,-107,-0.00805152979066022,-0.0353084415584416,-0.0430756843800322
"5807","2014","경기","이천시","초등학교",2014-04-01,"여자",1167,1231,1226,-5,-59,-64,-0.00406173842404549,-0.0481239804241436,-0.0519902518277823
"5808","2014","경기","이천시","초등학교",2014-04-01,"남자",1210,1253,1238,-15,-28,-43,-0.0119712689545092,-0.0226171243941842,-0.034317637669593
"5809","2014","경기","안성시","초등학교",2014-04-01,"전체",2031,2122,2089,-33,-58,-91,-0.0155513666352498,-0.0277644806127334,-0.0428840716305372
"5810","2014","경기","안성시","초등학교",2014-04-01,"여자",987,1036,1026,-10,-39,-49,-0.00965250965250965,-0.0380116959064327,-0.0472972972972973
"5811","2014","경기","안성시","초등학교",2014-04-01,"남자",1044,1086,1063,-23,-19,-42,-0.0211786372007366,-0.0178739416745061,-0.0386740331491713
"5812","2014","경기","여주군","초등학교",2014-04-01,"전체",1014,1029,1002,-27,12,-15,-0.0262390670553936,0.0119760479041916,-0.0145772594752187
"5813","2014","경기","여주군","초등학교",2014-04-01,"여자",503,483,480,-3,23,20,-0.0062111801242236,0.0479166666666667,0.041407867494824
"5814","2014","경기","여주군","초등학교",2014-04-01,"남자",511,546,522,-24,-11,-35,-0.043956043956044,-0.0210727969348659,-0.0641025641025641
"5815","2014","경기","양평군","초등학교",2014-04-01,"전체",847,786,830,44,17,61,0.0559796437659033,0.0204819277108434,0.0776081424936387
"5816","2014","경기","양평군","초등학교",2014-04-01,"여자",425,381,406,25,19,44,0.0656167979002625,0.0467980295566502,0.115485564304462
"5817","2014","경기","양평군","초등학교",2014-04-01,"남자",422,405,424,19,-2,17,0.0469135802469136,-0.00471698113207547,0.0419753086419753
"5818","2014","경기","고양시","초등학교",2014-04-01,"전체",9425,9606,9770,164,-345,-181,0.017072662919009,-0.0353121801432958,-0.0188423901728087
"5819","2014","경기","고양시","초등학교",2014-04-01,"여자",4555,4584,4682,98,-127,-29,0.0213787085514834,-0.0271251601879539,-0.00632635253054101
"5820","2014","경기","고양시","초등학교",2014-04-01,"남자",4870,5022,5088,66,-218,-152,0.013142174432497,-0.0428459119496855,-0.0302668259657507
"5821","2014","경기","남양주시","초등학교",2014-04-01,"전체",7590,7555,7768,213,-178,35,0.02819324950364,-0.0229145211122554,0.00463269358041032
"5822","2014","경기","남양주시","초등학교",2014-04-01,"여자",3672,3616,3725,109,-53,56,0.0301438053097345,-0.0142281879194631,0.0154867256637168
"5823","2014","경기","남양주시","초등학교",2014-04-01,"남자",3918,3939,4043,104,-125,-21,0.0264026402640264,-0.0309176354192431,-0.00533130236100533
"5824","2014","경기","구리시","초등학교",2014-04-01,"전체",1802,2034,1985,-49,-183,-232,-0.0240904621435595,-0.092191435768262,-0.114060963618486
"5825","2014","경기","구리시","초등학교",2014-04-01,"여자",848,983,964,-19,-116,-135,-0.0193285859613428,-0.120331950207469,-0.137334689725331
"5826","2014","경기","구리시","초등학교",2014-04-01,"남자",954,1051,1021,-30,-67,-97,-0.0285442435775452,-0.0656219392752204,-0.0922930542340628
"5827","2014","경기","의정부시","초등학교",2014-04-01,"전체",4073,4275,4270,-5,-197,-202,-0.00116959064327485,-0.046135831381733,-0.0472514619883041
"5828","2014","경기","의정부시","초등학교",2014-04-01,"여자",1929,2028,2041,13,-112,-99,0.00641025641025641,-0.054875061244488,-0.0488165680473373
"5829","2014","경기","의정부시","초등학교",2014-04-01,"남자",2144,2247,2229,-18,-85,-103,-0.00801068090787717,-0.0381336922386721,-0.045838896306186
"5830","2014","경기","파주시","초등학교",2014-04-01,"전체",4943,4962,5118,156,-175,-19,0.0314389359129383,-0.0341930441578742,-0.00382910116888351
"5831","2014","경기","파주시","초등학교",2014-04-01,"여자",2431,2395,2476,81,-45,36,0.0338204592901879,-0.0181744749596123,0.0150313152400835
"5832","2014","경기","파주시","초등학교",2014-04-01,"남자",2512,2567,2642,75,-130,-55,0.0292169848071679,-0.0492051476154428,-0.0214257888585898
"5833","2014","경기","동두천시","초등학교",2014-04-01,"전체",983,990,999,9,-16,-7,0.00909090909090909,-0.016016016016016,-0.00707070707070707
"5834","2014","경기","동두천시","초등학교",2014-04-01,"여자",492,508,513,5,-21,-16,0.00984251968503937,-0.0409356725146199,-0.031496062992126
"5835","2014","경기","동두천시","초등학교",2014-04-01,"남자",491,482,486,4,5,9,0.00829875518672199,0.0102880658436214,0.0186721991701245
"5836","2014","경기","양주시","초등학교",2014-04-01,"전체",2361,2524,2487,-37,-126,-163,-0.0146592709984152,-0.0506634499396864,-0.0645800316957211
"5837","2014","경기","양주시","초등학교",2014-04-01,"여자",1141,1222,1191,-31,-50,-81,-0.0253682487725041,-0.0419815281276238,-0.0662847790507365
"5838","2014","경기","양주시","초등학교",2014-04-01,"남자",1220,1302,1296,-6,-76,-82,-0.00460829493087558,-0.058641975308642,-0.0629800307219662
"5839","2014","경기","포천시","초등학교",2014-04-01,"전체",1335,1431,1391,-40,-56,-96,-0.0279524807826695,-0.0402588066139468,-0.0670859538784067
"5840","2014","경기","포천시","초등학교",2014-04-01,"여자",602,668,640,-28,-38,-66,-0.0419161676646707,-0.059375,-0.0988023952095808
"5841","2014","경기","포천시","초등학교",2014-04-01,"남자",733,763,751,-12,-18,-30,-0.0157273918741809,-0.0239680426098535,-0.0393184796854522
"5842","2014","경기","가평군","초등학교",2014-04-01,"전체",450,466,471,5,-21,-16,0.0107296137339056,-0.0445859872611465,-0.0343347639484979
"5843","2014","경기","가평군","초등학교",2014-04-01,"여자",216,216,219,3,-3,0,0.0138888888888889,-0.0136986301369863,0
"5844","2014","경기","가평군","초등학교",2014-04-01,"남자",234,250,252,2,-18,-16,0.008,-0.0714285714285714,-0.064
"5845","2014","경기","연천군","초등학교",2014-04-01,"전체",312,365,350,-15,-38,-53,-0.0410958904109589,-0.108571428571429,-0.145205479452055
"5846","2014","경기","연천군","초등학교",2014-04-01,"여자",142,173,166,-7,-24,-31,-0.0404624277456647,-0.144578313253012,-0.179190751445087
"5847","2014","경기","연천군","초등학교",2014-04-01,"남자",170,192,184,-8,-14,-22,-0.0416666666666667,-0.0760869565217391,-0.114583333333333
"5848","2014","강원","춘천시","초등학교",2014-04-01,"전체",2517,2489,2522,33,-5,28,0.0132583366813982,-0.00198255352894528,0.0112494977902772
"5849","2014","강원","춘천시","초등학교",2014-04-01,"여자",1228,1230,1248,18,-20,-2,0.0146341463414634,-0.016025641025641,-0.0016260162601626
"5850","2014","강원","춘천시","초등학교",2014-04-01,"남자",1289,1259,1274,15,15,30,0.0119142176330421,0.0117739403453689,0.0238284352660842
"5851","2014","강원","원주시","초등학교",2014-04-01,"전체",3415,3331,3372,41,43,84,0.0123086160312219,0.0127520759193357,0.0252176523566497
"5852","2014","강원","원주시","초등학교",2014-04-01,"여자",1651,1626,1643,17,8,25,0.0104551045510455,0.00486914181375533,0.0153751537515375
"5853","2014","강원","원주시","초등학교",2014-04-01,"남자",1764,1705,1729,24,35,59,0.0140762463343109,0.0202429149797571,0.0346041055718475
"5854","2014","강원","강릉시","초등학교",2014-04-01,"전체",1839,1852,1849,-3,-10,-13,-0.00161987041036717,-0.00540832882639264,-0.00701943844492441
"5855","2014","강원","강릉시","초등학교",2014-04-01,"여자",840,895,889,-6,-49,-55,-0.00670391061452514,-0.0551181102362205,-0.0614525139664804
"5856","2014","강원","강릉시","초등학교",2014-04-01,"남자",999,957,960,3,39,42,0.00313479623824451,0.040625,0.0438871473354232
"5857","2014","강원","동해시","초등학교",2014-04-01,"전체",928,865,887,22,41,63,0.0254335260115607,0.0462232243517475,0.0728323699421965
"5858","2014","강원","동해시","초등학교",2014-04-01,"여자",444,410,420,10,24,34,0.024390243902439,0.0571428571428571,0.0829268292682927
"5859","2014","강원","동해시","초등학교",2014-04-01,"남자",484,455,467,12,17,29,0.0263736263736264,0.0364025695931477,0.0637362637362637
"5860","2014","강원","태백시","초등학교",2014-04-01,"전체",449,467,449,-18,0,-18,-0.0385438972162741,0,-0.0385438972162741
"5861","2014","강원","태백시","초등학교",2014-04-01,"여자",205,209,206,-3,-1,-4,-0.0143540669856459,-0.00485436893203883,-0.0191387559808612
"5862","2014","강원","태백시","초등학교",2014-04-01,"남자",244,258,243,-15,1,-14,-0.0581395348837209,0.00411522633744856,-0.0542635658914729
"5863","2014","강원","속초시","초등학교",2014-04-01,"전체",712,687,694,7,18,25,0.0101892285298399,0.0259365994236311,0.0363901018922853
"5864","2014","강원","속초시","초등학교",2014-04-01,"여자",313,320,322,2,-9,-7,0.00625,-0.0279503105590062,-0.021875
"5865","2014","강원","속초시","초등학교",2014-04-01,"남자",399,367,372,5,27,32,0.0136239782016349,0.0725806451612903,0.0871934604904632
"5866","2014","강원","삼척시","초등학교",2014-04-01,"전체",500,494,492,-2,8,6,-0.00404858299595142,0.016260162601626,0.0121457489878543
"5867","2014","강원","삼척시","초등학교",2014-04-01,"여자",234,239,237,-2,-3,-5,-0.00836820083682008,-0.0126582278481013,-0.0209205020920502
"5868","2014","강원","삼척시","초등학교",2014-04-01,"남자",266,255,255,0,11,11,0,0.0431372549019608,0.0431372549019608
"5869","2014","강원","홍천군","초등학교",2014-04-01,"전체",569,596,603,7,-34,-27,0.011744966442953,-0.0563847429519071,-0.0453020134228188
"5870","2014","강원","홍천군","초등학교",2014-04-01,"여자",282,313,314,1,-32,-31,0.00319488817891374,-0.101910828025478,-0.0990415335463259
"5871","2014","강원","홍천군","초등학교",2014-04-01,"남자",287,283,289,6,-2,4,0.0212014134275618,-0.0069204152249135,0.0141342756183746
"5872","2014","강원","횡성군","초등학교",2014-04-01,"전체",314,307,311,4,3,7,0.0130293159609121,0.00964630225080386,0.0228013029315961
"5873","2014","강원","횡성군","초등학교",2014-04-01,"여자",155,150,141,-9,14,5,-0.06,0.099290780141844,0.0333333333333333
"5874","2014","강원","횡성군","초등학교",2014-04-01,"남자",159,157,170,13,-11,2,0.0828025477707006,-0.0647058823529412,0.0127388535031847
"5875","2014","강원","영월군","초등학교",2014-04-01,"전체",254,270,283,13,-29,-16,0.0481481481481481,-0.102473498233216,-0.0592592592592593
"5876","2014","강원","영월군","초등학교",2014-04-01,"여자",118,126,132,6,-14,-8,0.0476190476190476,-0.106060606060606,-0.0634920634920635
"5877","2014","강원","영월군","초등학교",2014-04-01,"남자",136,144,151,7,-15,-8,0.0486111111111111,-0.0993377483443709,-0.0555555555555556
"5878","2014","강원","평창군","초등학교",2014-04-01,"전체",313,344,336,-8,-23,-31,-0.0232558139534884,-0.068452380952381,-0.0901162790697674
"5879","2014","강원","평창군","초등학교",2014-04-01,"여자",150,168,166,-2,-16,-18,-0.0119047619047619,-0.0963855421686747,-0.107142857142857
"5880","2014","강원","평창군","초등학교",2014-04-01,"남자",163,176,170,-6,-7,-13,-0.0340909090909091,-0.0411764705882353,-0.0738636363636364
"5881","2014","강원","정선군","초등학교",2014-04-01,"전체",289,268,272,4,17,21,0.0149253731343284,0.0625,0.0783582089552239
"5882","2014","강원","정선군","초등학교",2014-04-01,"여자",141,135,135,0,6,6,0,0.0444444444444444,0.0444444444444444
"5883","2014","강원","정선군","초등학교",2014-04-01,"남자",148,133,137,4,11,15,0.0300751879699248,0.0802919708029197,0.112781954887218
"5884","2014","강원","철원군","초등학교",2014-04-01,"전체",427,441,444,3,-17,-14,0.00680272108843537,-0.0382882882882883,-0.0317460317460317
"5885","2014","강원","철원군","초등학교",2014-04-01,"여자",211,208,216,8,-5,3,0.0384615384615385,-0.0231481481481481,0.0144230769230769
"5886","2014","강원","철원군","초등학교",2014-04-01,"남자",216,233,228,-5,-12,-17,-0.0214592274678112,-0.0526315789473684,-0.0729613733905579
"5887","2014","강원","화천군","초등학교",2014-04-01,"전체",243,272,269,-3,-26,-29,-0.0110294117647059,-0.0966542750929368,-0.106617647058824
"5888","2014","강원","화천군","초등학교",2014-04-01,"여자",126,125,130,5,-4,1,0.04,-0.0307692307692308,0.008
"5889","2014","강원","화천군","초등학교",2014-04-01,"남자",117,147,139,-8,-22,-30,-0.054421768707483,-0.158273381294964,-0.204081632653061
"5890","2014","강원","양구군","초등학교",2014-04-01,"전체",209,221,204,-17,5,-12,-0.0769230769230769,0.0245098039215686,-0.0542986425339367
"5891","2014","강원","양구군","초등학교",2014-04-01,"여자",94,109,90,-19,4,-15,-0.174311926605505,0.0444444444444444,-0.137614678899083
"5892","2014","강원","양구군","초등학교",2014-04-01,"남자",115,112,114,2,1,3,0.0178571428571429,0.0087719298245614,0.0267857142857143
"5893","2014","강원","인제군","초등학교",2014-04-01,"전체",310,310,311,1,-1,0,0.0032258064516129,-0.00321543408360129,0
"5894","2014","강원","인제군","초등학교",2014-04-01,"여자",151,147,158,11,-7,4,0.0748299319727891,-0.0443037974683544,0.0272108843537415
"5895","2014","강원","인제군","초등학교",2014-04-01,"남자",159,163,153,-10,6,-4,-0.0613496932515337,0.0392156862745098,-0.0245398773006135
"5896","2014","강원","고성군","초등학교",2014-04-01,"전체",162,176,168,-8,-6,-14,-0.0454545454545455,-0.0357142857142857,-0.0795454545454545
"5897","2014","강원","고성군","초등학교",2014-04-01,"여자",71,74,70,-4,1,-3,-0.0540540540540541,0.0142857142857143,-0.0405405405405405
"5898","2014","강원","고성군","초등학교",2014-04-01,"남자",91,102,98,-4,-7,-11,-0.0392156862745098,-0.0714285714285714,-0.107843137254902
"5899","2014","강원","양양군","초등학교",2014-04-01,"전체",175,170,178,8,-3,5,0.0470588235294118,-0.0168539325842697,0.0294117647058824
"5900","2014","강원","양양군","초등학교",2014-04-01,"여자",86,81,83,2,3,5,0.0246913580246914,0.036144578313253,0.0617283950617284
"5901","2014","강원","양양군","초등학교",2014-04-01,"남자",89,89,95,6,-6,0,0.0674157303370786,-0.0631578947368421,0
"5902","2014","충북","청주시","초등학교",2014-04-01,"전체",7226,7229,7280,51,-54,-3,0.00705491769262692,-0.00741758241758242,-0.000414995158389819
"5903","2014","충북","청주시","초등학교",2014-04-01,"여자",3485,3502,3516,14,-31,-17,0.00399771559109081,-0.00881683731513083,-0.00485436893203883
"5904","2014","충북","청주시","초등학교",2014-04-01,"남자",3741,3727,3764,37,-23,14,0.00992755567480547,-0.00611052072263549,0.00375637241749396
"5905","2014","충북","충주시","초등학교",2014-04-01,"전체",1837,1897,1933,36,-96,-60,0.0189773326304692,-0.049663735126746,-0.0316288877174486
"5906","2014","충북","충주시","초등학교",2014-04-01,"여자",880,901,929,28,-49,-21,0.0310765815760266,-0.0527448869752422,-0.02330743618202
"5907","2014","충북","충주시","초등학교",2014-04-01,"남자",957,996,1004,8,-47,-39,0.00803212851405622,-0.0468127490039841,-0.0391566265060241
"5908","2014","충북","제천시","초등학교",2014-04-01,"전체",1105,1167,1160,-7,-55,-62,-0.00599828620394173,-0.0474137931034483,-0.053127677806341
"5909","2014","충북","제천시","초등학교",2014-04-01,"여자",537,553,552,-1,-15,-16,-0.00180831826401447,-0.0271739130434783,-0.0289330922242315
"5910","2014","충북","제천시","초등학교",2014-04-01,"남자",568,614,608,-6,-40,-46,-0.00977198697068404,-0.0657894736842105,-0.0749185667752443
"5911","2014","충북","청원군","초등학교",2014-04-01,"전체",1759,2005,1905,-100,-146,-246,-0.0498753117206983,-0.0766404199475066,-0.122693266832918
"5912","2014","충북","청원군","초등학교",2014-04-01,"여자",837,978,930,-48,-93,-141,-0.049079754601227,-0.1,-0.144171779141104
"5913","2014","충북","청원군","초등학교",2014-04-01,"남자",922,1027,975,-52,-53,-105,-0.0506329113924051,-0.0543589743589744,-0.102239532619279
"5914","2014","충북","보은군","초등학교",2014-04-01,"전체",191,192,195,3,-4,-1,0.015625,-0.0205128205128205,-0.00520833333333333
"5915","2014","충북","보은군","초등학교",2014-04-01,"여자",76,99,98,-1,-22,-23,-0.0101010101010101,-0.224489795918367,-0.232323232323232
"5916","2014","충북","보은군","초등학교",2014-04-01,"남자",115,93,97,4,18,22,0.043010752688172,0.185567010309278,0.236559139784946
"5917","2014","충북","옥천군","초등학교",2014-04-01,"전체",396,436,426,-10,-30,-40,-0.0229357798165138,-0.0704225352112676,-0.0917431192660551
"5918","2014","충북","옥천군","초등학교",2014-04-01,"여자",196,203,198,-5,-2,-7,-0.0246305418719212,-0.0101010101010101,-0.0344827586206897
"5919","2014","충북","옥천군","초등학교",2014-04-01,"남자",200,233,228,-5,-28,-33,-0.0214592274678112,-0.12280701754386,-0.141630901287554
"5920","2014","충북","영동군","초등학교",2014-04-01,"전체",343,322,335,13,8,21,0.0403726708074534,0.0238805970149254,0.0652173913043478
"5921","2014","충북","영동군","초등학교",2014-04-01,"여자",165,145,149,4,16,20,0.0275862068965517,0.10738255033557,0.137931034482759
"5922","2014","충북","영동군","초등학교",2014-04-01,"남자",178,177,186,9,-8,1,0.0508474576271186,-0.043010752688172,0.00564971751412429
"5923","2014","충북","진천군","초등학교",2014-04-01,"전체",698,683,688,5,10,15,0.00732064421669107,0.0145348837209302,0.0219619326500732
"5924","2014","충북","진천군","초등학교",2014-04-01,"여자",343,334,338,4,5,9,0.0119760479041916,0.014792899408284,0.0269461077844311
"5925","2014","충북","진천군","초등학교",2014-04-01,"남자",355,349,350,1,5,6,0.00286532951289398,0.0142857142857143,0.0171919770773639
"5926","2014","충북","괴산군","초등학교",2014-04-01,"전체",191,195,201,6,-10,-4,0.0307692307692308,-0.0497512437810945,-0.0205128205128205
"5927","2014","충북","괴산군","초등학교",2014-04-01,"여자",101,103,105,2,-4,-2,0.0194174757281553,-0.0380952380952381,-0.0194174757281553
"5928","2014","충북","괴산군","초등학교",2014-04-01,"남자",90,92,96,4,-6,-2,0.0434782608695652,-0.0625,-0.0217391304347826
"5929","2014","충북","음성군","초등학교",2014-04-01,"전체",836,888,895,7,-59,-52,0.00788288288288288,-0.0659217877094972,-0.0585585585585586
"5930","2014","충북","음성군","초등학교",2014-04-01,"여자",400,427,436,9,-36,-27,0.0210772833723653,-0.0825688073394495,-0.063231850117096
"5931","2014","충북","음성군","초등학교",2014-04-01,"남자",436,461,459,-2,-23,-25,-0.00433839479392625,-0.0501089324618736,-0.0542299349240781
"5932","2014","충북","단양군","초등학교",2014-04-01,"전체",211,207,204,-3,7,4,-0.0144927536231884,0.0343137254901961,0.0193236714975845
"5933","2014","충북","단양군","초등학교",2014-04-01,"여자",103,100,98,-2,5,3,-0.02,0.0510204081632653,0.03
"5934","2014","충북","단양군","초등학교",2014-04-01,"남자",108,107,106,-1,2,1,-0.00934579439252336,0.0188679245283019,0.00934579439252336
"5935","2014","충북","증평군","초등학교",2014-04-01,"전체",367,394,405,11,-38,-27,0.0279187817258883,-0.0938271604938272,-0.0685279187817259
"5936","2014","충북","증평군","초등학교",2014-04-01,"여자",175,187,197,10,-22,-12,0.053475935828877,-0.111675126903553,-0.0641711229946524
"5937","2014","충북","증평군","초등학교",2014-04-01,"남자",192,207,208,1,-16,-15,0.00483091787439614,-0.0769230769230769,-0.072463768115942
"5938","2014","충남","천안시","초등학교",2014-04-01,"전체",6797,6873,6839,-34,-42,-76,-0.0049468936417867,-0.00614124872057318,-0.0110577622581115
"5939","2014","충남","천안시","초등학교",2014-04-01,"여자",3291,3323,3303,-20,-12,-32,-0.00601865783930184,-0.0036330608537693,-0.00962985254288294
"5940","2014","충남","천안시","초등학교",2014-04-01,"남자",3506,3550,3536,-14,-30,-44,-0.00394366197183099,-0.0084841628959276,-0.0123943661971831
"5941","2014","충남","공주시","초등학교",2014-04-01,"전체",871,983,932,-51,-61,-112,-0.051881993896236,-0.065450643776824,-0.113936927772126
"5942","2014","충남","공주시","초등학교",2014-04-01,"여자",405,479,448,-31,-43,-74,-0.0647181628392484,-0.0959821428571429,-0.154488517745303
"5943","2014","충남","공주시","초등학교",2014-04-01,"남자",466,504,484,-20,-18,-38,-0.0396825396825397,-0.0371900826446281,-0.0753968253968254
"5944","2014","충남","보령시","초등학교",2014-04-01,"전체",828,914,914,0,-86,-86,0,-0.0940919037199125,-0.0940919037199125
"5945","2014","충남","보령시","초등학교",2014-04-01,"여자",406,460,460,0,-54,-54,0,-0.117391304347826,-0.117391304347826
"5946","2014","충남","보령시","초등학교",2014-04-01,"남자",422,454,454,0,-32,-32,0,-0.0704845814977974,-0.0704845814977974
"5947","2014","충남","아산시","초등학교",2014-04-01,"전체",3701,3879,3892,13,-191,-178,0.00335137922144883,-0.0490750256937307,-0.0458881154936839
"5948","2014","충남","아산시","초등학교",2014-04-01,"여자",1767,1864,1859,-5,-92,-97,-0.00268240343347639,-0.0494889725658956,-0.0520386266094421
"5949","2014","충남","아산시","초등학교",2014-04-01,"남자",1934,2015,2033,18,-99,-81,0.00893300248138958,-0.0486965076242007,-0.0401985111662531
"5950","2014","충남","서산시","초등학교",2014-04-01,"전체",1873,1864,1887,23,-14,9,0.0123390557939914,-0.00741918388977213,0.00482832618025751
"5951","2014","충남","서산시","초등학교",2014-04-01,"여자",906,891,904,13,2,15,0.0145903479236813,0.00221238938053097,0.0168350168350168
"5952","2014","충남","서산시","초등학교",2014-04-01,"남자",967,973,983,10,-16,-6,0.0102774922918808,-0.0162767039674466,-0.00616649537512847
"5953","2014","충남","논산시","초등학교",2014-04-01,"전체",1065,1028,1023,-5,42,37,-0.00486381322957198,0.0410557184750733,0.0359922178988327
"5954","2014","충남","논산시","초등학교",2014-04-01,"여자",501,499,506,7,-5,2,0.0140280561122244,-0.00988142292490119,0.00400801603206413
"5955","2014","충남","논산시","초등학교",2014-04-01,"남자",564,529,517,-12,47,35,-0.0226843100189036,0.0909090909090909,0.0661625708884688
"5956","2014","충남","계룡시","초등학교",2014-04-01,"전체",484,566,557,-9,-73,-82,-0.0159010600706714,-0.131059245960503,-0.144876325088339
"5957","2014","충남","계룡시","초등학교",2014-04-01,"여자",241,287,274,-13,-33,-46,-0.0452961672473868,-0.12043795620438,-0.160278745644599
"5958","2014","충남","계룡시","초등학교",2014-04-01,"남자",243,279,283,4,-40,-36,0.014336917562724,-0.141342756183746,-0.129032258064516
"5959","2014","충남","금산군","초등학교",2014-04-01,"전체",454,439,436,-3,18,15,-0.00683371298405467,0.0412844036697248,0.0341685649202733
"5960","2014","충남","금산군","초등학교",2014-04-01,"여자",233,210,212,2,21,23,0.00952380952380952,0.0990566037735849,0.10952380952381
"5961","2014","충남","금산군","초등학교",2014-04-01,"남자",221,229,224,-5,-3,-8,-0.0218340611353712,-0.0133928571428571,-0.0349344978165939
"5962","2014","충남","부여군","초등학교",2014-04-01,"전체",442,453,443,-10,-1,-11,-0.022075055187638,-0.00225733634311512,-0.0242825607064018
"5963","2014","충남","부여군","초등학교",2014-04-01,"여자",212,219,214,-5,-2,-7,-0.0228310502283105,-0.00934579439252336,-0.0319634703196347
"5964","2014","충남","부여군","초등학교",2014-04-01,"남자",230,234,229,-5,1,-4,-0.0213675213675214,0.00436681222707424,-0.0170940170940171
"5965","2014","충남","서천군","초등학교",2014-04-01,"전체",328,355,347,-8,-19,-27,-0.0225352112676056,-0.0547550432276657,-0.076056338028169
"5966","2014","충남","서천군","초등학교",2014-04-01,"여자",162,177,175,-2,-13,-15,-0.0112994350282486,-0.0742857142857143,-0.0847457627118644
"5967","2014","충남","서천군","초등학교",2014-04-01,"남자",166,178,172,-6,-6,-12,-0.0337078651685393,-0.0348837209302326,-0.0674157303370786
"5968","2014","충남","청양군","초등학교",2014-04-01,"전체",162,185,191,6,-29,-23,0.0324324324324324,-0.151832460732984,-0.124324324324324
"5969","2014","충남","청양군","초등학교",2014-04-01,"여자",86,90,92,2,-6,-4,0.0222222222222222,-0.0652173913043478,-0.0444444444444444
"5970","2014","충남","청양군","초등학교",2014-04-01,"남자",76,95,99,4,-23,-19,0.0421052631578947,-0.232323232323232,-0.2
"5971","2014","충남","홍성군","초등학교",2014-04-01,"전체",773,697,725,28,48,76,0.0401721664275466,0.0662068965517241,0.109038737446198
"5972","2014","충남","홍성군","초등학교",2014-04-01,"여자",377,359,371,12,6,18,0.0334261838440111,0.0161725067385445,0.0501392757660167
"5973","2014","충남","홍성군","초등학교",2014-04-01,"남자",396,338,354,16,42,58,0.0473372781065089,0.11864406779661,0.171597633136095
"5974","2014","충남","예산군","초등학교",2014-04-01,"전체",614,610,608,-2,6,4,-0.00327868852459016,0.00986842105263158,0.00655737704918033
"5975","2014","충남","예산군","초등학교",2014-04-01,"여자",276,282,281,-1,-5,-6,-0.00354609929078014,-0.0177935943060498,-0.0212765957446809
"5976","2014","충남","예산군","초등학교",2014-04-01,"남자",338,328,327,-1,11,10,-0.00304878048780488,0.0336391437308868,0.0304878048780488
"5977","2014","충남","태안군","초등학교",2014-04-01,"전체",438,432,431,-1,7,6,-0.00231481481481481,0.0162412993039443,0.0138888888888889
"5978","2014","충남","태안군","초등학교",2014-04-01,"여자",203,200,203,3,0,3,0.015,0,0.015
"5979","2014","충남","태안군","초등학교",2014-04-01,"남자",235,232,228,-4,7,3,-0.0172413793103448,0.0307017543859649,0.0129310344827586
"5980","2014","충남","당진시","초등학교",2014-04-01,"전체",1773,1773,1831,58,-58,0,0.0327129159616469,-0.0316766794101584,0
"5981","2014","충남","당진시","초등학교",2014-04-01,"여자",850,871,882,11,-32,-21,0.0126291618828932,-0.036281179138322,-0.0241102181400689
"5982","2014","충남","당진시","초등학교",2014-04-01,"남자",923,902,949,47,-26,21,0.0521064301552106,-0.0273972602739726,0.0232815964523282
"5983","2014","전북","전주시","초등학교",2014-04-01,"전체",6669,6572,6612,40,57,97,0.00608642726719416,0.00862068965517241,0.0147595861229458
"5984","2014","전북","전주시","초등학교",2014-04-01,"여자",3159,3139,3162,23,-3,20,0.00732717425931825,-0.00094876660341556,0.00637145587766805
"5985","2014","전북","전주시","초등학교",2014-04-01,"남자",3510,3433,3450,17,60,77,0.00495193708127003,0.0173913043478261,0.0224293620739878
"5986","2014","전북","군산시","초등학교",2014-04-01,"전체",2801,2851,2860,9,-59,-50,0.00315678709224833,-0.0206293706293706,-0.0175377060680463
"5987","2014","전북","군산시","초등학교",2014-04-01,"여자",1384,1375,1362,-13,22,9,-0.00945454545454546,0.0161527165932452,0.00654545454545455
"5988","2014","전북","군산시","초등학교",2014-04-01,"남자",1417,1476,1498,22,-81,-59,0.0149051490514905,-0.0540720961281709,-0.0399728997289973
"5989","2014","전북","익산시","초등학교",2014-04-01,"전체",2933,2957,2972,15,-39,-24,0.00507270882651336,-0.0131224764468371,-0.00811633412242137
"5990","2014","전북","익산시","초등학교",2014-04-01,"여자",1441,1460,1453,-7,-12,-19,-0.00479452054794521,-0.00825877494838266,-0.013013698630137
"5991","2014","전북","익산시","초등학교",2014-04-01,"남자",1492,1497,1519,22,-27,-5,0.0146960587842351,-0.0177748518762344,-0.00334001336005344
"5992","2014","전북","정읍시","초등학교",2014-04-01,"전체",963,938,930,-8,33,25,-0.00852878464818763,0.0354838709677419,0.0266524520255864
"5993","2014","전북","정읍시","초등학교",2014-04-01,"여자",475,437,435,-2,40,38,-0.0045766590389016,0.0919540229885057,0.0869565217391304
"5994","2014","전북","정읍시","초등학교",2014-04-01,"남자",488,501,495,-6,-7,-13,-0.0119760479041916,-0.0141414141414141,-0.0259481037924152
"5995","2014","전북","남원시","초등학교",2014-04-01,"전체",729,699,712,13,17,30,0.0185979971387697,0.023876404494382,0.0429184549356223
"5996","2014","전북","남원시","초등학교",2014-04-01,"여자",364,342,349,7,15,22,0.0204678362573099,0.0429799426934097,0.064327485380117
"5997","2014","전북","남원시","초등학교",2014-04-01,"남자",365,357,363,6,2,8,0.0168067226890756,0.00550964187327824,0.0224089635854342
"5998","2014","전북","김제시","초등학교",2014-04-01,"전체",669,675,675,0,-6,-6,0,-0.00888888888888889,-0.00888888888888889
"5999","2014","전북","김제시","초등학교",2014-04-01,"여자",334,361,359,-2,-25,-27,-0.00554016620498615,-0.0696378830083565,-0.074792243767313
"6000","2014","전북","김제시","초등학교",2014-04-01,"남자",335,314,316,2,19,21,0.00636942675159236,0.060126582278481,0.0668789808917197
"6001","2014","전북","완주군","초등학교",2014-04-01,"전체",916,883,921,38,-5,33,0.043035107587769,-0.00542888165038002,0.0373725934314836
"6002","2014","전북","완주군","초등학교",2014-04-01,"여자",441,436,455,19,-14,5,0.0435779816513761,-0.0307692307692308,0.0114678899082569
"6003","2014","전북","완주군","초등학교",2014-04-01,"남자",475,447,466,19,9,28,0.0425055928411633,0.01931330472103,0.0626398210290828
"6004","2014","전북","진안군","초등학교",2014-04-01,"전체",163,202,187,-15,-24,-39,-0.0742574257425743,-0.128342245989305,-0.193069306930693
"6005","2014","전북","진안군","초등학교",2014-04-01,"여자",82,95,94,-1,-12,-13,-0.0105263157894737,-0.127659574468085,-0.136842105263158
"6006","2014","전북","진안군","초등학교",2014-04-01,"남자",81,107,93,-14,-12,-26,-0.130841121495327,-0.129032258064516,-0.242990654205607
"6007","2014","전북","무주군","초등학교",2014-04-01,"전체",210,217,215,-2,-5,-7,-0.00921658986175115,-0.0232558139534884,-0.032258064516129
"6008","2014","전북","무주군","초등학교",2014-04-01,"여자",110,102,105,3,5,8,0.0294117647058824,0.0476190476190476,0.0784313725490196
"6009","2014","전북","무주군","초등학교",2014-04-01,"남자",100,115,110,-5,-10,-15,-0.0434782608695652,-0.0909090909090909,-0.130434782608696
"6010","2014","전북","장수군","초등학교",2014-04-01,"전체",179,196,192,-4,-13,-17,-0.0204081632653061,-0.0677083333333333,-0.086734693877551
"6011","2014","전북","장수군","초등학교",2014-04-01,"여자",103,103,98,-5,5,0,-0.0485436893203883,0.0510204081632653,0
"6012","2014","전북","장수군","초등학교",2014-04-01,"남자",76,93,94,1,-18,-17,0.010752688172043,-0.191489361702128,-0.182795698924731
"6013","2014","전북","임실군","초등학교",2014-04-01,"전체",163,177,172,-5,-9,-14,-0.0282485875706215,-0.0523255813953488,-0.0790960451977401
"6014","2014","전북","임실군","초등학교",2014-04-01,"여자",79,88,91,3,-12,-9,0.0340909090909091,-0.131868131868132,-0.102272727272727
"6015","2014","전북","임실군","초등학교",2014-04-01,"남자",84,89,81,-8,3,-5,-0.0898876404494382,0.037037037037037,-0.0561797752808989
"6016","2014","전북","순창군","초등학교",2014-04-01,"전체",208,237,221,-16,-13,-29,-0.0675105485232067,-0.0588235294117647,-0.122362869198312
"6017","2014","전북","순창군","초등학교",2014-04-01,"여자",97,117,108,-9,-11,-20,-0.0769230769230769,-0.101851851851852,-0.170940170940171
"6018","2014","전북","순창군","초등학교",2014-04-01,"남자",111,120,113,-7,-2,-9,-0.0583333333333333,-0.0176991150442478,-0.075
"6019","2014","전북","고창군","초등학교",2014-04-01,"전체",394,393,396,3,-2,1,0.00763358778625954,-0.00505050505050505,0.00254452926208651
"6020","2014","전북","고창군","초등학교",2014-04-01,"여자",189,186,193,7,-4,3,0.0376344086021505,-0.0207253886010363,0.0161290322580645
"6021","2014","전북","고창군","초등학교",2014-04-01,"남자",205,207,203,-4,2,-2,-0.0193236714975845,0.00985221674876847,-0.00966183574879227
"6022","2014","전북","부안군","초등학교",2014-04-01,"전체",353,392,392,0,-39,-39,0,-0.0994897959183673,-0.0994897959183673
"6023","2014","전북","부안군","초등학교",2014-04-01,"여자",176,191,194,3,-18,-15,0.0157068062827225,-0.0927835051546392,-0.0785340314136126
"6024","2014","전북","부안군","초등학교",2014-04-01,"남자",177,201,198,-3,-21,-24,-0.0149253731343284,-0.106060606060606,-0.119402985074627
"6025","2014","전남","목포시","초등학교",2014-04-01,"전체",2741,2653,2629,-24,112,88,-0.00904636260836789,0.0426017497147204,0.0331699962306822
"6026","2014","전남","목포시","초등학교",2014-04-01,"여자",1317,1291,1272,-19,45,26,-0.0147172734314485,0.035377358490566,0.0201394268009295
"6027","2014","전남","목포시","초등학교",2014-04-01,"남자",1424,1362,1357,-5,67,62,-0.00367107195301028,0.049373618275608,0.0455212922173275
"6028","2014","전남","여수시","초등학교",2014-04-01,"전체",2677,2775,2767,-8,-90,-98,-0.00288288288288288,-0.0325262016624503,-0.0353153153153153
"6029","2014","전남","여수시","초등학교",2014-04-01,"여자",1338,1372,1375,3,-37,-34,0.0021865889212828,-0.0269090909090909,-0.0247813411078717
"6030","2014","전남","여수시","초등학교",2014-04-01,"남자",1339,1403,1392,-11,-53,-64,-0.00784034212401996,-0.0380747126436782,-0.0456165359942979
"6031","2014","전남","순천시","초등학교",2014-04-01,"전체",2872,2651,2748,97,124,221,0.036589966050547,0.0451237263464338,0.0833647680120709
"6032","2014","전남","순천시","초등학교",2014-04-01,"여자",1348,1278,1321,43,27,70,0.0336463223787167,0.020439061317184,0.054773082942097
"6033","2014","전남","순천시","초등학교",2014-04-01,"남자",1524,1373,1427,54,97,151,0.0393299344501093,0.0679747722494744,0.109978150036417
"6034","2014","전남","나주시","초등학교",2014-04-01,"전체",597,638,643,5,-46,-41,0.00783699059561128,-0.0715396578538103,-0.0642633228840125
"6035","2014","전남","나주시","초등학교",2014-04-01,"여자",282,294,293,-1,-11,-12,-0.00340136054421769,-0.037542662116041,-0.0408163265306122
"6036","2014","전남","나주시","초등학교",2014-04-01,"남자",315,344,350,6,-35,-29,0.0174418604651163,-0.1,-0.0843023255813953
"6037","2014","전남","광양시","초등학교",2014-04-01,"전체",1610,1724,1690,-34,-80,-114,-0.0197215777262181,-0.0473372781065089,-0.0661252900232019
"6038","2014","전남","광양시","초등학교",2014-04-01,"여자",765,808,802,-6,-37,-43,-0.00742574257425743,-0.0461346633416459,-0.0532178217821782
"6039","2014","전남","광양시","초등학교",2014-04-01,"남자",845,916,888,-28,-43,-71,-0.0305676855895196,-0.0484234234234234,-0.0775109170305677
"6040","2014","전남","담양군","초등학교",2014-04-01,"전체",233,288,286,-2,-53,-55,-0.00694444444444444,-0.185314685314685,-0.190972222222222
"6041","2014","전남","담양군","초등학교",2014-04-01,"여자",116,145,137,-8,-21,-29,-0.0551724137931034,-0.153284671532847,-0.2
"6042","2014","전남","담양군","초등학교",2014-04-01,"남자",117,143,149,6,-32,-26,0.041958041958042,-0.214765100671141,-0.181818181818182
"6043","2014","전남","곡성군","초등학교",2014-04-01,"전체",154,177,172,-5,-18,-23,-0.0282485875706215,-0.104651162790698,-0.129943502824859
"6044","2014","전남","곡성군","초등학교",2014-04-01,"여자",74,89,89,0,-15,-15,0,-0.168539325842697,-0.168539325842697
"6045","2014","전남","곡성군","초등학교",2014-04-01,"남자",80,88,83,-5,-3,-8,-0.0568181818181818,-0.036144578313253,-0.0909090909090909
"6046","2014","전남","구례군","초등학교",2014-04-01,"전체",184,183,180,-3,4,1,-0.0163934426229508,0.0222222222222222,0.00546448087431694
"6047","2014","전남","구례군","초등학교",2014-04-01,"여자",86,73,80,7,6,13,0.0958904109589041,0.075,0.178082191780822
"6048","2014","전남","구례군","초등학교",2014-04-01,"남자",98,110,100,-10,-2,-12,-0.0909090909090909,-0.02,-0.109090909090909
"6049","2014","전남","고흥군","초등학교",2014-04-01,"전체",388,405,403,-2,-15,-17,-0.00493827160493827,-0.0372208436724566,-0.0419753086419753
"6050","2014","전남","고흥군","초등학교",2014-04-01,"여자",185,192,187,-5,-2,-7,-0.0260416666666667,-0.0106951871657754,-0.0364583333333333
"6051","2014","전남","고흥군","초등학교",2014-04-01,"남자",203,213,216,3,-13,-10,0.0140845070422535,-0.0601851851851852,-0.0469483568075117
"6052","2014","전남","보성군","초등학교",2014-04-01,"전체",256,354,320,-34,-64,-98,-0.096045197740113,-0.2,-0.27683615819209
"6053","2014","전남","보성군","초등학교",2014-04-01,"여자",129,169,151,-18,-22,-40,-0.106508875739645,-0.145695364238411,-0.236686390532544
"6054","2014","전남","보성군","초등학교",2014-04-01,"남자",127,185,169,-16,-42,-58,-0.0864864864864865,-0.248520710059172,-0.313513513513514
"6055","2014","전남","화순군","초등학교",2014-04-01,"전체",611,653,641,-12,-30,-42,-0.0183767228177642,-0.046801872074883,-0.0643185298621746
"6056","2014","전남","화순군","초등학교",2014-04-01,"여자",313,322,312,-10,1,-9,-0.031055900621118,0.00320512820512821,-0.0279503105590062
"6057","2014","전남","화순군","초등학교",2014-04-01,"남자",298,331,329,-2,-31,-33,-0.00604229607250755,-0.0942249240121581,-0.0996978851963746
"6058","2014","전남","장흥군","초등학교",2014-04-01,"전체",258,250,249,-1,9,8,-0.004,0.036144578313253,0.032
"6059","2014","전남","장흥군","초등학교",2014-04-01,"여자",125,121,124,3,1,4,0.0247933884297521,0.00806451612903226,0.0330578512396694
"6060","2014","전남","장흥군","초등학교",2014-04-01,"남자",133,129,125,-4,8,4,-0.0310077519379845,0.064,0.0310077519379845
"6061","2014","전남","강진군","초등학교",2014-04-01,"전체",249,308,287,-21,-38,-59,-0.0681818181818182,-0.132404181184669,-0.191558441558442
"6062","2014","전남","강진군","초등학교",2014-04-01,"여자",130,160,146,-14,-16,-30,-0.0875,-0.10958904109589,-0.1875
"6063","2014","전남","강진군","초등학교",2014-04-01,"남자",119,148,141,-7,-22,-29,-0.0472972972972973,-0.156028368794326,-0.195945945945946
"6064","2014","전남","해남군","초등학교",2014-04-01,"전체",499,564,561,-3,-62,-65,-0.00531914893617021,-0.110516934046346,-0.115248226950355
"6065","2014","전남","해남군","초등학교",2014-04-01,"여자",260,271,271,0,-11,-11,0,-0.040590405904059,-0.040590405904059
"6066","2014","전남","해남군","초등학교",2014-04-01,"남자",239,293,290,-3,-51,-54,-0.0102389078498294,-0.175862068965517,-0.184300341296928
"6067","2014","전남","영암군","초등학교",2014-04-01,"전체",497,602,583,-19,-86,-105,-0.0315614617940199,-0.147512864493997,-0.174418604651163
"6068","2014","전남","영암군","초등학교",2014-04-01,"여자",258,321,313,-8,-55,-63,-0.0249221183800623,-0.175718849840256,-0.196261682242991
"6069","2014","전남","영암군","초등학교",2014-04-01,"남자",239,281,270,-11,-31,-42,-0.0391459074733096,-0.114814814814815,-0.149466192170818
"6070","2014","전남","무안군","초등학교",2014-04-01,"전체",775,777,802,25,-27,-2,0.0321750321750322,-0.0336658354114713,-0.00257400257400257
"6071","2014","전남","무안군","초등학교",2014-04-01,"여자",381,367,379,12,2,14,0.0326975476839237,0.00527704485488127,0.0381471389645777
"6072","2014","전남","무안군","초등학교",2014-04-01,"남자",394,410,423,13,-29,-16,0.0317073170731707,-0.0685579196217494,-0.0390243902439024
"6073","2014","전남","함평군","초등학교",2014-04-01,"전체",192,217,204,-13,-12,-25,-0.0599078341013825,-0.0588235294117647,-0.115207373271889
"6074","2014","전남","함평군","초등학교",2014-04-01,"여자",95,112,100,-12,-5,-17,-0.107142857142857,-0.05,-0.151785714285714
"6075","2014","전남","함평군","초등학교",2014-04-01,"남자",97,105,104,-1,-7,-8,-0.00952380952380952,-0.0673076923076923,-0.0761904761904762
"6076","2014","전남","영광군","초등학교",2014-04-01,"전체",425,474,463,-11,-38,-49,-0.0232067510548523,-0.08207343412527,-0.10337552742616
"6077","2014","전남","영광군","초등학교",2014-04-01,"여자",206,245,243,-2,-37,-39,-0.00816326530612245,-0.152263374485597,-0.159183673469388
"6078","2014","전남","영광군","초등학교",2014-04-01,"남자",219,229,220,-9,-1,-10,-0.0393013100436681,-0.00454545454545455,-0.0436681222707424
"6079","2014","전남","장성군","초등학교",2014-04-01,"전체",340,336,331,-5,9,4,-0.0148809523809524,0.027190332326284,0.0119047619047619
"6080","2014","전남","장성군","초등학교",2014-04-01,"여자",156,159,158,-1,-2,-3,-0.00628930817610063,-0.0126582278481013,-0.0188679245283019
"6081","2014","전남","장성군","초등학교",2014-04-01,"남자",184,177,173,-4,11,7,-0.0225988700564972,0.0635838150289017,0.0395480225988701
"6082","2014","전남","완도군","초등학교",2014-04-01,"전체",376,382,383,1,-7,-6,0.00261780104712042,-0.0182767624020888,-0.0157068062827225
"6083","2014","전남","완도군","초등학교",2014-04-01,"여자",190,199,200,1,-10,-9,0.0050251256281407,-0.05,-0.0452261306532663
"6084","2014","전남","완도군","초등학교",2014-04-01,"남자",186,183,183,0,3,3,0,0.0163934426229508,0.0163934426229508
"6085","2014","전남","진도군","초등학교",2014-04-01,"전체",241,237,238,1,3,4,0.00421940928270042,0.0126050420168067,0.0168776371308017
"6086","2014","전남","진도군","초등학교",2014-04-01,"여자",128,124,124,0,4,4,0,0.032258064516129,0.032258064516129
"6087","2014","전남","진도군","초등학교",2014-04-01,"남자",113,113,114,1,-1,0,0.00884955752212389,-0.0087719298245614,0
"6088","2014","전남","신안군","초등학교",2014-04-01,"전체",174,238,234,-4,-60,-64,-0.0168067226890756,-0.256410256410256,-0.26890756302521
"6089","2014","전남","신안군","초등학교",2014-04-01,"여자",76,106,106,0,-30,-30,0,-0.283018867924528,-0.283018867924528
"6090","2014","전남","신안군","초등학교",2014-04-01,"남자",98,132,128,-4,-30,-34,-0.0303030303030303,-0.234375,-0.257575757575758
"6091","2014","경북","포항시","초등학교",2014-04-01,"전체",4684,4704,4736,32,-52,-20,0.00680272108843537,-0.0109797297297297,-0.00425170068027211
"6092","2014","경북","포항시","초등학교",2014-04-01,"여자",2256,2306,2321,15,-65,-50,0.00650477016478751,-0.028005170185265,-0.0216825672159584
"6093","2014","경북","포항시","초등학교",2014-04-01,"남자",2428,2398,2415,17,13,30,0.00708924103419516,0.00538302277432712,0.0125104253544621
"6094","2014","경북","경주시","초등학교",2014-04-01,"전체",2153,2220,2197,-23,-44,-67,-0.0103603603603604,-0.0200273099681384,-0.0301801801801802
"6095","2014","경북","경주시","초등학교",2014-04-01,"여자",1044,1049,1049,0,-5,-5,0,-0.00476644423260248,-0.00476644423260248
"6096","2014","경북","경주시","초등학교",2014-04-01,"남자",1109,1171,1148,-23,-39,-62,-0.0196413321947054,-0.0339721254355401,-0.0529461998292058
"6097","2014","경북","김천시","초등학교",2014-04-01,"전체",1028,1126,1121,-5,-93,-98,-0.0044404973357016,-0.0829616413916146,-0.0870337477797513
"6098","2014","경북","김천시","초등학교",2014-04-01,"여자",490,517,512,-5,-22,-27,-0.00967117988394584,-0.04296875,-0.0522243713733075
"6099","2014","경북","김천시","초등학교",2014-04-01,"남자",538,609,609,0,-71,-71,0,-0.116584564860427,-0.116584564860427
"6100","2014","경북","안동시","초등학교",2014-04-01,"전체",1391,1449,1423,-26,-32,-58,-0.0179434092477571,-0.022487702037948,-0.0400276052449966
"6101","2014","경북","안동시","초등학교",2014-04-01,"여자",665,695,689,-6,-24,-30,-0.00863309352517986,-0.034833091436865,-0.0431654676258993
"6102","2014","경북","안동시","초등학교",2014-04-01,"남자",726,754,734,-20,-8,-28,-0.026525198938992,-0.0108991825613079,-0.0371352785145889
"6103","2014","경북","구미시","초등학교",2014-04-01,"전체",4962,5105,5059,-46,-97,-143,-0.00901077375122429,-0.0191737497529156,-0.0280117531831538
"6104","2014","경북","구미시","초등학교",2014-04-01,"여자",2380,2508,2479,-29,-99,-128,-0.0115629984051037,-0.0399354578459056,-0.05103668261563
"6105","2014","경북","구미시","초등학교",2014-04-01,"남자",2582,2597,2580,-17,2,-15,-0.006546014632268,0.000775193798449612,-0.00577589526376588
"6106","2014","경북","영주시","초등학교",2014-04-01,"전체",840,866,869,3,-29,-26,0.00346420323325635,-0.0333716915995397,-0.0300230946882217
"6107","2014","경북","영주시","초등학교",2014-04-01,"여자",421,448,458,10,-37,-27,0.0223214285714286,-0.0807860262008734,-0.0602678571428571
"6108","2014","경북","영주시","초등학교",2014-04-01,"남자",419,418,411,-7,8,1,-0.0167464114832536,0.0194647201946472,0.00239234449760766
"6109","2014","경북","영천시","초등학교",2014-04-01,"전체",644,685,655,-30,-11,-41,-0.0437956204379562,-0.016793893129771,-0.0598540145985401
"6110","2014","경북","영천시","초등학교",2014-04-01,"여자",296,322,296,-26,0,-26,-0.0807453416149068,0,-0.0807453416149068
"6111","2014","경북","영천시","초등학교",2014-04-01,"남자",348,363,359,-4,-11,-15,-0.0110192837465565,-0.0306406685236769,-0.0413223140495868
"6112","2014","경북","상주시","초등학교",2014-04-01,"전체",703,735,738,3,-35,-32,0.00408163265306122,-0.0474254742547425,-0.0435374149659864
"6113","2014","경북","상주시","초등학교",2014-04-01,"여자",324,307,312,5,12,17,0.0162866449511401,0.0384615384615385,0.0553745928338762
"6114","2014","경북","상주시","초등학교",2014-04-01,"남자",379,428,426,-2,-47,-49,-0.00467289719626168,-0.110328638497653,-0.114485981308411
"6115","2014","경북","문경시","초등학교",2014-04-01,"전체",507,500,505,5,2,7,0.01,0.00396039603960396,0.014
"6116","2014","경북","문경시","초등학교",2014-04-01,"여자",228,218,218,0,10,10,0,0.0458715596330275,0.0458715596330275
"6117","2014","경북","문경시","초등학교",2014-04-01,"남자",279,282,287,5,-8,-3,0.0177304964539007,-0.0278745644599303,-0.0106382978723404
"6118","2014","경북","경산시","초등학교",2014-04-01,"전체",2386,2545,2553,8,-167,-159,0.0031434184675835,-0.0654132393262828,-0.062475442043222
"6119","2014","경북","경산시","초등학교",2014-04-01,"여자",1159,1227,1233,6,-74,-68,0.00488997555012225,-0.0600162206001622,-0.0554197229013855
"6120","2014","경북","경산시","초등학교",2014-04-01,"남자",1227,1318,1320,2,-93,-91,0.00151745068285281,-0.0704545454545455,-0.0690440060698027
"6121","2014","경북","군위군","초등학교",2014-04-01,"전체",80,104,102,-2,-22,-24,-0.0192307692307692,-0.215686274509804,-0.230769230769231
"6122","2014","경북","군위군","초등학교",2014-04-01,"여자",37,46,46,0,-9,-9,0,-0.195652173913043,-0.195652173913043
"6123","2014","경북","군위군","초등학교",2014-04-01,"남자",43,58,56,-2,-13,-15,-0.0344827586206897,-0.232142857142857,-0.258620689655172
"6124","2014","경북","의성군","초등학교",2014-04-01,"전체",225,263,263,0,-38,-38,0,-0.144486692015209,-0.144486692015209
"6125","2014","경북","의성군","초등학교",2014-04-01,"여자",120,130,125,-5,-5,-10,-0.0384615384615385,-0.04,-0.0769230769230769
"6126","2014","경북","의성군","초등학교",2014-04-01,"남자",105,133,138,5,-33,-28,0.037593984962406,-0.239130434782609,-0.210526315789474
"6127","2014","경북","청송군","초등학교",2014-04-01,"전체",125,138,138,0,-13,-13,0,-0.0942028985507246,-0.0942028985507246
"6128","2014","경북","청송군","초등학교",2014-04-01,"여자",62,70,67,-3,-5,-8,-0.0428571428571429,-0.0746268656716418,-0.114285714285714
"6129","2014","경북","청송군","초등학교",2014-04-01,"남자",63,68,71,3,-8,-5,0.0441176470588235,-0.112676056338028,-0.0735294117647059
"6130","2014","경북","영양군","초등학교",2014-04-01,"전체",107,118,123,5,-16,-11,0.0423728813559322,-0.130081300813008,-0.0932203389830508
"6131","2014","경북","영양군","초등학교",2014-04-01,"여자",51,63,69,6,-18,-12,0.0952380952380952,-0.260869565217391,-0.19047619047619
"6132","2014","경북","영양군","초등학교",2014-04-01,"남자",56,55,54,-1,2,1,-0.0181818181818182,0.037037037037037,0.0181818181818182
"6133","2014","경북","영덕군","초등학교",2014-04-01,"전체",216,225,227,2,-11,-9,0.00888888888888889,-0.0484581497797357,-0.04
"6134","2014","경북","영덕군","초등학교",2014-04-01,"여자",98,109,114,5,-16,-11,0.0458715596330275,-0.140350877192982,-0.100917431192661
"6135","2014","경북","영덕군","초등학교",2014-04-01,"남자",118,116,113,-3,5,2,-0.0258620689655172,0.0442477876106195,0.0172413793103448
"6136","2014","경북","청도군","초등학교",2014-04-01,"전체",216,226,220,-6,-4,-10,-0.0265486725663717,-0.0181818181818182,-0.0442477876106195
"6137","2014","경북","청도군","초등학교",2014-04-01,"여자",114,118,116,-2,-2,-4,-0.0169491525423729,-0.0172413793103448,-0.0338983050847458
"6138","2014","경북","청도군","초등학교",2014-04-01,"남자",102,108,104,-4,-2,-6,-0.037037037037037,-0.0192307692307692,-0.0555555555555556
"6139","2014","경북","고령군","초등학교",2014-04-01,"전체",247,268,266,-2,-19,-21,-0.00746268656716418,-0.0714285714285714,-0.0783582089552239
"6140","2014","경북","고령군","초등학교",2014-04-01,"여자",119,123,124,1,-5,-4,0.00813008130081301,-0.0403225806451613,-0.032520325203252
"6141","2014","경북","고령군","초등학교",2014-04-01,"남자",128,145,142,-3,-14,-17,-0.0206896551724138,-0.0985915492957746,-0.117241379310345
"6142","2014","경북","성주군","초등학교",2014-04-01,"전체",203,237,242,5,-39,-34,0.0210970464135021,-0.161157024793388,-0.143459915611814
"6143","2014","경북","성주군","초등학교",2014-04-01,"여자",96,123,118,-5,-22,-27,-0.040650406504065,-0.186440677966102,-0.219512195121951
"6144","2014","경북","성주군","초등학교",2014-04-01,"남자",107,114,124,10,-17,-7,0.087719298245614,-0.137096774193548,-0.0614035087719298
"6145","2014","경북","칠곡군","초등학교",2014-04-01,"전체",1316,1479,1429,-50,-113,-163,-0.0338066260987153,-0.0790762771168649,-0.110209601081812
"6146","2014","경북","칠곡군","초등학교",2014-04-01,"여자",607,706,691,-15,-84,-99,-0.0212464589235127,-0.121562952243126,-0.140226628895184
"6147","2014","경북","칠곡군","초등학교",2014-04-01,"남자",709,773,738,-35,-29,-64,-0.0452781371280724,-0.0392953929539295,-0.0827943078913325
"6148","2014","경북","예천군","초등학교",2014-04-01,"전체",248,284,281,-3,-33,-36,-0.0105633802816901,-0.117437722419929,-0.126760563380282
"6149","2014","경북","예천군","초등학교",2014-04-01,"여자",107,128,127,-1,-20,-21,-0.0078125,-0.15748031496063,-0.1640625
"6150","2014","경북","예천군","초등학교",2014-04-01,"남자",141,156,154,-2,-13,-15,-0.0128205128205128,-0.0844155844155844,-0.0961538461538462
"6151","2014","경북","봉화군","초등학교",2014-04-01,"전체",186,220,218,-2,-32,-34,-0.00909090909090909,-0.146788990825688,-0.154545454545455
"6152","2014","경북","봉화군","초등학교",2014-04-01,"여자",106,125,122,-3,-16,-19,-0.024,-0.131147540983607,-0.152
"6153","2014","경북","봉화군","초등학교",2014-04-01,"남자",80,95,96,1,-16,-15,0.0105263157894737,-0.166666666666667,-0.157894736842105
"6154","2014","경북","울진군","초등학교",2014-04-01,"전체",400,400,389,-11,11,0,-0.0275,0.0282776349614396,0
"6155","2014","경북","울진군","초등학교",2014-04-01,"여자",180,182,179,-3,1,-2,-0.0164835164835165,0.00558659217877095,-0.010989010989011
"6156","2014","경북","울진군","초등학교",2014-04-01,"남자",220,218,210,-8,10,2,-0.036697247706422,0.0476190476190476,0.00917431192660551
"6157","2014","경북","울릉군","초등학교",2014-04-01,"전체",54,61,56,-5,-2,-7,-0.0819672131147541,-0.0357142857142857,-0.114754098360656
"6158","2014","경북","울릉군","초등학교",2014-04-01,"여자",35,34,32,-2,3,1,-0.0588235294117647,0.09375,0.0294117647058824
"6159","2014","경북","울릉군","초등학교",2014-04-01,"남자",19,27,24,-3,-5,-8,-0.111111111111111,-0.208333333333333,-0.296296296296296
"6160","2014","경남","진주시","초등학교",2014-04-01,"전체",3364,3346,3376,30,-12,18,0.00896592946802152,-0.00355450236966825,0.00537955768081291
"6161","2014","경남","진주시","초등학교",2014-04-01,"여자",1648,1624,1650,26,-2,24,0.0160098522167488,-0.00121212121212121,0.0147783251231527
"6162","2014","경남","진주시","초등학교",2014-04-01,"남자",1716,1722,1726,4,-10,-6,0.00232288037166086,-0.00579374275782155,-0.00348432055749129
"6163","2014","경남","통영시","초등학교",2014-04-01,"전체",1483,1572,1554,-18,-71,-89,-0.0114503816793893,-0.0456885456885457,-0.0566157760814249
"6164","2014","경남","통영시","초등학교",2014-04-01,"여자",729,797,792,-5,-63,-68,-0.00627352572145546,-0.0795454545454545,-0.0853199498117942
"6165","2014","경남","통영시","초등학교",2014-04-01,"남자",754,775,762,-13,-8,-21,-0.0167741935483871,-0.010498687664042,-0.0270967741935484
"6166","2014","경남","사천시","초등학교",2014-04-01,"전체",1172,1210,1224,14,-52,-38,0.0115702479338843,-0.042483660130719,-0.031404958677686
"6167","2014","경남","사천시","초등학교",2014-04-01,"여자",585,586,594,8,-9,-1,0.0136518771331058,-0.0151515151515152,-0.00170648464163823
"6168","2014","경남","사천시","초등학교",2014-04-01,"남자",587,624,630,6,-43,-37,0.00961538461538462,-0.0682539682539682,-0.0592948717948718
"6169","2014","경남","김해시","초등학교",2014-04-01,"전체",6507,6500,6510,10,-3,7,0.00153846153846154,-0.000460829493087558,0.00107692307692308
"6170","2014","경남","김해시","초등학교",2014-04-01,"여자",3195,3150,3155,5,40,45,0.00158730158730159,0.0126782884310618,0.0142857142857143
"6171","2014","경남","김해시","초등학교",2014-04-01,"남자",3312,3350,3355,5,-43,-38,0.00149253731343284,-0.0128166915052161,-0.0113432835820896
"6172","2014","경남","밀양시","초등학교",2014-04-01,"전체",782,786,787,1,-5,-4,0.00127226463104326,-0.00635324015247776,-0.00508905852417303
"6173","2014","경남","밀양시","초등학교",2014-04-01,"여자",380,399,397,-2,-17,-19,-0.0050125313283208,-0.0428211586901763,-0.0476190476190476
"6174","2014","경남","밀양시","초등학교",2014-04-01,"남자",402,387,390,3,12,15,0.00775193798449612,0.0307692307692308,0.0387596899224806
"6175","2014","경남","거제시","초등학교",2014-04-01,"전체",3060,3195,3177,-18,-117,-135,-0.00563380281690141,-0.0368271954674221,-0.0422535211267606
"6176","2014","경남","거제시","초등학교",2014-04-01,"여자",1466,1586,1582,-4,-116,-120,-0.00252206809583859,-0.0733249051833123,-0.0756620428751576
"6177","2014","경남","거제시","초등학교",2014-04-01,"남자",1594,1609,1595,-14,-1,-15,-0.00870105655686762,-0.000626959247648903,-0.00932256059664388
"6178","2014","경남","양산시","초등학교",2014-04-01,"전체",3194,3171,3159,-12,35,23,-0.00378429517502365,0.0110794555239,0.00725323241879533
"6179","2014","경남","양산시","초등학교",2014-04-01,"여자",1582,1504,1507,3,75,78,0.00199468085106383,0.0497677504976775,0.0518617021276596
"6180","2014","경남","양산시","초등학교",2014-04-01,"남자",1612,1667,1652,-15,-40,-55,-0.00899820035992801,-0.0242130750605327,-0.0329934013197361
"6181","2014","경남","의령군","초등학교",2014-04-01,"전체",142,198,193,-5,-51,-56,-0.0252525252525253,-0.264248704663212,-0.282828282828283
"6182","2014","경남","의령군","초등학교",2014-04-01,"여자",73,102,101,-1,-28,-29,-0.00980392156862745,-0.277227722772277,-0.284313725490196
"6183","2014","경남","의령군","초등학교",2014-04-01,"남자",69,96,92,-4,-23,-27,-0.0416666666666667,-0.25,-0.28125
"6184","2014","경남","함안군","초등학교",2014-04-01,"전체",630,676,672,-4,-42,-46,-0.00591715976331361,-0.0625,-0.0680473372781065
"6185","2014","경남","함안군","초등학교",2014-04-01,"여자",305,315,314,-1,-9,-10,-0.00317460317460317,-0.0286624203821656,-0.0317460317460317
"6186","2014","경남","함안군","초등학교",2014-04-01,"남자",325,361,358,-3,-33,-36,-0.00831024930747922,-0.0921787709497207,-0.0997229916897507
"6187","2014","경남","창녕군","초등학교",2014-04-01,"전체",399,389,402,13,-3,10,0.0334190231362468,-0.00746268656716418,0.025706940874036
"6188","2014","경남","창녕군","초등학교",2014-04-01,"여자",179,184,187,3,-8,-5,0.016304347826087,-0.0427807486631016,-0.0271739130434783
"6189","2014","경남","창녕군","초등학교",2014-04-01,"남자",220,205,215,10,5,15,0.0487804878048781,0.0232558139534884,0.0731707317073171
"6190","2014","경남","고성군","초등학교",2014-04-01,"전체",382,418,425,7,-43,-36,0.0167464114832536,-0.101176470588235,-0.0861244019138756
"6191","2014","경남","고성군","초등학교",2014-04-01,"여자",172,186,189,3,-17,-14,0.0161290322580645,-0.0899470899470899,-0.0752688172043011
"6192","2014","경남","고성군","초등학교",2014-04-01,"남자",210,232,236,4,-26,-22,0.0172413793103448,-0.110169491525424,-0.0948275862068965
"6193","2014","경남","남해군","초등학교",2014-04-01,"전체",245,280,271,-9,-26,-35,-0.0321428571428571,-0.0959409594095941,-0.125
"6194","2014","경남","남해군","초등학교",2014-04-01,"여자",124,133,128,-5,-4,-9,-0.037593984962406,-0.03125,-0.0676691729323308
"6195","2014","경남","남해군","초등학교",2014-04-01,"남자",121,147,143,-4,-22,-26,-0.0272108843537415,-0.153846153846154,-0.17687074829932
"6196","2014","경남","하동군","초등학교",2014-04-01,"전체",296,304,301,-3,-5,-8,-0.00986842105263158,-0.0166112956810631,-0.0263157894736842
"6197","2014","경남","하동군","초등학교",2014-04-01,"여자",133,143,141,-2,-8,-10,-0.013986013986014,-0.0567375886524823,-0.0699300699300699
"6198","2014","경남","하동군","초등학교",2014-04-01,"남자",163,161,160,-1,3,2,-0.0062111801242236,0.01875,0.0124223602484472
"6199","2014","경남","산청군","초등학교",2014-04-01,"전체",215,249,242,-7,-27,-34,-0.0281124497991968,-0.111570247933884,-0.136546184738956
"6200","2014","경남","산청군","초등학교",2014-04-01,"여자",105,113,102,-11,3,-8,-0.0973451327433628,0.0294117647058824,-0.0707964601769911
"6201","2014","경남","산청군","초등학교",2014-04-01,"남자",110,136,140,4,-30,-26,0.0294117647058824,-0.214285714285714,-0.191176470588235
"6202","2014","경남","함양군","초등학교",2014-04-01,"전체",283,328,317,-11,-34,-45,-0.0335365853658537,-0.107255520504732,-0.13719512195122
"6203","2014","경남","함양군","초등학교",2014-04-01,"여자",128,152,141,-11,-13,-24,-0.0723684210526316,-0.0921985815602837,-0.157894736842105
"6204","2014","경남","함양군","초등학교",2014-04-01,"남자",155,176,176,0,-21,-21,0,-0.119318181818182,-0.119318181818182
"6205","2014","경남","거창군","초등학교",2014-04-01,"전체",495,495,506,11,-11,0,0.0222222222222222,-0.0217391304347826,0
"6206","2014","경남","거창군","초등학교",2014-04-01,"여자",249,236,243,7,6,13,0.0296610169491525,0.0246913580246914,0.0550847457627119
"6207","2014","경남","거창군","초등학교",2014-04-01,"남자",246,259,263,4,-17,-13,0.0154440154440154,-0.064638783269962,-0.0501930501930502
"6208","2014","경남","합천군","초등학교",2014-04-01,"전체",273,315,328,13,-55,-42,0.0412698412698413,-0.167682926829268,-0.133333333333333
"6209","2014","경남","합천군","초등학교",2014-04-01,"여자",127,153,160,7,-33,-26,0.0457516339869281,-0.20625,-0.169934640522876
"6210","2014","경남","합천군","초등학교",2014-04-01,"남자",146,162,168,6,-22,-16,0.037037037037037,-0.130952380952381,-0.0987654320987654
"6211","2014","제주","제주시","초등학교",2014-04-01,"전체",5147,4778,4924,146,223,369,0.0305567182921725,0.0452883834281072,0.0772289660946003
"6212","2014","제주","제주시","초등학교",2014-04-01,"여자",2492,2308,2390,82,102,184,0.035528596187175,0.0426778242677824,0.0797227036395147
"6213","2014","제주","제주시","초등학교",2014-04-01,"남자",2655,2470,2534,64,121,185,0.0259109311740891,0.047750591949487,0.0748987854251012
"6214","2014","제주","서귀포시","초등학교",2014-04-01,"전체",1431,1472,1480,8,-49,-41,0.00543478260869565,-0.0331081081081081,-0.0278532608695652
"6215","2014","제주","서귀포시","초등학교",2014-04-01,"여자",711,745,754,9,-43,-34,0.0120805369127517,-0.0570291777188329,-0.0456375838926174
"6216","2014","제주","서귀포시","초등학교",2014-04-01,"남자",720,727,726,-1,-6,-7,-0.00137551581843191,-0.00826446280991736,-0.00962861072902338
