"","prov","distinct","adm.year","adm.total","adm.male","adm.female","pop.age","pop.year","pop.total","pop.male","pop.female","sum.adm.total","sum.pop.total","correction","adm.per.pop.total","corr.adm.per.pop.total","percent.adm","index","zscore"
"1","강원","강릉시",2010,2054,1059,995,"5",2008,2065,1052,1013,470657,486853,0.966733284995676,0.994673123486683,1.02890128945041,0.436411229409103,0.0126128472605621,0.137731683056494
"2","강원","강릉시",2011,1935,989,946,"5",2009,2017,1036,981,451574,467208,0.966537388058424,0.959345562716906,0.992559185572775,0.428501198031773,-0.00318839789639797,-0.0962546552074701
"3","강원","강릉시",2012,1735,919,816,"5",2010,1767,916,851,407210,420213,0.969056169133273,0.981890209394454,1.01324385589812,0.426070086687458,0.00564281083058633,0.0345187219501916
"4","강원","강릉시",2013,1704,923,781,"5",2011,1730,947,783,420229,433401,0.969607822778443,0.984971098265896,1.0158448345058,0.405493195376807,0.00642497257397325,0.0461010472952705
"5","강원","강릉시",2014,1839,999,840,"5",2012,1896,1013,883,464047,479002,0.968778835996509,0.969936708860759,1.00119518802561,0.39629606483826,0.000473648311292119,-0.0420267273334818
"6","강원","강릉시",2015,1627,850,777,"5",2013,1654,840,814,441255,454391,0.971090976713887,0.983675937122128,1.01295961007776,0.368721034322557,0.0047784808322879,0.0217196412863196
"7","강원","강릉시",2016,1659,820,839,"5",2014,1666,827,839,422114,434628,0.971207561408837,0.995798319327731,1.02531977601495,0.393021790322046,0.00995122369994743,0.0983181087084618
"8","강원","강릉시",2017,1625,869,756,"5",2015,1655,877,778,445571,459820,0.969011787221086,0.981873111782477,1.01327261931279,0.364700575216969,0.00484053189801,0.0226384993579126
"9","강원","강릉시",2018,1662,875,787,"5",2016,1660,882,778,447106,462028,0.967703256079718,1.00120481927711,1.03461966567428,0.371723931237783,0.0128689582225805,0.141524198494148
"10","강원","강릉시",2019,1627,824,803,"5",2017,1662,846,816,459384,475293,0.966528015350531,0.978941034897714,1.01284289679144,0.354169931908817,0.00454856788213635,0.0183150684953122
"11","강원","강릉시",2020,1451,770,681,"5",2018,1474,792,682,417119,431567,0.966522000060246,0.984396200814111,1.01849332012386,0.347862360621309,0.0064331299940108,0.0462218431455536
"12","강원","고성군",2010,196,99,97,"5",2008,213,112,101,470657,486853,0.966733284995676,0.92018779342723,0.951852809569235,0.0416439147829523,-0.00200503749533737,-0.0787313420545962
"13","강원","고성군",2011,175,97,78,"5",2009,202,105,97,451574,467208,0.966537388058424,0.866336633663366,0.896330182739914,0.038753338323287,-0.00401755150219344,-0.108532840511936
"14","강원","고성군",2012,183,102,81,"5",2010,189,99,90,407210,420213,0.969056169133273,0.968253968253968,0.999172183300766,0.0449399572702046,-3.72020470911496e-05,-0.0495914479343949
"15","강원","고성군",2013,181,99,82,"5",2011,188,103,85,420229,433401,0.969607822778443,0.962765957446808,0.992943677669566,0.0430717537342735,-0.000303928177686087,-0.0535411537960077
"16","강원","고성군",2014,162,91,71,"5",2012,174,94,80,464047,479002,0.968778835996509,0.931034482758621,0.961039246693427,0.0349102569351811,-0.00136012990832066,-0.0691814892863021
"17","강원","고성군",2015,160,94,66,"5",2013,162,90,72,441255,454391,0.971090976713887,0.987654320987654,1.01705642897622,0.0362602123488686,0.00061846973659107,-0.039882197920055
"18","강원","고성군",2016,144,69,75,"5",2014,143,68,75,422114,434628,0.971207561408837,1.00699300699301,1.03684634161235,0.0341140071165609,0.00125697635998303,-0.0304271312287465
"19","강원","고성군",2017,154,82,72,"5",2015,155,87,68,445571,459820,0.969011787221086,0.993548387096774,1.02532126048338,0.0345623929744081,0.000875163355433828,-0.0360810544448342
"20","강원","고성군",2018,163,90,73,"5",2016,160,92,68,447106,462028,0.967703256079718,1.01875,1.05275041041722,0.03645667917675,0.00192310478902236,-0.0205630382173305
"21","강원","고성군",2019,155,78,77,"5",2017,161,90,71,459384,475293,0.966528015350531,0.962732919254658,0.99607347533067,0.033740835553698,-0.000132484223165416,-0.0510023954426436
"22","강원","고성군",2020,150,76,74,"5",2018,127,59,68,417119,431567,0.966522000060246,1.18110236220472,1.22201291034359,0.0359609607809762,0.00798379756173608,0.069184275690112
"23","강원","동해시",2010,980,531,449,"5",2008,983,528,455,470657,486853,0.966733284995676,0.996948118006104,1.03125456987918,0.208219573914762,0.00650781322313218,0.0473277594919084
"24","강원","동해시",2011,943,507,436,"5",2009,923,502,421,451574,467208,0.966537388058424,1.0216684723727,1.05703978448782,0.208825131650626,0.0119113405049926,0.127343704427427
"25","강원","동해시",2012,845,436,409,"5",2010,838,441,397,407210,420213,0.969056169133273,1.00835322195704,1.04055188344646,0.207509638761327,0.00841490668506681,0.0755681805126958
"26","강원","동해시",2013,845,445,400,"5",2011,837,438,399,420229,433401,0.969607822778443,1.00955794504182,1.04120235142998,0.201080839256691,0.00828500340488905,0.0736445604083722
"27","강원","동해시",2014,928,484,444,"5",2012,888,458,430,464047,479002,0.968778835996509,1.04504504504505,1.07872406602492,0.199979743431161,0.0157432185255215,0.184086517907718
"28","강원","동해시",2015,836,452,384,"5",2013,814,432,382,441255,454391,0.971090976713887,1.02702702702703,1.0576012460773,0.189459609522838,0.0109131095898337,0.112561806275747
"29","강원","동해시",2016,869,429,440,"5",2014,864,432,432,422114,434628,0.971207561408837,1.00578703703704,1.0356046194472,0.205868556835357,0.00732987162226614,0.0595008783025969
"30","강원","동해시",2017,810,426,384,"5",2015,819,440,379,445571,459820,0.969011787221086,0.989010989010989,1.02063876007871,0.181789209800458,0.00375190388597081,0.00651799241441838
"31","강원","동해시",2018,829,436,393,"5",2016,835,436,399,447106,462028,0.967703256079718,0.992814371257485,1.02594918950619,0.185414644401999,0.00481135974480977,0.0222065153440711
"32","강원","동해시",2019,861,439,422,"5",2017,875,448,427,459384,475293,0.966528015350531,0.984,1.01807705971475,0.187424899430542,0.00338809109903665,0.00113061812949798
"33","강원","동해시",2020,756,386,370,"5",2018,749,378,371,417119,431567,0.966522000060246,1.00934579439252,1.04430710768054,0.18124324233612,0.00803036385455621,0.0698738337746349
"34","강원","삼척시",2010,522,267,255,"5",2008,545,284,261,470657,486853,0.966733284995676,0.957798165137615,0.990757409518488,0.110908793452557,-0.00102508455868056,-0.0642201059436656
"35","강원","삼척시",2011,547,268,279,"5",2009,570,276,294,451574,467208,0.966537388058424,0.959649122807018,0.992873255254778,0.121131863216217,-0.000863275869655153,-0.0618240275164114
"36","강원","삼척시",2012,473,234,239,"5",2010,478,243,235,407210,420213,0.969056169133273,0.989539748953975,1.02113765999655,0.116156282998944,0.00245527201649516,-0.0126826553953731
"37","강원","삼척시",2013,464,256,208,"5",2011,495,273,222,420229,433401,0.969607822778443,0.937373737373737,0.966755543171735,0.110415987473497,-0.00367071952871286,-0.103396919724589
"38","강원","삼척시",2014,500,266,234,"5",2012,519,272,247,464047,479002,0.968778835996509,0.963391136801541,0.994438669596424,0.107747706590065,-0.000599220596574878,-0.0579138719664148
"39","강원","삼척시",2015,447,216,231,"5",2013,477,235,242,441255,454391,0.971090976713887,0.937106918238994,0.965004248530973,0.101301968249652,-0.00354513850418805,-0.101537303992278
"40","강원","삼척시",2016,461,249,212,"5",2014,496,265,231,422114,434628,0.971207561408837,0.929435483870968,0.95698954662454,0.109212203338435,-0.00469726637971904,-0.11859812294227
"41","강원","삼척시",2017,464,236,228,"5",2015,492,248,244,445571,459820,0.969011787221086,0.943089430894309,0.973248667695656,0.104136041169645,-0.00278577784218803,-0.0902926192248358
"42","강원","삼척시",2018,450,233,217,"5",2016,483,244,239,447106,462028,0.967703256079718,0.93167701863354,0.962771399992882,0.100647273800844,-0.00374695709813851,-0.10452585288972
"43","강원","삼척시",2019,486,260,226,"5",2017,492,264,228,459384,475293,0.966528015350531,0.98780487804878,1.02201370509735,0.105793845671595,0.00232891451972859,-0.0145537692023497
"44","강원","삼척시",2020,400,199,201,"5",2018,444,225,219,417119,431567,0.966522000060246,0.900900900900901,0.932105943625438,0.0958958954159365,-0.00651076132945868,-0.14545252830936
"45","강원","속초시",2010,847,429,418,"5",2008,833,426,407,470657,486853,0.966733284995676,1.01680672268908,1.05179653837369,0.179961203169187,0.0093213673657277,0.0889911363203699
"46","강원","속초시",2011,803,424,379,"5",2009,804,420,384,451574,467208,0.966537388058424,0.998756218905473,1.03333428302424,0.177822460991997,0.00592758424277407,0.0387356736708218
"47","강원","속초시",2012,677,339,338,"5",2010,674,340,334,407210,420213,0.969056169133273,1.00445103857567,1.03652509583015,0.166253284546057,0.00607241715012263,0.0408803731115294
"48","강원","속초시",2013,680,340,340,"5",2011,656,326,330,420229,433401,0.969607822778443,1.03658536585366,1.0690769417302,0.161816533366331,0.0111777912463295,0.116481237370821
"49","강원","속초시",2014,712,399,313,"5",2012,734,396,338,464047,479002,0.968778835996509,0.970027247956403,1.00128864495539,0.153432734184253,0.000197720318897985,-0.0461126952381309
"50","강원","속초시",2015,644,312,332,"5",2013,630,315,315,441255,454391,0.971090976713887,1.02222222222222,1.05265340399039,0.145947354704196,0.00768462502856821,0.064754100419129
"51","강원","속초시",2016,597,314,283,"5",2014,632,333,299,422114,434628,0.971207561408837,0.944620253164557,0.972624483889198,0.141430987837409,-0.0038717462861096,-0.106373743031177
"52","강원","속초시",2017,666,316,350,"5",2015,710,348,362,445571,459820,0.969011787221086,0.938028169014084,0.968025550756347,0.149471128058155,-0.00477925699748702,-0.119812247793379
"53","강원","속초시",2018,648,342,306,"5",2016,677,356,321,447106,462028,0.967703256079718,0.957163958641064,0.989108957345715,0.144932074273215,-0.00157846140288357,-0.0724145627835492
"54","강원","속초시",2019,663,324,339,"5",2017,673,322,351,459384,475293,0.966528015350531,0.985141158989599,1.0192577383619,0.144323703045818,0.00277934811267703,-0.00788370579923486
"55","강원","속초시",2020,579,274,305,"5",2018,606,296,310,417119,431567,0.966522000060246,0.955445544554455,0.988539882687513,0.138809308614568,-0.00159077096078817,-0.0725968438855217
"56","강원","양구군",2010,210,106,104,"5",2008,217,113,104,470657,486853,0.966733284995676,0.967741935483871,1.00104335963585,0.0446184801245918,4.65531211748609e-05,-0.048351193452006
"57","강원","양구군",2011,222,105,117,"5",2009,234,116,118,451574,467208,0.966537388058424,0.948717948717949,0.981563631618772,0.0491613777586841,-0.000906357270487802,-0.06246198098957
"58","강원","양구군",2012,192,100,92,"5",2010,196,108,88,407210,420213,0.969056169133273,0.979591836734694,1.01087209177033,0.0471501191031654,0.000512620421871583,-0.0414496246204788
"59","강원","양구군",2013,199,110,89,"5",2011,207,106,101,420229,433401,0.969607822778443,0.961352657004831,0.991486077587579,0.0473551325586763,-0.000403177924434482,-0.0550108534674322
"60","강원","양구군",2014,209,115,94,"5",2012,215,122,93,464047,479002,0.968778835996509,0.972093023255814,1.00342099469576,0.0450385413546473,0.000154076611078824,-0.0467589754065244
"61","강원","양구군",2015,197,106,91,"5",2013,208,109,99,441255,454391,0.971090976713887,0.947115384615385,0.975310663291678,0.0446453864545444,-0.00110226497864942,-0.065363000929143
"62","강원","양구군",2016,166,85,81,"5",2014,173,92,81,422114,434628,0.971207561408837,0.959537572254335,0.987984042116009,0.0393258693149244,-0.000472537989439449,-0.056037943894234
"63","강원","양구군",2017,197,93,104,"5",2015,207,101,106,445571,459820,0.969011787221086,0.951690821256039,0.982125123560447,0.0442129312724571,-0.000790300683525639,-0.0607434040328213
"64","강원","양구군",2018,199,110,89,"5",2016,213,117,96,447106,462028,0.967703256079718,0.934272300469484,0.965453298415397,0.0445084610808175,-0.00153762052294891,-0.0718097871565362
"65","강원","양구군",2019,195,97,98,"5",2017,217,112,105,459384,475293,0.966528015350531,0.898617511520737,0.929737676765464,0.0424481479546523,-0.0029825054922972,-0.0932057809426035
"66","강원","양구군",2020,166,83,83,"5",2018,183,85,98,417119,431567,0.966522000060246,0.907103825136612,0.938523722253679,0.0397967965976136,-0.00244655892104875,-0.085269433239251
"67","강원","양양군",2010,207,113,94,"5",2008,223,116,107,470657,486853,0.966733284995676,0.928251121076233,0.960193608188824,0.0439810732656691,-0.00175072783468926,-0.074965500458626
"68","강원","양양군",2011,180,103,77,"5",2009,210,118,92,451574,467208,0.966537388058424,0.857142857142857,0.886818107331246,0.0398605765610952,-0.00451149549805254,-0.115847210091705
"69","강원","양양군",2012,169,85,84,"5",2010,197,95,102,407210,420213,0.969056169133273,0.857868020304569,0.885261399317904,0.0415019277522654,-0.00476187311590438,-0.119554825624687
"70","강원","양양군",2013,168,82,86,"5",2011,173,90,83,420229,433401,0.969607822778443,0.971098265895954,1.00153716078037,0.0399782023610936,6.1452924738992e-05,-0.0481305557464207
"71","강원","양양군",2014,175,89,86,"5",2012,184,92,92,464047,479002,0.968778835996509,0.951086956521739,0.981737958327122,0.0377116973065228,-0.000688692587766674,-0.059238781705375
"72","강원","양양군",2015,150,87,63,"5",2013,163,93,70,441255,454391,0.971090976713887,0.920245398773006,0.947640767796093,0.0339939490770643,-0.0017798970732538,-0.0753974413122655
"73","강원","양양군",2016,151,70,81,"5",2014,162,74,88,422114,434628,0.971207561408837,0.932098765432099,0.959731783883553,0.0357723269069493,-0.00144048779087721,-0.070371436439408
"74","강원","양양군",2017,158,85,73,"5",2015,157,83,74,445571,459820,0.969011787221086,1.00636942675159,1.03855230661088,0.0354601174672499,0.0013670693210553,-0.02879686421029
"75","강원","양양군",2018,146,74,72,"5",2016,159,82,77,447106,462028,0.967703256079718,0.918238993710692,0.948884885879777,0.0326544488331626,-0.00166913587864009,-0.0737572790280933
"76","강원","양양군",2019,154,83,71,"5",2017,156,82,74,459384,475293,0.966528015350531,0.987179487179487,1.02136665621789,0.0335231527436741,0.000716277680013962,-0.0384338486091419
"77","강원","양양군",2020,141,76,65,"5",2018,136,72,64,417119,431567,0.966522000060246,1.03676470588235,1.07267574438836,0.0338033031341176,0.00245668021805747,-0.0126618026129608
"78","강원","영월군",2010,283,144,139,"5",2008,281,144,137,470657,486853,0.966733284995676,1.00711743772242,1.04177383085235,0.0601287136917118,0.0025118067151268,-0.0118454842113132
"79","강원","영월군",2011,287,147,140,"5",2009,300,148,152,451574,467208,0.966537388058424,0.956666666666667,0.989787543126929,0.0635554748501907,-0.000649057545955102,-0.0586518622437562
"80","강원","영월군",2012,244,132,112,"5",2010,252,138,114,407210,420213,0.969056169133273,0.968253968253968,0.999172183300766,0.0599199430269394,-4.96027294548727e-05,-0.0497750784160082
"81","강원","영월군",2013,253,137,116,"5",2011,254,132,122,420229,433401,0.969607822778443,0.996062992125984,1.02728440172,0.060205269031885,0.0016426647459266,-0.024715820997089
"82","강원","영월군",2014,254,136,118,"5",2012,269,140,129,464047,479002,0.968778835996509,0.944237918215613,0.9746681937414,0.0547358349477531,-0.00138655756629921,-0.0695728325543716
"83","강원","영월군",2015,232,120,112,"5",2013,242,125,117,441255,454391,0.971090976713887,0.958677685950413,0.987217170109561,0.0525773079058594,-0.000672086783057846,-0.0589928813728918
"84","강원","영월군",2016,205,113,92,"5",2014,211,114,97,422114,434628,0.971207561408837,0.971563981042654,1.00036698605734,0.0485650795756597,1.78227070777066e-05,-0.0487766361512758
"85","강원","영월군",2017,221,121,100,"5",2015,223,130,93,445571,459820,0.969011787221086,0.991031390134529,1.02272377199517,0.0495992782295078,0.00112708268961226,-0.0323506090301358
"86","강원","영월군",2018,238,115,123,"5",2016,253,126,127,447106,462028,0.967703256079718,0.940711462450593,0.972107365083722,0.053231224810224,-0.0014847591197779,-0.0710270104803556
"87","강원","영월군",2019,198,117,81,"5",2017,209,116,93,459384,475293,0.966528015350531,0.947368421052632,0.980176886760027,0.0431011963847239,-0.000854399896712682,-0.0616925912665014
"88","강원","영월군",2020,168,88,80,"5",2018,183,99,84,417119,431567,0.966522000060246,0.918032786885246,0.949831236979627,0.0402762760746933,-0.00202061094973442,-0.0789619552456637
"89","강원","원주시",2010,3262,1724,1538,"5",2008,3303,1733,1570,470657,486853,0.966733284995676,0.987587042082955,1.02157136555754,0.693073724601992,0.014950546671712,0.172348557849798
"90","강원","원주시",2011,3221,1671,1550,"5",2009,3188,1641,1547,451574,467208,0.966537388058424,1.0103513174404,1.04533081691748,0.713282872796042,0.0323336953170931,0.429759873137144
"91","강원","원주시",2012,3041,1599,1442,"5",2010,3070,1602,1468,407210,420213,0.969056169133273,0.990553745928339,1.0221840358483,0.746789126003782,0.0165667967423863,0.196282142323637
"92","강원","원주시",2013,3061,1576,1485,"5",2011,3026,1550,1476,420229,433401,0.969607822778443,1.01156642432254,1.04327378612093,0.728412365638735,0.0315211609184913,0.417727786630429
"93","강원","원주시",2014,3415,1764,1651,"5",2012,3429,1765,1664,464047,479002,0.968778835996509,0.995917177019539,1.02801293754019,0.735916836010145,0.0206151923619277,0.256231168963674
"94","강원","원주시",2015,3085,1569,1516,"5",2013,3084,1591,1493,441255,454391,0.971090976713887,1.0003242542153,1.03010354148315,0.699142219351622,0.0210466568028718,0.262620335363206
"95","강원","원주시",2016,3173,1655,1518,"5",2014,3084,1623,1461,422114,434628,0.971207561408837,1.02885862516213,1.05936018833056,0.751692670700332,0.0446206184994714,0.611705797994145
"96","강원","원주시",2017,3285,1649,1636,"5",2015,3256,1631,1625,445571,459820,0.969011787221086,1.00890663390663,1.0411706515975,0.737256239746303,0.0303533197846758,0.400434284260132
"97","강원","원주시",2018,3224,1648,1576,"5",2016,3260,1658,1602,447106,462028,0.967703256079718,0.988957055214724,1.02196313694459,0.721081801630933,0.0158372183574729,0.185478476342464
"98","강원","원주시",2019,3303,1634,1669,"5",2017,3329,1654,1675,459384,475293,0.966528015350531,0.992189846800841,1.02655053039617,0.719006321508803,0.0190899991942548,0.233645963753324
"99","강원","원주시",2020,3008,1537,1471,"5",2018,2914,1480,1434,417119,431567,0.966522000060246,1.03225806451613,1.06801300379276,0.721137133527842,0.0490467025977292,0.677247671480205
"100","강원","인제군",2010,305,165,140,"5",2008,337,176,161,470657,486853,0.966733284995676,0.905044510385757,0.93618842387309,0.0648030306571452,-0.00413518352403293,-0.110274746657901
"101","강원","인제군",2011,323,167,156,"5",2009,315,162,153,451574,467208,0.966537388058424,1.02539682539683,1.06089721728886,0.0715275901624097,0.00435583120026884,0.0154610054141212
"102","강원","인제군",2012,279,146,133,"5",2010,304,166,138,407210,420213,0.969056169133273,0.917763157894737,0.947069104070188,0.0685150168217873,-0.00362656122502337,-0.102743019371699
"103","강원","인제군",2013,291,140,151,"5",2011,306,154,152,420229,433401,0.969607822778443,0.950980392156863,0.980788696023303,0.06924795766118,-0.00133034356439439,-0.0687404102778855
"104","강원","인제군",2014,310,159,151,"5",2012,328,173,155,464047,479002,0.968778835996509,0.945121951219512,0.975580716776639,0.0668035780858404,-0.00163129549361208,-0.0731969350144886
"105","강원","인제군",2015,282,138,144,"5",2013,289,144,145,441255,454391,0.971090976713887,0.975778546712803,1.00482711724372,0.0639086242648809,0.000308494422211357,-0.0444723418007087
"106","강원","인제군",2016,264,137,127,"5",2014,282,148,134,422114,434628,0.971207561408837,0.936170212765957,0.963923933425668,0.0625423463803617,-0.00225628185173284,-0.0824517923342102
"107","강원","인제군",2017,300,163,137,"5",2015,326,175,151,445571,459820,0.969011787221086,0.920245398773006,0.949674101913732,0.0673293369631327,-0.00338840935022258,-0.0992164438023809
"108","강원","인제군",2018,253,152,101,"5",2016,279,158,121,447106,462028,0.967703256079718,0.906810035842294,0.937074490702749,0.0565861339369188,-0.00356071129714306,-0.101767907388649
"109","강원","인제군",2019,274,140,134,"5",2017,312,155,157,459384,475293,0.966528015350531,0.878205128205128,0.90861838897306,0.0596450899465371,-0.00545046440916133,-0.129751550861791
"110","강원","인제군",2020,251,123,128,"5",2018,259,129,130,417119,431567,0.966522000060246,0.969111969111969,1.00267967935708,0.0601746743735001,0.000161248832737587,-0.0466527684673572
"111","강원","정선군",2010,251,125,126,"5",2008,258,130,128,470657,486853,0.966733284995676,0.972868217054264,1.00634604409903,0.0533297071965359,0.000338432673657832,-0.0440290133313127
"112","강원","정선군",2011,256,142,114,"5",2009,267,140,127,451574,467208,0.966537388058424,0.958801498127341,0.991996284854927,0.0566905977757798,-0.000453735396001271,-0.05575951330571
"113","강원","정선군",2012,255,124,131,"5",2010,271,136,135,407210,420213,0.969056169133273,0.940959409594096,0.971006056785845,0.0626212519338916,-0.00181563702257056,-0.075926681874468
"114","강원","정선군",2013,227,112,115,"5",2011,235,111,124,420229,433401,0.969607822778443,0.965957446808511,0.996235203672891,0.0540181662855253,-0.00020336739402891,-0.0520520401655839
"115","강원","정선군",2014,289,148,141,"5",2012,287,148,139,464047,479002,0.968778835996509,1.00696864111498,1.03942056091594,0.0622781744090577,0.00245504056802575,-0.0126860827062791
"116","강원","정선군",2015,238,114,124,"5",2013,256,120,136,441255,454391,0.971090976713887,0.9296875,0.957363956924001,0.053937065868942,-0.00229966306378121,-0.0830941854403117
"117","강원","정선군",2016,267,143,124,"5",2014,271,141,130,422114,434628,0.971207561408837,0.985239852398524,1.01444829256614,0.0632530548619567,0.000913898642347964,-0.0355074586391485
"118","강원","정선군",2017,262,134,128,"5",2015,261,135,126,445571,459820,0.969011787221086,1.00383141762452,1.03593313400582,0.0588009542811359,0.00211290256985416,-0.0177524946616603
"119","강원","정선군",2018,218,108,110,"5",2016,229,112,117,447106,462028,0.967703256079718,0.951965065502183,0.983736553040762,0.0487580126412976,-0.000792973352429615,-0.0607829811676623
"120","강원","정선군",2019,251,136,115,"5",2017,266,140,126,459384,475293,0.966528015350531,0.943609022556391,0.976287295939551,0.0546383853159884,-0.00129562386133881,-0.0682262776191685
"121","강원","정선군",2020,187,95,92,"5",2018,191,94,97,417119,431567,0.966522000060246,0.979057591623037,1.01296979433682,0.0448313311069503,0.000581453144302922,-0.0404303431325668
"122","강원","철원군",2010,416,216,200,"5",2008,447,225,222,470657,486853,0.966733284995676,0.930648769574944,0.962673763300812,0.0883870844372866,-0.00329915723485729,-0.0978947900055319
"123","강원","철원군",2011,432,241,191,"5",2009,447,245,202,451574,467208,0.966537388058424,0.966442953020134,0.999902295514425,0.0956653837466285,-9.34693710632063e-06,-0.0491789668215113
"124","강원","철원군",2012,402,200,202,"5",2010,421,204,217,407210,420213,0.969056169133273,0.954869358669834,0.985360177340259,0.0987205618722526,-0.00144525151867977,-0.0704419781729192
"125","강원","철원군",2013,441,225,216,"5",2011,470,236,234,420229,433401,0.969607822778443,0.938297872340425,0.967708644977412,0.104942781197871,-0.00338874460471825,-0.0992214082827777
"126","강원","철원군",2014,427,216,211,"5",2012,442,223,219,464047,479002,0.968778835996509,0.96606334841629,0.997196999480871,0.0920165414279157,-0.00025792241339094,-0.0528598960710926
"127","강원","철원군",2015,418,221,197,"5",2013,442,239,203,441255,454391,0.971090976713887,0.945701357466063,0.973854541071177,0.0947298047614191,-0.00247675421972514,-0.0857165680884285
"128","강원","철원군",2016,361,184,177,"5",2014,393,202,191,422114,434628,0.971207561408837,0.918575063613232,0.945807158132854,0.0855219206186007,-0.00463467592025842,-0.117671277476993
"129","강원","철원군",2017,371,200,171,"5",2015,398,214,184,445571,459820,0.969011787221086,0.9321608040201,0.961970552178043,0.0832639467110741,-0.00316648191689903,-0.095930121302611
"130","강원","철원군",2018,359,200,159,"5",2016,371,203,168,447106,462028,0.967703256079718,0.967654986522911,0.999950119464305,0.0802941584322286,-4.005115635778e-06,-0.0490998646220874
"131","강원","철원군",2019,336,160,176,"5",2017,385,187,198,459384,475293,0.966528015350531,0.872727272727273,0.902950829015298,0.0731414241680163,-0.00709831458014643,-0.154153072620765
"132","강원","철원군",2020,301,141,160,"5",2018,317,156,161,417119,431567,0.966522000060246,0.949526813880126,0.982416141402824,0.0721616613004922,-0.00126888044844519,-0.0678302586223426
"133","강원","춘천시",2010,2590,1314,1276,"5",2008,2561,1306,1255,470657,486853,0.966733284995676,1.01132370167903,1.04612483854174,0.550294588203299,0.0253822490312726,0.326822196650217
"134","강원","춘천시",2011,2406,1264,1142,"5",2009,2448,1292,1156,451574,467208,0.966537388058424,0.982843137254902,1.01687027258121,0.532803040033306,0.00898853251746027,0.0840624862918984
"135","강원","춘천시",2012,2418,1265,1153,"5",2010,2430,1275,1155,407210,420213,0.969056169133273,0.995061728395062,1.02683596688213,0.59379681245549,0.0159351115937727,0.186928088678395
"136","강원","춘천시",2013,2271,1199,1072,"5",2011,2299,1202,1097,420229,433401,0.969607822778443,0.987820791648543,1.01878385099855,0.540419628345497,0.0101511617755341,0.10127881071146
"137","강원","춘천시",2014,2517,1289,1228,"5",2012,2523,1285,1238,464047,479002,0.968778835996509,0.997621878715815,1.029772577236,0.542401954974388,0.0161487040974306,0.190090986748458
"138","강원","춘천시",2015,2436,1277,1159,"5",2013,2412,1263,1149,441255,454391,0.971090976713887,1.00995024875622,1.04001609836169,0.552061733011524,0.0220913566099137,0.278090349277086
"139","강원","춘천시",2016,2297,1190,1107,"5",2014,2274,1195,1079,422114,434628,0.971207561408837,1.01011433597186,1.0400602055719,0.544165794074586,0.0217993935758225,0.273766932952814
"140","강원","춘천시",2017,2485,1289,1196,"5",2015,2504,1286,1218,445571,459820,0.969011787221086,0.99241214057508,1.02414867771743,0.557711341177949,0.0134679914374622,0.150394739205108
"141","강원","춘천시",2018,2570,1337,1233,"5",2016,2626,1357,1269,447106,462028,0.967703256079718,0.978674790555979,1.01133770544568,0.57480776370704,0.00651700111280238,0.0474638146343322
"142","강원","춘천시",2019,2544,1308,1236,"5",2017,2586,1333,1253,459384,475293,0.966528015350531,0.983758700696056,1.01782740393642,0.553785068700695,0.00987255011368779,0.0971531027748075
"143","강원","춘천시",2020,2377,1212,1165,"5",2018,2413,1227,1186,417119,431567,0.966522000060246,0.985080812266888,1.01920164487253,0.569861358509202,0.01094227543267,0.11299369684512
"144","강원","태백시",2010,437,224,213,"5",2008,461,234,227,470657,486853,0.966733284995676,0.947939262472885,0.98055924750447,0.0928489324497458,-0.00180505311522966,-0.0757699543698554
"145","강원","태백시",2011,397,195,202,"5",2009,436,219,217,451574,467208,0.966537388058424,0.910550458715596,0.942074740165723,0.0879147160819711,-0.00509248277230484,-0.12445052480076
"146","강원","태백시",2012,406,221,185,"5",2010,420,224,196,407210,420213,0.969056169133273,0.966666666666667,0.997534196115027,0.0997028560202353,-0.00024584768971763,-0.0526810924167095
"147","강원","태백시",2013,415,196,219,"5",2011,423,209,214,420229,433401,0.969607822778443,0.981087470449173,1.01183947509606,0.098755678451511,0.00116921539562108,-0.031726703919986
"148","강원","태백시",2014,449,244,205,"5",2012,472,258,214,464047,479002,0.968778835996509,0.951271186440678,0.98192812548612,0.0967574405178786,-0.00174858832332328,-0.0749338183712192
"149","강원","태백시",2015,399,204,195,"5",2013,421,218,203,441255,454391,0.971090976713887,0.947743467933492,0.975957444420499,0.090423904544991,-0.00217402175073845,-0.081233676949903
"150","강원","태백시",2016,399,189,210,"5",2014,402,193,209,422114,434628,0.971207561408837,0.992537313432836,1.02196209427474,0.0945242280521376,0.00207595000772782,-0.0182996917094579
"151","강원","태백시",2017,397,193,204,"5",2015,431,214,217,445571,459820,0.969011787221086,0.921113689095128,0.950570159457688,0.0890991559145456,-0.00440415706931057,-0.114257732449477
"152","강원","태백시",2018,373,181,192,"5",2016,392,193,199,447106,462028,0.967703256079718,0.951530612244898,0.983287600064159,0.0834254069504771,-0.00139423876576669,-0.0696865764852465
"153","강원","태백시",2019,360,179,181,"5",2017,392,194,198,459384,475293,0.966528015350531,0.918367346938776,0.95017147185921,0.0783658116085889,-0.0039048530490144,-0.106863991119028
"154","강원","태백시",2020,284,152,132,"5",2018,308,161,147,417119,431567,0.966522000060246,0.922077922077922,0.954016485936633,0.0680860857453149,-0.00313083748138927,-0.0954022951179296
"155","강원","평창군",2010,336,171,165,"5",2008,342,175,167,470657,486853,0.966733284995676,0.982456140350877,1.0162639019461,0.0713895681993469,0.00116107293716859,-0.0318472782176973
"156","강원","평창군",2011,314,178,136,"5",2009,323,179,144,451574,467208,0.966537388058424,0.972136222910217,1.00579267281428,0.0695345613343549,0.000402790963094533,-0.043075989671934
"157","강원","평창군",2012,304,175,129,"5",2010,293,165,128,407210,420213,0.969056169133273,1.03754266211604,1.07067339867824,0.0746543552466786,0.0052760770114158,0.0290880927426274
"158","강원","평창군",2013,286,146,140,"5",2011,298,160,138,420229,433401,0.969607822778443,0.959731543624161,0.989814150708911,0.0680581302099569,-0.000693229857351918,-0.0593059700241069
"159","강원","평창군",2014,313,163,150,"5",2012,334,179,155,464047,479002,0.968778835996509,0.937125748502994,0.967326817724134,0.0674500643253808,-0.00220380824622206,-0.0816747582025952
"160","강원","평창군",2015,312,156,156,"5",2013,317,165,152,441255,454391,0.971090976713887,0.984227129337539,1.01352721108387,0.0707074140802937,0.000956474115458876,-0.0348769969917201
"161","강원","평창군",2016,258,128,130,"5",2014,275,132,143,422114,434628,0.971207561408837,0.938181818181818,0.965995174935509,0.0611209294171717,-0.00207840651261004,-0.0798177974271398
"162","강원","평창군",2017,278,157,121,"5",2015,285,157,128,445571,459820,0.969011787221086,0.975438596491228,1.00663233342968,0.062391852252503,0.000413803567434018,-0.042912913981471
"163","강원","평창군",2018,237,116,121,"5",2016,251,130,121,447106,462028,0.967703256079718,0.944223107569721,0.975736210080435,0.0530075642017777,-0.00128616440193977,-0.0680862010464205
"164","강원","평창군",2019,261,132,129,"5",2017,266,143,123,459384,475293,0.966528015350531,0.981203007518797,1.01518320414431,0.0568152134162269,0.000862636983801345,-0.0362665461450707
"165","강원","평창군",2020,213,119,94,"5",2018,231,126,105,417119,431567,0.966522000060246,0.922077922077922,0.954016485936633,0.0510645643089862,-0.00234812811104195,-0.083811860460836
"166","강원","홍천군",2010,588,324,264,"5",2008,626,338,288,470657,486853,0.966733284995676,0.939297124600639,0.971619720950065,0.124931744348857,-0.00354559776681568,-0.101544104796864
"167","강원","홍천군",2011,530,259,271,"5",2009,562,269,293,451574,467208,0.966537388058424,0.943060498220641,0.975710313819372,0.117367253207669,-0.00285081374829661,-0.0912556770962165
"168","강원","홍천군",2012,495,250,245,"5",2010,506,250,256,407210,420213,0.969056169133273,0.978260869565217,1.00949862425434,0.121558900812848,0.00115464232359151,-0.0319425033539917
"169","강원","홍천군",2013,456,240,216,"5",2011,468,252,216,420229,433401,0.969607822778443,0.974358974358974,1.00490007554489,0.10851226355154,0.000531718288949633,-0.0411668215918658
"170","강원","홍천군",2014,569,287,282,"5",2012,561,282,279,464047,479002,0.968778835996509,1.01426024955437,1.04694715849265,0.122616890099494,0.0057565145733774,0.0362024577671042
"171","강원","홍천군",2015,494,241,253,"5",2013,518,248,270,441255,454391,0.971090976713887,0.953667953667954,0.982058299928919,0.111953405627132,-0.00200863442569807,-0.0787846057408265
"172","강원","홍천군",2016,504,274,230,"5",2014,513,279,234,422114,434628,0.971207561408837,0.982456140350877,1.01158205453603,0.119399024907963,0.00138288601803264,-0.0285626490600031
"173","강원","홍천군",2017,495,240,255,"5",2015,526,270,256,445571,459820,0.969011787221086,0.94106463878327,0.971159124371477,0.111093405989169,-0.00320403110528268,-0.0964861532486633
"174","강원","홍천군",2018,474,232,242,"5",2016,487,232,255,447106,462028,0.967703256079718,0.973305954825462,1.00578968677696,0.106015128403555,0.00061379438707557,-0.0399514309395018
"175","강원","홍천군",2019,443,220,223,"5",2017,485,239,246,459384,475293,0.966528015350531,0.91340206185567,0.945034233202652,0.0964334848405691,-0.00530054043920233,-0.127531462482664
"176","강원","홍천군",2020,384,195,189,"5",2018,415,207,208,417119,431567,0.966522000060246,0.925301204819277,0.957351415447968,0.092060059599299,-0.0039262312356858,-0.107180561336645
"177","강원","화천군",2010,200,95,105,"5",2008,240,121,119,470657,486853,0.966733284995676,0.833333333333333,0.862009559686424,0.0424937905948493,-0.00586373687477615,-0.13587132876372
"178","강원","화천군",2011,221,120,101,"5",2009,229,122,107,451574,467208,0.966537388058424,0.965065502183406,0.998477155779794,0.0489399301111224,-7.45278897070024e-05,-0.0501441725551159
"179","강원","화천군",2012,188,112,76,"5",2010,201,116,85,407210,420213,0.969056169133273,0.935323383084577,0.965190061089166,0.0461678249551828,-0.00160709916633598,-0.0728386335032766
"180","강원","화천군",2013,190,93,97,"5",2011,222,114,108,420229,433401,0.969607822778443,0.855855855855856,0.882682498789431,0.0452134431464749,-0.00530432817107056,-0.12758755157573
"181","강원","화천군",2014,243,117,126,"5",2012,256,129,127,464047,479002,0.968778835996509,0.94921875,0.979809544480408,0.0523653854027717,-0.00105728098474094,-0.0646968736771083
"182","강원","화천군",2015,191,99,92,"5",2013,232,125,107,441255,454391,0.971090976713887,0.823275862068966,0.847784483442407,0.0432856284914619,-0.00658874430034793,-0.146607307545051
"183","강원","화천군",2016,208,97,111,"5",2014,234,115,119,422114,434628,0.971207561408837,0.888888888888889,0.915240906484978,0.0492757880572547,-0.00417657112797125,-0.110887618225859
"184","강원","화천군",2017,197,101,96,"5",2015,231,111,120,445571,459820,0.969011787221086,0.852813852813853,0.880086149684036,0.0442129312724571,-0.00530174282263541,-0.127549267490681
"185","강원","화천군",2018,190,100,90,"5",2016,211,105,106,447106,462028,0.967703256079718,0.900473933649289,0.930526923405443,0.0424955156048007,-0.00295229421053753,-0.0927584094144115
"186","강원","화천군",2019,191,87,104,"5",2017,228,109,119,459384,475293,0.966528015350531,0.837719298245614,0.866730487829469,0.0415774167145569,-0.00554100204285989,-0.131092240736151
"187","강원","화천군",2020,180,94,86,"5",2018,195,96,99,417119,431567,0.966522000060246,0.923076923076923,0.955050089930064,0.0431531529371714,-0.00193973034376004,-0.0777642675545655
"188","강원","횡성군",2010,292,152,140,"5",2008,302,160,142,470657,486853,0.966733284995676,0.966887417218543,1.00015943613948,0.06204093426848,9.89156704950553e-06,-0.0488940812257002
"189","강원","횡성군",2011,309,164,145,"5",2009,315,175,140,451574,467208,0.966537388058424,0.980952380952381,1.01491405616798,0.0684273230965467,0.0010205289400865,-0.0339284670680415
"190","강원","횡성군",2012,291,148,143,"5",2010,308,154,154,407210,420213,0.969056169133273,0.944805194805195,0.974974645329622,0.0714618992657351,-0.00178835937454386,-0.0755227518730775
"191","강원","횡성군",2013,292,156,136,"5",2011,290,146,144,420229,433401,0.969607822778443,1.00689655172414,1.03845753723278,0.0694859231514246,0.00267225747674988,-0.00946951410193788
"192","강원","횡성군",2014,314,159,155,"5",2012,318,156,162,464047,479002,0.968778835996509,0.987421383647799,1.01924334735504,0.067665559738561,0.00130211187002214,-0.0297587603114662
"193","강원","횡성군",2015,293,156,137,"5",2013,288,156,132,441255,454391,0.971090976713887,1.01736111111111,1.04764757937902,0.0664015138638656,0.00316387140271555,-0.00218964841833949
"194","강원","횡성군",2016,260,135,125,"5",2014,282,140,142,422114,434628,0.971207561408837,0.921985815602837,0.949319025343461,0.0615947350715683,-0.00312168120713837,-0.095266708139636
"195","강원","횡성군",2017,255,126,129,"5",2015,278,135,143,445571,459820,0.969011787221086,0.91726618705036,0.946599617411134,0.0572299364186628,-0.00305610050029306,-0.0942955828072291
"196","강원","횡성군",2018,268,143,125,"5",2016,264,138,126,447106,462028,0.967703256079718,1.01515151515152,1.04903182744679,0.0599410430636135,0.00293901888047567,-0.00551928591245504
"197","강원","횡성군",2019,265,132,133,"5",2017,269,125,144,459384,475293,0.966528015350531,0.985130111524164,1.01924630830994,0.0576859446563224,0.00111024147600583,-0.0325999953199216
"198","강원","횡성군",2020,221,114,107,"5",2018,236,117,119,417119,431567,0.966522000060246,0.936440677966102,0.96887673318117,0.0529824822173049,-0.00164898793077307,-0.0734589263034753
"199","경기","가평군",2010,463,254,209,"5",2008,443,243,200,470657,486853,0.966733284995676,1.0451467268623,1.08111176379634,0.0983731252270762,0.00797921769732608,0.0691164566231717
"200","경기","가평군",2011,494,261,233,"5",2009,493,257,236,451574,467208,0.966537388058424,1.00202839756592,1.03671974819183,0.10939513789545,0.00401696191693198,0.0104429968983051
"201","경기","가평군",2012,447,236,211,"5",2010,447,227,220,407210,420213,0.969056169133273,1,1.03193192701554,0.109771371037057,0.00350521140835161,0.00286494678782384
"202","경기","가평군",2013,440,233,207,"5",2011,421,224,197,420229,433401,0.969607822778443,1.04513064133017,1.07789006728031,0.104704815707626,0.00815546514003897,0.0717263454856713
"203","경기","가평군",2014,450,234,216,"5",2012,452,230,222,464047,479002,0.968778835996509,0.995575221238938,1.02765996143471,0.0969729359310587,0.00268226766806388,-0.00932128223871332
"204","경기","가평군",2015,438,224,214,"5",2013,462,245,217,441255,454391,0.971090976713887,0.948051948051948,0.976275107879282,0.0992623313050277,-0.00235498810186271,-0.0839134438561146
"205","경기","가평군",2016,418,217,201,"5",2014,407,209,198,422114,434628,0.971207561408837,1.02702702702703,1.05747429060089,0.099025381768906,0.00569141356864985,0.0352384359091942
"206","경기","가평군",2017,459,238,221,"5",2015,461,234,227,445571,459820,0.969011787221086,0.995661605206074,1.02750205759768,0.103013885553593,0.00283309381385597,-0.00708783435420823
"207","경기","가평군",2018,422,196,226,"5",2016,460,224,236,447106,462028,0.967703256079718,0.917391304347826,0.948008905192991,0.0943847767643467,-0.00490716787709353,-0.121706364240909
"208","경기","가평군",2019,436,204,232,"5",2017,472,231,241,459384,475293,0.966528015350531,0.923728813559322,0.955718612278727,0.0949097051704021,-0.00420273345316226,-0.111275032420824
"209","경기","가평군",2020,357,189,168,"5",2018,368,194,174,417119,431567,0.966522000060246,0.970108695652174,1.00371093010992,0.0855870866587233,0.000317607696902613,-0.0443373915639762
"210","경기","고양시",2010,9935,5232,4703,"5",2008,10419,5460,4959,470657,486853,0.966733284995676,0.953546405605144,0.986359340683516,2.11087904779914,-0.0287937819493331,-0.47542161292977
"211","경기","고양시",2011,9446,4811,4635,"5",2009,9837,4988,4849,451574,467208,0.966537388058424,0.960252109382942,0.993497117904453,2.09179447886725,-0.0136026928641896,-0.250470523698127
"212","경기","고양시",2012,8370,4267,4103,"5",2010,8718,4482,4236,407210,420213,0.969056169133273,0.960082587749484,0.990739874870396,2.05545050465362,-0.0190337288708005,-0.330893820441098
"213","경기","고양시",2013,8587,4387,4200,"5",2011,9057,4691,4366,420229,433401,0.969607822778443,0.948106437010047,0.977824657285889,2.04340966473042,-0.0453133096207247,-0.720044346852518
"214","경기","고양시",2014,9425,4870,4555,"5",2012,9692,5035,4657,464047,479002,0.968778835996509,0.972451506397028,1.0037910307947,2.03104426922273,0.00769975137002819,0.0649780927193809
"215","경기","고양시",2015,9234,4715,4519,"5",2013,9459,4796,4663,441255,454391,0.971090976713887,0.976213130352046,1.00527463827899,2.09266750518408,0.0110380641280454,0.114412144939264
"216","경기","고양시",2016,8646,4490,4156,"5",2014,9023,4682,4341,422114,434628,0.971207561408837,0.958217887620525,0.986625234085422,2.04826184395685,-0.0273950226946856,-0.454708653105611
"217","경기","고양시",2017,9165,4721,4444,"5",2015,9625,4955,4670,445571,459820,0.969011787221086,0.952207792207792,0.982658626824876,2.0569112442237,-0.0356696654741909,-0.577240348879343
"218","경기","고양시",2018,9095,4631,4464,"5",2016,9617,4901,4716,447106,462028,0.967703256079718,0.945721118852033,0.977284216944007,2.03419323381927,-0.0462082921934083,-0.733297333747671
"219","경기","고양시",2019,9283,4787,4496,"5",2017,9872,5086,4786,459384,475293,0.966528015350531,0.940336304700162,0.972901240073346,2.02074952545147,-0.0547598062621088,-0.859928965854628
"220","경기","고양시",2020,8550,4305,4245,"5",2018,8768,4477,4291,417119,431567,0.966522000060246,0.975136861313869,1.00891325934959,2.04977476451564,0.0182701740843758,0.221505915701925
"221","경기","과천시",2010,711,391,320,"5",2008,744,401,343,470657,486853,0.966733284995676,0.955645161290323,0.988530317640399,0.151065425564689,-0.0017326724467449,-0.0746981345599851
"222","경기","과천시",2011,677,349,328,"5",2009,762,392,370,451574,467208,0.966537388058424,0.888451443569554,0.919210632249076,0.14992005739923,-0.0121119466504661,-0.228395412251838
"223","경기","과천시",2012,606,312,294,"5",2010,741,376,365,407210,420213,0.969056169133273,0.817813765182186,0.843928134644292,0.148817563419366,-0.0232262347205518,-0.392976845050172
"224","경기","과천시",2013,590,331,259,"5",2011,666,375,291,420229,433401,0.969607822778443,0.885885885885886,0.913653814536429,0.140399639244317,-0.0121229732892083,-0.228558695765069
"225","경기","과천시",2014,578,304,274,"5",2012,636,333,303,464047,479002,0.968778835996509,0.908805031446541,0.938093399317216,0.124556348818115,-0.00771086014878865,-0.16322370554891
"226","경기","과천시",2015,554,278,276,"5",2013,658,341,317,441255,454391,0.971090976713887,0.841945288753799,0.867009692132956,0.125550985257957,-0.0166970641824664,-0.296292267921474
"227","경기","과천시",2016,496,258,238,"5",2014,585,302,283,422114,434628,0.971207561408837,0.847863247863248,0.872999018493363,0.117503802290377,-0.0149230982216396,-0.270023211574611
"228","경기","과천시",2017,440,229,211,"5",2015,559,298,261,445571,459820,0.969011787221086,0.787119856887299,0.812291312930863,0.0987496942125946,-0.0185361754491249,-0.323526002141202
"229","경기","과천시",2018,418,205,213,"5",2016,516,245,271,447106,462028,0.967703256079718,0.810077519379845,0.837113561714741,0.0934901343305614,-0.0152282749959156,-0.274542298217893
"230","경기","과천시",2019,466,242,224,"5",2017,501,262,239,459384,475293,0.966528015350531,0.930139720558882,0.962351536413094,0.101440189471118,-0.00381906727955221,-0.105593667301365
"231","경기","과천시",2020,483,253,230,"5",2018,477,250,227,417119,431567,0.966522000060246,1.0125786163522,1.0476519068258,0.115794293714743,0.00551781889505415,0.0326678295036038
"232","경기","광명시",2010,3376,1785,1591,"5",2008,3371,1760,1611,470657,486853,0.966733284995676,1.00148323939484,1.03594575146889,0.717295185241057,0.0257837144585092,0.332767134807025
"233","경기","광명시",2011,3560,1794,1766,"5",2009,3270,1658,1612,451574,467208,0.966537388058424,1.08868501529052,1.1263765155298,0.788353625319438,0.0996293841731549,1.42628082195902
"234","경기","광명시",2012,3308,1765,1543,"5",2010,3314,1745,1569,407210,420213,0.969056169133273,0.99818949909475,1.03006361332753,0.812357260381621,0.0244223945599216,0.312608580521442
"235","경기","광명시",2013,3595,1859,1736,"5",2011,3743,1958,1785,420229,433401,0.969607822778443,0.960459524445632,0.990564949954099,0.855485937429354,-0.00807155263321007,-0.168564874098018
"236","경기","광명시",2014,3800,1877,1923,"5",2012,3993,1978,2015,464047,479002,0.968778835996509,0.951665414475332,0.982335058441306,0.818882570084496,-0.0144655127439754,-0.263247242383712
"237","경기","광명시",2015,3612,1822,1790,"5",2013,3874,1979,1895,441255,454391,0.971090976713887,0.93236964377904,0.960125947142586,0.818574293775708,-0.0326398746577331,-0.532374918857426
"238","경기","광명시",2016,3274,1735,1539,"5",2014,3479,1833,1646,422114,434628,0.971207561408837,0.941075021557919,0.96897415027617,0.775619856247365,-0.0240642651027495,-0.405386478502255
"239","경기","광명시",2017,3272,1651,1621,"5",2015,3516,1798,1718,445571,459820,0.969011787221086,0.930602957906712,0.960362887406641,0.734338635144567,-0.0291070631628789,-0.480060710879097
"240","경기","광명시",2018,3176,1654,1522,"5",2016,3426,1791,1635,447106,462028,0.967703256079718,0.927028604786924,0.957967847026192,0.71034609242551,-0.0298573756211756,-0.491171408987173
"241","경기","광명시",2019,3071,1575,1496,"5",2017,3333,1711,1622,459384,475293,0.966528015350531,0.921392139213921,0.9533010161943,0.668503909583268,-0.0312184532476761,-0.511326375684693
"242","경기","광명시",2020,2623,1355,1268,"5",2018,2808,1449,1359,417119,431567,0.966522000060246,0.934116809116809,0.966472371098209,0.628837334190003,-0.0210834247803137,-0.361245912042586
"243","경기","광주시",2010,2600,1361,1239,"5",2008,2794,1444,1350,470657,486853,0.966733284995676,0.930565497494631,0.96258762570567,0.552419277733041,-0.0206673167859518,-0.355084145361798
"244","경기","광주시",2011,2694,1385,1309,"5",2009,2824,1431,1393,451574,467208,0.966537388058424,0.953966005665722,0.986993382203295,0.596579962531058,-0.00775948755781398,-0.163943784837857
"245","경기","광주시",2012,2576,1312,1264,"5",2010,2667,1367,1300,407210,420213,0.969056169133273,0.965879265091864,0.996721651290605,0.632597431300803,-0.00207387497247153,-0.0797506939505989
"246","경기","광주시",2013,2725,1405,1320,"5",2011,2846,1452,1394,420229,433401,0.969607822778443,0.957484188334505,0.987496352484866,0.648455960916548,-0.00810806476438824,-0.169105549202526
"247","경기","광주시",2014,3122,1535,1587,"5",2012,3301,1603,1698,464047,479002,0.968778835996509,0.945774007876401,0.976253787484483,0.672776679948367,-0.0159758980175379,-0.285613170892392
"248","경기","광주시",2015,2939,1461,1478,"5",2013,3077,1543,1534,441255,454391,0.971090976713887,0.955151121221969,0.98358562083868,0.66605477558328,-0.0109328756286316,-0.210935616633726
"249","경기","광주시",2016,2816,1424,1392,"5",2014,3045,1590,1455,422114,434628,0.971207561408837,0.924794745484401,0.952211228815898,0.667118361390525,-0.0318807667252047,-0.521133976531991
"250","경기","광주시",2017,3151,1628,1523,"5",2015,3402,1770,1632,445571,459820,0.969011787221086,0.926219870664315,0.955839632581262,0.707182469236104,-0.0312294376735569,-0.511489034105863
"251","경기","광주시",2018,3451,1781,1670,"5",2016,3555,1846,1709,447106,462028,0.967703256079718,0.970745428973277,1.00314370430651,0.771852759748248,0.00242647684481023,-0.01310905703115
"252","경기","광주시",2019,3728,1931,1797,"5",2017,3932,2042,1890,459384,475293,0.966528015350531,0.948118006103764,0.980952430809685,0.811521515768943,-0.0154575122210384,-0.27793686480853
"253","경기","광주시",2020,3312,1680,1632,"5",2018,3627,1863,1764,417119,431567,0.966522000060246,0.913151364764268,0.944780734124365,0.794018014043954,-0.0438450918275371,-0.698302838396101
"254","경기","구리시",2010,1999,1015,984,"5",2008,2186,1109,1077,470657,486853,0.966733284995676,0.914455626715462,0.945923390565322,0.424725436995519,-0.0229677115733796,-0.389148609745774
"255","경기","구리시",2011,1831,938,893,"5",2009,2105,1055,1050,451574,467208,0.966537388058424,0.869833729216152,0.899948351675739,0.405470642685363,-0.0405680061477682,-0.649775442563081
"256","경기","구리시",2012,1653,919,734,"5",2010,1803,1008,795,407210,420213,0.969056169133273,0.916805324459235,0.94608068516733,0.405933056653815,-0.0218876322827052,-0.373154693079763
"257","경기","구리시",2013,1736,946,790,"5",2011,1931,1043,888,420229,433401,0.969607822778443,0.899016053858105,0.927195545186449,0.413108091064634,-0.0300761093490273,-0.494410438793145
"258","경기","구리시",2014,1802,954,848,"5",2012,2005,1059,946,464047,479002,0.968778835996509,0.898753117206983,0.927717538629447,0.388322734550595,-0.0280689230594608,-0.464687833679178
"259","경기","구리시",2015,1607,784,823,"5",2013,1798,875,923,441255,454391,0.971090976713887,0.89377085650723,0.920378088087788,0.364188507778949,-0.0289973852858154,-0.478436590464046
"260","경기","구리시",2016,1524,804,720,"5",2014,1682,897,785,422114,434628,0.971207561408837,0.906064209274673,0.932925406758915,0.36103990865027,-0.0242166050165154,-0.407642342406615
"261","경기","구리시",2017,1598,839,759,"5",2015,1686,854,832,445571,459820,0.969011787221086,0.947805456702254,0.978115508192478,0.358640934890287,-0.00784867460144869,-0.165264475046342
"262","경기","구리시",2018,1693,853,840,"5",2016,1705,853,852,447106,462028,0.967703256079718,0.992961876832845,1.02610161802643,0.378657410099618,0.0098835710812979,0.0973163023093758
"263","경기","구리시",2019,1806,929,877,"5",2017,1966,1024,942,459384,475293,0.966528015350531,0.918616480162767,0.950429232855306,0.393135154903088,-0.0194880112200941,-0.337620876593526
"264","경기","구리시",2020,1598,845,753,"5",2018,1819,979,840,417119,431567,0.966522000060246,0.878504672897196,0.90893396409232,0.383104102186666,-0.0348877719261106,-0.565661994995824
"265","경기","군포시",2010,3089,1593,1496,"5",2008,3260,1670,1590,470657,486853,0.966733284995676,0.947546012269939,0.980152464983324,0.656316595737448,-0.0130262666159245,-0.241934749094859
"266","경기","군포시",2011,2990,1550,1440,"5",2009,2963,1540,1423,451574,467208,0.966537388058424,1.00911238609517,1.04404899237501,0.662128466209303,0.0291660917593325,0.382853698959734
"267","경기","군포시",2012,2753,1400,1353,"5",2010,2911,1488,1423,407210,420213,0.969056169133273,0.945723119203023,0.975921880822327,0.676063947349034,-0.0162783482959979,-0.29009188332681
"268","경기","군포시",2013,2838,1463,1375,"5",2011,3060,1582,1478,420229,433401,0.969607822778443,0.927450980392157,0.956521759214479,0.675346061314188,-0.0293628586673717,-0.483848554991768
"269","경기","군포시",2014,2995,1551,1444,"5",2012,3149,1619,1530,464047,479002,0.968778835996509,0.951095585900286,0.981746865807577,0.645408762474491,-0.0117807327504126,-0.223490765378391
"270","경기","군포시",2015,2892,1507,1385,"5",2013,3061,1602,1459,441255,454391,0.971090976713887,0.944789284547534,0.972915316075372,0.655403338205799,-0.0177513922584501,-0.311904858155836
"271","경기","군포시",2016,2679,1361,1318,"5",2014,2847,1464,1383,422114,434628,0.971207561408837,0.940990516332982,0.968887139807662,0.634662674064352,-0.0197461710474597,-0.341443731823737
"272","경기","군포시",2017,2682,1415,1267,"5",2015,2936,1513,1423,445571,459820,0.969011787221086,0.913487738419619,0.942700337050906,0.601924272450406,-0.0344900579322872,-0.559772608421116
"273","경기","군포시",2018,2625,1346,1279,"5",2016,2896,1483,1413,447106,462028,0.967703256079718,0.906422651933702,0.936674177997218,0.587109097171588,-0.0371791661837018,-0.599593178679578
"274","경기","군포시",2019,2511,1291,1220,"5",2017,2783,1428,1355,459384,475293,0.966528015350531,0.902263744160977,0.933510182665272,0.546601535969908,-0.0363434362815208,-0.587217610953962
"275","경기","군포시",2020,2338,1185,1153,"5",2018,2448,1233,1215,417119,431567,0.966522000060246,0.955065359477124,0.988146528912526,0.560511508706149,-0.0066440069626446,-0.147425642294311
"276","경기","김포시",2010,2576,1335,1241,"5",2008,2555,1319,1236,470657,486853,0.966733284995676,1.00821917808219,1.04291348371925,0.547320022861659,0.0234874088902913,0.298763223969289
"277","경기","김포시",2011,2662,1400,1262,"5",2009,2519,1311,1208,451574,467208,0.966537388058424,1.05676855895197,1.09335507555977,0.589493637809086,0.0550322230996737,0.765881827266148
"278","경기","김포시",2012,2601,1357,1244,"5",2010,2342,1231,1111,407210,420213,0.969056169133273,1.11058923996584,1.14605249452068,0.638736769725694,0.0932890985605187,1.33239327073683
"279","경기","김포시",2013,3302,1719,1583,"5",2011,2753,1440,1313,420229,433401,0.969607822778443,1.19941881583727,1.23701437597759,0.785762048787685,0.186236901660288,2.70877316238197
"280","경기","김포시",2014,3827,1938,1889,"5",2012,3414,1725,1689,464047,479002,0.968778835996509,1.12097246631517,1.15709842604284,0.824700946240359,0.129559220610399,1.86948468109953
"281","경기","김포시",2015,4265,2158,2107,"5",2013,3862,1963,1899,441255,454391,0.971090976713887,1.10435007767996,1.1372261756741,0.966561285424528,0.132637508753448,1.91506826413737
"282","경기","김포시",2016,4133,2137,1996,"5",2014,4184,2174,2010,422114,434628,0.971207561408837,0.987810707456979,1.01709536324455,0.979119384810738,0.0167384015431243,0.198823282503057
"283","경기","김포시",2017,4856,2591,2265,"5",2015,4582,2441,2141,445571,459820,0.969011787221086,1.05979921431689,1.09369073554426,1.08983753430991,0.102107680213243,1.46297966498018
"284","경기","김포시",2018,5362,2712,2650,"5",2016,4898,2463,2435,447106,462028,0.967703256079718,1.09473254389547,1.13126884405697,1.19926818248916,0.157426548029654,2.28214671091194
"285","경기","김포시",2019,6010,3023,2987,"5",2017,5649,2814,2835,459384,475293,0.966528015350531,1.06390511594973,1.10074938237965,1.30827368824339,0.131807766074067,1.90278135577533
"286","경기","김포시",2020,5412,2756,2656,"5",2018,5352,2733,2619,417119,431567,0.966522000060246,1.01121076233184,1.04623667362854,1.29747146497762,0.0599907646685188,0.839308381521757
"287","경기","남양주시",2010,6436,3320,3116,"5",2008,6390,3315,3075,470657,486853,0.966733284995676,1.00719874804382,1.04185793918156,1.36745018134225,0.0572386465244419,0.798554754791352
"288","경기","남양주시",2011,6648,3403,3245,"5",2009,6511,3334,3177,451574,467208,0.966537388058424,1.0210413146982,1.05639091390895,1.47218396098978,0.0830177990023047,1.18029489184546
"289","경기","남양주시",2012,6176,3235,2941,"5",2010,6444,3348,3096,407210,420213,0.969056169133273,0.958410924891372,0.989014832595904,1.51666216448516,-0.0166607877723281,-0.295755083396501
"290","경기","남양주시",2013,6846,3544,3302,"5",2011,6929,3593,3336,420229,433401,0.969607822778443,0.988021359503536,1.01899070561573,1.62911174621456,0.0309379815874863,0.409092011736893
"291","경기","남양주시",2014,7590,3918,3672,"5",2012,7784,4001,3783,464047,479002,0.968778835996509,0.975077081192189,1.00650122087896,1.63561018603719,0.0106334630913124,0.108420774379377
"292","경기","남양주시",2015,7243,3775,3468,"5",2013,7513,3929,3584,441255,454391,0.971090976713887,0.964062292027153,0.992762073940262,1.64145448776784,-0.0118807262128896,-0.224971478062925
"293","경기","남양주시",2016,7049,3628,3421,"5",2014,7361,3780,3581,422114,434628,0.971207561408837,0.957614454557805,0.986003911634178,1.6699280289211,-0.0233724602573423,-0.395142166679854
"294","경기","남양주시",2017,7192,3700,3492,"5",2015,7610,3931,3679,445571,459820,0.969011787221086,0.945072273324573,0.975294919822217,1.6141086381295,-0.0398766833206412,-0.63953826851313
"295","경기","남양주시",2018,7351,3780,3571,"5",2016,7674,3949,3725,447106,462028,0.967703256079718,0.957909825384415,0.989879717120125,1.64412913268889,-0.0166390519138557,-0.295433216740901
"296","경기","남양주시",2019,7734,3947,3787,"5",2017,7739,3902,3837,459384,475293,0.966528015350531,0.999353921695309,1.033962705502,1.68355885272452,0.0571782135103603,0.79765985698205
"297","경기","남양주시",2020,7055,3634,3421,"5",2018,7185,3717,3468,417119,431567,0.966522000060246,0.981906750173974,1.01591764089464,1.69136385539858,0.026922522472408,0.34963071198154
"298","경기","동두천시",2010,1015,526,489,"5",2008,1036,537,499,470657,486853,0.966733284995676,0.97972972972973,1.01344367152323,0.21565598726886,0.0028992082548601,-0.00610880543571126
"299","경기","동두천시",2011,931,459,472,"5",2009,956,488,468,451574,467208,0.966537388058424,0.973849372384937,1.00756513345149,0.206167759879887,0.00155968661688547,-0.0259445690088731
"300","경기","동두천시",2012,804,413,391,"5",2010,887,454,433,407210,420213,0.969056169133273,0.906426155580609,0.93537008942559,0.197441123744505,-0.0127606021713185,-0.238000764780154
"301","경기","동두천시",2013,896,460,436,"5",2011,987,516,471,420229,433401,0.969607822778443,0.907801418439716,0.936256285390089,0.213217079259166,-0.0135912486502551,-0.25030105669181
"302","경기","동두천시",2014,983,491,492,"5",2012,1038,519,519,464047,479002,0.968778835996509,0.947013487475915,0.977533212213285,0.211831991156068,-0.00475918439174064,-0.119515010742035
"303","경기","동두천시",2015,866,414,452,"5",2013,917,440,477,441255,454391,0.971090976713887,0.944383860414395,0.972497822614038,0.196258399338251,-0.00539753331208558,-0.128967742151653
"304","경기","동두천시",2016,863,431,432,"5",2014,901,433,468,422114,434628,0.971207561408837,0.957824639289678,0.986220327506774,0.204447139872167,-0.00281721462961532,-0.0907581381572887
"305","경기","동두천시",2017,923,482,441,"5",2015,978,510,468,445571,459820,0.969011787221086,0.943762781186094,0.973943551184861,0.207149926723238,-0.00539759146272381,-0.128968603251824
"306","경기","동두천시",2018,835,439,396,"5",2016,902,477,425,447106,462028,0.967703256079718,0.925720620842572,0.956616209593814,0.186756608052677,-0.00810220954072751,-0.169018844494733
"307","경기","동두천시",2019,803,401,402,"5",2017,852,429,423,459384,475293,0.966528015350531,0.942488262910798,0.975127723089315,0.174799296449158,-0.00434765650507633,-0.113421066730814
"308","경기","동두천시",2020,733,377,356,"5",2018,796,411,385,417119,431567,0.966522000060246,0.920854271356784,0.952750450894429,0.175729228349704,-0.00830312680419348,-0.1719940464048
"309","경기","부천시",2010,8247,4254,3993,"5",2008,8668,4456,4212,470657,486853,0.966733284995676,0.951430549146285,0.984170674490162,1.75223145517861,-0.0277366420725985,-0.459767385282971
"310","경기","부천시",2011,7620,3898,3722,"5",2009,8153,4151,4002,451574,467208,0.966537388058424,0.934625291303815,0.966983070547624,1.6874310744197,-0.0557137927398629,-0.874055688177184
"311","경기","부천시",2012,6986,3558,3428,"5",2010,7465,3819,3646,407210,420213,0.969056169133273,0.935833891493637,0.965716871015485,1.71557672945163,-0.0588153382986226,-0.919983669234638
"312","경기","부천시",2013,7249,3755,3494,"5",2011,7702,4047,3655,420229,433401,0.969607822778443,0.94118410802389,0.970685349182617,1.72501183878314,-0.0505681197097796,-0.797858073479555
"313","경기","부천시",2014,7777,3979,3798,"5",2012,8294,4269,4025,464047,479002,0.968778835996509,0.937665782493369,0.96788425557301,1.67590782830187,-0.0538230274969348,-0.846057056973449
"314","경기","부천시",2015,7048,3609,3439,"5",2013,7549,3812,3737,441255,454391,0.971090976713887,0.933633593853491,0.961427524548575,1.59726235396766,-0.061610362937903,-0.961372659419041
"315","경기","부천시",2016,6657,3403,3254,"5",2014,7135,3662,3473,422114,434628,0.971207561408837,0.933006306937631,0.960666230382524,1.57706212065935,-0.0620317981264626,-0.967613311697208
"316","경기","부천시",2017,6934,3528,3406,"5",2015,7249,3692,3557,445571,459820,0.969011787221086,0.956545730445579,0.987135288817015,1.55620540834121,-0.0200201331197096,-0.34550058819627
"317","경기","부천시",2018,7070,3575,3495,"5",2016,7321,3691,3630,447106,462028,0.967703256079718,0.96571506624778,0.997945455056138,1.58128050171548,-0.00324881185962751,-0.0971492709099464
"318","경기","부천시",2019,7059,3638,3421,"5",2017,7505,3894,3611,459384,475293,0.966528015350531,0.940572951365756,0.973146082087065,1.53662295595841,-0.0412643467224384,-0.660086919894976
"319","경기","부천시",2020,6172,3198,2974,"5",2018,6673,3415,3258,417119,431567,0.966522000060246,0.924921324741496,0.956958377236983,1.4796736662679,-0.0636875557558736,-0.992131927851192
"320","경기","성남시",2010,8852,4638,4214,"5",2008,8936,4602,4334,470657,486853,0.966733284995676,0.99059982094897,1.02468781857801,1.88077517172803,0.0464322362256421,0.638532405256425
"321","경기","성남시",2011,8517,4411,4106,"5",2009,8929,4613,4316,451574,467208,0.966537388058424,0.953858214805689,0.986881859502399,1.88606961428249,-0.0247417261884133,-0.415418386568752
"322","경기","성남시",2012,7665,3948,3717,"5",2010,8135,4143,3992,407210,420213,0.969056169133273,0.942224953902889,0.972312012363141,1.88232116107168,-0.052117685036351,-0.820804183932473
"323","경기","성남시",2013,7917,4076,3841,"5",2011,8380,4285,4095,420229,433401,0.969607822778443,0.944749403341289,0.974362398019932,1.88397278626654,-0.0483005444355816,-0.764279603562975
"324","경기","성남시",2014,8606,4427,4179,"5",2012,9011,4602,4409,464047,479002,0.968778835996509,0.955054932859838,0.985833811983976,1.8545535258282,-0.0262719539326627,-0.438078144266969
"325","경기","성남시",2015,7921,4067,3854,"5",2013,8458,4326,4132,441255,454391,0.971090976713887,0.936509813194609,0.964389367887755,1.79510713759617,-0.063924899879002,-0.995646542157066
"326","경기","성남시",2016,7483,3825,3658,"5",2014,8017,4064,3953,422114,434628,0.971207561408837,0.933391542971186,0.961062887131156,1.77274385592518,-0.0690255276057086,-1.07117712172624
"327","경기","성남시",2017,8106,4157,3949,"5",2015,8447,4370,4077,445571,459820,0.969011787221086,0.959630638096366,0.990318849318001,1.81923868474385,-0.0176123238335277,-0.309845519718106
"328","경기","성남시",2018,7902,4071,3831,"5",2016,8466,4409,4057,447106,462028,0.967703256079718,0.933380581148122,0.964531818286278,1.76736612794281,-0.0626852629805534,-0.977289881288658
"329","경기","성남시",2019,7813,4093,3720,"5",2017,8508,4473,4035,459384,475293,0.966528015350531,0.9183121767748,0.950114391088556,1.7007557947164,-0.084843238429095,-1.30540728514169
"330","경기","성남시",2020,7248,3704,3544,"5",2018,7789,3949,3840,417119,431567,0.966522000060246,0.930543073565284,0.96277484993335,1.73763362493677,-0.0646836724491279,-1.00688251840421
"331","경기","수원시",2010,11610,6047,5563,"5",2008,11947,6223,5724,470657,486853,0.966733284995676,0.971792081694149,1.00523287733751,2.466764544031,0.0129082762794387,0.142106424012488
"332","경기","수원시",2011,10941,5633,5308,"5",2009,11468,5891,5577,451574,467208,0.966537388058424,0.954046041158005,0.987076188614378,2.4228587119719,-0.031312569007536,-0.512720050790913
"333","경기","수원시",2012,10298,5241,5057,"5",2010,10219,5254,4965,407210,420213,0.969056169133273,1.00773069771993,1.03990948081085,2.52891628398124,0.100927735907796,1.44550693769545
"334","경기","수원시",2013,11042,5631,5411,"5",2011,10533,5375,5158,420229,433401,0.969607822778443,1.04832431406057,1.08118384508962,2.62761494328093,0.213319884510488,3.10982054335958
"335","경기","수원시",2014,12350,6416,5934,"5",2012,11969,6219,5750,464047,479002,0.968778835996509,1.03183223326928,1.06508544048437,2.66136835277461,0.173216331531502,2.51596332389896
"336","경기","수원시",2015,11849,6089,5760,"5",2013,11734,6019,5715,441255,454391,0.971090976713887,1.00980057951253,1.03986197351934,2.6852953507609,0.107041172163641,1.53603528210793
"337","경기","수원시",2016,11258,5747,5511,"5",2014,11500,5919,5581,422114,434628,0.971207561408837,0.97895652173913,1.00797868616164,2.66705202859891,0.0212795711129578,0.266069352577036
"338","경기","수원시",2017,11580,5984,5596,"5",2015,11998,6220,5778,445571,459820,0.969011787221086,0.965160860143357,0.996025923390702,2.59891240677692,-0.0103282770053864,-0.201982662827407
"339","경기","수원시",2018,11749,6072,5677,"5",2016,12004,6219,5785,447106,462028,0.967703256079718,0.978757080973009,1.01142274227543,2.6277884886358,0.0300165506600228,0.395447375093471
"340","경기","수원시",2019,12205,6273,5932,"5",2017,12664,6478,6186,459384,475293,0.966528015350531,0.963755527479469,0.997131497662738,2.65681869634119,-0.00762109064013487,-0.16189439014313
"341","경기","수원시",2020,10731,5521,5210,"5",2018,11156,5765,5391,417119,431567,0.966522000060246,0.961903908210828,0.995221948544234,2.57264713427104,-0.0122922403850749,-0.231065218988839
"342","경기","시흥시",2010,4860,2513,2347,"5",2008,5105,2656,2449,470657,486853,0.966733284995676,0.952007835455436,0.984767826070759,1.03259911145484,-0.0157287292648597,-0.281953072539513
"343","경기","시흥시",2011,4589,2386,2203,"5",2009,4802,2478,2324,451574,467208,0.966537388058424,0.955643481882549,0.988728934534278,1.01622325466037,-0.0114539188310664,-0.21865127383694
"344","경기","시흥시",2012,4164,2099,2065,"5",2010,4401,2234,2167,407210,420213,0.969056169133273,0.94614860259032,0.976360950714094,1.0225682080499,-0.0241725402682918,-0.406989827431945
"345","경기","시흥시",2013,4245,2122,2123,"5",2011,4482,2256,2226,420229,433401,0.969607822778443,0.947121820615797,0.976809178273529,1.01016350608835,-0.0234265217842817,-0.395942714902722
"346","경기","시흥시",2014,4395,2199,2196,"5",2012,4570,2266,2304,464047,479002,0.968778835996509,0.961706783369803,0.992700033935576,0.947102340926673,-0.00691381494830089,-0.151420984558226
"347","경기","시흥시",2015,4152,2179,1973,"5",2013,4290,2261,2029,441255,454391,0.971090976713887,0.967832167832168,0.996644177569493,0.940952510453139,-0.00315766954062065,-0.09579962679814
"348","경기","시흥시",2016,4069,2106,1963,"5",2014,4079,2105,1974,422114,434628,0.971207561408837,0.997548418730081,1.02712175889882,0.963957603870045,0.0261442257208501,0.338105619802361
"349","경기","시흥시",2017,4248,2165,2083,"5",2015,4133,2096,2037,445571,459820,0.969011787221086,1.02782482458263,1.06069383070169,0.953383411397959,0.0578644913651899,0.807822324603312
"350","경기","시흥시",2018,4662,2422,2240,"5",2016,4102,2130,1972,447106,462028,0.967703256079718,1.13651877133106,1.17444967162272,1.04270575657674,0.181899676833928,2.6445471254294
"351","경기","시흥시",2019,5317,2756,2561,"5",2017,4454,2300,2154,459384,475293,0.966528015350531,1.19375841939829,1.2350996561288,1.15741950089685,0.272108926657619,3.98037426019713
"352","경기","시흥시",2020,4959,2537,2422,"5",2018,4430,2279,2151,417119,431567,0.966522000060246,1.11941309255079,1.15818687260198,1.18886936341907,0.188063526531574,2.73582199687372
"353","경기","안산시",2010,7654,3947,3707,"5",2008,8136,4209,3927,470657,486853,0.966733284995676,0.940757128810226,0.973129966053081,1.62623736606488,-0.0436970532319112,-0.696110668819073
"354","경기","안산시",2011,7397,3852,3545,"5",2009,7736,4045,3691,451574,467208,0.966537388058424,0.956178903826267,0.989282893388154,1.63804824901345,-0.0175551377200243,-0.308998702320787
"355","경기","안산시",2012,6600,3390,3210,"5",2010,6896,3522,3374,407210,420213,0.969056169133273,0.95707656612529,0.987637865183091,1.62078534417131,-0.0200363669339159,-0.34574098005808
"356","경기","안산시",2013,6424,3298,3126,"5",2011,6699,3423,3276,420229,433401,0.969607822778443,0.958949096880131,0.989007178316932,1.52869030933134,-0.0168046199791141,-0.297884964368283
"357","경기","안산시",2014,7139,3668,3471,"5",2012,7401,3788,3613,464047,479002,0.968778835996509,0.96459937846237,0.9956858496709,1.53842175469295,-0.00663698271930317,-0.147321626632114
"358","경기","안산시",2015,6508,3354,3154,"5",2013,6710,3452,3258,441255,454391,0.971090976713887,0.969895678092399,0.998769117775625,1.47488413729023,-0.00181540866760296,-0.0759233003724305
"359","경기","안산시",2016,5900,3037,2863,"5",2014,6193,3208,2985,422114,434628,0.971207561408837,0.952688519295979,0.980931941998069,1.3977266804702,-0.0266519334140524,-0.443704916498057
"360","경기","안산시",2017,6090,3146,2944,"5",2015,6254,3205,3049,445571,459820,0.969011787221086,0.97377678285897,1.00491737634229,1.36678554035159,0.0067209988811127,0.0504846329525599
"361","경기","안산시",2018,5745,2909,2836,"5",2016,6093,3080,3013,447106,462028,0.967703256079718,0.942885278188085,0.974353731130167,1.2849301955241,-0.0329536652733783,-0.537021560081398
"362","경기","안산시",2019,5611,2815,2796,"5",2017,5907,2955,2952,459384,475293,0.966528015350531,0.949889961063145,0.982785750621671,1.22141824704387,-0.0210257982998548,-0.360392573649587
"363","경기","안산시",2020,5094,2610,2484,"5",2018,5075,2592,2483,417119,431567,0.966522000060246,1.00374384236453,1.03851111749341,1.22123422812195,0.0470310948461792,0.647400360557755
"364","경기","안성시",2010,1798,937,861,"5",2008,1832,966,866,470657,486853,0.966733284995676,0.981441048034934,1.01521387880973,0.382019177447695,0.00581199346868266,0.037023994515282
"365","경기","안성시",2011,1852,948,904,"5",2009,1835,942,893,451574,467208,0.966537388058424,1.00926430517711,1.04420617106651,0.410121043284157,0.0181298809973948,0.219428442352177
"366","경기","안성시",2012,1696,876,820,"5",2010,1743,898,845,407210,420213,0.969056169133273,0.973034997131383,1.00410587964335,0.416492718744628,0.00171006897549825,-0.0237176927670471
"367","경기","안성시",2013,1813,966,847,"5",2011,1860,987,873,420229,433401,0.969607822778443,0.974731182795699,1.00528395078597,0.431431433813468,0.00227966246379223,-0.0152830983220518
"368","경기","안성시",2014,2031,1044,987,"5",2012,2102,1079,1023,464047,479002,0.968778835996509,0.966222645099905,0.997361429872717,0.437671184168845,-0.00115482611212053,-0.0661413311831034
"369","경기","안성시",2015,1926,990,936,"5",2013,1994,1034,960,441255,454391,0.971090976713887,0.965897693079238,0.994652114210531,0.436482306149505,-0.00233425752241149,-0.0836064634676897
"370","경기","안성시",2016,1802,919,883,"5",2014,1919,979,940,422114,434628,0.971207561408837,0.939030745179781,0.966869269240058,0.426898894611408,-0.0141434723390874,-0.258478437497497
"371","경기","안성시",2017,1809,938,871,"5",2015,1837,945,892,445571,459820,0.969011787221086,0.984757757212847,1.01624951336961,0.40599590188769,0.00659723583573166,0.0486519380279861
"372","경기","안성시",2018,1888,984,904,"5",2016,1951,1002,949,447106,462028,0.967703256079718,0.967708867247565,1.00000579843853,0.422271228746651,2.44851376352773e-06,-0.0490042986653127
"373","경기","안성시",2019,1787,897,890,"5",2017,1830,914,916,459384,475293,0.966528015350531,0.976502732240437,1.01032015288899,0.388999181512634,0.00401453102690098,0.0104070000479667
"374","경기","안성시",2020,1681,886,795,"5",2018,1664,885,779,417119,431567,0.966522000060246,1.01021634615385,1.04520781326331,0.403002500485473,0.0182188617865927,0.220746078325381
"375","경기","안양시",2010,6023,3126,2897,"5",2008,6273,3271,3002,470657,486853,0.966733284995676,0.960146660290132,0.993186719845305,1.27970050376389,-0.00871895804624749,-0.17815171491114
"376","경기","안양시",2011,5482,2893,2589,"5",2009,5782,3018,2764,451574,467208,0.966537388058424,0.948114839156001,0.980939641725159,1.21397600393291,-0.0231388175720206,-0.391682363616391
"377","경기","안양시",2012,5104,2628,2476,"5",2010,5279,2730,2549,407210,420213,0.969056169133273,0.966849782155711,0.997723158834503,1.25340733282581,-0.00285380941251373,-0.0913000371763158
"378","경기","안양시",2013,5291,2688,2603,"5",2011,5423,2764,2659,420229,433401,0.969607822778443,0.975659229208925,1.00624108664175,1.2590754088842,0.00785799871534696,0.0673214344309562
"379","경기","안양시",2014,5378,2845,2533,"5",2012,5615,2958,2657,464047,479002,0.968778835996509,0.957791629563669,0.988658705140334,1.15893433208274,-0.0131438159831406,-0.243675431283316
"380","경기","안양시",2015,5127,2626,2501,"5",2013,5387,2753,2634,441255,454391,0.971090976713887,0.951735659922035,0.980068482504749,1.16191317945406,-0.0231586928642508,-0.391976678830456
"381","경기","안양시",2016,4642,2389,2253,"5",2014,4791,2459,2332,422114,434628,0.971207561408837,0.968900020872469,0.997624050071212,1.09970292385469,-0.00261283908362049,-0.0877317256712471
"382","경기","안양시",2017,4978,2583,2395,"5",2015,5197,2723,2474,445571,459820,0.969011787221086,0.957860304021551,0.988491901392123,1.11721813134158,-0.0128570564219873,-0.239429068480262
"383","경기","안양시",2018,4837,2443,2394,"5",2016,5214,2666,2548,447106,462028,0.967703256079718,0.927694668200997,0.958656140064259,1.08184636305485,-0.0447277045061308,-0.711372650725322
"384","경기","안양시",2019,4602,2360,2242,"5",2017,5068,2610,2458,459384,475293,0.966528015350531,0.908050513022889,0.939497354035378,1.00177629172979,-0.0606101163142801,-0.946560912465079
"385","경기","안양시",2020,4147,2145,2002,"5",2018,4396,2257,2139,417119,431567,0.966522000060246,0.943357597816197,0.976033238516449,0.994200695724721,-0.0238277709412153,-0.401884450508353
"386","경기","양주시",2010,2278,1155,1123,"5",2008,2266,1135,1131,470657,486853,0.966733284995676,1.00529567519859,1.03988937879912,0.484004274875334,0.0193066298608962,0.236853851229254
"387","경기","양주시",2011,2334,1242,1092,"5",2009,2278,1203,1075,451574,467208,0.966537388058424,1.02458296751536,1.06005518273177,0.516858809408868,0.0310400502455769,0.410603454115066
"388","경기","양주시",2012,2112,1104,1008,"5",2010,2252,1177,1075,407210,420213,0.969056169133273,0.937833037300178,0.967779853400014,0.51865131013482,-0.0167110212468189,-0.296498945455321
"389","경기","양주시",2013,2158,1144,1014,"5",2011,2256,1189,1067,420229,433401,0.969607822778443,0.956560283687943,0.986543488218658,0.513529527947857,-0.00691031614289745,-0.151369173915677
"390","경기","양주시",2014,2361,1220,1141,"5",2012,2515,1290,1225,464047,479002,0.968778835996509,0.938767395626243,0.969021370765809,0.508784670518288,-0.015761451668026,-0.28243762899187
"391","경기","양주시",2015,2212,1111,1101,"5",2013,2257,1133,1124,441255,454391,0.971090976713887,0.980062029242357,1.00923811748187,0.501297435723108,0.00463104460457174,0.019536391630481
"392","경기","양주시",2016,2141,1089,1052,"5",2014,2196,1115,1081,422114,434628,0.971207561408837,0.974954462659381,1.00385798195919,0.507208953031645,0.00195680299033538,-0.0200640320533865
"393","경기","양주시",2017,2136,1074,1062,"5",2015,2196,1100,1096,445571,459820,0.969011787221086,0.972677595628415,1.00378303799363,0.479384879177505,0.00181353121149837,-0.0221856141549002
"394","경기","양주시",2018,2187,1100,1087,"5",2016,2212,1123,1089,447106,462028,0.967703256079718,0.98869801084991,1.0216954470684,0.4891457506721,0.0106122357424371,0.108106437782162
"395","경기","양주시",2019,2359,1179,1180,"5",2017,2350,1174,1176,459384,475293,0.966528015350531,1.00382978723404,1.03859357544849,0.513513748846281,0.0198183316099366,0.244431179303839
"396","경기","양주시",2020,2065,1035,1030,"5",2018,2062,1056,1006,417119,431567,0.966522000060246,1.00145489815713,1.03614288975803,0.495062560084772,0.0178929915324696,0.215920560668134
"397","경기","양평군",2010,722,380,342,"5",2008,699,375,324,470657,486853,0.966733284995676,1.03290414878398,1.06844790058987,0.153402584047406,0.0105000848231057,0.106445696322448
"398","경기","양평군",2011,790,429,361,"5",2009,734,400,334,451574,467208,0.966537388058424,1.07629427792916,1.11355679689868,0.174943641573696,0.0198660395748997,0.245137643377831
"399","경기","양평군",2012,681,361,320,"5",2010,656,339,317,407210,420213,0.969056169133273,1.03810975609756,1.07125860106339,0.16723557869404,0.0119169733857643,0.127427116660612
"400","경기","양평군",2013,776,390,386,"5",2011,794,408,386,420229,433401,0.969607822778443,0.977329974811083,1.00796420145468,0.184661220429813,0.00147067916036988,-0.0272625998742507
"401","경기","양평군",2014,847,422,425,"5",2012,847,426,421,464047,479002,0.968778835996509,1,1.03222733904109,0.182524614963571,0.00588228264977513,0.0380648433813066
"402","경기","양평군",2015,816,410,406,"5",2013,812,404,408,441255,454391,0.971090976713887,1.00492610837438,1.03484239115782,0.18492708297923,0.00644330176083736,0.0463724676343062
"403","경기","양평군",2016,822,431,391,"5",2014,810,424,386,422114,434628,0.971207561408837,1.01481481481481,1.04490003490368,0.194734123957035,0.00874356896260906,0.0804350427177753
"404","경기","양평군",2017,831,421,410,"5",2015,840,426,414,445571,459820,0.969011787221086,0.989285714285714,1.0209222708454,0.186502263387878,0.00390205086788188,0.00874138317570171
"405","경기","양평군",2018,873,444,429,"5",2016,889,459,430,447106,462028,0.967703256079718,0.982002249718785,1.01477621734683,0.195255711173637,0.00288514082651113,-0.00631711725009482
"406","경기","양평군",2019,840,438,402,"5",2017,891,469,422,459384,475293,0.966528015350531,0.942760942760943,0.975409846158501,0.182853560420041,-0.00449639718119465,-0.115623632782421
"407","경기","양평군",2020,746,373,373,"5",2018,809,403,406,417119,431567,0.966522000060246,0.9221260815822,0.954066313570433,0.178845844950722,-0.00821504896119741,-0.170689781344666
"408","경기","여주시",2015,884,475,409,"5",2013,927,503,424,441255,454391,0.971090976713887,0.95361380798274,0.982002542346456,0.200337673227499,-0.00360556879032153,-0.102432161405865
"409","경기","여주시",2016,908,481,427,"5",2014,932,499,433,422114,434628,0.971207561408837,0.974248927038627,1.00313153001546,0.215107767096093,0.000673616429219124,-0.0390655804606566
"410","경기","여주시",2017,939,463,476,"5",2015,952,474,478,445571,459820,0.969011787221086,0.986344537815126,1.01788703793144,0.210740824694605,0.00376952912501614,0.00677898862732942
"411","경기","여주시",2018,955,494,461,"5",2016,1010,520,490,447106,462028,0.967703256079718,0.945544554455445,0.977101759774954,0.213595881066235,-0.00489096979573499,-0.121466501514501
"412","경기","여주시",2019,868,457,411,"5",2017,930,487,443,459384,475293,0.966528015350531,0.933333333333333,0.965655747696916,0.188948679100709,-0.00648930110736922,-0.145134743303484
"413","경기","여주시",2020,804,428,376,"5",2018,851,473,378,417119,431567,0.966522000060246,0.944770857814336,0.977495450445459,0.192750749786032,-0.00433776880023462,-0.113274648658899
"414","경기","연천군",2010,333,192,141,"5",2008,374,213,161,470657,486853,0.966733284995676,0.890374331550802,0.921013422595441,0.0707521613404241,-0.00558847106825524,-0.131795166570342
"415","경기","연천군",2011,334,159,175,"5",2009,366,169,197,451574,467208,0.966537388058424,0.912568306010929,0.944162447604942,0.0739635142855877,-0.00412994160424413,-0.110197123812063
"416","경기","연천군",2012,329,186,143,"5",2010,340,190,150,407210,420213,0.969056169133273,0.967647058823529,0.998545894082689,0.08079369367157,-0.00011748258804925,-0.0507802498057691
"417","경기","연천군",2013,281,147,134,"5",2011,297,150,147,420229,433401,0.969607822778443,0.946127946127946,0.975784150974345,0.0668683027587339,-0.0016192727242073,-0.0730189007038458
"418","경기","연천군",2014,312,170,142,"5",2012,338,178,160,464047,479002,0.968778835996509,0.923076923076923,0.952825236037928,0.0672345689122007,-0.00317177491852475,-0.0960085005731384
"419","경기","연천군",2015,300,157,143,"5",2013,321,166,155,441255,454391,0.971090976713887,0.934579439252336,0.962401527419085,0.0679878981541286,-0.00255624112458204,-0.0868936177210778
"420","경기","연천군",2016,271,147,124,"5",2014,305,172,133,422114,434628,0.971207561408837,0.888524590163934,0.914865807752812,0.0642006661707501,-0.00546567185617818,-0.129976744180828
"421","경기","연천군",2017,334,165,169,"5",2015,349,168,181,445571,459820,0.969011787221086,0.95702005730659,0.98762478426719,0.0749599951522877,-0.000927646111339917,-0.062777228165814
"422","경기","연천군",2018,300,166,134,"5",2016,350,189,161,447106,462028,0.967703256079718,0.857142857142857,0.885749687993451,0.0670981825338958,-0.00766598828956995,-0.162559238798006
"423","경기","연천군",2019,286,156,130,"5",2017,356,192,164,459384,475293,0.966528015350531,0.803370786516854,0.831192447355491,0.0622572836668234,-0.0105094996900914,-0.204666225545616
"424","경기","연천군",2020,284,143,141,"5",2018,340,169,171,417119,431567,0.966522000060246,0.835294117647059,0.86422669902495,0.0680860857453149,-0.00924427261211168,-0.185930622869488
"425","경기","오산시",2010,2310,1200,1110,"5",2008,2238,1158,1080,470657,486853,0.966733284995676,1.03217158176944,1.06769012486629,0.49080328137051,0.0332225354007571,0.442921901471801
"426","경기","오산시",2011,2447,1243,1204,"5",2009,2261,1152,1109,451574,467208,0.966537388058424,1.08226448474127,1.11973369898842,0.541882393583333,0.0648815834004315,0.911732089579283
"427","경기","오산시",2012,2479,1264,1215,"5",2010,2388,1202,1186,407210,420213,0.969056169133273,1.03810720268007,1.07125596611036,0.608776798212225,0.0433789789021827,0.5933194809712
"428","경기","오산시",2013,2583,1276,1307,"5",2011,2660,1311,1349,420229,433401,0.969607822778443,0.971052631578947,1.00149009606416,0.614664861301814,0.000915909690605439,-0.0354776788456472
"429","경기","오산시",2014,2993,1554,1439,"5",2012,3049,1581,1468,464047,479002,0.968778835996509,0.981633322400787,1.01326875229583,0.644977771648131,0.00855805028831382,0.0776878645779052
"430","경기","오산시",2015,2971,1600,1371,"5",2013,3080,1642,1438,441255,454391,0.971090976713887,0.96461038961039,0.993326488188133,0.673306818053053,-0.00449332100328766,-0.115578080447959
"431","경기","오산시",2016,2728,1427,1301,"5",2014,2922,1524,1398,422114,434628,0.971207561408837,0.933607118412047,0.961284853525803,0.646270912597071,-0.0250204730432084,-0.419546096455423
"432","경기","오산시",2017,2839,1439,1400,"5",2015,2927,1483,1444,445571,459820,0.969011787221086,0.969935087119918,1.00095282628241,0.637159958794446,0.000607102754839966,-0.0400505212648695
"433","경기","오산시",2018,2943,1502,1441,"5",2016,2988,1520,1468,447106,462028,0.967703256079718,0.984939759036145,1.01781176496838,0.658233170657517,0.0117242945301422,0.124573909875953
"434","경기","오산시",2019,2979,1555,1424,"5",2017,3039,1578,1461,459384,475293,0.966528015350531,0.980256663376111,1.01420408700787,0.648477091061073,0.0092110250240397,0.0873571764500825
"435","경기","오산시",2020,2677,1378,1299,"5",2018,2736,1407,1329,417119,431567,0.966522000060246,0.97843567251462,1.01232633344469,0.641783280071155,0.00791083470938601,0.0681038348462987
"436","경기","용인시",2010,11092,5717,5375,"5",2008,11701,6019,5682,470657,486853,0.966733284995676,0.947953166396035,0.980573629882077,2.35670562639034,-0.045782235757251,-0.726988249596392
"437","경기","용인시",2011,11162,5763,5399,"5",2009,11422,5856,5566,451574,467208,0.966537388058424,0.977236911223954,1.01106995269684,2.47179864208303,0.0273626940439622,0.356148814397696
"438","경기","용인시",2012,10455,5449,5006,"5",2010,10979,5682,5297,407210,420213,0.969056169133273,0.952272520265962,0.982680416882004,2.56747132928956,-0.0444675330907024,-0.707520007708121
"439","경기","용인시",2013,11055,5738,5317,"5",2011,11458,5957,5501,420229,433401,0.969607822778443,0.964828067725607,0.995070424412274,2.63070849465411,-0.0129682763736694,-0.241076024082652
"440","경기","용인시",2014,12253,6241,6012,"5",2012,12790,6556,6234,464047,479002,0.968778835996509,0.958014073494918,0.988888317847573,2.64046529769614,-0.029340011122513,-0.483510226378629
"441","경기","용인시",2015,11757,6077,5680,"5",2013,12307,6365,5942,441255,454391,0.971090976713887,0.955309986186723,0.983749215155344,2.6644457286603,-0.0432993342667216,-0.690221208627902
"442","경기","용인시",2016,10993,5693,5300,"5",2014,11609,5953,5656,422114,434628,0.971207561408837,0.946937720733913,0.975010655147991,2.60427277939135,-0.0650790705729092,-1.01273761135549
"443","경기","용인시",2017,11437,5882,5555,"5",2015,12031,6155,5876,445571,459820,0.969011787221086,0.950627545507439,0.981027845113867,2.56681875615783,-0.0486980830064585,-0.770166392458038
"444","경기","용인시",2018,11495,5866,5629,"5",2016,11881,6068,5813,447106,462028,0.967703256079718,0.967511152259911,0.999801484785134,2.57097869409044,-0.000510378387873619,-0.0565982881063584
"445","경기","용인시",2019,11990,6091,5899,"5",2017,12202,6245,5957,459384,475293,0.966528015350531,0.982625799049336,1.0166552685935,2.61001689218606,0.0434705323729297,0.594675213457005
"446","경기","용인시",2020,10958,5579,5379,"5",2018,11157,5692,5465,417119,431567,0.966522000060246,0.982163664067402,1.01618345366808,2.62706805491958,0.0425150341496871,0.580526105063748
"447","경기","의왕시",2010,1394,727,667,"5",2008,1494,788,706,470657,486853,0.966733284995676,0.933065595716198,0.965173755986245,0.2961817204461,-0.0103148968686696,-0.201784528492757
"448","경기","의왕시",2011,1331,657,674,"5",2009,1457,708,749,451574,467208,0.966537388058424,0.913520933424846,0.945148056051844,0.294746818904543,-0.0161674359894494,-0.288449483362763
"449","경기","의왕시",2012,1198,606,592,"5",2010,1380,712,668,407210,420213,0.969056169133273,0.868115942028985,0.895836556930886,0.294197097320793,-0.030644582597873,-0.502828444626047
"450","경기","의왕시",2013,1407,721,686,"5",2011,1514,783,731,420229,433401,0.969607822778443,0.929326287978864,0.958455847969387,0.334817444774159,-0.013909706828199,-0.255016815621382
"451","경기","의왕시",2014,1503,767,736,"5",2012,1642,842,800,464047,479002,0.968778835996509,0.915347137637028,0.944846340181946,0.323889606009736,-0.0178636971484644,-0.31356787962804
"452","경기","의왕시",2015,1397,729,668,"5",2013,1627,845,782,441255,454391,0.971090976713887,0.858635525507068,0.884196791131392,0.316596979071059,-0.0366629460945362,-0.591948942595503
"453","경기","의왕시",2016,1368,701,667,"5",2014,1585,792,793,422114,434628,0.971207561408837,0.863091482649842,0.888678709829893,0.324083067607329,-0.0360773452083337,-0.583277309082729
"454","경기","의왕시",2017,1326,708,618,"5",2015,1574,834,740,445571,459820,0.969011787221086,0.842439644218551,0.869380182293224,0.297595669377047,-0.0388718920843557,-0.624659224503448
"455","경기","의왕시",2018,1237,647,590,"5",2016,1547,796,751,447106,462028,0.967703256079718,0.799612152553329,0.826298917079864,0.276668172648097,-0.0480575611985097,-0.760681484722515
"456","경기","의왕시",2019,1313,686,627,"5",2017,1542,816,726,459384,475293,0.966528015350531,0.851491569390402,0.880979708675688,0.285817529561326,-0.0340180856339841,-0.552783597824484
"457","경기","의왕시",2020,1257,590,667,"5",2018,1360,658,702,417119,431567,0.966522000060246,0.924264705882353,0.956279014678136,0.30135285134458,-0.0131754435903383,-0.244143775893042
"458","경기","의정부시",2010,4414,2261,2153,"5",2008,4842,2487,2355,470657,486853,0.966733284995676,0.911606774060306,0.942976504697863,0.937837958428325,-0.0534787984166036,-0.840959680074946
"459","경기","의정부시",2011,4024,2034,1990,"5",2009,4470,2276,2194,451574,467208,0.966537388058424,0.900223713646532,0.931390471562511,0.891105333788039,-0.061138316739329,-0.954382554500183
"460","경기","의정부시",2012,3709,1908,1801,"5",2010,4028,2072,1956,407210,420213,0.969056169133273,0.920804369414101,0.950207427333827,0.910832248716878,-0.0453526809309287,-0.720627360951456
"461","경기","의정부시",2013,3720,1873,1847,"5",2011,4016,2018,1998,420229,433401,0.969607822778443,0.926294820717131,0.955329359929052,0.88523162370993,-0.0395438632421673,-0.634609837197164
"462","경기","의정부시",2014,4073,2144,1929,"5",2012,4334,2257,2077,464047,479002,0.968778835996509,0.939778495616059,0.970065055817802,0.877712817882671,-0.0262742842113175,-0.438112651254498
"463","경기","의정부시",2015,3574,1856,1718,"5",2013,3901,1999,1902,441255,454391,0.971090976713887,0.916175339656498,0.943449544507951,0.809962493342852,-0.0458037479300139,-0.727306803892772
"464","경기","의정부시",2016,3466,1731,1735,"5",2014,3715,1880,1835,422114,434628,0.971207561408837,0.932974427994616,0.960633406355734,0.821105199069446,-0.0323241147109614,-0.527699115591189
"465","경기","의정부시",2017,3749,1897,1852,"5",2015,3934,2016,1918,445571,459820,0.969011787221086,0.952974072191154,0.983449411821991,0.841392280915948,-0.0139255371375954,-0.255251232345662
"466","경기","의정부시",2018,3683,1884,1799,"5",2016,3867,1970,1897,447106,462028,0.967703256079718,0.952417895009051,0.984204495567588,0.823742020907794,-0.0130114207424134,-0.241714909990619
"467","경기","의정부시",2019,3868,1967,1901,"5",2017,4074,2090,1984,459384,475293,0.966528015350531,0.949435444280805,0.982315493396715,0.841997109172283,-0.0148903034371039,-0.269537583292065
"468","경기","의정부시",2020,3502,1812,1690,"5",2018,3715,1940,1775,417119,431567,0.966522000060246,0.942664872139973,0.975316518487127,0.839568564366524,-0.0207234751373307,-0.355915743560014
"469","경기","이천시",2010,2251,1164,1087,"5",2008,2302,1209,1093,470657,486853,0.966733284995676,0.977845351867941,1.01149444944612,0.478267613145029,0.00549742290101212,0.0323658036876796
"470","경기","이천시",2011,2187,1158,1029,"5",2009,2229,1181,1048,451574,467208,0.966537388058424,0.981157469717362,1.01512624533678,0.484306005217307,0.00732573145299078,0.0594395702829496
"471","경기","이천시",2012,2124,1116,1008,"5",2010,2155,1141,1014,407210,420213,0.969056169133273,0.985614849187935,1.01708743061764,0.521598192578768,0.00891277292597685,0.0829406310695097
"472","경기","이천시",2013,2165,1142,1023,"5",2011,2242,1182,1060,420229,433401,0.969607822778443,0.965655664585192,0.995923962141801,0.515195286379569,-0.00209995549164902,-0.0801368967543492
"473","경기","이천시",2014,2377,1210,1167,"5",2012,2474,1245,1229,464047,479002,0.968778835996509,0.960792239288601,0.991756016532202,0.51223259712917,-0.00422283706240016,-0.111572728574813
"474","경기","이천시",2015,2168,1141,1027,"5",2013,2277,1165,1112,441255,454391,0.971090976713887,0.952129995608257,0.980474557420157,0.491325877327169,-0.00959335520574274,-0.19109987105367
"475","경기","이천시",2016,2032,1064,968,"5",2014,2091,1100,991,422114,434628,0.971207561408837,0.971783835485414,1.00059335830926,0.481386544867026,0.000285634706362115,-0.0448108506430301
"476","경기","이천시",2017,2274,1203,1071,"5",2015,2238,1180,1058,445571,459820,0.969011787221086,1.01608579088472,1.04857939220598,0.510356374180546,0.0247928024661392,0.318093615958772
"477","경기","이천시",2018,2274,1181,1093,"5",2016,2323,1219,1104,447106,462028,0.967703256079718,0.978906586310805,1.01157723729945,0.50860422360693,0.00588823178820088,0.0381529387878546
"478","경기","이천시",2019,2291,1163,1128,"5",2017,2361,1197,1164,459384,475293,0.966528015350531,0.970351545955104,1.003955943898,0.498711317764659,0.00197287399437493,-0.0198260510999814
"479","경기","이천시",2020,2035,1016,1019,"5",2018,2082,1045,1037,417119,431567,0.966522000060246,0.977425552353506,1.01128122514809,0.487870367928577,0.00550377546368315,0.032459873038748
"480","경기","파주시",2010,3766,1961,1805,"5",2008,3877,2019,1858,470657,486853,0.966733284995676,0.971369615682229,1.00479587364841,0.800158076901013,0.00383745703557248,0.00778487157510443
"481","경기","파주시",2011,4048,2133,1915,"5",2009,3813,1984,1829,451574,467208,0.966537388058424,1.0616312614739,1.09838613031463,0.896420077329519,0.0881953025447956,1.25696385579243
"482","경기","파주시",2012,4011,2075,1936,"5",2010,3886,1999,1887,407210,420213,0.969056169133273,1.03216675244467,1.06512582585161,0.984995456889566,0.0641486425900154,0.900878632482078
"483","경기","파주시",2013,4441,2243,2198,"5",2011,4313,2196,2117,420229,433401,0.969607822778443,1.02967771852539,1.06195277547866,1.05680474217629,0.0654719869168308,0.920474840895914
"484","경기","파주시",2014,4943,2512,2431,"5",2012,5016,2548,2468,464047,479002,0.968778835996509,0.985446570972887,1.01720489172251,1.06519382734938,0.0183265444630301,0.222340653620162
"485","경기","파주시",2015,4757,2456,2301,"5",2013,4874,2515,2359,441255,454391,0.971090976713887,0.975995075913008,1.00505009243904,1.0780614383973,0.00544430991886813,0.0315793016061853
"486","경기","파주시",2016,4591,2396,2195,"5",2014,4637,2423,2214,422114,434628,0.971207561408837,0.990079792969592,1.01943171811119,1.08762087966758,0.0211343423455478,0.263918791202961
"487","경기","파주시",2017,4992,2492,2500,"5",2015,5189,2594,2595,445571,459820,0.969011787221086,0.962035074195413,0.992800177337697,1.12036016706653,-0.00806639452078718,-0.168488492279611
"488","경기","파주시",2018,4847,2483,2364,"5",2016,5022,2583,2439,447106,462028,0.967703256079718,0.965153325368379,0.997364966279364,1.08408296913931,-0.00285659517964892,-0.0913412890805008
"489","경기","파주시",2019,5245,2689,2556,"5",2017,5245,2675,2570,459384,475293,0.966528015350531,1,1.0346311582467,1.14174633857514,0.0395399981287808,0.536471489252118
"490","경기","파주시",2020,4595,2333,2262,"5",2018,4865,2451,2414,417119,431567,0.966522000060246,0.944501541623844,0.977216805789181,1.10160409859057,-0.0250980601216231,-0.42069501327777
"491","경기","평택시",2010,4672,2350,2322,"5",2008,4790,2390,2400,470657,486853,0.966733284995676,0.975365344467641,1.00892910134154,0.99265494829568,0.00886351663051153,0.0822112391704604
"492","경기","평택시",2011,4523,2376,2147,"5",2009,4625,2445,2180,451574,467208,0.966537388058424,0.977945945945946,1.01180353499872,1.0016077099213,0.0118225116590472,0.126028318444327
"493","경기","평택시",2012,4190,2142,2048,"5",2010,4168,2083,2085,407210,420213,0.969056169133273,1.0052783109405,1.03737878459576,1.02895312001179,0.0384610170320572,0.520493834746379
"494","경기","평택시",2013,4508,2318,2190,"5",2011,4523,2311,2212,420229,433401,0.969607822778443,0.996683617068318,1.02792448003595,1.07274843002268,0.0299559421177616,0.394549878046223
"495","경기","평택시",2014,4946,2541,2405,"5",2012,4989,2554,2435,464047,479002,0.968778835996509,0.991381038284225,1.02333061112392,1.06584031358893,0.0248667058765373,0.319187984675446
"496","경기","평택시",2015,4718,2401,2317,"5",2013,4734,2419,2315,441255,454391,0.971090976713887,0.996620194338826,1.02628921309858,1.06922301163726,0.0281090316028359,0.367200651817788
"497","경기","평택시",2016,4704,2401,2303,"5",2014,4650,2371,2279,422114,434628,0.971207561408837,1.01161290322581,1.04160319938032,1.11439089914099,0.0463622267645803,0.637495698511167
"498","경기","평택시",2017,4918,2572,2346,"5",2015,4894,2563,2331,445571,459820,0.969011787221086,1.0049039640376,1.03703997958522,1.10375226394896,0.0408829613238142,0.556358215728905
"499","경기","평택시",2018,5043,2593,2450,"5",2016,4952,2546,2406,447106,462028,0.967703256079718,1.01837641357027,1.05236435567639,1.12792044839479,0.0590628275344152,0.825567400352788
"500","경기","평택시",2019,5410,2767,2643,"5",2017,5211,2683,2528,459384,475293,0.966528015350531,1.03818844751487,1.07414211593065,1.17766400222907,0.0873145009806223,1.24392086261747
"501","경기","평택시",2020,5066,2515,2551,"5",2018,4806,2390,2416,417119,431567,0.966522000060246,1.05409904286309,1.09061050115505,1.21452151544284,0.110048403177869,1.58056664443686
"502","경기","포천시",2010,1571,773,798,"5",2008,1684,834,850,470657,486853,0.966733284995676,0.932897862232779,0.965000250546821,0.333788725122541,-0.0116825217495849,-0.222036447555167
"503","경기","포천시",2011,1273,642,631,"5",2009,1388,700,688,451574,467208,0.966537388058424,0.917146974063401,0.948899634297398,0.281902855345968,-0.0144053390007867,-0.262356183882403
"504","경기","포천시",2012,1263,683,580,"5",2010,1284,697,587,407210,420213,0.969056169133273,0.983644859813084,1.01505453568585,0.31015937722551,0.00466930541274287,0.020102961309899
"505","경기","포천시",2013,1322,689,633,"5",2011,1404,741,663,420229,433401,0.969607822778443,0.941595441595442,0.971109575928615,0.314590378103367,-0.0090886494321836,-0.183626140048125
"506","경기","포천시",2014,1335,733,602,"5",2012,1383,753,630,464047,479002,0.968778835996509,0.96529284164859,0.996401661330335,0.287686376595474,-0.00103519301363933,-0.0643697929042699
"507","경기","포천시",2015,1240,653,587,"5",2013,1257,661,596,441255,454391,0.971090976713887,0.986475735879077,1.01584275781992,0.281016645703731,0.00445207866125112,0.0168862469529204
"508","경기","포천시",2016,1192,603,589,"5",2014,1243,617,626,422114,434628,0.971207561408837,0.958970233306517,0.987399883826513,0.282388170020421,-0.00355812374827577,-0.101729590719391
"509","경기","포천시",2017,1171,605,566,"5",2015,1217,632,585,445571,459820,0.969011787221086,0.962202136400986,0.992972582057408,0.262808845279428,-0.00184686759478847,-0.0763891471525248
"510","경기","포천시",2018,1110,606,504,"5",2016,1193,644,549,447106,462028,0.967703256079718,0.930427493713328,0.961480172633294,0.248263275375414,-0.00956305850895404,-0.190651234691619
"511","경기","포천시",2019,1127,553,574,"5",2017,1231,607,624,459384,475293,0.966528015350531,0.915515840779854,0.947221214739257,0.245328526896888,-0.0129481416394251,-0.240777867026614
"512","경기","포천시",2020,922,486,436,"5",2018,988,515,473,417119,431567,0.966522000060246,0.933198380566802,0.965522130389824,0.221040038933734,-0.00762098964098556,-0.161892894538139
"513","경기","하남시",2010,1286,666,620,"5",2008,1412,730,682,470657,486853,0.966733284995676,0.910764872521246,0.942105632087882,0.273235073524881,-0.015818771873144,-0.283286432030546
"514","경기","하남시",2011,1320,676,644,"5",2009,1502,755,747,451574,467208,0.966537388058424,0.878828229027963,0.909254251191823,0.292310894781365,-0.0265259710317231,-0.441839653583176
"515","경기","하남시",2012,1109,598,511,"5",2010,1280,683,597,407210,420213,0.969056169133273,0.86640625,0.894072271140812,0.27234105252818,-0.0288484691694309,-0.476231426476324
"516","경기","하남시",2013,1189,624,565,"5",2011,1350,712,638,420229,433401,0.969607822778443,0.880740740740741,0.908347395771776,0.282940967900835,-0.0259322765509658,-0.433048169353926
"517","경기","하남시",2014,1328,699,629,"5",2012,1490,779,711,464047,479002,0.968778835996509,0.891275167785235,0.919998594796353,0.286177908703213,-0.0228946348344981,-0.388066482459394
"518","경기","하남시",2015,1390,709,681,"5",2013,1363,686,677,441255,454391,0.971090976713887,1.01980924431401,1.05016859261218,0.315010594780796,0.0158036381980792,0.184981218154466
"519","경기","하남시",2016,1652,836,816,"5",2014,1364,689,675,422114,434628,0.971207561408837,1.21114369501466,1.24704928497238,0.391363470531657,0.0966860655591565,1.38269588051975
"520","경기","하남시",2017,2477,1269,1208,"5",2015,1805,940,865,445571,459820,0.969011787221086,1.37229916897507,1.41618418586065,0.555915892192266,0.231363402999036,3.37701067797209
"521","경기","하남시",2018,2735,1333,1402,"5",2016,2559,1285,1274,447106,462028,0.967703256079718,1.06877686596327,1.10444690482185,0.611711764100683,0.0638914004034275,0.897069365763612
"522","경기","하남시",2019,3089,1646,1443,"5",2017,2947,1555,1392,459384,475293,0.966528015350531,1.04818459450288,1.08448444106686,0.672422200163697,0.0568092137417797,0.79219567338052
"523","경기","하남시",2020,3027,1522,1505,"5",2018,3054,1563,1491,417119,431567,0.966522000060246,0.991159135559921,1.0254905066808,0.725692188560099,0.0184982615806956,0.224883456999305
"524","경기","화성시",2010,7266,3772,3494,"5",2008,7068,3633,3435,470657,486853,0.966733284995676,1.02801358234295,1.06338904256054,1.54379941231088,0.0978599666519048,1.40007911933718
"525","경기","화성시",2011,7373,3783,3590,"5",2009,7648,3932,3716,451574,467208,0.966537388058424,0.964042887029289,0.997419136538374,1.63273350547197,-0.00421386224684443,-0.111439828654103
"526","경기","화성시",2012,6814,3475,3339,"5",2010,7101,3606,3495,407210,420213,0.969056169133273,0.959583157301788,0.990224496646095,1.67333808108838,-0.0163577220238958,-0.291267257024308
"527","경기","화성시",2013,7351,3762,3589,"5",2011,7713,3940,3773,420229,433401,0.969607822778443,0.953066251782705,0.982939936531929,1.74928431878809,-0.0298429015022263,-0.490957074859774
"528","경기","화성시",2014,8041,4064,3977,"5",2012,8433,4269,4164,464047,479002,0.968778835996509,0.953515949247006,0.984245231024474,1.73279861738143,-0.0272998418979545,-0.453299206832299
"529","경기","화성시",2015,8225,4211,4014,"5",2013,8198,4230,3968,441255,454391,0.971090976713887,1.00329348621615,1.03316116643492,1.86400154105902,0.0618124653380145,0.866284297965947
"530","경기","화성시",2016,8751,4483,4268,"5",2014,7854,4064,3790,422114,434628,0.971207561408837,1.11420932009167,1.14724119165155,2.07313664081267,0.305251109449755,4.47114684910233
"531","경기","화성시",2017,9716,4984,4732,"5",2015,9122,4669,4453,445571,459820,0.969011787221086,1.06511729883797,1.09917888810465,2.18057279311266,0.216266785052165,3.15345852632394
"532","경기","화성시",2018,10549,5378,5171,"5",2016,9664,4967,4697,447106,462028,0.967703256079718,1.09157698675497,1.12800797134555,2.35939575850022,0.302021464646911,4.42332196227826
"533","경기","화성시",2019,11743,5921,5822,"5",2017,10571,5369,5202,459384,475293,0.966528015350531,1.11086935956863,1.14934005215126,2.55624923811017,0.381750394530985,5.60395552450495
"534","경기","화성시",2020,11118,5741,5377,"5",2018,10473,5453,5020,417119,431567,0.966522000060246,1.06158693784016,1.0983577588239,2.66542641308595,0.262165368301149,3.83312910413299
"535","경남","거제시",2010,2755,1388,1367,"5",2008,2785,1383,1402,470657,486853,0.966733284995676,0.989228007181329,1.02326879867983,0.585351965444049,0.0136204370407586,0.152652168170069
"536","경남","거제시",2011,2706,1429,1277,"5",2009,2841,1501,1340,451574,467208,0.966537388058424,0.952481520591341,0.985457502585267,0.599237334301798,-0.00871440738489553,-0.178084328285856
"537","경남","거제시",2012,2467,1272,1195,"5",2010,2551,1310,1241,407210,420213,0.969056169133273,0.967071736573893,0.997952200684966,0.605829915768277,-0.00124061808653716,-0.0674117468843206
"538","경남","거제시",2013,2643,1349,1294,"5",2011,2691,1374,1317,420229,433401,0.969607822778443,0.98216276477146,1.01294847431928,0.62894279071649,0.0081438495738874,0.071554341079457
"539","경남","거제시",2014,3060,1594,1466,"5",2012,3094,1610,1484,464047,479002,0.968778835996509,0.989010989010989,1.02088418146921,0.659415964331199,0.0137713626627859,0.154887089108107
"540","경남","거제시",2015,3028,1546,1482,"5",2013,3036,1538,1498,441255,454391,0.971090976713887,0.997364953886693,1.02705614386586,0.686224518702338,0.0185665893022884,0.225895260386862
"541","경남","거제시",2016,3054,1595,1459,"5",2014,3080,1622,1458,422114,434628,0.971207561408837,0.991558441558442,1.02095420274538,0.72350123426373,0.0151603915492931,0.175455960717161
"542","경남","거제시",2017,3305,1674,1631,"5",2015,3387,1724,1663,445571,459820,0.969011787221086,0.975789784470033,1.00699475211585,0.741744862210512,0.00518832144436603,0.0277885999752988
"543","경남","거제시",2018,3396,1731,1665,"5",2016,3534,1792,1742,447106,462028,0.967703256079718,0.960950764006791,0.993022145962098,0.7595514262837,-0.00530003898688808,-0.127524036929193
"544","경남","거제시",2019,3412,1791,1621,"5",2017,3586,1892,1694,459384,475293,0.966528015350531,0.951477969882878,0.984428754026136,0.742733747801404,-0.0115652898801052,-0.220300466903331
"545","경남","거제시",2020,3038,1573,1465,"5",2018,3200,1648,1552,417119,431567,0.966522000060246,0.949375,0.982259069054634,0.728329325684037,-0.0129212402724452,-0.240379509030684
"546","경남","거창군",2010,473,280,193,"5",2008,478,281,197,470657,486853,0.966733284995676,0.989539748953975,1.02359126794564,0.100497814756819,0.00237087087587907,-0.0139324754976428
"547","경남","거창군",2011,484,249,235,"5",2009,497,265,232,451574,467208,0.966537388058424,0.973843058350101,1.00755860081766,0.107180661419834,0.00081013583504525,-0.037043988139677
"548","경남","거창군",2012,453,239,214,"5",2010,437,235,202,407210,420213,0.969056169133273,1.03661327231121,1.069714331666,0.111244812259031,0.00775535773794794,0.0658015170941347
"549","경남","거창군",2013,428,216,212,"5",2011,439,222,217,420229,433401,0.969607822778443,0.9749430523918,1.00550246139524,0.101849229824691,0.000560421455244804,-0.0407417823806344
"550","경남","거창군",2014,495,246,249,"5",2012,510,264,246,464047,479002,0.968778835996509,0.970588235294118,1.00186771142223,0.106670229524165,0.000199229206094494,-0.0460903514932894
"551","경남","거창군",2015,483,252,231,"5",2013,476,252,224,441255,454391,0.971090976713887,1.01470588235294,1.04491330543163,0.109460516028147,0.00491623358907636,0.023759497185429
"552","경남","거창군",2016,490,260,230,"5",2014,479,255,224,422114,434628,0.971207561408837,1.02296450939457,1.05329133549028,0.116082385327186,0.00618618534098305,0.0425650632815708
"553","경남","거창군",2017,454,240,214,"5",2015,451,240,211,445571,459820,0.969011787221086,1.00665188470067,1.03884379733659,0.101891729937541,0.00395786170796797,0.00956783539370477
"554","경남","거창군",2018,519,269,250,"5",2016,518,274,244,447106,462028,0.967703256079718,1.0019305019305,1.03536956772207,0.11607985578364,0.00410569432030813,0.0117569547506836
"555","경남","거창군",2019,482,255,227,"5",2017,475,256,219,459384,475293,0.966528015350531,1.01473684210526,1.04987835426296,0.1049231144315,0.0052333922719877,0.0284560130692016
"556","경남","거창군",2020,427,219,208,"5",2018,441,225,216,417119,431567,0.966522000060246,0.968253968253968,1.00179195941077,0.102368868356512,0.000183440857021149,-0.046324146865123
"557","경남","고성군",2010,356,176,180,"5",2008,341,169,172,470657,486853,0.966733284995676,1.04398826979472,1.07991344251625,0.0756389472588318,0.00604456866375814,0.0404679900818444
"558","경남","고성군",2011,339,165,174,"5",2009,353,172,181,451574,467208,0.966537388058424,0.960339943342776,0.993587992774809,0.0750707525233959,-0.000481354207580513,-0.0561684952893724
"559","경남","고성군",2012,333,155,178,"5",2010,342,157,185,407210,420213,0.969056169133273,0.973684210526316,1.00477582367303,0.0817759878195526,0.000390547698514067,-0.0432572890960694
"560","경남","고성군",2013,374,193,181,"5",2011,387,196,191,420229,433401,0.969607822778443,0.96640826873385,0.996700156527796,0.0889990933514822,-0.000293683077227925,-0.0533894433758769
"561","경남","고성군",2014,382,210,172,"5",2012,399,232,167,464047,479002,0.968778835996509,0.957393483709273,0.988247728104501,0.0823192478348098,-0.000967438182787661,-0.0633664729371917
"562","경남","고성군",2015,397,207,190,"5",2013,412,217,195,441255,454391,0.971090976713887,0.963592233009709,0.99227802143775,0.0899706518906301,-0.000694751445131062,-0.0593285018403817
"563","경남","고성군",2016,364,187,177,"5",2014,377,198,179,422114,434628,0.971207561408837,0.96551724137931,0.994140984630235,0.0862326291001957,-0.000505238299273317,-0.0565221731864271
"564","경남","고성군",2017,397,214,183,"5",2015,423,228,195,445571,459820,0.969011787221086,0.938534278959811,0.968547845688566,0.0890991559145456,-0.00280236040084277,-0.0905381753275433
"565","경남","고성군",2018,368,194,174,"5",2016,389,205,184,447106,462028,0.967703256079718,0.946015424164524,0.977588344589173,0.0823071039082455,-0.00184463845065471,-0.076356137774584
"566","경남","고성군",2019,382,197,185,"5",2017,412,214,198,459384,475293,0.966528015350531,0.927184466019418,0.959293937986014,0.0831548334291138,-0.00338490580632819,-0.0991645629918085
"567","경남","고성군",2020,309,142,167,"5",2018,329,151,178,417119,431567,0.966522000060246,0.939209726443769,0.971741694845255,0.0740795792088109,-0.00209336335501766,-0.080039279769334
"568","경남","김해시",2010,6399,3400,2999,"5",2008,6322,3331,2991,470657,486853,0.966733284995676,1.01217968997153,1.04701028265108,1.3595888300822,0.0639146551914124,0.897413724871622
"569","경남","김해시",2011,6059,3190,2869,"5",2009,6225,3274,2951,451574,467208,0.966537388058424,0.973333333333333,1.00703122854726,1.34175129657598,0.00943416001980696,0.0906613806491502
"570","경남","김해시",2012,5594,2977,2617,"5",2010,5713,3033,2680,407210,420213,0.969056169133273,0.979170313320497,1.01043710830124,1.37373836595368,0.0143378561030207,0.163275777747161
"571","경남","김해시",2013,5830,3015,2815,"5",2011,5909,3057,2852,420229,433401,0.969607822778443,0.986630563547132,1.01755631541824,1.38733880812605,0.0243565577074218,0.311633662159868
"572","경남","김해시",2014,6507,3312,3195,"5",2012,6486,3282,3204,464047,479002,0.968778835996509,1.00323774283071,1.03556942570773,1.40222865356311,0.0498764679181691,0.689534915113194
"573","경남","김해시",2015,6072,3127,2945,"5",2013,6191,3184,3007,441255,454391,0.971090976713887,0.980778549507349,1.00997596829315,1.37607505863956,0.013727681153983,0.154240249179159
"574","경남","김해시",2016,5671,2930,2741,"5",2014,5834,2995,2839,422114,434628,0.971207561408837,0.972060335961604,1.00087805592404,1.34347593304178,0.00117964700181221,-0.0315722317052569
"575","경남","김해시",2017,5886,3038,2848,"5",2015,6045,3147,2898,445571,459820,0.969011787221086,0.973697270471464,1.00483532121298,1.32100159121666,0.00638746701638986,0.0455456614382503
"576","경남","김해시",2018,5838,2909,2929,"5",2016,5974,2994,2980,447106,462028,0.967703256079718,0.977234683629059,1.00984953547429,1.30573063210961,0.0128608401808281,0.141403985761251
"577","경남","김해시",2019,6171,3071,3100,"5",2017,6095,3028,3067,459384,475293,0.966528015350531,1.01246923707957,1.04753221944879,1.34332062065723,0.0638510105311605,0.896471268700954
"578","경남","김해시",2020,5602,2829,2773,"5",2018,5460,2755,2705,417119,431567,0.966522000060246,1.02600732600733,1.06154575471988,1.34302201530019,0.0826573035370708,1.17495664077518
"579","경남","남해군",2010,259,128,131,"5",2008,270,130,140,470657,486853,0.966733284995676,0.959259259259259,0.992268782039039,0.0550294588203299,-0.000425444740413685,-0.0553405825921953
"580","경남","남해군",2011,244,129,115,"5",2009,278,149,129,451574,467208,0.966537388058424,0.877697841726619,0.908084728610173,0.0540332260050402,-0.00496647863232115,-0.122584643534567
"581","경남","남해군",2012,218,118,100,"5",2010,233,121,112,407210,420213,0.969056169133273,0.935622317596567,0.965498541156175,0.0535350310650524,-0.0018470366709938,-0.0763916508490233
"582","경남","남해군",2013,218,120,98,"5",2011,244,129,115,420229,433401,0.969607822778443,0.89344262295082,0.921447416121943,0.0518764768733238,-0.00407503130088983,-0.109384006827471
"583","경남","남해군",2014,245,121,124,"5",2012,265,130,135,464047,479002,0.968778835996509,0.924528301886792,0.95432338892478,0.052796376229132,-0.00241155954319905,-0.0847511591296337
"584","경남","남해군",2015,237,131,106,"5",2013,242,132,110,441255,454391,0.971090976713887,0.979338842975207,1.00849340222399,0.0537104395417616,0.000456184366655525,-0.0422853350834768
"585","경남","남해군",2016,226,132,94,"5",2014,217,125,92,422114,434628,0.971207561408837,1.04147465437788,1.07235023259818,0.0535400389468248,0.00387363427111853,0.00832058751330094
"586","경남","남해군",2017,221,114,107,"5",2015,238,126,112,445571,459820,0.969011787221086,0.928571428571429,0.958266391407238,0.0495992782295078,-0.00206995686411379,-0.0796926742300996
"587","경남","남해군",2018,197,119,78,"5",2016,215,125,90,447106,462028,0.967703256079718,0.916279069767442,0.946859550188348,0.0440611398639249,-0.00234142879158307,-0.0837126563023362
"588","경남","남해군",2019,183,91,92,"5",2017,205,102,103,459384,475293,0.966528015350531,0.892682926829268,0.923597570532416,0.039835954234366,-0.00304356368366505,-0.0941099364365072
"589","경남","남해군",2020,152,71,81,"5",2018,154,74,80,417119,431567,0.966522000060246,0.987012987012987,1.02120074550964,0.0364404402580559,0.000772564500170125,-0.0376003480330774
"590","경남","마산시",2010,3481,1875,1606,"5",2008,3493,1906,1587,470657,486853,0.966733284995676,0.996564557686802,1.03085781068484,0.739604425303353,0.0228225733376775,0.288918275994713
"591","경남","마산시",2011,0,0,0,"5",2009,3448,1795,1653,451574,467208,0.966537388058424,0,0,0,0,-0.0490405564895554
"592","경남","밀양시",2010,774,394,380,"5",2008,791,410,381,470657,486853,0.966733284995676,0.978508217446271,1.01218012520449,0.164450969602067,0.00200303339975277,-0.0193794477621761
"593","경남","밀양시",2011,728,391,337,"5",2009,738,393,345,451574,467208,0.966537388058424,0.986449864498645,1.02060186878049,0.161213887424874,0.00332130735432063,0.000141678098099615
"594","경남","밀양시",2012,681,348,333,"5",2010,720,379,341,407210,420213,0.969056169133273,0.945833333333333,0.976035614302203,0.16723557869404,-0.0040076979102183,-0.108386927586587
"595","경남","밀양시",2013,667,344,323,"5",2011,686,350,336,420229,433401,0.969607822778443,0.972303206997085,1.00277987053664,0.158722981993151,0.000441229341131068,-0.0425067905210928
"596","경남","밀양시",2014,782,402,380,"5",2012,801,415,386,464047,479002,0.968778835996509,0.976279650436954,1.0077425457305,0.168517413106862,0.0013047537773656,-0.0297196386967335
"597","경남","밀양시",2015,739,364,375,"5",2013,723,354,369,441255,454391,0.971090976713887,1.02213001383126,1.05255845058934,0.167476855786337,0.0088023240497043,0.0813050936249812
"598","경남","밀양시",2016,635,330,305,"5",2014,635,341,294,422114,434628,0.971207561408837,1,1.0296460197956,0.150433295270946,0.00445974844951981,0.0169998219056804
"599","경남","밀양시",2017,692,359,333,"5",2015,699,364,335,445571,459820,0.969011787221086,0.989985693848355,1.021644635188,0.155306337261626,0.00336154901241173,0.000737580391170386
"600","경남","밀양시",2018,648,333,315,"5",2016,678,337,341,447106,462028,0.967703256079718,0.955752212389381,0.987650094576769,0.144932074273215,-0.00178989741006696,-0.0755455272491062
"601","경남","밀양시",2019,673,359,314,"5",2017,709,377,332,459384,475293,0.966528015350531,0.949224259520451,0.982096995063506,0.146500531146056,-0.00262279973230678,-0.0878792239025375
"602","경남","밀양시",2020,607,298,309,"5",2018,630,303,327,417119,431567,0.966522000060246,0.963492063492064,0.996865113708748,0.145522021293684,-0.000456194989628806,-0.0557959352016307
"603","경남","사천시",2010,1083,564,519,"5",2008,1154,610,544,470657,486853,0.966733284995676,0.938474870017331,0.970769171376496,0.230103876071109,-0.00672612696703849,-0.148641683114858
"604","경남","사천시",2011,1052,555,497,"5",2009,1082,571,511,451574,467208,0.966537388058424,0.972273567467652,1.00593477239484,0.232962925234845,0.00138258193770467,-0.0285671519103653
"605","경남","사천시",2012,972,497,475,"5",2010,1025,511,514,407210,420213,0.969056169133273,0.948292682926829,0.978573495667424,0.238697477959775,-0.00511445254568011,-0.124775855290446
"606","경남","사천시",2013,1065,555,510,"5",2011,1081,564,517,420229,433401,0.969607822778443,0.985198889916744,1.01607976624366,0.253433247110504,0.00407514737190841,0.0113046126390216
"607","경남","사천시",2014,1172,587,585,"5",2012,1178,590,588,464047,479002,0.968778835996509,0.99490662139219,1.02696981439402,0.252560624247113,0.00681151315918252,0.051824976974552
"608","경남","사천시",2015,1166,602,564,"5",2013,1191,620,571,441255,454391,0.971090976713887,0.979009235936188,1.00815398290395,0.26424629749238,0.00215465979218374,-0.0171341497494767
"609","경남","사천시",2016,1121,546,575,"5",2014,1172,583,589,422114,434628,0.971207561408837,0.956484641638225,0.98484060425842,0.265568069289339,-0.00402585145868454,-0.108655747055554
"610","경남","사천시",2017,1167,619,548,"5",2015,1224,639,585,445571,459820,0.969011787221086,0.95343137254902,0.983921336275229,0.261911120786586,-0.00421118083690533,-0.111400122081184
"611","경남","사천시",2018,1061,554,507,"5",2016,1110,583,527,447106,462028,0.967703256079718,0.955855855855856,0.987757197106211,0.237303905561545,-0.00290526494171641,-0.0920619955373167
"612","경남","사천시",2019,1068,551,517,"5",2017,1119,579,540,459384,475293,0.966528015350531,0.954423592493298,0.987476386959313,0.23248524110548,-0.00291155519727592,-0.0921551422387629
"613","경남","사천시",2020,904,481,423,"5",2018,972,522,450,417119,431567,0.966522000060246,0.930041152263374,0.962255543283446,0.216724723640016,-0.00818015695083773,-0.170173097143033
"614","경남","산청군",2010,187,98,89,"5",2008,213,107,106,470657,486853,0.966733284995676,0.877934272300469,0.908145282599219,0.0397316942061841,-0.0036495435431633,-0.103083343720379
"615","경남","산청군",2011,184,99,85,"5",2009,189,104,85,451574,467208,0.966537388058424,0.973544973544973,1.00725019598117,0.0407463671513418,0.00029541914736786,-0.0446659617118001
"616","경남","산청군",2012,181,86,95,"5",2010,199,91,108,407210,420213,0.969056169133273,0.909547738693467,0.938591350702581,0.0444488101962133,-0.0027295413970268,-0.0894598646064783
"617","경남","산청군",2013,181,92,89,"5",2011,204,100,104,420229,433401,0.969607822778443,0.887254901960784,0.915065742166071,0.0430717537342735,-0.00365826743702627,-0.103212527968843
"618","경남","산청군",2014,215,110,105,"5",2012,241,122,119,464047,479002,0.968778835996509,0.892116182572614,0.920866713252423,0.046331513833728,-0.00366636496965371,-0.103332437000672
"619","경남","산청군",2015,175,107,68,"5",2013,189,115,74,441255,454391,0.971090976713887,0.925925925925926,0.953490402165205,0.039659607256575,-0.00184455238378923,-0.0763548632882698
"620","경남","산청군",2016,159,77,82,"5",2014,175,95,80,422114,434628,0.971207561408837,0.908571428571429,0.935506955128574,0.037667549524536,-0.00242929496168256,-0.0850137868901244
"621","경남","산청군",2017,194,108,86,"5",2015,206,114,92,445571,459820,0.969011787221086,0.941747572815534,0.971863898081425,0.0435396379028258,-0.00122503568953174,-0.0671810012702594
"622","경남","산청군",2018,149,88,61,"5",2016,169,103,66,447106,462028,0.967703256079718,0.881656804733728,0.911081779661903,0.0333254306585016,-0.00296323798615461,-0.0929204658826194
"623","경남","산청군",2019,159,90,69,"5",2017,182,92,90,459384,475293,0.966528015350531,0.873626373626374,0.903881066819915,0.0346115667937934,-0.00332682687591066,-0.0983045246768724
"624","경남","산청군",2020,139,77,62,"5",2018,170,90,80,417119,431567,0.966522000060246,0.817647058823529,0.84596838848217,0.0333238236570379,-0.00513292225982955,-0.125049356570863
"625","경남","양산시",2010,2902,1539,1363,"5",2008,2884,1519,1365,470657,486853,0.966733284995676,1.00624133148405,1.04086757650902,0.616584901531264,0.0251983306376333,0.324098715618212
"626","경남","양산시",2011,2830,1462,1368,"5",2009,2840,1476,1364,451574,467208,0.966537388058424,0.996478873239437,1.03097809308873,0.626696842599441,0.0194138731284594,0.238441919715712
"627","경남","양산시",2012,2683,1385,1298,"5",2010,2733,1413,1320,407210,420213,0.969056169133273,0.981705085986096,1.01305282114259,0.658873799759338,0.00860016186379934,0.07831145678526
"628","경남","양산시",2013,2741,1394,1347,"5",2011,2790,1455,1335,420229,433401,0.969607822778443,0.982437275985663,1.01323159003653,0.652263408760462,0.00863048202055024,0.0787604405446575
"629","경남","양산시",2014,3194,1612,1582,"5",2012,3189,1658,1531,464047,479002,0.968778835996509,1.00156788962057,1.03384575757204,0.688292349697337,0.0232957760065461,0.295925506035475
"630","경남","양산시",2015,3213,1671,1542,"5",2013,3109,1632,1477,441255,454391,0.971090976713887,1.03345127050499,1.0642167369345,0.728150389230717,0.0467594419939796,0.643377699334937
"631","경남","양산시",2016,3092,1584,1508,"5",2014,3026,1564,1462,422114,434628,0.971207561408837,1.02181097157964,1.05210359987045,0.732503541697267,0.0381660714402853,0.516126252424842
"632","경남","양산시",2017,3559,1800,1759,"5",2015,3404,1755,1649,445571,459820,0.969011787221086,1.04553466509988,1.07897001758693,0.798750367505964,0.0630773305695163,0.885014542385079
"633","경남","양산시",2018,3935,1987,1948,"5",2016,3674,1852,1822,447106,462028,0.967703256079718,1.07103973870441,1.10678530011702,0.880104494236266,0.0939822225513588,1.34265711659003
"634","경남","양산시",2019,4026,2088,1938,"5",2017,4013,2074,1939,459384,475293,0.966528015350531,1.00323947171692,1.03798281662128,0.876390993156053,0.0332877983815877,0.443888321887221
"635","경남","양산시",2020,3713,1862,1851,"5",2018,3828,1906,1922,417119,431567,0.966522000060246,0.969958202716823,1.00355522446086,0.89015364919843,0.00316469602755809,-0.00217743729539123
"636","경남","의령군",2010,156,93,63,"5",2008,186,105,81,470657,486853,0.966733284995676,0.838709677419355,0.867570911684401,0.0331451566639825,-0.0043893828790889,-0.114038954838191
"637","경남","의령군",2011,161,85,76,"5",2009,180,92,88,451574,467208,0.966537388058424,0.894444444444444,0.925411117557698,0.035653071257424,-0.00265932274072701,-0.0884200600782784
"638","경남","의령군",2012,130,70,60,"5",2010,150,74,76,407210,420213,0.969056169133273,0.866666666666667,0.894341003413472,0.0319245598094349,-0.00337311695593149,-0.0989899925760428
"639","경남","의령군",2013,129,66,63,"5",2011,138,72,66,420229,433401,0.969607822778443,0.934782608695652,0.964083196046214,0.030697548241554,-0.00110255782205379,-0.065367337382074
"640","경남","의령군",2014,142,69,73,"5",2012,180,87,93,464047,479002,0.968778835996509,0.788888888888889,0.814312678576859,0.0306003486715785,-0.0056820967794396,-0.133181584989256
"641","경남","의령군",2015,131,65,66,"5",2013,169,94,75,441255,454391,0.971090976713887,0.775147928994083,0.798223799398421,0.0296880488606361,-0.00599034170237319,-0.137746105069113
"642","경남","의령군",2016,143,80,63,"5",2014,182,91,91,422114,434628,0.971207561408837,0.785714285714286,0.809007586982257,0.0338771042893626,-0.00647026989427908,-0.144852927293452
"643","경남","의령군",2017,127,66,61,"5",2015,153,77,76,445571,459820,0.969011787221086,0.830065359477124,0.856610177939703,0.0285027526477262,-0.00408700463038613,-0.109561309027256
"644","경남","의령군",2018,120,54,66,"5",2016,147,74,73,447106,462028,0.967703256079718,0.816326530612245,0.843571131422335,0.0268392730135583,-0.00419843711095799,-0.11121141177762
"645","경남","의령군",2019,129,79,50,"5",2017,160,93,67,459384,475293,0.966528015350531,0.80625,0.834171371336398,0.0280810824930777,-0.00465664740121654,-0.117996633252729
"646","경남","의령군",2020,96,52,44,"5",2018,134,78,56,417119,431567,0.966522000060246,0.716417910447761,0.741232905617363,0.0230150148998247,-0.00595552853280074,-0.137230588349342
"647","경남","진주시",2010,3296,1769,1527,"5",2008,3256,1747,1509,470657,486853,0.966733284995676,1.01228501228501,1.04711922926036,0.700297669003117,0.0329974864162563,0.439589354745877
"648","경남","진주시",2011,3165,1765,1400,"5",2009,3112,1740,1372,451574,467208,0.966537388058424,1.01703084832905,1.05224160068143,0.70088180453259,0.036615187357275,0.49316061370139
"649","경남","진주시",2012,2845,1478,1367,"5",2010,2782,1468,1314,407210,420213,0.969056169133273,1.02264557872035,1.05530062270281,0.698656712752634,0.0386361512707208,0.523087239177643
"650","경남","진주시",2013,3054,1594,1460,"5",2011,2969,1546,1423,420229,433401,0.969607822778443,1.02862916807006,1.06087135840394,0.726746607207023,0.0442380531961488,0.606040734666407
"651","경남","진주시",2014,3364,1716,1648,"5",2012,3319,1705,1614,464047,479002,0.968778835996509,1.01355830069298,1.04622258768732,0.724926569937959,0.033507981945827,0.447148821008049
"652","경남","진주시",2015,3261,1679,1582,"5",2013,3096,1602,1494,441255,454391,0.971090976713887,1.05329457364341,1.08465076795142,0.739028452935377,0.0625593260789283,0.877343882715353
"653","경남","진주시",2016,3086,1650,1436,"5",2014,2881,1520,1361,422114,434628,0.971207561408837,1.07115584866366,1.10291135615731,0.731082124734077,0.0752366529187544,1.06507094199206
"654","경남","진주시",2017,3352,1776,1576,"5",2015,3267,1735,1532,445571,459820,0.969011787221086,1.02601775329048,1.058828970732,0.752293125001403,0.0442566302325938,0.606315825185564
"655","경남","진주시",2018,3368,1789,1579,"5",2016,3373,1786,1587,447106,462028,0.967703256079718,0.998517640083012,1.03184280285273,0.753288929247203,0.0239868308651649,0.306158711982319
"656","경남","진주시",2019,3444,1791,1653,"5",2017,3373,1736,1637,459384,475293,0.966528015350531,1.02104951082123,1.05640963800819,0.749699597722167,0.0422902829223919,0.577197967554789
"657","경남","진주시",2020,3121,1670,1451,"5",2018,3052,1629,1423,417119,431567,0.966522000060246,1.02260812581914,1.05802881440401,0.748227723982844,0.0434187677269359,0.593908677665218
"658","경남","진해시",2010,2224,1190,1034,"5",2008,2323,1269,1054,470657,486853,0.966733284995676,0.957382694791218,0.990327642226056,0.472530951414725,-0.00457048842134523,-0.1167207828999
"659","경남","진해시",2011,0,0,0,"5",2009,2242,1215,1027,451574,467208,0.966537388058424,0,0,0,0,-0.0490405564895554
"660","경남","창녕군",2010,345,168,177,"5",2008,377,188,189,470657,486853,0.966733284995676,0.915119363395225,0.946609967401007,0.0733017887761151,-0.0039135848923213,-0.106993293083613
"661","경남","창녕군",2011,331,192,139,"5",2009,353,200,153,451574,467208,0.966537388058424,0.937677053824363,0.970140488520537,0.0732991713429028,-0.00218867744814856,-0.0814506999083873
"662","경남","창녕군",2012,322,171,151,"5",2010,317,171,146,407210,420213,0.969056169133273,1.01577287066246,1.04820845583282,0.0790746789126004,0.0038120681658529,0.00740891078218378
"663","경남","창녕군",2013,369,197,172,"5",2011,357,195,162,420229,433401,0.969607822778443,1.03361344537815,1.06601186695905,0.0878092659002591,0.00579645357838008,0.0367938783445114
"664","경남","창녕군",2014,399,220,179,"5",2012,422,225,197,464047,479002,0.968778835996509,0.945497630331754,0.975968503027001,0.0859826698588721,-0.00206629227044388,-0.0796384085791631
"665","경남","창녕군",2015,379,201,178,"5",2013,392,206,186,441255,454391,0.971090976713887,0.966836734693878,0.995619110750667,0.0858913780013824,-0.000376280614496624,-0.0546125555485661
"666","경남","창녕군",2016,355,192,163,"5",2014,372,196,176,422114,434628,0.971207561408837,0.954301075268817,0.982592303837199,0.0841005036554106,-0.00146399601477192,-0.0707195484504281
"667","경남","창녕군",2017,382,203,179,"5",2015,396,206,190,445571,459820,0.969011787221086,0.964646464646465,0.995495077942095,0.085732689066389,-0.000386219082058656,-0.054759725319663
"668","경남","창녕군",2018,391,200,191,"5",2016,413,214,199,447106,462028,0.967703256079718,0.946731234866828,0.978328045213106,0.0874512979025108,-0.00189524057419844,-0.077105458823575
"669","경남","창녕군",2019,392,186,206,"5",2017,424,221,203,459384,475293,0.966528015350531,0.924528301886792,0.956545787812983,0.0853316615293524,-0.00370802012636722,-0.103949270515524
"670","경남","창녕군",2020,354,193,161,"5",2018,396,214,182,417119,431567,0.966522000060246,0.893939393939394,0.924903306788332,0.0848678674431038,-0.00637329620490323,-0.143416931695661
"671","경남","창원시",2010,4988,2665,2323,"5",2008,5184,2774,2410,470657,486853,0.966733284995676,0.962191358024691,0.995301778637936,1.05979513743554,-0.00497915215411121,-0.122772314248306
"672","경남","창원시",2011,10242,5418,4824,"5",2009,4787,2537,2250,451574,467208,0.966537388058424,2.13954459995822,2.21361804146669,2.26806680632632,2.75256679540936,40.711229845436
"673","경남","통영시",2010,1290,680,610,"5",2008,1316,689,627,470657,486853,0.966733284995676,0.980243161094225,1.01397477081655,0.274084949336778,0.00383027435124819,0.0076785097037929
"674","경남","통영시",2011,1279,684,595,"5",2009,1266,685,581,451574,467208,0.966537388058424,1.01026856240126,1.04524519680577,0.283231541231337,0.012814866824614,0.140723207938275
"675","경남","통영시",2012,1235,651,584,"5",2010,1269,661,608,407210,420213,0.969056169133273,0.973207249802994,1.0042836326747,0.303283318189632,0.00129915433148935,-0.0298025558228128
"676","경남","통영시",2013,1254,637,617,"5",2011,1298,656,642,420229,433401,0.969607822778443,0.966101694915254,0.996383973209764,0.298408724766734,-0.00107905394319653,-0.0650192897127808
"677","경남","통영시",2014,1483,754,729,"5",2012,1525,773,752,464047,479002,0.968778835996509,0.972459016393443,1.00379878281832,0.319579697746133,0.00121401386488117,-0.0310633239345561
"678","경남","통영시",2015,1439,714,725,"5",2013,1472,728,744,441255,454391,0.971090976713887,0.97758152173913,1.0066837661773,0.326115284812637,0.00217967831053178,-0.0167636731548225
"679","경남","통영시",2016,1411,756,655,"5",2014,1416,753,663,422114,434628,0.971207561408837,0.996468926553672,1.02601026407598,0.334269889176857,0.00869444809013961,0.0797076561753044
"680","경남","통영시",2017,1522,789,733,"5",2015,1571,810,761,445571,459820,0.969011787221086,0.968809675366009,0.999791424771357,0.341584169526293,-7.12459962598646e-05,-0.0500955739654073
"681","경남","통영시",2018,1455,732,723,"5",2016,1522,771,751,447106,462028,0.967703256079718,0.955978975032852,0.987884425340922,0.325426185289394,-0.00394272524389257,-0.107424806175914
"682","경남","통영시",2019,1427,742,685,"5",2017,1463,757,706,459384,475293,0.966528015350531,0.975393028024607,1.00917201833085,0.310633369904045,0.00284913496293386,-0.00685029549590954
"683","경남","통영시",2020,1103,569,534,"5",2018,1180,609,571,417119,431567,0.966522000060246,0.934745762711864,0.967123110134689,0.264432931609445,-0.00869373236928512,-0.17777817069206
"684","경남","하동군",2010,304,169,135,"5",2008,344,196,148,470657,486853,0.966733284995676,0.883720930232558,0.914131067946534,0.064590561704171,-0.00554632255427069,-0.131171027374187
"685","경남","하동군",2011,281,151,130,"5",2009,332,178,154,451574,467208,0.966537388058424,0.846385542168675,0.875688362008313,0.0622267889648208,-0.00773551406317988,-0.163588783053561
"686","경남","하동군",2012,294,158,136,"5",2010,305,158,147,407210,420213,0.969056169133273,0.963934426229508,0.99471470997564,0.0721986198767221,-0.000381590645407004,-0.0546911869903573
"687","경남","하동군",2013,261,130,131,"5",2011,303,154,149,420229,433401,0.969607822778443,0.861386138613861,0.888386127233928,0.0621089929538418,-0.006932225237179,-0.151693605863584
"688","경남","하동군",2014,296,163,133,"5",2012,326,174,152,464047,479002,0.968778835996509,0.907975460122699,0.937237093117062,0.0637866423013186,-0.00400343509113293,-0.10832380335691
"689","경남","하동군",2015,268,138,130,"5",2013,301,151,150,441255,454391,0.971090976713887,0.890365448504983,0.916871302334541,0.0607358556843548,-0.00504889258463768,-0.123805037163857
"690","경남","하동군",2016,217,91,126,"5",2014,249,111,138,422114,434628,0.971207561408837,0.8714859437751,0.897322033315844,0.0514079135020397,-0.00527846002986439,-0.12720449368514
"691","경남","하동군",2017,266,150,116,"5",2015,305,167,138,445571,459820,0.969011787221086,0.872131147540984,0.900021195863948,0.0596986787739777,-0.0059686025123246,-0.137424189079217
"692","경남","하동군",2018,226,131,95,"5",2016,252,136,116,447106,462028,0.967703256079718,0.896825396825397,0.926756617993148,0.0505472975088681,-0.00370225502085603,-0.103863900285845
"693","경남","하동군",2019,214,113,101,"5",2017,259,138,121,459384,475293,0.966528015350531,0.826254826254826,0.854868987894953,0.0465841213451056,-0.0067608006788395,-0.149155134730712
"694","경남","하동군",2020,171,96,75,"5",2018,197,108,89,417119,431567,0.966522000060246,0.868020304568528,0.898086442434236,0.0409954952903128,-0.00417799676920632,-0.110908729256602
"695","경남","함안군",2010,599,325,274,"5",2008,657,355,302,470657,486853,0.966733284995676,0.911719939117199,0.943093563930901,0.127268902831574,-0.00724241968256937,-0.156286994657045
"696","경남","함안군",2011,543,295,248,"5",2009,567,308,259,451574,467208,0.966537388058424,0.957671957671958,0.990827638437997,0.12024607262597,-0.0011029404545363,-0.0653730034401974
"697","경남","함안군",2012,554,306,248,"5",2010,587,320,267,407210,420213,0.969056169133273,0.943781942078365,0.9739187181714,0.136047739495592,-0.00354829943592849,-0.101584111369551
"698","경남","함안군",2013,547,293,254,"5",2011,604,326,278,420229,433401,0.969607822778443,0.905629139072848,0.934015916329695,0.130167123163799,-0.00858895834596303,-0.176226667008724
"699","경남","함안군",2014,630,325,305,"5",2012,637,314,323,464047,479002,0.968778835996509,0.989010989010989,1.02088418146921,0.135762110303482,0.00283528054822062,-0.00705545298415435
"700","경남","함안군",2015,686,360,326,"5",2013,668,351,317,441255,454391,0.971090976713887,1.02694610778443,1.05751791789844,0.155465660445774,0.00894206109354657,0.0833743330351476
"701","경남","함안군",2016,646,329,317,"5",2014,652,324,328,422114,434628,0.971207561408837,0.99079754601227,1.02017074967478,0.153039226370128,0.00308691592553411,-0.00332921242966736
"702","경남","함안군",2017,628,337,291,"5",2015,657,352,305,445571,459820,0.969011787221086,0.9558599695586,0.986427597851825,0.140942745376158,-0.00191293162011309,-0.0773674295108538
"703","경남","함안군",2018,598,290,308,"5",2016,605,286,319,447106,462028,0.967703256079718,0.988429752066116,1.02141823524534,0.133749043850899,0.00286466848503794,-0.00662027362602701
"704","경남","함안군",2019,592,304,288,"5",2017,609,309,300,459384,475293,0.966528015350531,0.972085385878489,1.00574982870615,0.128868223534124,0.000740970210986737,-0.0380681992664859
"705","경남","함안군",2020,502,245,257,"5",2018,542,267,275,417119,431567,0.966522000060246,0.92619926199262,0.958280579164145,0.120349348747,-0.00502090512769718,-0.123390596244691
"706","경남","함양군",2010,267,127,140,"5",2008,262,131,131,470657,486853,0.966733284995676,1.01908396946565,1.05415214856309,0.0567292104441239,0.00307200863183714,-0.00354996104985079
"707","경남","함양군",2011,270,148,122,"5",2009,266,139,127,451574,467208,0.966537388058424,1.01503759398496,1.05017933762911,0.0597908648416428,0.00300026599402509,-0.00461233284095274
"708","경남","함양군",2012,266,136,130,"5",2010,278,141,137,407210,420213,0.969056169133273,0.956834532374101,0.987388102827824,0.0653225608408438,-0.000823841420347964,-0.0612400784476394
"709","경남","함양군",2013,283,149,134,"5",2011,297,151,146,420229,433401,0.969607822778443,0.952861952861953,0.982729233899429,0.0673442337392231,-0.00116308650913229,-0.0662636519261961
"710","경남","함양군",2014,283,155,128,"5",2012,296,156,140,464047,479002,0.968778835996509,0.956081081081081,0.986893030231852,0.0609852019299769,-0.000799331198000633,-0.0608771287484151
"711","경남","함양군",2015,283,143,140,"5",2013,309,155,154,441255,454391,0.971090976713887,0.915857605177994,0.943122351190204,0.0641352505920613,-0.0036478622595035,-0.103058447112344
"712","경남","함양군",2016,241,115,126,"5",2014,265,131,134,422114,434628,0.971207561408837,0.909433962264151,0.936395059512225,0.0570935813547999,-0.00363143384430598,-0.102815173580583
"713","경남","함양군",2017,253,142,111,"5",2015,279,150,129,445571,459820,0.969011787221086,0.906810035842294,0.935809086949114,0.0567810741722419,-0.0036448289951263,-0.103013530245505
"714","경남","함양군",2018,191,93,98,"5",2016,213,104,109,447106,462028,0.967703256079718,0.896713615023474,0.926641105514276,0.042719176213247,-0.00313383154034465,-0.0954466314271607
"715","경남","함양군",2019,222,132,90,"5",2017,239,137,102,459384,475293,0.966528015350531,0.928870292887029,0.961038146990654,0.0483255838252965,-0.00188285429359201,-0.0769220416045508
"716","경남","함양군",2020,216,105,111,"5",2018,221,112,109,417119,431567,0.966522000060246,0.97737556561086,1.01122950698477,0.0517837835246057,0.000581506358787578,-0.0404295551274265
"717","경남","합천군",2010,258,142,116,"5",2008,342,187,155,470657,486853,0.966733284995676,0.754385964912281,0.780345496137184,0.0548169898673556,-0.012040798712567,-0.227341846833501
"718","경남","합천군",2011,244,112,132,"5",2009,290,137,153,451574,467208,0.966537388058424,0.841379310344828,0.870508808805614,0.0540332260050402,-0.00699682679946814,-0.152650231930455
"719","경남","합천군",2012,214,105,109,"5",2010,252,124,128,407210,420213,0.969056169133273,0.849206349206349,0.876323144370344,0.0525527369170698,-0.00649955725663576,-0.145286617335418
"720","경남","합천군",2013,205,107,98,"5",2011,243,127,116,420229,433401,0.969607822778443,0.843621399176955,0.87006455533695,0.048782925500144,-0.00633863111682562,-0.142903607780722
"721","경남","합천군",2014,273,146,127,"5",2012,320,165,155,464047,479002,0.968778835996509,0.853125,0.880618948619429,0.0588302477981756,-0.00702321683512575,-0.153041018083625
"722","경남","합천군",2015,226,120,106,"5",2013,282,154,128,441255,454391,0.971090976713887,0.801418439716312,0.825276373618735,0.0512175499427769,-0.00894891606036554,-0.181556955013642
"723","경남","합천군",2016,210,101,109,"5",2014,264,126,138,422114,434628,0.971207561408837,0.795454545454545,0.819036606655591,0.0497495937116514,-0.0090028552955661,-0.182355692328832
"724","경남","합천군",2017,165,85,80,"5",2015,225,112,113,445571,459820,0.969011787221086,0.733333333333333,0.756784739880588,0.037031135329723,-0.00900653721173574,-0.182410214492989
"725","경남","합천군",2018,212,109,103,"5",2016,255,129,126,447106,462028,0.967703256079718,0.831372549019608,0.859119305217177,0.0474160489906197,-0.00668000592565485,-0.147958718355874
"726","경남","합천군",2019,177,97,80,"5",2017,230,118,112,459384,475293,0.966528015350531,0.769565217391304,0.796216152215935,0.0385298573742229,-0.00785176259029035,-0.165310202278246
"727","경남","합천군",2020,183,95,88,"5",2018,217,108,109,417119,431567,0.966522000060246,0.84331797235023,0.872528480777121,0.0438723721527909,-0.00559247793022779,-0.131854500562794
"728","경북","경산시",2010,2359,1274,1085,"5",2008,2615,1399,1216,470657,486853,0.966733284995676,0.902103250478011,0.933145950883491,0.501214260066248,-0.0335082027603636,-0.545233203829779
"729","경북","경산시",2011,2320,1193,1127,"5",2009,2513,1292,1221,451574,467208,0.966537388058424,0.923199363310784,0.955161564070794,0.513758542343005,-0.0230361294839291,-0.390161748659964
"730","경북","경산시",2012,2048,1052,996,"5",2010,2218,1135,1083,407210,420213,0.969056169133273,0.923354373309288,0.952838857767284,0.502934603767098,-0.0237189703820148,-0.400273321499498
"731","경북","경산시",2013,2128,1139,989,"5",2011,2200,1171,1029,420229,433401,0.969607822778443,0.967272727272727,0.99759171135911,0.506390563240519,-0.00121953464130628,-0.0670995412259336
"732","경북","경산시",2014,2386,1227,1159,"5",2012,2549,1326,1223,464047,479002,0.968778835996509,0.936053354256571,0.966219863064746,0.514172055847791,-0.0173688024548195,-0.306239432025212
"733","경북","경산시",2015,2156,1132,1024,"5",2013,2302,1185,1117,441255,454391,0.971090976713887,0.936576889661164,0.964458441196193,0.488606361401004,-0.017365831725648,-0.306195441185634
"734","경북","경산시",2016,2155,1109,1046,"5",2014,2280,1171,1109,422114,434628,0.971207561408837,0.945175438596491,0.973196128359438,0.510525592612422,-0.0136840624536053,-0.251675452302442
"735","경북","경산시",2017,2164,1102,1062,"5",2015,2321,1165,1156,445571,459820,0.969011787221086,0.932356742783283,0.962172756904308,0.485668950627397,-0.0183715174594123,-0.321087730998895
"736","경북","경산시",2018,2342,1220,1122,"5",2016,2454,1281,1173,447106,462028,0.967703256079718,0.954360228198859,0.986211653420581,0.52381314498128,-0.00722251718585714,-0.155992276596427
"737","경북","경산시",2019,2437,1241,1196,"5",2017,2504,1269,1235,459384,475293,0.966528015350531,0.973242811501597,1.00694733731917,0.530493008028142,0.0036855138722317,0.00553488278870228
"738","경북","경산시",2020,2228,1130,1098,"5",2018,2301,1178,1123,417119,431567,0.966522000060246,0.968274663189917,1.00181337116958,0.534140137466766,0.00096859432579644,-0.0346975197664948
"739","경북","경주시",2010,2304,1208,1096,"5",2008,2451,1280,1171,470657,486853,0.966733284995676,0.940024479804162,0.972372105516534,0.489528467652664,-0.0135246408509605,-0.249314722076913
"740","경북","경주시",2011,2130,1134,996,"5",2009,2226,1208,1018,451574,467208,0.966537388058424,0.956873315363881,0.990001346234567,0.471683489306293,-0.00471619989644508,-0.118878492255269
"741","경북","경주시",2012,1947,1026,921,"5",2010,2028,1060,968,407210,420213,0.969056169133273,0.960059171597633,0.990715710995693,0.478131676530537,-0.00443911266702323,-0.114775358258669
"742","경북","경주시",2013,2046,1061,985,"5",2011,2105,1094,1011,420229,433401,0.969607822778443,0.971971496437055,1.00243776257068,0.486877393040461,0.00118689148526622,-0.031464954706566
"743","경북","경주시",2014,2153,1109,1044,"5",2012,2280,1176,1104,464047,479002,0.968778835996509,0.944298245614035,0.974730465331344,0.463961624576821,-0.01172409435717,-0.22265205867469
"744","경북","경주시",2015,1973,1007,966,"5",2013,2068,1056,1012,441255,454391,0.971090976713887,0.954061895551257,0.982463969318039,0.447133743526986,-0.00784095104542924,-0.165150103895625
"745","경북","경주시",2016,1909,990,919,"5",2014,1916,996,920,422114,434628,0.971207561408837,0.996346555323591,1.02588426502599,0.452247497121631,0.0117060940728379,0.124304395776458
"746","경북","경주시",2017,1946,992,954,"5",2015,1975,1002,973,445571,459820,0.969011787221086,0.985316455696203,1.01682607857834,0.436742965767521,0.00734867146053994,0.0597792680923853
"747","경북","경주시",2018,1939,993,946,"5",2016,1963,999,964,447106,462028,0.967703256079718,0.987773815588385,1.02074040712643,0.433677919777413,0.00899465661792761,0.084153172552967
"748","경북","경주시",2019,1984,1010,974,"5",2017,2019,1018,1001,459384,475293,0.966528015350531,0.982664685487865,1.01669550171444,0.431882695087334,0.0072104982762654,0.0577331864631518
"749","경북","경주시",2020,1768,941,827,"5",2018,1816,959,857,417119,431567,0.966522000060246,0.973568281938326,1.00729034815311,0.423859857738439,0.00309008593104133,-0.00328227068719435
"750","경북","고령군",2010,209,106,103,"5",2008,247,125,122,470657,486853,0.966733284995676,0.846153846153846,0.875271245220062,0.0444060111716175,-0.00553870647817989,-0.131058247796456
"751","경북","고령군",2011,205,117,88,"5",2009,227,131,96,451574,467208,0.966537388058424,0.903083700440529,0.934349474317429,0.0453967677501362,-0.00298032166708605,-0.0931734426515708
"752","경북","고령군",2012,193,115,78,"5",2010,209,124,85,407210,420213,0.969056169133273,0.923444976076555,0.952932353655503,0.0473956926401611,-0.00223080369943958,-0.082074509436463
"753","경북","고령군",2013,230,112,118,"5",2011,247,123,124,420229,433401,0.969607822778443,0.931174089068826,0.960361568041516,0.0547320627562591,-0.00216949314551145,-0.0811666169338106
"754","경북","고령군",2014,247,128,119,"5",2012,273,152,121,464047,479002,0.968778835996509,0.904761904761905,0.933919973418128,0.0532273670554922,-0.00351726582991,-0.101124562785673
"755","경북","고령군",2015,230,131,99,"5",2013,239,138,101,441255,454391,0.971090976713887,0.96234309623431,0.990991698317309,0.0521240552514986,-0.000469549214630751,-0.0559936858331486
"756","경북","고령군",2016,213,114,99,"5",2014,228,119,109,422114,434628,0.971207561408837,0.934210526315789,0.961906150072205,0.0504603021932464,-0.00192222717906069,-0.0775050790301581
"757","경북","고령군",2017,191,99,92,"5",2015,227,117,110,445571,459820,0.969011787221086,0.841409691629956,0.868317292654339,0.0428663445331945,-0.00564475630214294,-0.132628643656792
"758","경북","고령군",2018,160,76,84,"5",2016,186,86,100,447106,462028,0.967703256079718,0.860215053763441,0.888924418057944,0.0357856973514111,-0.00397491715851028,-0.107901507103485
"759","경북","고령군",2019,188,100,88,"5",2017,218,111,107,459384,475293,0.966528015350531,0.862385321100917,0.892250723625591,0.0409243682844853,-0.00440957106873311,-0.114337903466866
"760","경북","고령군",2020,153,76,77,"5",2018,183,92,91,417119,431567,0.966522000060246,0.836065573770492,0.865024876535017,0.0366801799965957,-0.0049509118237583,-0.122354128755643
"761","경북","구미시",2010,4998,2687,2311,"5",2008,5141,2750,2391,470657,486853,0.966733284995676,0.972184399922194,1.00563869581313,1.06191982696528,0.00598784288218798,0.0396279893234918
"762","경북","구미시",2011,4722,2489,2233,"5",2009,4636,2456,2180,451574,467208,0.966537388058424,1.01855047454702,1.05381383806899,1.04567579178606,0.0562718277318371,0.784238010332341
"763","경북","구미시",2012,4463,2284,2179,"5",2010,4421,2290,2131,407210,420213,0.969056169133273,1.00950011309658,1.04173539703017,1.0959946956116,0.0457417737643094,0.628307971584829
"764","경북","구미시",2013,4506,2346,2160,"5",2011,4515,2344,2171,420229,433401,0.969607822778443,0.998006644518272,1.02928897753573,1.07227249904219,0.0314057651366314,0.416018994938364
"765","경북","구미시",2014,4962,2582,2380,"5",2012,5068,2623,2445,464047,479002,0.968778835996509,0.979084451460142,1.01063773802721,1.06928824019981,0.0113748081748179,0.11939868275029
"766","경북","구미시",2015,4723,2422,2301,"5",2013,4765,2430,2335,441255,454391,0.971090976713887,0.991185729275971,1.02069296599798,1.07035614327316,0.022148843278478,0.278941617322278
"767","경북","구미시",2016,4405,2311,2094,"5",2014,4439,2312,2127,422114,434628,0.971207561408837,0.992340617256139,1.02175956683929,1.04355695380869,0.0227073472870086,0.287211997698235
"768","경북","구미시",2017,4667,2411,2256,"5",2015,4662,2433,2229,445571,459820,0.969011787221086,1.0010725010725,1.03308598953513,1.04742005202313,0.0346549288801228,0.464132920088416
"769","경북","구미시",2018,4998,2616,2382,"5",2016,4959,2600,2359,447106,462028,0.967703256079718,1.00786448880823,1.04150159925183,1.1178557210147,0.0463928001549152,0.637948432177515
"770","경북","구미시",2019,5161,2660,2501,"5",2017,5235,2693,2542,459384,475293,0.966528015350531,0.985864374403056,1.02000599956279,1.12346098253313,0.0224759599253674,0.283785591681926
"771","경북","구미시",2020,4552,2362,2190,"5",2018,4590,2382,2208,417119,431567,0.966522000060246,0.991721132897603,1.02607197025602,1.09129528983336,0.028452218337068,0.372282593556307
"772","경북","군위군",2010,77,43,34,"5",2008,86,49,37,470657,486853,0.966733284995676,0.895348837209302,0.926159108314251,0.016360109379017,-0.001208045064623,-0.0669294024837257
"773","경북","군위군",2011,68,36,32,"5",2009,91,43,48,451574,467208,0.966537388058424,0.747252747252747,0.773123478186214,0.0150584400341915,-0.00341640649889884,-0.0996310282376906
"774","경북","군위군",2012,77,42,35,"5",2010,90,48,42,407210,420213,0.969056169133273,0.855555555555556,0.882875093113299,0.0189091623486653,-0.00221473387939293,-0.0818365460157372
"775","경북","군위군",2013,77,37,40,"5",2011,85,41,44,420229,433401,0.969607822778443,0.905882352941176,0.934277067139723,0.0183233427488346,-0.00120426382525749,-0.066873409532256
"776","경북","군위군",2014,80,43,37,"5",2012,97,51,46,464047,479002,0.968778835996509,0.824742268041237,0.851321516734918,0.0172396330544104,-0.00256316249457631,-0.0869961100249844
"777","경북","군위군",2015,93,52,41,"5",2013,104,54,50,441255,454391,0.971090976713887,0.894230769230769,0.920851692244934,0.0210762484277799,-0.00166814939688414,-0.0737426711126065
"778","경북","군위군",2016,70,39,31,"5",2014,72,44,28,422114,434628,0.971207561408837,0.972222222222222,1.00104474146794,0.0165831979038838,1.73251545213201e-05,-0.0487840039567624
"779","경북","군위군",2017,78,38,40,"5",2015,85,42,43,445571,459820,0.969011787221086,0.917647058823529,0.946992669155388,0.0175056276104145,-0.000927926594387817,-0.062781381585413
"780","경북","군위군",2018,79,43,36,"5",2016,99,52,47,447106,462028,0.967703256079718,0.797979797979798,0.824612083266631,0.0176691880672592,-0.0030989620854867,-0.0949302812295386
"781","경북","군위군",2019,87,50,37,"5",2017,115,58,57,459384,475293,0.966528015350531,0.756521739130435,0.782720963195326,0.0189384044720756,-0.00411491828230992,-0.109974657034729
"782","경북","군위군",2020,66,44,22,"5",2018,70,40,30,417119,431567,0.966522000060246,0.942857142857143,0.975515448999994,0.0158228227436295,-0.000387414710430449,-0.054777430298091
"783","경북","김천시",2010,1026,547,479,"5",2008,1101,587,514,470657,486853,0.966733284995676,0.931880108991826,0.963947474919097,0.217993145751577,-0.00785920335467376,-0.165420385823572
"784","경북","김천시",2011,1002,513,489,"5",2009,1087,561,526,451574,467208,0.966537388058424,0.921803127874885,0.953716989393032,0.221890542856763,-0.0102697623486254,-0.201116172235414
"785","경북","김천시",2012,913,452,461,"5",2010,948,467,481,407210,420213,0.969056169133273,0.963080168776371,0.993833174435857,0.224208639277031,-0.0013826555683953,-0.0695150513990019
"786","경북","김천시",2013,884,503,381,"5",2011,939,527,412,420229,433401,0.969607822778443,0.941427050053248,0.970935906184789,0.210361493376231,-0.00611396617859461,-0.139576748048417
"787","경북","김천시",2014,1028,538,490,"5",2012,1096,570,526,464047,479002,0.968778835996509,0.937956204379562,0.968184036983795,0.221529284749174,-0.00704816753058613,-0.15341049035052
"788","경북","김천시",2015,1077,577,500,"5",2013,1093,587,506,441255,454391,0.971090976713887,0.985361390667887,1.01469523895927,0.244076554373322,0.00358676329087063,0.00407257480571804
"789","경북","김천시",2016,1021,528,493,"5",2014,1019,523,496,422114,434628,0.971207561408837,1.00196270853778,1.03166691482955,0.241877786569505,0.00765952326645575,0.064382391142909
"790","경북","김천시",2017,1130,568,562,"5",2015,1156,573,583,445571,459820,0.969011787221086,0.977508650519031,1.00876858611009,0.2536071692278,0.00222377630151123,-0.0161106659182672
"791","경북","김천시",2018,1131,605,526,"5",2016,1189,628,561,447106,462028,0.967703256079718,0.951219512195122,0.982966117163464,0.252960148152787,-0.00430889352594729,-0.112847060856182
"792","경북","김천시",2019,1228,630,598,"5",2017,1296,654,642,459384,475293,0.966528015350531,0.947530864197531,0.980344955499184,0.267314490709298,-0.00525407821060427,-0.12684344539102
"793","경북","김천시",2020,1118,602,516,"5",2018,1150,610,540,417119,431567,0.966522000060246,0.972173913043478,1.00584768166982,0.268029027687542,0.0015673484321888,-0.0258311121205411
"794","경북","문경시",2010,518,283,235,"5",2008,509,277,232,470657,486853,0.966733284995676,1.01768172888016,1.05270165481548,0.11005891764066,0.0058002870868638,0.0368506453020455
"795","경북","문경시",2011,485,259,226,"5",2009,481,267,214,451574,467208,0.966537388058424,1.00831600831601,1.04322504310103,0.107402109067395,0.00464246079357994,0.0197054436410298
"796","경북","문경시",2012,485,256,229,"5",2010,498,265,233,407210,420213,0.969056169133273,0.973895582329317,1.00499394498502,0.119103165442892,0.000594794655763357,-0.0402327807643785
"797","경북","문경시",2013,464,257,207,"5",2011,466,255,211,420229,433401,0.969607822778443,0.995708154506438,1.02691844178114,0.110415987473497,0.00297222633051185,-0.00502754684000436
"798","경북","문경시",2014,507,279,228,"5",2012,518,289,229,464047,479002,0.968778835996509,0.978764478764479,1.010307453463,0.109256174482326,0.00112615293402154,-0.032364376939183
"799","경북","문경시",2015,484,256,228,"5",2013,486,251,235,441255,454391,0.971090976713887,0.995884773662551,1.02553189921769,0.109687142355327,0.0028005210640923,-0.00757017472477277
"800","경북","문경시",2016,456,249,207,"5",2014,466,250,216,422114,434628,0.971207561408837,0.978540772532189,1.00755061164548,0.108027689202443,0.000815675128126258,-0.0369619617618997
"801","경북","문경시",2017,464,238,226,"5",2015,497,254,243,445571,459820,0.969011787221086,0.933601609657948,0.963457433614211,0.104136041169645,-0.00380539819759504,-0.105391254238166
"802","경북","문경시",2018,513,278,235,"5",2016,563,308,255,447106,462028,0.967703256079718,0.911190053285968,0.941600689634246,0.114737892132962,-0.00670061377338522,-0.148263881321326
"803","경북","문경시",2019,486,256,230,"5",2017,508,270,238,459384,475293,0.966528015350531,0.956692913385827,0.989824297062784,0.105793845671595,-0.00107652674613986,-0.0649818667388641
"804","경북","문경시",2020,415,223,192,"5",2018,446,239,207,417119,431567,0.966522000060246,0.930493273542601,0.962723324957529,0.0994919914940341,-0.00370873063625138,-0.103959791813336
"805","경북","봉화군",2010,192,99,93,"5",2008,187,95,92,470657,486853,0.966733284995676,1.02673796791444,1.06206953236231,0.0407940389710554,0.00253206692210328,-0.0115454691431457
"806","경북","봉화군",2011,186,98,88,"5",2009,196,103,93,451574,467208,0.966537388058424,0.948979591836735,0.981834333116736,0.041189262446465,-0.000748230420769803,-0.0601204235882893
"807","경북","봉화군",2012,140,69,71,"5",2010,169,90,79,407210,420213,0.969056169133273,0.828402366863905,0.854854850782108,0.0343802951793915,-0.00499013307396794,-0.12293492075194
"808","경북","봉화군",2013,171,88,83,"5",2011,195,98,97,420229,433401,0.969607822778443,0.876923076923077,0.904410067990402,0.0406920988318274,-0.00388975496066224,-0.106640417193479
"809","경북","봉화군",2014,186,80,106,"5",2012,206,89,117,464047,479002,0.968778835996509,0.902912621359223,0.932011092532245,0.0400821468515043,-0.00272514137339589,-0.0893947086388666
"810","경북","봉화군",2015,175,102,73,"5",2013,211,119,92,441255,454391,0.971090976713887,0.829383886255924,0.854074341275942,0.039659607256575,-0.00578735431365315,-0.134740248547771
"811","경북","봉화군",2016,157,91,66,"5",2014,183,105,78,422114,434628,0.971207561408837,0.85792349726776,0.88335751425087,0.0371937438701393,-0.00433837073932952,-0.113283562230157
"812","경북","봉화군",2017,177,89,88,"5",2015,226,113,113,445571,459820,0.969011787221086,0.783185840707965,0.808231490097731,0.0397243088082483,-0.00761787150705534,-0.161846720914903
"813","경북","봉화군",2018,160,82,78,"5",2016,192,92,100,447106,462028,0.967703256079718,0.833333333333333,0.861145529993633,0.0357856973514111,-0.00496900403953843,-0.122622040004372
"814","경북","봉화군",2019,141,78,63,"5",2017,196,100,96,459384,475293,0.966528015350531,0.719387755102041,0.744300986289715,0.030693276213364,-0.00784824045529453,-0.165258046168879
"815","경북","봉화군",2020,132,69,63,"5",2018,166,86,80,417119,431567,0.966522000060246,0.795180722891566,0.822723872650598,0.031645645487259,-0.00561001747945338,-0.13211422787272
"816","경북","상주시",2010,696,359,337,"5",2008,722,370,352,470657,486853,0.966733284995676,0.96398891966759,0.997161197022301,0.147878391270076,-0.000419797617474813,-0.0552569594596467
"817","경북","상주시",2011,634,336,298,"5",2009,658,349,309,451574,467208,0.966537388058424,0.963525835866261,0.996884184482287,0.14039780855408,-0.000437453670545717,-0.0555184119695734
"818","경북","상주시",2012,650,329,321,"5",2010,661,327,334,407210,420213,0.969056169133273,0.983358547655068,1.0147590810289,0.159622799047175,0.00235588582519736,-0.0141543755506377
"819","경북","상주시",2013,619,331,288,"5",2011,639,348,291,420229,433401,0.969607822778443,0.968701095461659,0.999064851483782,0.14730063846141,-0.000137747973495088,-0.0510803415572024
"820","경북","상주시",2014,703,379,324,"5",2012,710,384,326,464047,479002,0.968778835996509,0.990140845070423,1.02205044978294,0.151493275465632,0.00334049486310756,0.000425808549647131
"821","경북","상주시",2015,712,372,340,"5",2013,697,365,332,441255,454391,0.971090976713887,1.02152080344333,1.05193110423093,0.161357944952465,0.00837949625781457,0.0750438195445055
"822","경북","상주시",2016,658,339,319,"5",2014,682,357,325,422114,434628,0.971207561408837,0.964809384164223,0.993412142266136,0.155882060296508,-0.00102692883649498,-0.064247416184615
"823","경북","상주시",2017,637,348,289,"5",2015,667,359,308,445571,459820,0.969011787221086,0.955022488755622,0.985563335090502,0.142962625485052,-0.00206390351870971,-0.0796030357167242
"824","경북","상주시",2018,609,305,304,"5",2016,631,320,311,447106,462028,0.967703256079718,0.96513470681458,0.997345726338109,0.136209310543808,-0.000361536785480698,-0.0543942275288969
"825","경북","상주시",2019,606,320,286,"5",2017,639,348,291,459384,475293,0.966528015350531,0.948356807511737,0.981199502187007,0.131915782874458,-0.0024800823874305,-0.0857658519117457
"826","경북","상주시",2020,564,288,276,"5",2018,589,298,291,417119,431567,0.966522000060246,0.957555178268251,0.9907225890446,0.13521321253647,-0.00125442853930071,-0.0676162533798412
"827","경북","성주군",2010,227,131,96,"5",2008,261,144,117,470657,486853,0.966733284995676,0.869731800766284,0.89966055194859,0.048230452325154,-0.00483941696557581,-0.1207031023117
"828","경북","성주군",2011,214,141,73,"5",2009,229,146,83,451574,467208,0.966537388058424,0.934497816593886,0.966851182519801,0.047389796578191,-0.00157091571719423,-0.0723028255535651
"829","경북","성주군",2012,196,100,96,"5",2010,217,114,103,407210,420213,0.969056169133273,0.903225806451613,0.932067546981782,0.0481324132511481,-0.00326975290183705,-0.0974593678508754
"830","경북","성주군",2013,207,118,89,"5",2011,229,126,103,420229,433401,0.969607822778443,0.903930131004367,0.932263653168686,0.0492588564806332,-0.00333661498708611,-0.0984494679563237
"831","경북","성주군",2014,203,107,96,"5",2012,237,112,125,464047,479002,0.968778835996509,0.856540084388186,0.884144092090046,0.0437455688755665,-0.00506818259911617,-0.124090685529416
"832","경북","성주군",2015,207,114,93,"5",2013,232,127,105,441255,454391,0.971090976713887,0.892241379310345,0.918803078914022,0.0469116497263487,-0.00380908152084336,-0.105445797238477
"833","경북","성주군",2016,218,126,92,"5",2014,230,127,103,422114,434628,0.971207561408837,0.947826086956522,0.975925357893221,0.0516448163292381,-0.00124333046979674,-0.0674519121131094
"834","경북","성주군",2017,178,84,94,"5",2015,227,106,121,445571,459820,0.969011787221086,0.784140969162996,0.809217162787813,0.0399487399314587,-0.00762153394717549,-0.16190095467587
"835","경북","성주군",2018,192,92,100,"5",2016,238,113,125,447106,462028,0.967703256079718,0.80672268907563,0.833646765170307,0.0429428368216933,-0.00714367981805233,-0.154824845370105
"836","경북","성주군",2019,193,94,99,"5",2017,239,116,123,459384,475293,0.966528015350531,0.807531380753138,0.835497127789173,0.0420127823346046,-0.00691122336361077,-0.151382608126121
"837","경북","성주군",2020,162,80,82,"5",2018,201,104,97,417119,431567,0.966522000060246,0.805970149253731,0.833887018819534,0.0388378376434543,-0.00645146899355713,-0.14457452177083
"838","경북","안동시",2010,1370,700,670,"5",2008,1390,701,689,470657,486853,0.966733284995676,0.985611510791367,1.01952785332696,0.291082465574718,0.00568421569379441,0.0351318490950554
"839","경북","안동시",2011,1374,718,656,"5",2009,1372,718,654,451574,467208,0.966537388058424,1.00145772594752,1.03612931927987,0.304269067749693,0.0109930342957183,0.113745338907573
"840","경북","안동시",2012,1267,669,598,"5",2010,1275,674,601,407210,420213,0.969056169133273,0.993725490196078,1.02545706002251,0.311141671373493,0.00792075220365789,0.068250694042924
"841","경북","안동시",2013,1244,635,609,"5",2011,1269,650,619,420229,433401,0.969607822778443,0.980299448384555,1.0110267526261,0.296029069864288,0.00326423932352873,-0.000703390719217641
"842","경북","안동시",2014,1391,726,665,"5",2012,1441,748,693,464047,479002,0.968778835996509,0.96530187369882,0.99641098445951,0.299754119733561,-0.00107582219404961,-0.0649714336646298
"843","경북","안동시",2015,1318,674,644,"5",2013,1351,676,675,441255,454391,0.971090976713887,0.975573649148779,1.00461611995414,0.298693499223805,0.00137880502193802,-0.0286230808375728
"844","경북","안동시",2016,1302,665,637,"5",2014,1305,675,630,422114,434628,0.971207561408837,0.997701149425287,1.02727901745124,0.308447481012238,0.00841414421732464,0.0755568898179902
"845","경북","안동시",2017,1407,743,664,"5",2015,1413,748,665,445571,459820,0.969011787221086,0.995753715498938,1.02759711350317,0.315774590357092,0.00871446721150234,0.0800041012248176
"846","경북","안동시",2018,1473,776,697,"5",2016,1389,740,649,447106,462028,0.967703256079718,1.06047516198704,1.0958681344973,0.329452076241428,0.0315839559555271,0.418657661499859
"847","경북","안동시",2019,1424,759,665,"5",2017,1412,743,669,459384,475293,0.966528015350531,1.00849858356941,1.04342405760857,0.309980321473974,0.0134606033372075,0.150285335515198
"848","경북","안동시",2020,1315,686,629,"5",2018,1250,660,590,417119,431567,0.966522000060246,1.052,1.0884387524903,0.315257756179891,0.0278810026694396,0.363823977725738
"849","경북","영덕군",2010,245,125,120,"5",2008,267,139,128,470657,486853,0.966733284995676,0.917602996254682,0.94917906572213,0.0520548934786904,-0.00264547832032206,-0.0882150505866995
"850","경북","영덕군",2011,212,109,103,"5",2009,233,122,111,451574,467208,0.966537388058424,0.909871244635193,0.941372010929591,0.0469469012830677,-0.00275240241531325,-0.0897983927354134
"851","경북","영덕군",2012,200,99,101,"5",2010,225,118,107,407210,420213,0.969056169133273,0.888888888888889,0.917272824013818,0.0491147073991307,-0.00406312104251774,-0.109207638590881
"852","경북","영덕군",2013,205,99,106,"5",2011,229,114,115,420229,433401,0.969607822778443,0.895196506550218,0.923256274877201,0.048782925500144,-0.00374378342526905,-0.104478856840599
"853","경북","영덕군",2014,216,118,98,"5",2012,237,135,102,464047,479002,0.968778835996509,0.911392405063291,0.940764157100739,0.0465470092469082,-0.00275725132718031,-0.0898701958826381
"854","경북","영덕군",2015,168,86,82,"5",2013,178,92,86,441255,454391,0.971090976713887,0.943820224719101,0.971917407690195,0.038073222966312,-0.00106919479848323,-0.0648732945619579
"855","경북","영덕군",2016,191,98,93,"5",2014,207,109,98,422114,434628,0.971207561408837,0.922705314009662,0.950059854014298,0.0452484399948829,-0.00225971369896974,-0.0825026114538725
"856","경북","영덕군",2017,203,106,97,"5",2015,190,90,100,445571,459820,0.969011787221086,1.06842105263158,1.102588293271,0.0455595180117198,0.0046738731950717,0.0201706014642344
"857","경북","영덕군",2018,186,94,92,"5",2016,210,107,103,447106,462028,0.967703256079718,0.885714285714286,0.915274677593233,0.0416008731710154,-0.0035246473918173,-0.101233869655113
"858","경북","영덕군",2019,174,87,87,"5",2017,194,98,96,459384,475293,0.966528015350531,0.896907216494845,0.927968152241882,0.0378768089441513,-0.00272833653542844,-0.0894420229015547
"859","경북","영덕군",2020,169,88,81,"5",2018,207,111,96,417119,431567,0.966522000060246,0.816425120772947,0.844704125433314,0.0405160158132332,-0.00629197010967374,-0.142212647157384
"860","경북","영양군",2010,104,52,52,"5",2008,110,56,54,470657,486853,0.966733284995676,0.945454545454545,0.977989027716961,0.0220967711093217,-0.000486371416431932,-0.0562427905943175
"861","경북","영양군",2011,75,34,41,"5",2009,83,39,44,451574,467208,0.966537388058424,0.903614457831325,0.934898607126313,0.016608573567123,-0.0010812412728648,-0.0650516798981472
"862","경북","영양군",2012,95,51,44,"5",2010,105,53,52,407210,420213,0.969056169133273,0.904761904761905,0.933652695871207,0.0233294860145871,-0.00154784850377823,-0.0719612440675778
"863","경북","영양군",2013,87,45,42,"5",2011,87,49,38,420229,433401,0.969607822778443,1,1.03134481437502,0.0207029976512806,0.00064893161838585,-0.0394311154827541
"864","경북","영양군",2014,107,56,51,"5",2012,116,54,62,464047,479002,0.968778835996509,0.922413793103448,0.95214073514997,0.023058009210274,-0.00110353936970894,-0.0653818722329277
"865","경북","영양군",2015,105,54,51,"5",2013,107,56,51,441255,454391,0.971090976713887,0.981308411214953,1.01052160379004,0.023795764353945,0.000250369604413355,-0.0453330596203309
"866","경북","영양군",2016,81,45,36,"5",2014,84,48,36,422114,434628,0.971207561408837,0.964285714285714,0.992872947660043,0.0191891290030655,-0.000136761926763035,-0.0510657400835908
"867","경북","영양군",2017,93,46,47,"5",2015,95,49,46,445571,459820,0.969011787221086,0.978947368421053,1.01025331304633,0.0208720944585711,0.000214008118416398,-0.0458715039566949
"868","경북","영양군",2018,71,45,26,"5",2016,85,53,32,447106,462028,0.967703256079718,0.835294117647059,0.863171754770089,0.0158799031996887,-0.00217281928923425,-0.0812158707858017
"869","경북","영양군",2019,70,42,28,"5",2017,83,45,38,459384,475293,0.966528015350531,0.843373493975904,0.872580494906852,0.0152377967016701,-0.00194159251443681,-0.0777918427547191
"870","경북","영양군",2020,77,46,31,"5",2018,89,53,36,417119,431567,0.966522000060246,0.865168539325843,0.895135898895126,0.0184599598675678,-0.00193578709794455,-0.0777058755962055
"871","경북","영주시",2010,937,471,466,"5",2008,952,472,480,470657,486853,0.966733284995676,0.984243697478992,1.0181129715456,0.199083408936869,0.00360599212127542,0.0043573171517054
"872","경북","영주시",2011,874,463,411,"5",2009,869,450,419,451574,467208,0.966537388058424,1.00575373993096,1.04057406610137,0.193545243968873,0.00785291752239954,0.0672461916434437
"873","경북","영주시",2012,836,461,375,"5",2010,852,461,391,407210,420213,0.969056169133273,0.981220657276995,1.01255292369131,0.205299476928366,0.0025771086677475,-0.0108784866979258
"874","경북","영주시",2013,826,440,386,"5",2011,840,448,392,420229,433401,0.969607822778443,0.983333333333333,1.01415573413544,0.196559494942044,0.00278244395219509,-0.00783786231376979
"875","경북","영주시",2014,840,419,421,"5",2012,854,417,437,464047,479002,0.968778835996509,0.983606557377049,1.01530557938468,0.18101614707131,0.00277055700890834,-0.00801388529836297
"876","경북","영주시",2015,816,402,414,"5",2013,806,402,404,441255,454391,0.971090976713887,1.01240694789082,1.04254593253121,0.18492708297923,0.00786789519562693,0.0674679824503946
"877","경북","영주시",2016,787,396,391,"5",2014,776,389,387,422114,434628,0.971207561408837,1.01417525773196,1.04424151749889,0.186442525005093,0.00824850023254978,0.0731040179672012
"878","경북","영주시",2017,830,427,403,"5",2015,781,404,377,445571,459820,0.969011787221086,1.06274007682458,1.09672564445505,0.186277832264667,0.0180178433734893,0.217769378581881
"879","경북","영주시",2018,809,403,406,"5",2016,813,406,407,447106,462028,0.967703256079718,0.995079950799508,1.02829038194074,0.180941432233072,0.00511890222677755,0.0267606336114251
"880","경북","영주시",2019,845,445,400,"5",2017,847,440,407,459384,475293,0.966528015350531,0.997638724911452,1.03218810946689,0.18394197447016,0.00592074440980182,0.0386343887748776
"881","경북","영주시",2020,666,333,333,"5",2018,692,355,337,417119,431567,0.966522000060246,0.96242774566474,0.99576393046899,0.159666665867534,-0.000676359098399358,-0.059056146224031
"882","경북","영천시",2010,728,393,335,"5",2008,771,420,351,470657,486853,0.966733284995676,0.944228274967575,0.976720559457925,0.154677397765252,-0.00360080328447905,-0.10236159334297
"883","경북","영천시",2011,648,352,296,"5",2009,714,392,322,451574,467208,0.966537388058424,0.907563025210084,0.938983878350731,0.143498075619943,-0.00875569603846247,-0.178695734587322
"884","경북","영천시",2012,579,279,300,"5",2010,613,297,316,407210,420213,0.969056169133273,0.944535073409462,0.974695898437195,0.142187077920483,-0.00359791626061838,-0.102318842019582
"885","경북","영천시",2013,568,292,276,"5",2011,641,329,312,420229,433401,0.969607822778443,0.886115444617785,0.913890568744167,0.135164398458935,-0.0116389294773357,-0.221390929049576
"886","경북","영천시",2014,644,348,296,"5",2012,684,364,320,464047,479002,0.968778835996509,0.941520467836257,0.971863167167341,0.138779046088004,-0.00390480282045409,-0.106863247329739
"887","경북","영천시",2015,578,313,265,"5",2013,611,327,284,441255,454391,0.971090976713887,0.945990180032733,0.974151961780045,0.130990017110288,-0.00338583496869929,-0.0991783221164032
"888","경북","영천시",2016,577,325,252,"5",2014,599,334,265,422114,434628,0.971207561408837,0.963272120200334,0.991829304544343,0.136692931293442,-0.00111687631253979,-0.0655793669484154
"889","경북","영천시",2017,615,324,291,"5",2015,636,326,310,445571,459820,0.969011787221086,0.966981132075472,0.997904406146144,0.138025140774422,-0.000289244636684541,-0.0533237185269784
"890","경북","영천시",2018,552,274,278,"5",2016,629,317,312,447106,462028,0.967703256079718,0.87758346581876,0.906872494543375,0.123460655862368,-0.0114975829025012,-0.219297855551688
"891","경북","영천시",2019,610,291,319,"5",2017,681,344,337,459384,475293,0.966528015350531,0.895741556534508,0.926762124126996,0.132786514114553,-0.00972500223833056,-0.193049312809212
"892","경북","영천시",2020,542,271,271,"5",2018,598,302,296,417119,431567,0.966522000060246,0.906354515050167,0.937748457866114,0.129938938288594,-0.00808889929170485,-0.168821745063691
"893","경북","예천군",2010,233,124,109,"5",2008,266,147,119,470657,486853,0.966733284995676,0.87593984962406,0.906082228903474,0.0495052660429995,-0.00464942424429902,-0.117889672059415
"894","경북","예천군",2011,232,129,103,"5",2009,253,133,120,451574,467208,0.966537388058424,0.91699604743083,0.948743482414982,0.0513758542343005,-0.00263334737600573,-0.0880354144116977
"895","경북","예천군",2012,211,104,107,"5",2010,224,115,109,407210,420213,0.969056169133273,0.941964285714286,0.972043020536964,0.0518160163060829,-0.00144861930372549,-0.0704918486535731
"896","경북","예천군",2013,253,139,114,"5",2011,259,141,118,420229,433401,0.969607822778443,0.976833976833977,1.00745265651305,0.060205269031885,0.000448689190370388,-0.0423963243654088
"897","경북","예천군",2014,248,141,107,"5",2012,285,150,135,464047,479002,0.968778835996509,0.870175438596491,0.898218877481368,0.0534428624686724,-0.00543947453267033,-0.129588811727466
"898","경북","예천군",2015,243,144,99,"5",2013,268,153,115,441255,454391,0.971090976713887,0.906716417910448,0.933709034120285,0.0550701975048441,-0.00365065658378279,-0.103099825731531
"899","경북","예천군",2016,243,138,105,"5",2014,267,146,121,422114,434628,0.971207561408837,0.910112359550562,0.937093568578018,0.0575673870091966,-0.00362135888303672,-0.102665982597713
"900","경북","예천군",2017,208,108,100,"5",2015,259,135,124,445571,459820,0.969011787221086,0.803088803088803,0.828770933108962,0.046681673627772,-0.00799325941619536,-0.16740550070825
"901","경북","예천군",2018,219,108,111,"5",2016,327,156,171,447106,462028,0.967703256079718,0.669724770642202,0.692076591077452,0.0489816732497439,-0.0150826038017915,-0.272385185347038
"902","경북","예천군",2019,367,210,157,"5",2017,400,215,185,459384,475293,0.966528015350531,0.9175,0.949274087691343,0.0798895912787559,-0.00405247240158061,-0.10904995250503
"903","경북","예천군",2020,394,204,190,"5",2018,481,249,232,417119,431567,0.966522000060246,0.819126819126819,0.847499404127129,0.0944574569846974,-0.0144048184748024,-0.262348475884216
"904","경북","울릉군",2010,58,31,27,"5",2008,72,37,35,470657,486853,0.966733284995676,0.805555555555556,0.833275907696877,0.0123231992725063,-0.00205457421297912,-0.0794648864718539
"905","경북","울릉군",2011,48,29,19,"5",2009,51,31,20,451574,467208,0.966537388058424,0.941176470588235,0.973761059030387,0.0106294870829587,-0.000278906484107013,-0.0531706301822308
"906","경북","울릉군",2012,57,27,30,"5",2010,66,37,29,407210,420213,0.969056169133273,0.863636363636364,0.89121393696797,0.0139976916087522,-0.00152275376165263,-0.0715896387439898
"907","경북","울릉군",2013,51,25,26,"5",2011,60,32,28,420229,433401,0.969607822778443,0.85,0.876643092218766,0.0121362400024748,-0.00149708903879621,-0.0712095930916325
"908","경북","울릉군",2014,54,19,35,"5",2012,71,25,46,464047,479002,0.968778835996509,0.76056338028169,0.785074314200265,0.011636752311727,-0.00250103697107959,-0.0860761493755969
"909","경북","울릉군",2015,57,32,25,"5",2013,51,28,23,441255,454391,0.971090976713887,1.11764705882353,1.15091900308412,0.0129177006492844,0.00194952650412907,-0.0201717829518714
"910","경북","울릉군",2016,41,21,20,"5",2014,52,25,27,422114,434628,0.971207561408837,0.788461538461538,0.811836284838839,0.00971301591513193,-0.00182763716001071,-0.0761043810488301
"911","경북","울릉군",2017,40,22,18,"5",2015,45,23,22,445571,459820,0.969011787221086,0.888888888888889,0.917314836218894,0.00897724492841769,-0.000742284967209319,-0.060032382747576
"912","경북","울릉군",2018,50,29,21,"5",2016,54,34,20,447106,462028,0.967703256079718,0.925925925925926,0.956828366659592,0.011183030422316,-0.000482789689026849,-0.056189752034897
"913","경북","울릉군",2019,50,20,30,"5",2017,52,25,27,459384,475293,0.966528015350531,0.961538461538462,0.994837652160284,0.0108841405011929,-5.61877192034953e-05,-0.0498725895693053
"914","경북","울릉군",2020,50,22,28,"5",2018,53,22,31,417119,431567,0.966522000060246,0.943396226415094,0.976073205117204,0.0119869869269921,-0.000286810177464895,-0.0532876688237557
"915","경북","울진군",2010,396,186,210,"5",2008,415,194,221,470657,486853,0.966733284995676,0.95421686746988,0.987052874127684,0.0841377053778017,-0.00108934146213426,-0.0651716282697837
"916","경북","울진군",2011,413,205,208,"5",2009,420,205,215,451574,467208,0.966537388058424,0.983333333333333,1.01737743979946,0.0914578784429573,0.00158930377682855,-0.0255059952929399
"917","경북","울진군",2012,397,191,206,"5",2010,393,195,198,407210,420213,0.969056169133273,1.01017811704835,1.04243505095463,0.0974926941872744,0.00413710744554159,0.012222123291124
"918","경북","울진군",2013,362,196,166,"5",2011,372,201,171,420229,433401,0.969607822778443,0.973118279569892,1.00362049140795,0.0861435074685469,0.000311881828640461,-0.044422180764747
"919","경북","울진군",2014,400,220,180,"5",2012,419,237,182,464047,479002,0.968778835996509,0.954653937947494,0.985419894072638,0.0861981652720522,-0.00125677838041076,-0.0676510500500643
"920","경북","울진군",2015,368,189,179,"5",2013,409,210,199,441255,454391,0.971090976713887,0.899755501222494,0.92654089348787,0.0833984884023977,-0.00612637844250234,-0.139760550030633
"921","경북","울진군",2016,332,169,163,"5",2014,388,207,181,422114,434628,0.971207561408837,0.855670103092783,0.881037315907575,0.0786517386298488,-0.00935662193594265,-0.187594302321868
"922","경북","울진군",2017,335,181,154,"5",2015,367,196,171,445571,459820,0.969011787221086,0.912806539509537,0.941997353950942,0.0751844262754982,-0.00436089566565921,-0.113617113477492
"923","경북","울진군",2018,343,166,177,"5",2016,367,174,193,447106,462028,0.967703256079718,0.934604904632153,0.965797003120925,0.0767155886970875,-0.0026239030407829,-0.0878955617991868
"924","경북","울진군",2019,330,185,145,"5",2017,375,209,166,459384,475293,0.966528015350531,0.88,0.910475419257092,0.0718353273078731,-0.0064310275597669,-0.144271823078801
"925","경북","울진군",2020,299,148,151,"5",2018,341,169,172,417119,431567,0.966522000060246,0.87683284457478,0.907204227653509,0.0716821818234125,-0.00665180342578514,-0.147541093060598
"926","경북","의성군",2010,231,123,108,"5",2008,249,132,117,470657,486853,0.966733284995676,0.927710843373494,0.959634738735248,0.049080328137051,-0.00198114026821182,-0.0783774696468064
"927","경북","의성군",2011,223,123,100,"5",2009,248,136,112,451574,467208,0.966537388058424,0.899193548387097,0.930324640822631,0.0493828254062457,-0.00344076609737348,-0.0999917474843098
"928","경북","의성군",2012,214,115,99,"5",2010,238,125,113,407210,420213,0.969056169133273,0.899159663865546,0.927871564627423,0.0525527369170698,-0.00379054668837493,-0.105171331679811
"929","경북","의성군",2013,217,110,107,"5",2011,227,110,117,420229,433401,0.969607822778443,0.955947136563877,0.985911122111803,0.0516385113830792,-0.000727528681204498,-0.0598138702636327
"930","경북","의성군",2014,225,105,120,"5",2012,243,112,131,464047,479002,0.968778835996509,0.925925925925926,0.955766054667675,0.0484864679655293,-0.00214474777334477,-0.080800185113739
"931","경북","의성군",2015,220,135,85,"5",2013,245,146,99,441255,454391,0.971090976713887,0.897959183673469,0.924691100222256,0.0498577919796943,-0.00375473545933842,-0.104641035600752
"932","경북","의성군",2016,193,95,98,"5",2014,211,101,110,422114,434628,0.971207561408837,0.914691943127962,0.94180891858081,0.0457222456492796,-0.00266062691924545,-0.0884393724775824
"933","경북","의성군",2017,192,104,88,"5",2015,212,119,93,445571,459820,0.969011787221086,0.905660377358491,0.934622663317364,0.0430907756564049,-0.00281716014800473,-0.0907573313884272
"934","경북","의성군",2018,183,88,95,"5",2016,214,105,109,447106,462028,0.967703256079718,0.855140186915888,0.883680179376644,0.0409298913456764,-0.00476095761946253,-0.11954126886647
"935","경북","의성군",2019,177,90,87,"5",2017,200,103,97,459384,475293,0.966528015350531,0.885,0.915648575048326,0.0385298573742229,-0.00325004837270048,-0.0971675813129106
"936","경북","의성군",2020,162,83,79,"5",2018,193,102,91,417119,431567,0.966522000060246,0.839378238341969,0.868452283848323,0.0388378376434543,-0.00510902884226605,-0.12469554057543
"937","경북","청도군",2010,181,90,91,"5",2008,205,98,107,470657,486853,0.966733284995676,0.882926829268293,0.91330964079947,0.0384568804883386,-0.00333384078326594,-0.0984083872828051
"938","경북","청도군",2011,198,110,88,"5",2009,225,127,98,451574,467208,0.966537388058424,0.88,0.910466590193412,0.0438466342172047,-0.00392573867000854,-0.107173267377338
"939","경북","청도군",2012,163,80,83,"5",2010,180,93,87,407210,420213,0.969056169133273,0.905555555555556,0.934471689464077,0.0400284865302915,-0.00262299909563997,-0.0878821760937005
"940","경북","청도군",2013,184,98,86,"5",2011,202,107,95,420229,433401,0.969607822778443,0.910891089108911,0.939442801212889,0.0437856502050073,-0.00265153632348754,-0.0883047580726477
"941","경북","청도군",2014,216,102,114,"5",2012,232,101,131,464047,479002,0.968778835996509,0.931034482758621,0.961039246693427,0.0465470092469082,-0.00181350654442755,-0.0758951335518843
"942","경북","청도군",2015,176,92,84,"5",2013,181,94,87,441255,454391,0.971090976713887,0.972375690607735,1.0013229593567,0.0398862335837554,5.27678659230232e-05,-0.0482591649218223
"943","경북","청도군",2016,175,82,93,"5",2014,186,91,95,422114,434628,0.971207561408837,0.940860215053763,0.96875297561414,0.0414579947597095,-0.0012954389732455,-0.0682235397787317
"944","경북","청도군",2017,182,97,85,"5",2015,197,108,89,445571,459820,0.969011787221086,0.923857868020305,0.953402095004155,0.0408464644243005,-0.00190335966865971,-0.0772256871450864
"945","경북","청도군",2018,174,83,91,"5",2016,199,96,103,447106,462028,0.967703256079718,0.874371859296482,0.903553701822465,0.0389169458696595,-0.00375339536550416,-0.104621191364042
"946","경북","청도군",2019,183,98,85,"5",2017,188,100,88,459384,475293,0.966528015350531,0.973404255319149,1.00711437212311,0.039835954234366,0.00028340780230259,-0.0448438268497389
"947","경북","청도군",2020,145,74,71,"5",2018,152,74,78,417119,431567,0.966522000060246,0.953947368421053,0.986989813332331,0.034762262088277,-0.000452263518758927,-0.0557377176077831
"948","경북","청송군",2010,151,85,66,"5",2008,164,91,73,470657,486853,0.966733284995676,0.920731707317073,0.952415440336464,0.0320828118991112,-0.00152664647698727,-0.0716472824421926
"949","경북","청송군",2011,121,61,60,"5",2009,146,77,69,451574,467208,0.966537388058424,0.828767123287671,0.857459973641056,0.0267951653549584,-0.00381938357598803,-0.105598351049012
"950","경북","청송군",2012,120,62,58,"5",2010,135,63,72,407210,420213,0.969056169133273,0.888888888888889,0.917272824013818,0.0294688244394784,-0.00243787262551064,-0.0851408057503505
"951","경북","청송군",2013,118,58,60,"5",2011,128,64,64,420229,433401,0.969607822778443,0.921875,0.950771000751971,0.0280799278488634,-0.0013823467469564,-0.069510478341819
"952","경북","청송군",2014,125,63,62,"5",2012,127,58,69,464047,479002,0.968778835996509,0.984251968503937,1.01597179039477,0.0269369266475163,0.00043023094629348,-0.0426696557959028
"953","경북","청송군",2015,123,74,49,"5",2013,130,81,49,441255,454391,0.971090976713887,0.946153846153846,0.974320500181737,0.0278750382431927,-0.000715817039500145,-0.0596404431615126
"954","경북","청송군",2016,106,49,57,"5",2014,113,52,61,422114,434628,0.971207561408837,0.938053097345133,0.965862638038351,0.025111699683024,-0.000857247181551627,-0.0617347541306834
"955","경북","청송군",2017,98,50,48,"5",2015,107,57,50,445571,459820,0.969011787221086,0.91588785046729,0.945177202739562,0.0219942500746233,-0.00120578631273646,-0.0668959546713712
"956","경북","청송군",2018,116,64,52,"5",2016,120,64,56,447106,462028,0.967703256079718,0.966666666666667,0.998928814792614,0.025944630579773,-2.77915044881365e-05,-0.0494520957262061
"957","경북","청송군",2019,115,59,56,"5",2017,136,69,67,459384,475293,0.966528015350531,0.845588235294118,0.874871935282132,0.0250335231527437,-0.00313239630517275,-0.0954253783284912
"958","경북","청송군",2020,104,45,59,"5",2018,129,62,67,417119,431567,0.966522000060246,0.806201550387597,0.834126435132718,0.0249329328081435,-0.00413571444748318,-0.110282608622752
"959","경북","칠곡군",2010,1282,655,627,"5",2008,1446,731,715,470657,486853,0.966733284995676,0.886583679114799,0.917092328230702,0.272385197712984,-0.0225828225668035,-0.383449136799674
"960","경북","칠곡군",2011,1207,666,541,"5",2009,1335,709,626,451574,467208,0.966537388058424,0.904119850187266,0.935421496734294,0.267287310606899,-0.0172610144609094,-0.304643297179298
"961","경북","칠곡군",2012,1153,616,537,"5",2010,1303,691,612,407210,420213,0.969056169133273,0.884881043745203,0.913137000651514,0.283146288155988,-0.0245949358436197,-0.413244701208543
"962","경북","칠곡군",2013,1214,633,581,"5",2011,1304,671,633,420229,433401,0.969607822778443,0.930981595092024,0.960163040376743,0.28889010515695,-0.0115085034546958,-0.21945956812525
"963","경북","칠곡군",2014,1316,709,607,"5",2012,1415,751,664,464047,479002,0.968778835996509,0.930035335689046,0.960007899772489,0.283591963745052,-0.0113414382378087,-0.216985650534428
"964","경북","칠곡군",2015,1235,635,600,"5",2013,1328,700,628,441255,454391,0.971090976713887,0.929969879518072,0.957654742777071,0.279883514067829,-0.0118517393956595,-0.224542238521723
"965","경북","칠곡군",2016,1212,623,589,"5",2014,1270,645,625,422114,434628,0.971207561408837,0.954330708661417,0.982622815741943,0.287126226564388,-0.00498944534433006,-0.122924736786178
"966","경북","칠곡군",2017,1223,651,572,"5",2015,1315,698,617,445571,459820,0.969011787221086,0.930038022813688,0.959779886146518,0.274479263686371,-0.0110395872358858,-0.212515812243859
"967","경북","칠곡군",2018,1206,591,615,"5",2016,1326,662,664,447106,462028,0.967703256079718,0.909502262443439,0.939856569386716,0.269734693786261,-0.0162227698397293,-0.289268872270437
"968","경북","칠곡군",2019,1244,649,595,"5",2017,1316,686,630,459384,475293,0.966528015350531,0.945288753799392,0.978025198221041,0.270797415669679,-0.00595071953159571,-0.137159376202989
"969","경북","칠곡군",2020,1123,600,523,"5",2018,1187,637,550,417119,431567,0.966522000060246,0.946082561078349,0.978852587959071,0.269227726380242,-0.00569346966260545,-0.13334999572278
"970","경북","포항시",2010,4670,2451,2219,"5",2008,4679,2452,2227,470657,486853,0.966733284995676,0.99807651207523,1.0324217936488,0.992230010389732,0.0321698766489995,0.427334030749045
"971","경북","포항시",2011,4461,2357,2104,"5",2009,4455,2369,2086,451574,467208,0.966537388058424,1.0013468013468,1.03601455434466,0.987877955772476,0.0355779843240614,0.477801612726012
"972","경북","포항시",2012,4263,2245,2018,"5",2010,4333,2293,2040,407210,420213,0.969056169133273,0.983844911147011,1.01526097504437,1.04687998821247,0.0159764093745638,0.187539630136664
"973","경북","포항시",2013,4337,2271,2066,"5",2011,4301,2232,2069,420229,433401,0.969607822778443,1.00837014647756,1.03997732154021,1.03205633119085,0.0412588477996299,0.561924378344915
"974","경북","포항시",2014,4684,2428,2256,"5",2012,4687,2419,2268,464047,479002,0.968778835996509,0.999359931726051,1.03156664306987,1.00938051533573,0.0318627544492798,0.422786136061116
"975","경북","포항시",2015,4423,2262,2161,"5",2013,4529,2298,2231,441255,454391,0.971090976713887,0.97659527489512,1.00566815912538,1.00236824511904,0.00568158271556058,0.0350928597034257
"976","경북","포항시",2016,4355,2275,2080,"5",2014,4440,2331,2109,422114,434628,0.971207561408837,0.980855855855856,1.00993432797519,1.03171181244877,0.0102493635207427,0.102732991476597
"977","경북","포항시",2017,4712,2432,2280,"5",2015,4857,2496,2361,445571,459820,0.969011787221086,0.970146180770023,1.00117067053662,1.0575194525676,0.00123800686502213,-0.0307080333108627
"978","경북","포항시",2018,4691,2485,2206,"5",2016,4813,2555,2258,447106,462028,0.967703256079718,0.974651984209433,1.00718063940165,1.04919191422168,0.0075338687991568,0.0625216878630262
"979","경북","포항시",2019,4866,2559,2307,"5",2017,5027,2648,2379,459384,475293,0.966528015350531,0.967972946091108,1.00149497036571,1.05924455357609,0.00158353921763516,-0.0255913574326935
"980","경북","포항시",2020,4488,2298,2190,"5",2018,4603,2361,2242,417119,431567,0.966522000060246,0.975016293721486,1.00878851558548,1.07595194656681,0.00945602045163171,0.0909850919987771
"981","광주","광산구",2010,5399,2796,2603,"5",2008,5007,2601,2406,470657,486853,0.966733284995676,1.07829039344917,1.11539595272547,1.14711987710796,0.132372991109191,1.9111512617511
"982","광주","광산구",2011,5118,2683,2435,"5",2009,4856,2541,2315,451574,467208,0.966537388058424,1.05395387149918,1.09044294046023,1.13336906022047,0.102505230432985,1.46886662637276
"983","광주","광산구",2012,4901,2544,2357,"5",2010,4819,2510,2309,407210,420213,0.969056169133273,1.01701597841876,1.04949125841527,1.2035559048157,0.0595654963024575,0.833010967187271
"984","광주","광산구",2013,5131,2682,2449,"5",2011,5099,2660,2439,420229,433401,0.969607822778443,1.00627574034124,1.03781726663232,1.22100093044507,0.0461749177449576,0.634722008767734
"985","광주","광산구",2014,5817,3039,2778,"5",2012,5746,2994,2752,464047,479002,0.968778835996509,1.01235642185868,1.04498197549635,1.25353681846882,0.0563865624521337,0.785937012962025
"986","광주","광산구",2015,5397,2739,2658,"5",2013,5390,2713,2677,441255,454391,0.971090976713887,1.0012987012987,1.0311069974999,1.22310228779277,0.0380470398084913,0.514363620721809
"987","광주","광산구",2016,5163,2606,2557,"5",2014,5273,2652,2621,422114,434628,0.971207561408837,0.979139010051204,1.00816658452583,1.22312929682503,0.00998878878853635,0.0988743761062633
"988","광주","광산구",2017,5323,2737,2586,"5",2015,5444,2811,2633,445571,459820,0.969011787221086,0.977773695811903,1.00904210733694,1.19464686884918,0.0108021252178779,0.110918339160306
"989","광주","광산구",2018,5100,2664,2436,"5",2016,5216,2742,2474,447106,462028,0.967703256079718,0.977760736196319,1.01039314485449,1.14066910307623,0.0118551392193158,0.126511470454052
"990","광주","광산구",2019,5395,2820,2575,"5",2017,5348,2777,2571,459384,475293,0.966528015350531,1.00878833208676,1.04372384045268,1.17439876007871,0.0513492240135047,0.71134362717863
"991","광주","광산구",2020,4616,2337,2279,"5",2018,4696,2384,2312,417119,431567,0.966522000060246,0.982964224872232,1.01701174397578,1.10663863309991,0.0188258531000054,0.229734463314834
"992","광주","남구",2010,1931,1029,902,"5",2008,1742,912,830,470657,486853,0.966733284995676,1.10849598163031,1.14664095964718,0.41027754819327,0.0601634933887519,0.841866164807752
"993","광주","남구",2011,1908,1008,900,"5",2009,1700,886,814,451574,467208,0.966537388058424,1.12235294117647,1.16121006289374,0.422522111547609,0.0681148161765846,0.959610107452694
"994","광주","남구",2012,1764,923,841,"5",2010,1635,847,788,407210,420213,0.969056169133273,1.07889908256881,1.11335040933053,0.433191719260333,0.049102458696756,0.678073313087405
"995","광주","남구",2013,1941,990,951,"5",2011,1766,902,864,420229,433401,0.969607822778443,1.09909399773499,1.1335448950747,0.461891016564778,0.0616831873430877,0.864369937144977
"996","광주","남구",2014,2074,1054,1020,"5",2012,1870,978,892,464047,479002,0.968778835996509,1.10909090909091,1.14483395784557,0.446937486935591,0.0647317251424347,0.90951297426913
"997","광주","남구",2015,2076,1076,1000,"5",2013,1863,947,916,441255,454391,0.971090976713887,1.11433172302738,1.1475049709536,0.47047625522657,0.069397586361555,0.978605490122471
"998","광주","남구",2016,1985,1030,955,"5",2014,1811,917,894,422114,434628,0.971207561408837,1.09607951408062,1.1285739090526,0.470252111988704,0.0604621522786308,0.846288734000152
"999","광주","남구",2017,2240,1143,1097,"5",2015,2069,1077,992,445571,459820,0.969011787221086,1.08264862252296,1.11727084933379,0.502725715991391,0.0589550716962485,0.823971741672176
"1000","광주","남구",2018,2195,1123,1072,"5",2016,2025,1032,993,447106,462028,0.967703256079718,1.08395061728395,1.1201270745695,0.490935035539671,0.0589745896230523,0.824260764985083
"1001","광주","남구",2019,2317,1205,1112,"5",2017,2122,1116,1006,459384,475293,0.966528015350531,1.09189443920829,1.1297080083212,0.504371070825279,0.0654209670515796,0.919719333888064
"1002","광주","남구",2020,2173,1101,1072,"5",2018,1868,961,907,417119,431567,0.966522000060246,1.16327623126338,1.20356932505507,0.520954451847075,0.106050346146941,1.52136303639556
"1003","광주","동구",2010,810,460,350,"5",2008,820,467,353,470657,486853,0.966733284995676,0.98780487804878,1.02179669757952,0.17209985190914,0.00375120842554325,0.00650769397038852
"1004","광주","동구",2011,742,361,381,"5",2009,752,387,365,451574,467208,0.966537388058424,0.986702127659574,1.02086286557591,0.164314154490737,0.00342806411735897,0.00172254237937118
"1005","광주","동구",2012,619,331,288,"5",2010,572,307,265,407210,420213,0.969056169133273,1.08216783216783,1.11672353640319,0.152010019400309,0.017743147033121,0.21370164909735
"1006","광주","동구",2013,673,350,323,"5",2011,635,329,306,420229,433401,0.969607822778443,1.05984251968504,1.09306308673132,0.160150774934619,0.0149041254578285,0.17166114810794
"1007","광주","동구",2014,608,303,305,"5",2012,712,352,360,464047,479002,0.968778835996509,0.853932584269663,0.881452559181154,0.131021211213519,-0.0155322292823482,-0.279043282145142
"1008","광주","동구",2015,530,270,260,"5",2013,649,342,307,441255,454391,0.971090976713887,0.816640986132512,0.840952089675444,0.120111953405627,-0.0191035551941654,-0.331927815265955
"1009","광주","동구",2016,496,263,233,"5",2014,586,307,279,422114,434628,0.971207561408837,0.84641638225256,0.871509259076139,0.117503802290377,-0.0150981506176613,-0.272615404072265
"1010","광주","동구",2017,560,300,260,"5",2015,650,337,313,445571,459820,0.969011787221086,0.861538461538462,0.889089764335236,0.125681428997848,-0.0139393569088356,-0.25545587683007
"1011","광주","동구",2018,578,276,302,"5",2016,675,326,349,447106,462028,0.967703256079718,0.856296296296296,0.884874873486791,0.129275831681973,-0.0148828964774874,-0.269427900330936
"1012","광주","동구",2019,587,292,295,"5",2017,693,361,332,459384,475293,0.966528015350531,0.847041847041847,0.876375887288327,0.127779809484005,-0.0157966655699267,-0.282959079793999
"1013","광주","동구",2020,571,295,276,"5",2018,600,306,294,417119,431567,0.966522000060246,0.951666666666667,0.984630113548731,0.136891390706249,-0.00210400513131129,-0.0801968642028921
"1014","광주","북구",2010,4979,2630,2349,"5",2008,5264,2775,2489,470657,486853,0.966733284995676,0.945858662613982,0.978407051142562,1.05788291685877,-0.0228428117208887,-0.387299080873604
"1015","광주","북구",2011,4554,2408,2146,"5",2009,4721,2463,2258,451574,467208,0.966537388058424,0.964626138529972,0.998022580862298,1.00847258699571,-0.00199417299337316,-0.0785704594781652
"1016","광주","북구",2012,3765,1960,1805,"5",2010,4201,2166,2035,407210,420213,0.969056169133273,0.896215186860271,0.924833064797316,0.924584366788635,-0.0694981731878156,-1.07817610237335
"1017","광주","북구",2013,3856,2003,1853,"5",2011,3905,2042,1863,420229,433401,0.969607822778443,0.987451984635083,1.01840348379771,0.917594930383196,0.0168869434341719,0.201022904926465
"1018","광주","북구",2014,4308,2305,2003,"5",2012,4352,2314,2038,464047,479002,0.968778835996509,0.989889705882353,1.02179121704711,0.928354239980002,0.0202299687400063,0.250526741001777
"1019","광주","북구",2015,3986,2051,1935,"5",2013,3994,2047,1947,441255,454391,0.971090976713887,0.99799699549324,1.02770700111992,0.903332540141188,0.0250286357013489,0.321585856892922
"1020","광주","북구",2016,3883,2076,1807,"5",2014,3952,2099,1853,422114,434628,0.971207561408837,0.98254048582996,1.01166890052285,0.919893678011153,0.0107341478203137,0.109911723404222
"1021","광주","북구",2017,3957,2018,1939,"5",2015,4078,2081,1997,445571,459820,0.969011787221086,0.970328592447278,1.0013589155917,0.88807395454372,0.00120681754340818,-0.0311698877460601
"1022","광주","북구",2018,3978,2058,1920,"5",2016,3967,2064,1903,447106,462028,0.967703256079718,1.00277287622889,1.03624005595604,0.889721900399458,0.0322435714557899,0.428425310443693
"1023","광주","북구",2019,4081,2110,1971,"5",2017,4137,2152,1985,459384,475293,0.966528015350531,0.986463620981388,1.0206259987442,0.888363547707365,0.0183233854194072,0.222293874202313
"1024","광주","북구",2020,3635,1904,1731,"5",2018,3742,1960,1782,417119,431567,0.966522000060246,0.971405665419562,1.00505282379399,0.871453949592323,0.00440330325186391,0.0161639760605654
"1025","광주","서구",2010,3339,1788,1551,"5",2008,3580,1902,1678,470657,486853,0.966733284995676,0.93268156424581,0.964776509427811,0.70943383398101,-0.0249887359628218,-0.419076130756323
"1026","광주","서구",2011,3064,1571,1493,"5",2009,3213,1636,1577,451574,467208,0.966537388058424,0.953625894802365,0.986641496319149,0.678515592128865,-0.00906395303496809,-0.18326043345378
"1027","광주","서구",2012,2893,1482,1411,"5",2010,2816,1462,1354,407210,420213,0.969056169133273,1.02734375,1.06014881564488,0.710444242528425,0.0427323797698059,0.58374457963864
"1028","광주","서구",2013,2924,1520,1404,"5",2011,3135,1607,1528,420229,433401,0.969607822778443,0.932695374800638,0.961930538192203,0.695811093475224,-0.0264891538484965,-0.441294461238976
"1029","광주","서구",2014,3174,1665,1509,"5",2012,3321,1721,1600,464047,479002,0.968778835996509,0.955736224028907,0.986537059354536,0.683982441433734,-0.00920841501156172,-0.185399640116656
"1030","광주","서구",2015,2852,1455,1397,"5",2013,3043,1564,1479,441255,454391,0.971090976713887,0.937232993756162,0.965134077270186,0.646338285118582,-0.0225351807062647,-0.382743651606272
"1031","광주","서구",2016,2724,1387,1337,"5",2014,2798,1442,1356,422114,434628,0.971207561408837,0.973552537526805,1.00241449532638,0.645323301288278,0.00155813009496555,-0.0259676181332207
"1032","광주","서구",2017,2820,1472,1348,"5",2015,2782,1447,1335,445571,459820,0.969011787221086,1.0136592379583,1.04607524008068,0.632895767453447,0.0291608244314616,0.382775699868606
"1033","광주","서구",2018,2794,1445,1349,"5",2016,2807,1443,1364,447106,462028,0.967703256079718,0.995368721054507,1.02858878979788,0.624907739999016,0.017865356021901,0.215511331404252
"1034","광주","서구",2019,2803,1472,1331,"5",2017,2910,1524,1386,459384,475293,0.966528015350531,0.963230240549828,0.996588019438312,0.610164916496874,-0.00208187083451139,-0.0798690974347159
"1035","광주","서구",2020,2547,1313,1234,"5",2018,2625,1341,1284,417119,431567,0.966522000060246,0.970285714285714,1.00389408024363,0.610617114060975,0.00237779204028736,-0.013829986238073
"1036","대구","남구",2010,1102,568,534,"5",2008,1276,662,614,470657,486853,0.966733284995676,0.863636363636364,0.89335536185684,0.23414078617762,-0.0249698594164674,-0.418796605065995
"1037","대구","남구",2011,954,497,457,"5",2009,1129,584,545,451574,467208,0.966537388058424,0.844995571302037,0.87425026878625,0.211261055773804,-0.0265660209794889,-0.442432717011551
"1038","대구","남구",2012,894,476,418,"5",2010,1040,539,501,407210,420213,0.969056169133273,0.859615384615385,0.887064560338363,0.219542742074114,-0.0247941561006615,-0.416194773686388
"1039","대구","남구",2013,857,475,382,"5",2011,1002,548,454,420229,433401,0.969607822778443,0.855289421157685,0.88209830930079,0.203936425139626,-0.0240444493191148,-0.405093044497121
"1040","대구","남구",2014,938,495,443,"5",2012,1084,563,521,464047,479002,0.968778835996509,0.865313653136531,0.893200409613045,0.202134697562962,-0.0215879029027154,-0.36871627196818
"1041","대구","남구",2015,832,445,387,"5",2013,992,526,466,441255,454391,0.971090976713887,0.838709677419355,0.863677757832224,0.188553104214117,-0.0257039819341627,-0.429667560996767
"1042","대구","남구",2016,779,382,397,"5",2014,911,448,463,422114,434628,0.971207561408837,0.855104281009879,0.880454719452001,0.184547302387507,-0.022061759038291,-0.375733178605972
"1043","대구","남구",2017,731,386,345,"5",2015,906,498,408,445571,459820,0.969011787221086,0.806843267108168,0.832645461849352,0.164059151066833,-0.0274560434561773,-0.455612254334355
"1044","대구","남구",2018,732,389,343,"5",2016,907,493,414,447106,462028,0.967703256079718,0.807056229327453,0.833991437206623,0.163719565382706,-0.0271788497503392,-0.451507543624877
"1045","대구","남구",2019,737,371,366,"5",2017,898,445,453,459384,475293,0.966528015350531,0.820712694877506,0.849134926088881,0.160432230987583,-0.0242036203856676,-0.407450064760416
"1046","대구","남구",2020,720,353,367,"5",2018,781,398,383,417119,431567,0.966522000060246,0.921895006402049,0.953827234501216,0.172612611748686,-0.00797000164440464,-0.167061097415761
"1047","대구","달서구",2010,6108,3217,2891,"5",2008,5834,3064,2770,470657,486853,0.966733284995676,1.0469660610216,1.08299370392143,1.2977603647667,0.107705939474413,1.54587921955082
"1048","대구","달서구",2011,5784,3043,2741,"5",2009,5456,2872,2584,451574,467208,0.966537388058424,1.06011730205279,1.09681975591482,1.28085319349653,0.124011893557049,1.78733933549718
"1049","대구","달서구",2012,5386,2812,2574,"5",2010,5074,2654,2420,407210,420213,0.969056169133273,1.06148994875838,1.09538536832986,1.32265907025859,0.12616232259145,1.8191830927744
"1050","대구","달서구",2013,5330,2746,2584,"5",2011,5086,2617,2469,420229,433401,0.969607822778443,1.04797483287456,1.0808234094807,1.26835606300374,0.102512861447483,1.46897962715984
"1051","대구","달서구",2014,5906,2978,2928,"5",2012,5699,2910,2789,464047,479002,0.968778835996509,1.03632216178277,1.06972006744634,1.27271591024185,0.0887338391020868,1.26493855625496
"1052","대구","달서구",2015,5526,2906,2620,"5",2013,5337,2800,2537,441255,454391,0.971090976713887,1.035413153457,1.0662370244246,1.25233708399905,0.0829510820206831,1.1793069404483
"1053","대구","달서구",2016,5193,2742,2451,"5",2014,5152,2719,2433,422114,434628,0.971207561408837,1.00795807453416,1.03784001956494,1.23023638164098,0.046552168750791,0.640308377473777
"1054","대구","달서구",2017,5415,2796,2619,"5",2015,5517,2841,2676,445571,459820,0.969011787221086,0.981511691136487,1.01289964072702,1.21529453218455,0.0156768628426939,0.183103916657398
"1055","대구","달서구",2018,5249,2636,2613,"5",2016,5292,2674,2618,447106,462028,0.967703256079718,0.991874527588813,1.02497797889718,1.17399453373473,0.0293240106890352,0.385192177461692
"1056","대구","달서구",2019,5343,2677,2666,"5",2017,5289,2664,2625,459384,475293,0.966528015350531,1.01020986954056,1.04519460739499,1.16307925395747,0.0525649102518641,0.72934562439885
"1057","대구","달서구",2020,4632,2364,2268,"5",2018,4621,2341,2280,417119,431567,0.966522000060246,1.00238043713482,1.03710048718223,1.11047446891654,0.0411991438002265,0.561040275854171
"1058","대구","달성군",2010,1945,1021,924,"5",2008,2065,1082,983,470657,486853,0.966733284995676,0.941888619854721,0.974300393369547,0.41325211353491,-0.0106204167570506,-0.206308696002277
"1059","대구","달성군",2011,1797,935,862,"5",2009,1935,992,943,451574,467208,0.966537388058424,0.928682170542636,0.960834192258376,0.397941422668267,-0.0155856972526539,-0.279835040925034
"1060","대구","달성군",2012,1772,930,842,"5",2010,1947,1027,920,407210,420213,0.969056169133273,0.910118130457114,0.939179956174394,0.435156307556298,-0.0264662256965629,-0.440954938988622
"1061","대구","달성군",2013,1761,917,844,"5",2011,1883,965,918,420229,433401,0.969607822778443,0.935209771640998,0.96452374833479,0.419057228320749,-0.0148665796940323,-0.269186279852615
"1062","대구","달성군",2014,1921,986,935,"5",2012,2106,1089,1017,464047,479002,0.968778835996509,0.912155745489079,0.941552097957232,0.413966688719031,-0.0241954844712188,-0.407329587366933
"1063","대구","달성군",2015,1896,986,910,"5",2013,2048,1065,983,441255,454391,0.971090976713887,0.92578125,0.953341419289866,0.429683516334093,-0.0200484230266882,-0.345919507824312
"1064","대구","달성군",2016,1916,955,961,"5",2014,1844,931,913,422114,434628,0.971207561408837,1.03904555314534,1.06984911818241,0.453905816912019,0.0317049210491724,0.420448924089527
"1065","대구","달성군",2017,2687,1377,1310,"5",2015,2226,1151,1075,445571,459820,0.969011787221086,1.20709793351303,1.24569994857825,0.603046428066459,0.148168476366228,2.14505230687022
"1066","대구","달성군",2018,2910,1510,1400,"5",2016,2699,1389,1310,447106,462028,0.967703256079718,1.0781771026306,1.1141608709662,0.650852370578789,0.0743018734956888,1.05122863955861
"1067","대구","달성군",2019,3044,1569,1475,"5",2017,3109,1593,1516,459384,475293,0.966528015350531,0.979092955934384,1.01300007902957,0.662626473712624,0.0086141965253511,0.0785192833858
"1068","대구","달성군",2020,2880,1481,1399,"5",2018,2987,1540,1447,417119,431567,0.966522000060246,0.964178105122196,0.997574918172682,0.690450446994743,-0.00167439883167072,-0.0738352133361722
"1069","대구","동구",2010,2923,1465,1458,"5",2008,3023,1567,1456,470657,486853,0.966733284995676,0.966920277869666,1.00019342757397,0.621046749543723,0.000120127566084201,-0.0472616960875178
"1070","대구","동구",2011,2814,1469,1345,"5",2009,2923,1552,1371,451574,467208,0.966537388058424,0.962709544988026,0.99603963269534,0.623153680238455,-0.00246791746099471,-0.085585712526293
"1071","대구","동구",2012,2567,1364,1203,"5",2010,2662,1425,1237,407210,420213,0.969056169133273,0.964312546957175,0.995104904826786,0.630387269467842,-0.0030858056800277,-0.0947354599285912
"1072","대구","동구",2013,2592,1385,1207,"5",2011,2668,1422,1246,420229,433401,0.969607822778443,0.971514242878561,1.00196617648428,0.616806550714015,0.0012127505353617,-0.0310820314380057
"1073","대구","동구",2014,3072,1524,1548,"5",2012,3082,1533,1549,464047,479002,0.968778835996509,0.99675535366645,1.02887812639008,0.662001909289361,0.0191173748069319,0.234051344424558
"1074","대구","동구",2015,2929,1485,1444,"5",2013,2925,1495,1430,441255,454391,0.971090976713887,1.00136752136752,1.031177866317,0.663788512311475,0.0206955094996099,0.257420512762814
"1075","대구","동구",2016,2890,1518,1372,"5",2014,2930,1541,1389,422114,434628,0.971207561408837,0.986348122866894,1.01558941884276,0.684649170603202,0.010673282680881,0.1090104266417
"1076","대구","동구",2017,3072,1578,1494,"5",2015,3231,1705,1526,445571,459820,0.969011787221086,0.950789229340761,0.981194699465335,0.689452410502479,-0.0129653597838481,-0.241032834943712
"1077","대구","동구",2018,3015,1579,1436,"5",2016,3158,1631,1527,447106,462028,0.967703256079718,0.954718176060798,0.986581547662117,0.674336734465652,-0.00904855533111123,-0.183032422793395
"1078","대구","동구",2019,3154,1644,1510,"5",2017,3302,1738,1564,459384,475293,0.966528015350531,0.955178679588128,0.988257623594815,0.686571582815248,-0.00806198195452048,-0.168423150579458
"1079","대구","동구",2020,2723,1361,1362,"5",2018,2925,1491,1434,417119,431567,0.966522000060246,0.930940170940171,0.963185701807246,0.652811308043987,-0.024032790157933,-0.40492039453156
"1080","대구","북구",2010,5034,2655,2379,"5",2008,5508,2912,2596,470657,486853,0.966733284995676,0.913943355119826,0.945393490950209,1.06956870927236,-0.0584054134022544,-0.913913462455891
"1081","대구","북구",2011,4559,2390,2169,"5",2009,4983,2617,2366,451574,467208,0.966537388058424,0.91491069636765,0.946585934151517,1.00957982523352,-0.0539257632643233,-0.847578377969434
"1082","대구","북구",2012,4205,2215,1990,"5",2010,4498,2368,2130,407210,420213,0.969056169133273,0.934859937750111,0.964711817052105,1.03263672306672,-0.0364398736022938,-0.588645663954564
"1083","대구","북구",2013,4109,2121,1988,"5",2011,4372,2278,2094,420229,433401,0.969607822778443,0.939844464775846,0.969303715065635,0.977800199415081,-0.0300148335301247,-0.493503060650047
"1084","대구","북구",2014,4452,2303,2149,"5",2012,4823,2500,2323,464047,479002,0.968778835996509,0.923076923076923,0.952825236037928,0.959385579477941,-0.0452587882604876,-0.719236989374526
"1085","대구","북구",2015,4014,2085,1929,"5",2013,4356,2291,2065,441255,454391,0.971090976713887,0.921487603305785,0.948919952303586,0.90967807730224,-0.0464663995769803,-0.737119412385207
"1086","대구","북구",2016,3662,1862,1800,"5",2014,3956,2027,1929,422114,434628,0.971207561408837,0.925682507583418,0.953125309527676,0.86753815320032,-0.0406655824041963,-0.651220361030981
"1087","대구","북구",2017,3816,1988,1828,"5",2015,4162,2185,1977,445571,459820,0.969011787221086,0.916866890917828,0.946187552111416,0.856429166171048,-0.0460865498748431,-0.73149456193761
"1088","대구","북구",2018,3807,1943,1864,"5",2016,4106,2116,1990,447106,462028,0.967703256079718,0.927179736970287,0.958124023191163,0.851475936355137,-0.0356563865640908,-0.577043713518042
"1089","대구","북구",2019,3864,1967,1897,"5",2017,4189,2143,2046,459384,475293,0.966528015350531,0.922415851038434,0.954360180345006,0.841126377932187,-0.038388856195883,-0.617506383213342
"1090","대구","북구",2020,3458,1754,1704,"5",2018,3771,1905,1866,417119,431567,0.966522000060246,0.916998143728454,0.948760756269692,0.829020015870771,-0.0424783586505062,-0.678064123769458
"1091","대구","서구",2010,1514,794,720,"5",2008,1642,863,779,470657,486853,0.966733284995676,0.92204628501827,0.953775254590923,0.321677994803009,-0.0148694834134716,-0.269229278405716
"1092","대구","서구",2011,1332,693,639,"5",2009,1453,772,681,451574,467208,0.966537388058424,0.916724019270475,0.948462036333624,0.294968266552104,-0.0152020638042962,-0.27415416040422
"1093","대구","서구",2012,1158,609,549,"5",2010,1238,634,604,407210,420213,0.969056169133273,0.935379644588045,0.965248119130857,0.284374155840967,-0.00988253678604836,-0.195382099346248
"1094","대구","서구",2013,1136,570,566,"5",2011,1261,650,611,420229,433401,0.969607822778443,0.900872323552736,0.929109999310089,0.270328796917871,-0.0191636086000108,-0.332817091800459
"1095","대구","서구",2014,1204,600,604,"5",2012,1362,681,681,464047,479002,0.968778835996509,0.883994126284875,0.912482904702989,0.259456477468877,-0.0227068772640706,-0.385286150533062
"1096","대구","서구",2015,1080,548,532,"5",2013,1203,614,589,441255,454391,0.971090976713887,0.897755610972569,0.924481467236488,0.244756433354863,-0.0184836467313896,-0.322748151902535
"1097","대구","서구",2016,1028,498,530,"5",2014,1128,561,567,422114,434628,0.971207561408837,0.911347517730496,0.938365344281806,0.243536106359893,-0.0150102640704415,-0.271313971738145
"1098","대구","서구",2017,991,509,482,"5",2015,1148,595,553,445571,459820,0.969011787221086,0.863240418118467,0.890846148109355,0.222411243101548,-0.0242770438883206,-0.408537326957644
"1099","대구","서구",2018,1018,531,487,"5",2016,1153,586,567,447106,462028,0.967703256079718,0.882914137033825,0.912381074969837,0.227686499398353,-0.0199496463211645,-0.344456812992248
"1100","대구","서구",2019,1024,509,515,"5",2017,1149,585,564,459384,475293,0.966528015350531,0.891209747606614,0.922073373406977,0.222907197464431,-0.017370405941708,-0.306263176611272
"1101","대구","서구",2020,869,424,445,"5",2018,987,499,488,417119,431567,0.966522000060246,0.880445795339412,0.91094232235224,0.208333832791122,-0.018553727323834,-0.323785911968058
"1102","대구","수성구",2010,4270,2302,1968,"5",2008,4046,2205,1841,470657,486853,0.966733284995676,1.05536332179931,1.09167992680011,0.907242429200033,0.0831759194990112,1.18263635517074
"1103","대구","수성구",2011,3937,2079,1858,"5",2009,3870,2015,1855,451574,467208,0.966537388058424,1.01731266149871,1.05253317054013,0.871839388450177,0.0458004872770552,0.629177406855121
"1104","대구","수성구",2012,3731,1986,1745,"5",2010,3712,1970,1742,407210,420213,0.969056169133273,1.00511853448276,1.03721390616783,0.916234866530783,0.0340966783507739,0.455866293256242
"1105","대구","수성구",2013,3735,1982,1753,"5",2011,3718,1971,1747,420229,433401,0.969607822778443,1.0045723507262,1.03606048458599,0.888801106063599,0.0320505985852141,0.425567749857689
"1106","대구","수성구",2014,4119,2146,1973,"5",2012,4037,2075,1962,464047,479002,0.968778835996509,1.02031211295516,1.0531940573471,0.887625606888957,0.0472164074356058,0.650144486973327
"1107","대구","수성구",2015,3821,1990,1831,"5",2013,3859,2005,1854,441255,454391,0.971090976713887,0.990152889349572,1.01962937880464,0.865939196156417,0.0169978485031402,0.202665197715737
"1108","대구","수성구",2016,3558,1874,1684,"5",2014,3606,1893,1713,422114,434628,0.971207561408837,0.986688851913478,1.0159402491494,0.842900259171693,0.0134360401392927,0.149921601348743
"1109","대구","수성구",2017,3571,1852,1719,"5",2015,3536,1801,1735,445571,459820,0.969011787221086,1.00989819004525,1.042193916899,0.80144354098449,0.0338160421675434,0.451710606014749
"1110","대구","수성구",2018,3553,1778,1775,"5",2016,3657,1849,1808,447106,462028,0.967703256079718,0.971561389116762,1.00398689682277,0.794666141809772,0.00316825191594082,-0.00212478136266659
"1111","대구","수성구",2019,3675,1919,1756,"5",2017,3657,1868,1789,459384,475293,0.966528015350531,1.00492206726825,1.03972368240542,0.799984326837678,0.0317783233286105,0.421535872011374
"1112","대구","수성구",2020,3323,1689,1634,"5",2018,3282,1668,1614,417119,431567,0.966522000060246,1.01249238269348,1.04756268624032,0.796655151167892,0.0378910589967348,0.51205384205438
"1113","대구","중구",2010,760,405,355,"5",2008,550,281,269,470657,486853,0.966733284995676,1.38181818181818,1.42936857897094,0.161476404260427,0.0693328942346373,0.977647522965983
"1114","대구","중구",2011,717,359,358,"5",2009,506,256,250,451574,467208,0.966537388058424,1.41699604743083,1.46605404502488,0.158777963301696,0.0739991120575666,1.04674531944238
"1115","대구","중구",2012,626,330,296,"5",2010,454,240,214,407210,420213,0.969056169133273,1.37885462555066,1.42288411081879,0.153729034159279,0.0650095659174782,0.913627266840827
"1116","대구","중구",2013,701,346,355,"5",2011,504,253,251,420229,433401,0.969607822778443,1.39087301587302,1.43446967237478,0.166813808661468,0.072475540796737,1.02418413158253
"1117","대구","중구",2014,735,391,344,"5",2012,503,275,228,464047,479002,0.968778835996509,1.46123260437376,1.5083242429328,0.158389128687396,0.0805130339288068,1.14320409286491
"1118","대구","중구",2015,725,380,345,"5",2013,495,258,237,441255,454391,0.971090976713887,1.46464646464646,1.50824845433405,0.164304087205811,0.0835072983631204,1.18754344484759
"1119","대구","중구",2016,686,370,316,"5",2014,481,273,208,422114,434628,0.971207561408837,1.42619542619543,1.46847644403281,0.162515339458061,0.0761346083300975,1.07836795096429
"1120","대구","중구",2017,735,385,350,"5",2015,573,280,293,445571,459820,0.969011787221086,1.28272251308901,1.3237429410096,0.164956875559675,0.0534036240334431,0.741765377693845
"1121","대구","중구",2018,797,416,381,"5",2016,586,293,293,447106,462028,0.967703256079718,1.36006825938567,1.40546004246742,0.178257504931716,0.0722762955197508,1.02123368860697
"1122","대구","중구",2019,787,436,351,"5",2017,631,358,273,459384,475293,0.966528015350531,1.24722662440571,1.29041952700499,0.171316371488776,0.0497536195759818,0.687715765200344
"1123","대구","중구",2020,717,361,356,"5",2018,564,277,287,417119,431567,0.966522000060246,1.27127659574468,1.31531056268294,0.171893392533066,0.0541998023210803,0.753555261356744
"1124","대전","대덕구",2010,2264,1141,1123,"5",2008,2360,1168,1192,470657,486853,0.966733284995676,0.959322033898305,0.992333716845795,0.481029709533694,-0.00368770995887009,-0.103648515627224
"1125","대전","대덕구",2011,2074,1093,981,"5",2009,2157,1154,1003,451574,467208,0.966537388058424,0.961520630505331,0.994809556655465,0.459282421042841,-0.00238387938556379,-0.0843412687277503
"1126","대전","대덕구",2012,1747,916,831,"5",2010,1825,964,861,407210,420213,0.969056169133273,0.957260273972603,0.987827439175976,0.429016969131406,-0.00522223515129031,-0.126371910345903
"1127","대전","대덕구",2013,1763,927,836,"5",2011,1768,937,831,420229,433401,0.969607822778443,0.997171945701357,1.02842811523934,0.419533159301238,0.0119265369993415,0.127568735558317
"1128","대전","대덕구",2014,1929,997,932,"5",2012,2029,1043,986,464047,479002,0.968778835996509,0.950714637752587,0.981353640714766,0.415690652024472,-0.00775111724916155,-0.163819836512756
"1129","대전","대덕구",2015,1721,849,872,"5",2013,1834,894,940,441255,454391,0.971090976713887,0.938386041439477,0.966321450761408,0.390023909077518,-0.0131354394260952,-0.243551390431418
"1130","대전","대덕구",2016,1575,834,741,"5",2014,1704,905,799,422114,434628,0.971207561408837,0.924295774647887,0.951697465480088,0.373121952837385,-0.0180227360070647,-0.315922942143425
"1131","대전","대덕구",2017,1553,831,722,"5",2015,1670,894,776,445571,459820,0.969011787221086,0.929940119760479,0.959678852232896,0.348541534345817,-0.014053594709331,-0.257147521024166
"1132","대전","대덕구",2018,1510,792,718,"5",2016,1634,838,796,447106,462028,0.967703256079718,0.924112607099143,0.954954528977028,0.337727518753942,-0.015213095159691,-0.27431751376209
"1133","대전","대덕구",2019,1376,716,660,"5",2017,1560,799,761,459384,475293,0.966528015350531,0.882051282051282,0.912597739581701,0.299531546592829,-0.0261797342388024,-0.436712546286059
"1134","대전","대덕구",2020,1269,661,608,"5",2018,1351,702,649,417119,431567,0.966522000060246,0.939304219096965,0.971839460496933,0.304229728207058,-0.00856727327918233,-0.175905552481316
"1135","대전","동구",2010,2165,1116,1049,"5",2008,2347,1239,1108,470657,486853,0.966733284995676,0.922454196847039,0.954197203266012,0.459995283189244,-0.0210690704545102,-0.361033351823461
"1136","대전","동구",2011,2111,1076,1035,"5",2009,2379,1232,1147,451574,467208,0.966537388058424,0.887347625052543,0.918068598292967,0.467475984002622,-0.0383009626337091,-0.616204847001116
"1137","대전","동구",2012,2070,1077,993,"5",2010,2136,1098,1038,407210,420213,0.969056169133273,0.969101123595506,1.00004638994484,0.508337221581002,2.35817356691304e-05,-0.0486913559092012
"1138","대전","동구",2013,2170,1115,1055,"5",2011,2310,1210,1100,420229,433401,0.969607822778443,0.939393939393939,0.968839068049261,0.516385113830792,-0.0160910413924562,-0.287318224918506
"1139","대전","동구",2014,2378,1224,1154,"5",2012,2539,1303,1236,464047,479002,0.968778835996509,0.936589208349744,0.966772986309456,0.51244809254235,-0.0170271197865979,-0.301179762638953
"1140","대전","동구",2015,2140,1105,1035,"5",2013,2425,1226,1199,441255,454391,0.971090976713887,0.882474226804124,0.908745161849163,0.484980340166117,-0.0442568024481967,-0.70439948834967
"1141","대전","동구",2016,1971,1035,936,"5",2014,2220,1176,1044,422114,434628,0.971207561408837,0.887837837837838,0.914158695953661,0.466935472407928,-0.0400823498569897,-0.64258379810688
"1142","대전","동구",2017,1953,999,954,"5",2015,2181,1109,1072,445571,459820,0.969011787221086,0.895460797799175,0.924096909457789,0.438313983629994,-0.0332693859853846,-0.541696782355506
"1143","대전","동구",2018,1931,960,971,"5",2016,2149,1076,1073,447106,462028,0.967703256079718,0.898557468590042,0.928546497022451,0.431888634909842,-0.0308599558605001,-0.506017712343971
"1144","대전","동구",2019,1869,929,940,"5",2017,1999,1005,994,459384,475293,0.966528015350531,0.934967483741871,0.96734649062685,0.406849171934591,-0.0132850532492243,-0.245766886126846
"1145","대전","동구",2020,1637,803,834,"5",2018,1832,919,913,417119,431567,0.966522000060246,0.893558951965066,0.924509687218054,0.39245395198972,-0.0296264715882148,-0.487752160147846
"1146","대전","서구",2010,5198,2641,2557,"5",2008,5251,2711,2540,470657,486853,0.966733284995676,0.989906684441059,1.02397083022282,1.10441361756013,0.0264737113223067,0.342984673866121
"1147","대전","서구",2011,5017,2593,2424,"5",2009,4999,2578,2421,451574,467208,0.966537388058424,1.00360072014403,1.0383465063468,1.11100284781675,0.0426030777551215,0.581829863130819
"1148","대전","서구",2012,4427,2265,2162,"5",2010,4486,2319,2167,407210,420213,0.969056169133273,0.986847971466786,1.0183599288671,1.08715404827976,0.0199600709939977,0.246530069558044
"1149","대전","서구",2013,4487,2332,2155,"5",2011,4587,2400,2187,420229,433401,0.969607822778443,0.978199258774798,1.00886073296288,1.06775115472754,0.00946105785284328,0.0910596863141081
"1150","대전","서구",2014,4873,2428,2445,"5",2012,4916,2485,2431,464047,479002,0.968778835996509,0.991253051261188,1.0231984994197,1.05010914842678,0.0243609564703959,0.311698799459553
"1151","대전","서구",2015,4476,2316,2160,"5",2013,4597,2380,2217,441255,454391,0.971090976713887,0.97367848596911,1.0026645384596,1.0143794404596,0.00270285303173034,-0.00901645221941403
"1152","대전","서구",2016,4253,2210,2043,"5",2014,4401,2261,2140,422114,434628,0.971207561408837,0.966371279254715,0.9950203413294,1.00754772407454,-0.00501724376023143,-0.123336378367692
"1153","대전","서구",2017,4454,2299,2155,"5",2015,4603,2353,2250,445571,459820,0.969011787221086,0.967629806647838,0.998573824806392,0.99961622277931,-0.00142562786005553,-0.0701513891731778
"1154","대전","서구",2018,4459,2294,2165,"5",2016,4636,2408,2228,447106,462028,0.967703256079718,0.961820534943917,0.993920945187647,0.997302653062137,-0.00606265749246963,-0.13881696415365
"1155","대전","서구",2019,4556,2339,2217,"5",2017,4792,2452,2340,459384,475293,0.966528015350531,0.950751252086811,0.983676869151074,0.991762882468697,-0.0161886753016449,-0.288763997113959
"1156","대전","서구",2020,4192,2171,2021,"5",2018,4325,2224,2101,417119,431567,0.966522000060246,0.969248554913295,1.0028209961624,1.00498898395901,0.00283507006700684,-0.00705856980994849
"1157","대전","유성구",2010,3738,1989,1749,"5",2008,3700,1940,1760,470657,486853,0.966733284995676,1.01027027027027,1.04503515700795,0.794208946217734,0.035767324590036,0.480605381358247
"1158","대전","유성구",2011,3743,1921,1822,"5",2009,3627,1852,1775,451574,467208,0.966537388058424,1.031982354563,1.06771074488494,0.828878544823218,0.0561239836891217,0.78204872171328
"1159","대전","유성구",2012,3627,1932,1695,"5",2010,3499,1868,1631,407210,420213,0.969056169133273,1.0365818805373,1.06968193749225,0.890695218683235,0.0620653685529307,0.870029312780007
"1160","대전","유성구",2013,3957,2087,1870,"5",2011,3852,2011,1841,420229,433401,0.969607822778443,1.02725856697819,1.05945779607527,0.941629444897901,0.0559872115132118,0.780023386348906
"1161","대전","유성구",2014,4268,2193,2075,"5",2012,4173,2113,2060,464047,479002,0.968778835996509,1.02276539659717,1.0557264037928,0.919734423452797,0.0512534918634711,0.709926016413277
"1162","대전","유성구",2015,4122,2124,1998,"5",2013,4003,2117,1886,441255,454391,0.971090976713887,1.02972770422183,1.06038232144466,0.934153720637727,0.0564063702382718,0.786230328539471
"1163","대전","유성구",2016,3830,1930,1900,"5",2014,3883,1962,1921,422114,434628,0.971207561408837,0.986350759721865,1.01559213386998,0.907337828169641,0.0141473328821218,0.160454491806113
"1164","대전","유성구",2017,4067,2108,1959,"5",2015,4114,2112,2002,445571,459820,0.969011787221086,0.988575595527467,1.02018944306393,0.912761378096869,0.0184281438740443,0.223845147343083
"1165","대전","유성구",2018,4099,2141,1958,"5",2016,4223,2218,2005,447106,462028,0.967703256079718,0.970636987923277,1.00303164407594,0.916784834021462,0.00277936531097029,-0.00788345112527567
"1166","대전","유성구",2019,4129,2141,1988,"5",2017,4316,2258,2058,459384,475293,0.966528015350531,0.956672845227062,0.989803533920437,0.89881232258851,-0.00916470935916691,-0.184752442667106
"1167","대전","유성구",2020,3737,1874,1863,"5",2018,3937,2005,1932,417119,431567,0.966522000060246,0.949199898399797,0.982077902355695,0.895907402923386,-0.0160565399554487,-0.286807324364149
"1168","대전","중구",2010,2627,1357,1270,"5",2008,2556,1308,1248,470657,486853,0.966733284995676,1.02777777777778,1.06314512361326,0.558155939463346,0.0352448257928862,0.472868169570316
"1169","대전","중구",2011,2421,1246,1175,"5",2009,2426,1253,1173,451574,467208,0.966537388058424,0.997938994229184,1.0324887651101,0.53612475474673,0.0174180312266767,0.208887303372949
"1170","대전","중구",2012,2314,1204,1110,"5",2010,2243,1156,1087,407210,420213,0.969056169133273,1.03165403477486,1.06459673611858,0.568257164607942,0.0367075581096707,0.49452844857143
"1171","대전","중구",2013,2339,1191,1148,"5",2011,2314,1172,1142,420229,433401,0.969607822778443,1.01080380293863,1.04248726051131,0.55660128168213,0.0236484636557574,0.301148138224908
"1172","대전","중구",2014,2546,1329,1217,"5",2012,2549,1321,1228,464047,479002,0.968778835996509,0.998823067869753,1.03101247752005,0.548651321956612,0.017015036788526,0.202919723477379
"1173","대전","중구",2015,2374,1255,1119,"5",2013,2497,1312,1185,441255,454391,0.971090976713887,0.95074088906688,0.979044097684987,0.538010900726337,-0.0112745038800334,-0.215994480210551
"1174","대전","중구",2016,2067,1053,1014,"5",2014,2196,1123,1073,422114,434628,0.971207561408837,0.941256830601093,0.969161349233837,0.489678143818968,-0.0151010132650563,-0.272657794426634
"1175","대전","중구",2017,2166,1086,1080,"5",2015,2195,1104,1091,445571,459820,0.969011787221086,0.986788154897494,1.01834484152911,0.486117812873818,0.00891775424164638,0.0830143948648102
"1176","대전","중구",2018,2057,1067,990,"5",2016,2187,1126,1061,447106,462028,0.967703256079718,0.94055784179241,0.971948617391991,0.460069871574079,-0.0129055959939421,-0.24014784706953
"1177","대전","중구",2019,2024,1038,986,"5",2017,2145,1097,1048,459384,475293,0.966528015350531,0.943589743589744,0.976267349319959,0.440590007488289,-0.0104563687408363,-0.203879457405434
"1178","대전","중구",2020,1788,920,868,"5",2018,1856,945,911,417119,431567,0.966522000060246,0.963362068965517,0.996730616484124,0.428654652509236,-0.00140143645491717,-0.0697931605494486
"1179","부산","강서구",2010,437,235,202,"5",2008,307,162,145,470657,486853,0.966733284995676,1.42345276872964,1.47243587328847,0.0928489324497458,0.0438651664857979,0.600518992862162
"1180","부산","강서구",2011,430,232,198,"5",2009,416,227,189,451574,467208,0.966537388058424,1.03365384615385,1.06944010539545,0.0952224884515052,0.0066122596340898,0.0488744118602518
"1181","부산","강서구",2012,467,243,224,"5",2010,452,237,215,407210,420213,0.969056169133273,1.03318584070796,1.06617745556695,0.11468284177697,0.0075894186659865,0.0633442755642749
"1182","부산","강서구",2013,474,233,241,"5",2011,468,241,227,420229,433401,0.969607822778443,1.01282051282051,1.04456718379008,0.112795642375943,0.00502698412448918,0.0253995016271426
"1183","부산","강서구",2014,692,356,336,"5",2012,603,301,302,464047,479002,0.968778835996509,1.14759535655058,1.18457930118811,0.14912282592065,0.0275249869996305,0.358552063891369
"1184","부산","강서구",2015,898,438,460,"5",2013,697,342,355,441255,454391,0.971090976713887,1.2883787661406,1.32673333089799,0.203510441808025,0.0664936445244584,0.935603643733519
"1185","부산","강서구",2016,1191,623,568,"5",2014,914,468,446,422114,434628,0.971207561408837,1.30306345733042,1.34169410238136,0.282151267193223,0.0964094239793505,1.37859934574497
"1186","부산","강서구",2017,1561,789,772,"5",2015,1305,667,638,445571,459820,0.969011787221086,1.19616858237548,1.23442108563594,0.3503369833315,0.0821263759709916,1.16709461497682
"1187","부산","강서구",2018,1750,887,863,"5",2016,1615,819,796,447106,462028,0.967703256079718,1.08359133126935,1.11975579751494,0.391406064781059,0.0468731454400403,0.645061430757839
"1188","부산","강서구",2019,1958,1033,925,"5",2017,1871,981,890,459384,475293,0.966528015350531,1.04649919828968,1.08274067763069,0.426222942026714,0.0352659750450387,0.473181349703845
"1189","부산","강서구",2020,1956,1014,942,"5",2018,1914,994,920,417119,431567,0.966522000060246,1.02194357366771,1.0573412437627,0.468930928583929,0.0268890826838,0.349135532417462
"1190","부산","금정구",2010,1820,948,872,"5",2008,1865,1004,861,470657,486853,0.966733284995676,0.975871313672922,1.00945248169177,0.386693494413129,0.00365521317626651,0.00508618720646699
"1191","부산","금정구",2011,1724,870,854,"5",2009,1650,825,825,451574,467208,0.966537388058424,1.04484848484848,1.08102231507813,0.381775744396267,0.0309323546516615,0.409008687537046
"1192","부산","금정구",2012,1583,825,758,"5",2010,1505,789,716,407210,420213,0.969056169133273,1.05182724252492,1.08541411326618,0.388742909064119,0.0332041308662287,0.4426493653774
"1193","부산","금정구",2013,1625,866,759,"5",2011,1530,834,696,420229,433401,0.969607822778443,1.06209150326797,1.09538256428719,0.386693921647483,0.0368838578410081,0.497139111728845
"1194","부산","금정구",2014,1782,923,859,"5",2012,1777,908,869,464047,479002,0.968778835996509,1.00281373100732,1.03513174911155,0.384012826286993,0.0134910422687309,0.150736078102703
"1195","부산","금정구",2015,1612,854,758,"5",2013,1622,864,758,441255,454391,0.971090976713887,0.99383477188656,1.02342086963843,0.365321639414851,0.00855615049283305,0.0776597322260823
"1196","부산","금정구",2016,1534,806,728,"5",2014,1560,812,748,422114,434628,0.971207561408837,0.983333333333333,1.01248525279901,0.363408936922253,0.00453725244689269,0.018147508456073
"1197","부산","금정구",2017,1656,874,782,"5",2015,1637,879,758,445571,459820,0.969011787221086,1.01160659743433,1.04395695777385,0.371657940036492,0.0163369523765019,0.192878585134968
"1198","부산","금정구",2018,1709,859,850,"5",2016,1681,862,819,447106,462028,0.967703256079718,1.01665675193337,1.05058730095832,0.38223597983476,0.0193362865490009,0.237293010281957
"1199","부산","금정구",2019,1702,890,812,"5",2017,1696,877,819,459384,475293,0.966528015350531,1.00353773584906,1.03829140998578,0.370496142660606,0.0141868196967658,0.161039216305763
"1200","부산","금정구",2020,1527,765,762,"5",2018,1534,779,755,417119,431567,0.966522000060246,0.995436766623207,1.02991630460679,0.366082580750337,0.0109518379969652,0.113135300204958
"1201","부산","기장군",2010,927,497,430,"5",2008,747,400,347,470657,486853,0.966733284995676,1.24096385542169,1.28366724791858,0.196958719407127,0.0558707378877871,0.778298633847015
"1202","부산","기장군",2011,970,501,469,"5",2009,807,412,395,451574,467208,0.966537388058424,1.20198265179678,1.24359664369665,0.214804218134791,0.0523255865895172,0.725801696888315
"1203","부산","기장군",2012,1036,556,480,"5",2010,953,532,421,407210,420213,0.969056169133273,1.08709338929696,1.12180637606307,0.254414184327497,0.030989269811974,0.409851492633792
"1204","부산","기장군",2013,1207,628,579,"5",2011,1052,532,520,420229,433401,0.969607822778443,1.14733840304182,1.1833015123105,0.287224346725238,0.0526486571271321,0.730585756077738
"1205","부산","기장군",2014,1702,888,814,"5",2012,1319,677,642,464047,479002,0.968778835996509,1.29037149355572,1.3319567331675,0.366773193232582,0.1217528310389,1.75388692328028
"1206","부산","기장군",2015,1720,880,840,"5",2013,1576,806,770,441255,454391,0.971090976713887,1.09137055837563,1.1238602608262,0.389797282750337,0.0482803931107991,0.66590008785356
"1207","부산","기장군",2016,1799,919,880,"5",2014,1739,891,848,422114,434628,0.971207561408837,1.03450258769408,1.06517147188746,0.426188186129813,0.0277753113911247,0.362258891243394
"1208","부산","기장군",2017,1987,990,997,"5",2015,2045,1026,1019,445571,459820,0.969011787221086,0.971638141809291,1.00271034328255,0.445944641819149,0.00120866306434277,-0.0311425590968692
"1209","부산","기장군",2018,2106,1074,1032,"5",2016,2209,1128,1081,447106,462028,0.967703256079718,0.953372566772295,0.985191029153422,0.471029241387948,-0.0069754583035997,-0.152333805215168
"1210","부산","기장군",2019,2166,1100,1066,"5",2017,2279,1192,1087,459384,475293,0.966528015350531,0.950416849495393,0.983330885810594,0.471500966511676,-0.00785950345119863,-0.1654248296814
"1211","부산","기장군",2020,2038,1061,977,"5",2018,2130,1102,1028,417119,431567,0.966522000060246,0.956807511737089,0.989949025141124,0.488589587144196,-0.00491080165669512,-0.121760173594196
"1212","부산","남구",2010,2289,1215,1074,"5",2008,2493,1302,1191,470657,486853,0.966733284995676,0.918170878459687,0.949766489589519,0.486341433358051,-0.0244306374556401,-0.410811755082833
"1213","부산","남구",2011,2110,1104,1006,"5",2009,2343,1225,1118,451574,467208,0.966537388058424,0.900554844216816,0.931733066245732,0.46725453635506,-0.0318980344797321,-0.521389679080226
"1214","부산","남구",2012,1950,1045,905,"5",2010,2174,1156,1018,407210,420213,0.969056169133273,0.896964121435143,0.925605914296372,0.478868397141524,-0.0356249765777056,-0.576578591457964
"1215","부산","남구",2013,1895,968,927,"5",2011,2127,1080,1047,420229,433401,0.969607822778443,0.890926187118007,0.918852103075064,0.450944604013526,-0.0365932062453456,-0.590916228288428
"1216","부산","남구",2014,2222,1183,1039,"5",2012,2293,1214,1079,464047,479002,0.968778835996509,0.969036197121675,1.0002656551894,0.47883080808625,0.000127203889013678,-0.0471569092258373
"1217","부산","남구",2015,2073,1041,1032,"5",2013,2197,1108,1089,441255,454391,0.971090976713887,0.943559399180701,0.971648817470891,0.469796376245028,-0.0133192828144368,-0.246273760777856
"1218","부산","남구",2016,1932,971,961,"5",2014,2070,1025,1045,422114,434628,0.971207561408837,0.933333333333333,0.961002951809227,0.457696262147192,-0.0178488031916908,-0.313347328502284
"1219","부산","남구",2017,2120,1069,1051,"5",2015,2310,1168,1142,445571,459820,0.969011787221086,0.917748917748918,0.94709778544678,0.475793981206138,-0.0251705552768976,-0.421768528418891
"1220","부산","남구",2018,2139,1093,1046,"5",2016,2218,1103,1115,447106,462028,0.967703256079718,0.964382326420198,0.996568235521938,0.478410041466677,-0.00164179058625374,-0.0733523473426039
"1221","부산","남구",2019,2214,1116,1098,"5",2017,2117,1080,1037,459384,475293,0.966528015350531,1.04581955597544,1.08203749851591,0.481949741392822,0.0395379511942574,0.536441178051383
"1222","부산","남구",2020,2013,1034,979,"5",2018,2148,1105,1043,417119,431567,0.966522000060246,0.937150837988827,0.969611491440869,0.4825960936807,-0.014665375523419,-0.266206829394275
"1223","부산","동구",2010,591,314,277,"5",2008,591,321,270,470657,486853,0.966733284995676,1,1.03441147162371,0.12556915120778,0.00432101928359973,0.0149455072474615
"1224","부산","동구",2011,517,281,236,"5",2009,589,320,269,451574,467208,0.966537388058424,0.877758913412564,0.908147914666604,0.114488433789368,-0.0105160013901079,-0.204762503336653
"1225","부산","동구",2012,448,225,223,"5",2010,493,242,251,407210,420213,0.969056169133273,0.908722109533469,0.937739357612503,0.110016944574053,-0.00684972564269016,-0.150471944036876
"1226","부산","동구",2013,454,216,238,"5",2011,499,244,255,420229,433401,0.969607822778443,0.909819639278557,0.938337766986491,0.108036332571051,-0.00666176151292111,-0.147688553360208
"1227","부산","동구",2014,507,256,251,"5",2012,584,293,291,464047,479002,0.968778835996509,0.868150684931507,0.896128871393548,0.109256174482326,-0.0113485621507027,-0.217091142112821
"1228","부산","동구",2015,428,219,209,"5",2013,504,268,236,441255,454391,0.971090976713887,0.849206349206349,0.874486911700088,0.0969960680332234,-0.0121742760517983,-0.229318391943567
"1229","부산","동구",2016,388,192,196,"5",2014,484,242,242,422114,434628,0.971207561408837,0.801652892561983,0.825418710084076,0.0919182969529558,-0.016047214848922,-0.286669237301488
"1230","부산","동구",2017,403,203,200,"5",2015,456,224,232,445571,459820,0.969011787221086,0.883771929824561,0.912034240944608,0.0904457426538083,-0.0079561284058709,-0.166855661182595
"1231","부산","동구",2018,435,223,212,"5",2016,497,260,237,447106,462028,0.967703256079718,0.875251509054326,0.904462709570778,0.0972923646741489,-0.00929504890041997,-0.186682522966846
"1232","부산","동구",2019,404,206,198,"5",2017,497,254,243,459384,475293,0.966528015350531,0.812877263581489,0.84102814473172,0.0879438552496386,-0.0139805978284801,-0.256066576283082
"1233","부산","동구",2020,422,224,198,"5",2018,412,218,194,417119,431567,0.966522000060246,1.02427184466019,1.05975016046851,0.101170169663813,0.00604493387203959,0.0404733981207446
"1234","부산","동래구",2010,2088,1101,987,"5",2008,2156,1135,1021,470657,486853,0.966733284995676,0.968460111317254,1.00178624895654,0.443635173810227,0.000792442866303799,-0.0373059873003575
"1235","부산","동래구",2011,2018,1032,986,"5",2009,2052,1067,985,451574,467208,0.966537388058424,0.983430799220273,1.01747828006507,0.446881352779389,0.00781071743973676,0.0666212888134062
"1236","부산","동래구",2012,1738,904,834,"5",2010,1793,939,854,407210,420213,0.969056169133273,0.969325153374233,1.00027757342611,0.426806807298446,0.000118470227789284,-0.0472862381103166
"1237","부산","동래구",2013,1857,950,907,"5",2011,1963,991,972,420229,433401,0.969607822778443,0.946001018848701,0.975653245183093,0.441901915384231,-0.0107588775869816,-0.208359037115697
"1238","부산","동래구",2014,2140,1139,1001,"5",2012,2097,1108,989,464047,479002,0.968778835996509,1.0205054840248,1.05339366025175,0.461160184205479,0.0246230301971039,0.315579612082766
"1239","부산","동래구",2015,2021,1054,967,"5",2013,2024,1066,958,441255,454391,0.971090976713887,0.998517786561265,1.0282432959476,0.458011807231646,0.01293576301914,0.142513450263244
"1240","부산","동래구",2016,1856,970,886,"5",2014,1877,961,916,422114,434628,0.971207561408837,0.988811933937134,1.01812627210476,0.439691647280119,0.00796997044078946,0.0689795223705542
"1241","부산","동래구",2017,2214,1167,1047,"5",2015,2141,1097,1044,445571,459820,0.969011787221086,1.03409621672116,1.06716577688567,0.496890506787919,0.0333740369155229,0.44516535028418
"1242","부산","동래구",2018,2004,1032,972,"5",2016,2037,1045,992,447106,462028,0.967703256079718,0.98379970544919,1.01663366250795,0.448215859326424,0.00745547133474541,0.0613607707679122
"1243","부산","동래구",2019,2225,1167,1058,"5",2017,2300,1212,1088,459384,475293,0.966528015350531,0.967391304347826,1.00089318569517,0.484344252303084,0.000432609357696401,-0.0426344360540707
"1244","부산","동래구",2020,2036,1080,956,"5",2018,1930,1002,928,417119,431567,0.966522000060246,1.05492227979275,1.09146225303406,0.488110107667117,0.0446436501759344,0.612046853245559
"1245","부산","부산진구",2010,3108,1602,1506,"5",2008,3096,1594,1502,470657,486853,0.966733284995676,1.00387596899225,1.03842081841295,0.660353505843959,0.0253713221363845,0.326660390153446
"1246","부산","부산진구",2011,2917,1540,1377,"5",2009,2901,1514,1387,451574,467208,0.966537388058424,1.00551533953809,1.04032741201865,0.645962787937304,0.0260500074978667,0.33671042741248
"1247","부산","부산진구",2012,2661,1350,1311,"5",2010,2602,1317,1285,407210,420213,0.969056169133273,1.02267486548809,1.05533084465348,0.653471181945434,0.0361571124537513,0.486377397045903
"1248","부산","부산진구",2013,2738,1404,1334,"5",2011,2719,1384,1335,420229,433401,0.969607822778443,1.00698786318499,1.03855171083443,0.651549512289728,0.0251183483921046,0.322914330933872
"1249","부산","부산진구",2014,2900,1454,1446,"5",2012,2963,1490,1473,464047,479002,0.968778835996509,0.978737765777928,1.01027987958797,0.624936698222378,0.00642427400782997,0.0460907028615074
"1250","부산","부산진구",2015,2724,1421,1303,"5",2013,2747,1427,1320,441255,454391,0.971090976713887,0.991627229705133,1.02114760973348,0.617330115239487,0.0130550563538066,0.144279957287257
"1251","부산","부산진구",2016,2550,1288,1262,"5",2014,2569,1306,1263,422114,434628,0.971207561408837,0.992604126119113,1.02203088769123,0.604102209355766,0.0133089079283433,0.148039015500604
"1252","부산","부산진구",2017,2673,1395,1278,"5",2015,2776,1439,1337,445571,459820,0.969011787221086,0.962896253602305,0.993688896565109,0.599904392341512,-0.00378605867111281,-0.105104872694155
"1253","부산","부산진구",2018,2659,1292,1367,"5",2016,2733,1326,1407,447106,462028,0.967703256079718,0.972923527259422,1.00539449583011,0.594713557858763,0.00320817980797778,-0.00153352534711065
"1254","부산","부산진구",2019,2739,1386,1353,"5",2017,2754,1396,1358,459384,475293,0.966528015350531,0.994553376906318,1.02899591228675,0.596233216655347,0.017288326052583,0.206966616842323
"1255","부산","부산진구",2020,2372,1180,1192,"5",2018,2341,1179,1162,417119,431567,0.966522000060246,1.01324220418625,1.04833847974809,0.568662659816503,0.0274882884650374,0.358008628507398
"1256","부산","북구",2010,2638,1369,1269,"5",2008,2814,1492,1322,470657,486853,0.966733284995676,0.937455579246624,0.969714805310357,0.560493097946063,-0.0169746425934978,-0.300402675381974
"1257","부산","북구",2011,2472,1262,1210,"5",2009,2628,1351,1277,451574,467208,0.966537388058424,0.940639269406393,0.97320525933916,0.547418584772374,-0.0146679390118997,-0.266244789775045
"1258","부산","북구",2012,2240,1200,1040,"5",2010,2336,1239,1097,407210,420213,0.969056169133273,0.958904109589041,0.989523765631344,0.550084722870263,-0.0057628164794058,-0.134376889968911
"1259","부산","북구",2013,2273,1219,1054,"5",2011,2224,1188,1036,420229,433401,0.969607822778443,1.02203237410072,1.05406778915217,0.540895559325987,0.0292450270549808,0.38402258031086
"1260","부산","북구",2014,2304,1184,1120,"5",2012,2441,1241,1200,464047,479002,0.968778835996509,0.94387546087669,0.974294055366927,0.496501431967021,-0.0127630383203859,-0.238036839506803
"1261","부산","북구",2015,2252,1165,1087,"5",2013,2364,1224,1140,441255,454391,0.971090976713887,0.952622673434856,0.980981902085501,0.510362488810325,-0.00970612378408219,-0.192769758866609
"1262","부산","북구",2016,2203,1096,1107,"5",2014,2194,1102,1092,422114,434628,0.971207561408837,1.00410209662716,1.03386972726058,0.521896928317943,0.0176765066202619,0.212714831537694
"1263","부산","북구",2017,2235,1186,1049,"5",2015,2329,1214,1115,445571,459820,0.969011787221086,0.959639330184629,0.990327819372212,0.501603560375339,-0.00485160023949182,-0.120883513388381
"1264","부산","북구",2018,2224,1141,1083,"5",2016,2425,1244,1181,447106,462028,0.967703256079718,0.917113402061856,0.947721728019385,0.497421193184614,-0.0260043204262274,-0.434115001897776
"1265","부산","북구",2019,2275,1195,1080,"5",2017,2475,1303,1172,459384,475293,0.966528015350531,0.919191919191919,0.951024600004538,0.495228392804277,-0.024254008626699,-0.408196218616862
"1266","부산","북구",2020,2038,1029,1009,"5",2018,2211,1132,1079,417119,431567,0.966522000060246,0.92175486205337,0.953682235889006,0.488589587144196,-0.0226303772444326,-0.384153330980273
"1267","부산","사상구",2010,1826,956,870,"5",2008,2078,1085,993,470657,486853,0.966733284995676,0.878729547641963,0.90896792453556,0.387968308130974,-0.0353175603035902,-0.572026342088468
"1268","부산","사상구",2011,1732,886,846,"5",2009,1964,1005,959,451574,467208,0.966537388058424,0.881873727087576,0.912405187821115,0.38354732557676,-0.0335967559456098,-0.546544507803077
"1269","부산","사상구",2012,1510,748,762,"5",2010,1680,850,830,407210,420213,0.969056169133273,0.898809523809524,0.927510243924686,0.370816040863437,-0.0268803643510041,-0.447087543496918
"1270","부산","사상구",2013,1526,784,742,"5",2011,1726,898,828,420229,433401,0.969607822778443,0.884125144843569,0.911837883392978,0.363135338113267,-0.0320147800228723,-0.52311845816546
"1271","부산","사상구",2014,1660,877,783,"5",2012,1898,1000,898,464047,479002,0.968778835996509,0.874604847207587,0.902791034145525,0.357722385879017,-0.0347738231942946,-0.563974631358174
"1272","부산","사상구",2015,1562,791,771,"5",2013,1799,904,895,441255,454391,0.971090976713887,0.868260144524736,0.894107931537862,0.353990323055829,-0.0374847675239622,-0.604118552336261
"1273","부산","사상구",2016,1394,726,668,"5",2014,1591,821,770,422114,434628,0.971207561408837,0.876178504085481,0.902153709362078,0.330242541114486,-0.0323130076588938,-0.527534641309802
"1274","부산","사상구",2017,1462,746,716,"5",2015,1710,883,827,445571,459820,0.969011787221086,0.854970760233918,0.88231203325791,0.328118302133667,-0.038615575828978,-0.620863669062241
"1275","부산","사상구",2018,1434,748,686,"5",2016,1721,886,835,447106,462028,0.967703256079718,0.833236490412551,0.861045454975621,0.320729312512022,-0.0445667956960898,-0.708989897791493
"1276","부산","사상구",2019,1489,750,739,"5",2017,1800,903,897,459384,475293,0.966528015350531,0.827222222222222,0.855869885905183,0.324129704125525,-0.0467168512371311,-0.740828124343582
"1277","부산","사상구",2020,1280,628,652,"5",2018,1524,748,776,417119,431567,0.966522000060246,0.83989501312336,0.86898695846655,0.306866865330997,-0.0402035613728494,-0.64437870974009
"1278","부산","사하구",2010,2915,1522,1393,"5",2008,3169,1654,1515,470657,486853,0.966733284995676,0.919848532660145,0.95150187433989,0.619346997919929,-0.0300371685323325,-0.493833799482957
"1279","부산","사하구",2011,2765,1411,1354,"5",2009,2993,1521,1472,451574,467208,0.966537388058424,0.923822251921149,0.955806017785737,0.612302745507934,-0.0270600966447222,-0.449749036363912
"1280","부산","사하구",2012,2478,1230,1248,"5",2010,2608,1299,1309,407210,420213,0.969056169133273,0.950153374233129,0.980493602432715,0.608531224675229,-0.0118702520006221,-0.224816374933372
"1281","부산","사하구",2013,2520,1280,1240,"5",2011,2622,1329,1293,420229,433401,0.969607822778443,0.961098398169336,0.991223849056083,0.599673035416404,-0.00526282107581147,-0.12697291056895
"1282","부산","사하구",2014,2714,1420,1294,"5",2012,2927,1532,1395,464047,479002,0.968778835996509,0.927229244960711,0.957111376206872,0.584854551370874,-0.0250836068274441,-0.420480987525545
"1283","부산","사하구",2015,2545,1285,1260,"5",2013,2763,1395,1368,441255,454391,0.971090976713887,0.92110025334781,0.948521071079002,0.576764002674191,-0.0296911930978551,-0.488710562406479
"1284","부산","사하구",2016,2413,1253,1160,"5",2014,2624,1361,1263,422114,434628,0.971207561408837,0.919588414634146,0.946850550978195,0.571646522029594,-0.0303826976811041,-0.498950427918338
"1285","부산","사하구",2017,2498,1250,1248,"5",2015,2709,1368,1341,445571,459820,0.969011787221086,0.922111480251015,0.951599859167275,0.560628945779685,-0.027134519930639,-0.450851103446618
"1286","부산","사하구",2018,2577,1310,1267,"5",2016,2770,1400,1370,447106,462028,0.967703256079718,0.930324909747292,0.961374164964733,0.576373387966165,-0.0222629034022989,-0.378711743442421
"1287","부산","사하구",2019,2572,1290,1282,"5",2017,2832,1455,1377,459384,475293,0.966528015350531,0.90819209039548,0.939643834396363,0.559880187381363,-0.0337922213077846,-0.549438977441286
"1288","부산","사하구",2020,2145,1094,1051,"5",2018,2376,1188,1188,417119,431567,0.966522000060246,0.902777777777778,0.934047831007991,0.514241739167959,-0.0339153580843498,-0.551262398517785
"1289","부산","서구",2010,761,415,346,"5",2008,885,471,414,470657,486853,0.966733284995676,0.859887005649718,0.889476982944229,0.161688873213402,-0.0178703420918932,-0.313666278581125
"1290","부산","서구",2011,711,342,369,"5",2009,780,389,391,451574,467208,0.966537388058424,0.911538461538462,0.943096948758036,0.157449277416326,-0.00895934430083134,-0.181711377388391
"1291","부산","서구",2012,589,303,286,"5",2010,659,335,324,407210,420213,0.969056169133273,0.893778452200303,0.92231852050403,0.14464281329044,-0.0112360677348607,-0.21542531412417
"1292","부산","서구",2013,626,316,310,"5",2011,678,339,339,420229,433401,0.969607822778443,0.92330383480826,0.952244622122068,0.148966396893123,-0.00711394657474505,-0.154384552680695
"1293","부산","서구",2014,688,354,334,"5",2012,734,381,353,464047,479002,0.968778835996509,0.93732970027248,0.967537342316443,0.14826084426793,-0.004812941035345,-0.120311044223536
"1294","부산","서구",2015,599,283,316,"5",2013,614,302,312,441255,454391,0.971090976713887,0.97557003257329,1.00461239571452,0.135749169981077,0.000626128889870138,-0.0397687804512308
"1295","부산","서구",2016,572,304,268,"5",2014,613,354,259,422114,434628,0.971207561408837,0.933115823817292,0.960778994001767,0.13550841715745,-0.00531477644214339,-0.12774227056561
"1296","부산","서구",2017,644,317,327,"5",2015,677,326,351,445571,459820,0.969011787221086,0.951255539143279,0.981675921477975,0.144533643347525,-0.00264844582977445,-0.0882589937483701
"1297","부산","서구",2018,615,323,292,"5",2016,638,346,292,447106,462028,0.967703256079718,0.963949843260188,0.996121318393889,0.137551274194486,-0.00053351759711526,-0.0569409357133662
"1298","부산","서구",2019,655,336,319,"5",2017,625,320,305,459384,475293,0.966528015350531,1.048,1.08429345384254,0.142582240565627,0.0120187495138842,0.12893422722721
"1299","부산","서구",2020,561,322,239,"5",2018,613,360,253,417119,431567,0.966522000060246,0.915171288743883,0.946870623417613,0.134493993320851,-0.00714558201921259,-0.154853013345458
"1300","부산","수영구",2010,1273,657,616,"5",2008,1314,681,633,470657,486853,0.966733284995676,0.968797564687976,1.00213531459435,0.270472977136216,0.00057754489545743,-0.0404882168524729
"1301","부산","수영구",2011,1172,616,556,"5",2009,1268,658,610,451574,467208,0.966537388058424,0.924290220820189,0.956290188294629,0.259536642942242,-0.0113442977936494,-0.21702799510877
"1302","부산","수영구",2012,1058,565,493,"5",2010,1158,631,527,407210,420213,0.969056169133273,0.913644214162349,0.942818634527156,0.259816802141401,-0.0148566795192331,-0.269039677124385
"1303","부산","수영구",2013,1010,545,465,"5",2011,1040,554,486,420229,433401,0.969607822778443,0.971153846153846,1.00159448319112,0.240345145147051,0.00038322629400536,-0.0433657051490402
"1304","부산","수영구",2014,1098,550,548,"5",2012,1260,642,618,464047,479002,0.968778835996509,0.871428571428571,0.899512395450092,0.236613963671783,-0.0237767704124366,-0.401129229836821
"1305","부산","수영구",2015,1102,557,545,"5",2013,1185,582,603,441255,454391,0.971090976713887,0.929957805907173,0.95764230973919,0.249742212552832,-0.0105785032843623,-0.205688037319948
"1306","부산","수영구",2016,1017,532,485,"5",2014,1096,575,521,422114,434628,0.971207561408837,0.927919708029197,0.955428834062158,0.240930175260712,-0.0107385388209785,-0.208057858738005
"1307","부산","수영구",2017,992,528,464,"5",2015,1113,578,535,445571,459820,0.969011787221086,0.891284815813118,0.919787382947247,0.222635674224759,-0.0178581900788721,-0.313486330418742
"1308","부산","수영구",2018,1089,555,534,"5",2016,1185,609,576,447106,462028,0.967703256079718,0.918987341772152,0.949658209785384,0.243566402598042,-0.0122615687429194,-0.230611030400203
"1309","부산","수영구",2019,1042,535,507,"5",2017,1238,640,598,459384,475293,0.966528015350531,0.841680129240711,0.870828486989545,0.22682548804486,-0.0292993914800894,-0.482908726857683
"1310","부산","수영구",2020,970,518,452,"5",2018,1089,562,527,417119,431567,0.966522000060246,0.890725436179982,0.921578025253911,0.232547546383646,-0.0182368378097632,-0.319093381962029
"1311","부산","연제구",2010,1765,879,886,"5",2008,1784,874,910,470657,486853,0.966733284995676,0.989349775784753,1.02339475752009,0.375007701999545,0.00877321425644675,0.0808740330430905
"1312","부산","연제구",2011,1596,820,776,"5",2009,1557,784,773,451574,467208,0.966537388058424,1.02504816955684,1.06053649059138,0.353430445508377,0.0213954388392253,0.267785132866691
"1313","부산","연제구",2012,1576,844,732,"5",2010,1534,821,713,407210,420213,0.969056169133273,1.02737940026076,1.06018560428716,0.38702389430515,0.0232932669523242,0.295888351722378
"1314","부산","연제구",2013,1552,818,734,"5",2011,1555,809,746,420229,433401,0.969607822778443,0.998070739549839,1.02935508161417,0.369322440859627,0.0108414903933778,0.111501262415965
"1315","부산","연제구",2014,1657,882,775,"5",2012,1726,906,820,464047,479002,0.968778835996509,0.960023174971031,0.990962167318125,0.357075899639476,-0.0032271922356716,-0.096829125466101
"1316","부산","연제구",2015,1570,806,764,"5",2013,1537,788,749,441255,454391,0.971090976713887,1.02147039687703,1.05187919707958,0.355803333673273,0.0184587912692089,0.224298976879974
"1317","부산","연제구",2016,1472,783,689,"5",2014,1415,742,673,422114,434628,0.971207561408837,1.04028268551237,1.07112292660009,0.348720961635956,0.0248020553583459,0.318230633664928
"1318","부산","연제구",2017,1650,824,826,"5",2015,1648,841,807,445571,459820,0.969011787221086,1.00121359223301,1.03323159267677,0.37031135329723,0.0123060360563582,0.133188393619686
"1319","부산","연제구",2018,1675,885,790,"5",2016,1651,860,791,447106,462028,0.967703256079718,1.0145366444579,1.0483964356676,0.374631519147585,0.0181308302154802,0.219442498463692
"1320","부산","연제구",2019,1654,829,825,"5",2017,1688,844,844,459384,475293,0.966528015350531,0.979857819905213,1.01379143112561,0.360047367779461,0.00496556847468865,0.024490052854835
"1321","부산","연제구",2020,1564,764,800,"5",2018,1536,743,793,417119,431567,0.966522000060246,1.01822916666667,1.05349817862728,0.374952951076312,0.0200592999535071,0.247999461410059
"1322","부산","영도구",2010,965,522,443,"5",2008,1074,570,504,470657,486853,0.966733284995676,0.898510242085661,0.929429301784804,0.205032539620148,-0.0144692894778288,-0.26330316861713
"1323","부산","영도구",2011,832,416,416,"5",2009,916,446,470,451574,467208,0.966537388058424,0.908296943231441,0.939743205439806,0.184244442771284,-0.0111019795369267,-0.213439723360445
"1324","부산","영도구",2012,716,357,359,"5",2010,773,380,393,407210,420213,0.969056169133273,0.926261319534282,0.955838628386973,0.175830652488888,-0.00776492278552279,-0.164024270205724
"1325","부산","영도구",2013,746,377,369,"5",2011,822,424,398,420229,433401,0.969607822778443,0.907542579075426,0.935989332753971,0.177522255722475,-0.0113633180398158,-0.217309648719554
"1326","부산","영도구",2014,776,404,372,"5",2012,852,430,422,464047,479002,0.968778835996509,0.910798122065728,0.940150721943527,0.167224440627781,-0.0100082620449703,-0.197243850915204
"1327","부산","영도구",2015,731,371,360,"5",2013,817,408,409,441255,454391,0.971090976713887,0.894736842105263,0.92137283072385,0.165663845168893,-0.0130256791970324,-0.241926050540143
"1328","부산","영도구",2016,617,316,301,"5",2014,686,350,336,422114,434628,0.971207561408837,0.899416909620991,0.926081041128113,0.146169044381376,-0.01080466357997,-0.209037040446239
"1329","부산","영도구",2017,708,359,349,"5",2015,806,401,405,445571,459820,0.969011787221086,0.878411910669975,0.906502812715073,0.158897235232993,-0.0148564445616362,-0.269036197849986
"1330","부산","영도구",2018,686,321,365,"5",2016,743,357,386,447106,462028,0.967703256079718,0.92328398384926,0.954098250727805,0.153431177394175,-0.00704275943528517,-0.153330406761924
"1331","부산","영도구",2019,645,348,297,"5",2017,725,381,344,459384,475293,0.966528015350531,0.889655172413793,0.920464961474647,0.140405412465388,-0.0111671498896028,-0.214404772129362
"1332","부산","영도구",2020,589,302,287,"5",2018,633,324,309,417119,431567,0.966522000060246,0.930489731437599,0.96271966016252,0.141206705999966,-0.00526423398700989,-0.126993833092102
"1333","부산","중구",2010,365,208,157,"5",2008,302,164,138,470657,486853,0.966733284995676,1.20860927152318,1.25019929517435,0.0775511678356,0.0194032475324149,0.238284574880819
"1334","부산","중구",2011,341,161,180,"5",2009,254,121,133,451574,467208,0.966537388058424,1.34251968503937,1.38899922716515,0.0755136478185192,0.0293747506418251,0.385943539499243
"1335","부산","중구",2012,316,162,154,"5",2010,227,116,111,407210,420213,0.969056169133273,1.3920704845815,1.43652197769565,0.0776012376906265,0.0338746457483423,0.452578413402337
"1336","부산","중구",2013,275,142,133,"5",2011,237,117,120,420229,433401,0.969607822778443,1.16033755274262,1.1967081179457,0.0654405098172663,0.0128726795235614,0.141579303872329
"1337","부산","중구",2014,280,135,145,"5",2012,253,120,133,464047,479002,0.968778835996509,1.10671936758893,1.14238598787156,0.0603387156904365,0.00859138764048402,0.0781815272534879
"1338","부산","중구",2015,250,138,112,"5",2013,224,115,109,441255,454391,0.971090976713887,1.11607142857143,1.14929646689556,0.0566565817951071,0.00845862748838875,0.076215602318613
"1339","부산","중구",2016,245,135,110,"5",2014,215,123,92,422114,434628,0.971207561408837,1.13953488372093,1.1733175574415,0.0580411926635932,0.0100595577434454,0.0999223295085074
"1340","부산","중구",2017,270,129,141,"5",2015,228,112,116,445571,459820,0.969011787221086,1.18421052631579,1.22208062062057,0.0605964032668194,0.0134572868448694,0.150236224581828
"1341","부산","중구",2018,229,115,114,"5",2016,225,120,105,447106,462028,0.967703256079718,1.01777777777778,1.05174574063222,0.0512182793342071,0.00265032779805668,-0.00979425086576611
"1342","부산","중구",2019,229,125,104,"5",2017,196,97,99,459384,475293,0.966528015350531,1.16836734693878,1.20882926142088,0.0498493634954635,0.0104100057610588,0.105111797020637
"1343","부산","중구",2020,209,114,95,"5",2018,184,92,92,417119,431567,0.966522000060246,1.13586956521739,1.17521335794383,0.0501056053548268,0.00877917136602774,0.080962246487262
"1344","부산","해운대구",2010,3965,2094,1871,"5",2008,4101,2153,1948,470657,486853,0.966733284995676,0.966837356742258,1.00010765300854,0.842439398542888,9.06911357623923e-05,-0.0476975935420629
"1345","부산","해운대구",2011,3703,1915,1788,"5",2009,3824,1957,1867,451574,467208,0.966537388058424,0.968357740585774,1.00188337518014,0.820020638920753,0.00154440651854911,-0.0261708381555463
"1346","부산","해운대구",2012,3386,1774,1612,"5",2010,3463,1792,1671,407210,420213,0.969056169133273,0.977764943690442,1.00898686251072,0.831511996267282,0.00747268398647107,0.0616156573486274
"1347","부산","해운대구",2013,3499,1789,1710,"5",2011,3558,1810,1748,420229,433401,0.969607822778443,0.983417650365374,1.01424269406919,0.832641250365872,0.0118590545983525,0.126569449758506
"1348","부산","해운대구",2014,3694,1874,1820,"5",2012,3939,2008,1931,464047,479002,0.968778835996509,0.937801472454938,0.968024318460975,0.796040056287402,-0.0254539233321534,-0.425964669480665
"1349","부산","해운대구",2015,3424,1774,1650,"5",2013,3591,1837,1754,441255,454391,0.971090976713887,0.95349484823169,0.981880041207116,0.775968544265787,-0.0140605180466701,-0.257250042460702
"1350","부산","해운대구",2016,3149,1615,1534,"5",2014,3355,1730,1625,422114,434628,0.971207561408837,0.938599105812221,0.966424833483262,0.746007002847572,-0.0250473093432596,-0.419943490934096
"1351","부산","해운대구",2017,3285,1711,1574,"5",2015,3591,1876,1715,445571,459820,0.969011787221086,0.914786967418546,0.944041114341813,0.737256239746303,-0.0412560376207482,-0.65996387792838
"1352","부산","해운대구",2018,3294,1710,1584,"5",2016,3623,1882,1741,447106,462028,0.967703256079718,0.909191277946453,0.939535205895344,0.736738044222175,-0.0445467141529605,-0.708692528394534
"1353","부산","해운대구",2019,3398,1793,1605,"5",2017,3592,1903,1689,459384,475293,0.966528015350531,0.945991091314031,0.978751858497292,0.73968618846107,-0.0157169568000197,-0.281778744762626
"1354","부산","해운대구",2020,3075,1598,1477,"5",2018,3259,1723,1536,417119,431567,0.966522000060246,0.943540963485732,0.976222955532226,0.737199696010012,-0.0175284299536592,-0.308603211181139
"1355","서울","강남구",2010,3545,1848,1697,"5",2008,3907,2006,1901,470657,486853,0.966733284995676,0.907345789608395,0.938568893500396,0.753202438293704,-0.0462700592025817,-0.734211985482926
"1356","서울","강남구",2011,3548,1876,1672,"5",2009,4050,2089,1961,451574,467208,0.966537388058424,0.876049382716049,0.906379198093779,0.785696253548699,-0.0735575133119431,-1.13828719627624
"1357","서울","강남구",2012,3132,1645,1487,"5",2010,3599,1860,1739,407210,420213,0.969056169133273,0.870241733814949,0.898030229345009,0.769136317870386,-0.0784286539356677,-1.21041950903971
"1358","서울","강남구",2013,3320,1698,1622,"5",2011,3860,1954,1906,420229,433401,0.969607822778443,0.860103626943005,0.887063415472815,0.790045427612088,-0.0892250322158289,-1.37029330349032
"1359","서울","강남구",2014,3846,2003,1843,"5",2012,4325,2209,2116,464047,479002,0.968778835996509,0.889248554913295,0.917906669584284,0.828795359090782,-0.0680385712608519,-1.05656217848186
"1360","서울","강남구",2015,3970,2089,1881,"5",2013,4171,2153,2018,441255,454391,0.971090976713887,0.951810117477823,0.980145156634748,0.899706518906301,-0.0178635320075812,-0.313565434206165
"1361","서울","강남구",2016,3703,1896,1807,"5",2014,4176,2115,2061,422114,434628,0.971207561408837,0.886733716475096,0.913021841787143,0.877251169115452,-0.0763016909797379,-1.17892323968008
"1362","서울","강남구",2017,3957,2060,1897,"5",2015,4501,2324,2177,445571,459820,0.969011787221086,0.879137969340147,0.907252090153951,0.88807395454372,-0.082367003072645,-1.26873895691945
"1363","서울","강남구",2018,3938,2056,1882,"5",2016,4459,2284,2175,447106,462028,0.967703256079718,0.883157658667863,0.912632724049767,0.880775476061605,-0.0769509540672718,-1.18853758911349
"1364","서울","강남구",2019,4096,2116,1980,"5",2017,4545,2343,2202,459384,475293,0.966528015350531,0.901210121012101,0.932420071326395,0.891628789857723,-0.0602562100219177,-0.94132023449218
"1365","서울","강남구",2020,3913,2064,1849,"5",2018,4094,2106,1988,417119,431567,0.966522000060246,0.955788959452858,0.988895192652916,0.938101596906398,-0.0104174375056378,-0.203302959978953
"1366","서울","강동구",2010,3930,2025,1905,"5",2008,3906,2013,1893,470657,486853,0.966733284995676,1.00614439324117,1.04076730247854,0.835002985188789,0.034040819267675,0.455039126651126
"1367","서울","강동구",2011,3823,1997,1826,"5",2009,3992,2076,1916,451574,467208,0.966537388058424,0.957665330661323,0.990820781992797,0.84659435662815,-0.00777107416315774,-0.16411536038968
"1368","서울","강동구",2012,3433,1774,1659,"5",2010,3613,1859,1754,407210,420213,0.969056169133273,0.950179905895378,0.980520981302066,0.843053952506078,-0.0164218637042329,-0.292217073115577
"1369","서울","강동구",2013,3587,1873,1714,"5",2011,3918,2058,1860,420229,433401,0.969607822778443,0.915518121490556,0.944214867065644,0.853582213507397,-0.0476171972509118,-0.754160533583641
"1370","서울","강동구",2014,3845,2032,1813,"5",2012,4266,2263,2003,464047,479002,0.968778835996509,0.901312705110173,0.9303596152398,0.828579863677602,-0.0577026205110626,-0.903506438608438
"1371","서울","강동구",2015,3665,1924,1741,"5",2013,4146,2157,1989,441255,454391,0.971090976713887,0.883984563434636,0.910300460648894,0.830585489116271,-0.0745031357654427,-1.15229006333365
"1372","서울","강동구",2016,3229,1646,1583,"5",2014,3730,1923,1807,422114,434628,0.971207561408837,0.865683646112601,0.891347720621982,0.764959229023439,-0.0831145638646479,-1.27980890809184
"1373","서울","강동구",2017,3470,1806,1664,"5",2015,3821,2003,1818,445571,459820,0.969011787221086,0.908139230567914,0.937180788246404,0.778775997540235,-0.0489220942980983,-0.773483572929572
"1374","서울","강동구",2018,3210,1697,1513,"5",2016,3449,1795,1654,447106,462028,0.967703256079718,0.930704552044071,0.961766477684974,0.717950553112685,-0.0274497784935191,-0.455519482172594
"1375","서울","강동구",2019,3292,1711,1581,"5",2017,3684,1896,1788,459384,475293,0.966528015350531,0.893593919652552,0.924540112092324,0.716611810598541,-0.0540754469010826,-0.849794907471726
"1376","서울","강동구",2020,3404,1798,1606,"5",2018,3170,1650,1520,417119,431567,0.966522000060246,1.07381703470032,1.11101147685555,0.816074069989619,0.0905935877330688,1.29247789052466
"1377","서울","강북구",2010,2358,1207,1151,"5",2008,2895,1486,1409,470657,486853,0.966733284995676,0.814507772020725,0.842536183104907,0.501001791113274,-0.0788896542999741,-1.21724604619618
"1378","서울","강북구",2011,2155,1050,1105,"5",2009,2664,1299,1365,451574,467208,0.966537388058424,0.808933933933934,0.836940136955195,0.477219680495334,-0.0778153757438546,-1.2013380273581
"1379","서울","강북구",2012,1945,990,955,"5",2010,2381,1240,1141,407210,420213,0.969056169133273,0.816883662326753,0.842968331812362,0.477640529456546,-0.0750046891345878,-1.15971711323538
"1380","서울","강북구",2013,1972,1012,960,"5",2011,2486,1288,1198,420229,433401,0.969607822778443,0.793242156074014,0.818106184210595,0.469267946762361,-0.0853569374642653,-1.31301418921889
"1381","서울","강북구",2014,2041,1062,979,"5",2012,2624,1368,1256,464047,479002,0.968778835996509,0.77782012195122,0.802887194734322,0.439826138300646,-0.0866953639496103,-1.33283373566795
"1382","서울","강북구",2015,1855,928,927,"5",2013,2382,1195,1187,441255,454391,0.971090976713887,0.778757346767422,0.801940668219048,0.420391836919695,-0.0832625263064819,-1.28199994997629
"1383","서울","강북구",2016,1778,898,880,"5",2014,2352,1224,1128,422114,434628,0.971207561408837,0.755952380952381,0.778363360202626,0.421213226758648,-0.0933562842169959,-1.43146927529485
"1384","서울","강북구",2017,1791,911,880,"5",2015,2355,1196,1159,445571,459820,0.969011787221086,0.760509554140127,0.784830034236325,0.401956141669902,-0.0864888892416119,-1.32977623859169
"1385","서울","강북구",2018,1753,897,856,"5",2016,2239,1119,1120,447106,462028,0.967703256079718,0.782938811969629,0.809069109823406,0.392077046606398,-0.0748596195263693,-1.15756890870572
"1386","서울","강북구",2019,1706,892,814,"5",2017,2249,1189,1060,459384,475293,0.966528015350531,0.758559359715429,0.784829148941246,0.371366873900702,-0.0799073263122429,-1.23231582995936
"1387","서울","강북구",2020,1528,810,718,"5",2018,1968,1034,934,417119,431567,0.966522000060246,0.776422764227642,0.803316183365972,0.366322320488877,-0.0720496721119859,-1.11595894065101
"1388","서울","강서구",2010,5328,2743,2585,"5",2008,5612,2868,2744,470657,486853,0.966733284995676,0.949394155381326,0.982064205418945,1.13203458144679,-0.0203039397114799,-0.34970322314838
"1389","서울","강서구",2011,4919,2540,2379,"5",2009,5343,2770,2573,451574,467208,0.966537388058424,0.920643833052592,0.95251755847953,1.08930097835571,-0.0517226700029651,-0.81495476382013
"1390","서울","강서구",2012,4386,2224,2162,"5",2010,4672,2379,2293,407210,420213,0.969056169133273,0.938784246575342,0.96876143662033,1.07708553326294,-0.0336466046961603,-0.547282672833268
"1391","서울","강서구",2013,4427,2324,2103,"5",2011,4717,2471,2246,420229,433401,0.969607822778443,0.938520245919016,0.967937988814546,1.05347322531287,-0.0337764703335579,-0.54920573551973
"1392","서울","강서구",2014,4807,2442,2365,"5",2012,5052,2575,2477,464047,479002,0.968778835996509,0.951504354711006,0.982168808149349,1.03588645115689,-0.0184710900460682,-0.322562211314316
"1393","서울","강서구",2015,4757,2433,2324,"5",2013,4752,2399,2353,441255,454391,0.971090976713887,1.00105218855219,1.03085314615906,1.0780614383973,0.0332615871273221,0.443500183145876
"1394","서울","강서구",2016,4413,2289,2124,"5",2014,4627,2381,2246,422114,434628,0.971207561408837,0.953749729846553,0.982024613217632,1.04545217642627,-0.0187924072337306,-0.327320306731199
"1395","서울","강서구",2017,4529,2353,2176,"5",2015,4803,2513,2290,445571,459820,0.969011787221086,0.942952321465751,0.973107173618529,1.01644855702009,-0.0273351745696384,-0.453822416388653
"1396","서울","강서구",2018,4816,2460,2356,"5",2016,5163,2625,2538,447106,462028,0.967703256079718,0.932791012976951,0.963922573492002,1.07714949027747,-0.0388607815736133,-0.624494699005678
"1397","서울","강서구",2019,4946,2556,2390,"5",2017,5399,2771,2628,459384,475293,0.966528015350531,0.916095573254306,0.947821024020774,1.076659178378,-0.0561789734063994,-0.8809441276459
"1398","서울","강서구",2020,4277,2180,2097,"5",2018,4812,2449,2363,417119,431567,0.966522000060246,0.88881961762261,0.919606193720586,1.0253668617349,-0.0824331448476465,-1.26971839060238
"1399","서울","관악구",2010,3663,1895,1768,"5",2008,4326,2186,2140,470657,486853,0.966733284995676,0.846740638002774,0.875878229440048,0.778273774744665,-0.0966007189016855,-1.47951317209325
"1400","서울","관악구",2011,3379,1767,1612,"5",2009,4031,2077,1954,451574,467208,0.966537388058424,0.838253535102952,0.86727481570768,0.748271601110781,-0.0993144861581375,-1.51969889523913
"1401","서울","관악구",2012,3148,1594,1554,"5",2010,3724,1891,1833,407210,420213,0.969056169133273,0.845327604726101,0.87232054410444,0.773065494462317,-0.0987045817045805,-1.51066737219389
"1402","서울","관악구",2013,3029,1606,1423,"5",2011,3680,1930,1750,420229,433401,0.969607822778443,0.823097826086956,0.848897674658134,0.720797469950908,-0.108914173810116,-1.66185198126823
"1403","서울","관악구",2014,3225,1623,1602,"5",2012,3811,1916,1895,464047,479002,0.968778835996509,0.846234584098662,0.873506472948704,0.694972707505921,-0.0879095489768126,-1.35081350281085
"1404","서울","관악구",2015,3014,1560,1454,"5",2013,3510,1801,1709,441255,454391,0.971090976713887,0.858689458689459,0.884252329884901,0.683051750121812,-0.0790616486446407,-1.21979295477907
"1405","서울","관악구",2016,2732,1422,1310,"5",2014,3224,1663,1561,422114,434628,0.971207561408837,0.847394540942928,0.872516416278406,0.647218523905864,-0.08250973687852,-1.27085257266628
"1406","서울","관악구",2017,2769,1411,1358,"5",2015,3225,1633,1592,445571,459820,0.969011787221086,0.858604651162791,0.886062133077948,0.621449780169715,-0.0708066623517154,-1.09755233412456
"1407","서울","관악구",2018,2687,1393,1294,"5",2016,3257,1658,1599,447106,462028,0.967703256079718,0.824992324224747,0.852526142742238,0.60097605489526,-0.0886282569349562,-1.36145619848051
"1408","서울","관악구",2019,2581,1318,1263,"5",2017,3133,1601,1532,459384,475293,0.966528015350531,0.823811043728056,0.852340574348778,0.561839332671578,-0.082960873170551,-1.27753304170411
"1409","서울","관악구",2020,2302,1169,1133,"5",2018,2717,1393,1324,417119,431567,0.966522000060246,0.847258005152742,0.876604986849684,0.551880878118714,-0.0680993482128666,-1.05746216935673
"1410","서울","광진구",2010,2935,1539,1396,"5",2008,3149,1640,1509,470657,486853,0.966733284995676,0.932041918069228,0.964114852084975,0.623596376979414,-0.0223778482271801,-0.380413857320738
"1411","서울","광진구",2011,2839,1442,1397,"5",2009,2993,1541,1452,451574,467208,0.966537388058424,0.948546608753759,0.981386359672227,0.628689871427496,-0.0117022071444654,-0.222327950751251
"1412","서울","광진구",2012,2528,1266,1262,"5",2010,2581,1286,1295,407210,420213,0.969056169133273,0.979465323518016,1.01074153874285,0.620809901525012,0.00666845360917622,0.0497065375777099
"1413","서울","광진구",2013,2689,1341,1348,"5",2011,2721,1361,1360,420229,433401,0.969607822778443,0.988239617787578,1.01921580516517,0.639889203267742,0.0122959862572886,0.133039575241056
"1414","서울","광진구",2014,2817,1416,1401,"5",2012,2879,1468,1411,464047,479002,0.968778835996509,0.978464744703022,1.00999805977032,0.607050578928428,0.00606932797173268,0.0408346282646817
"1415","서울","광진구",2015,2601,1364,1237,"5",2013,2658,1403,1255,441255,454391,0.971090976713887,0.978555304740406,1.00768653834245,0.589455076996295,0.00453086905048412,0.0180529825160922
"1416","서울","광진구",2016,2407,1246,1161,"5",2014,2423,1244,1179,422114,434628,0.971207561408837,0.99339661576558,1.02284687150145,0.570225105066404,0.0130278597023521,0.143877226690797
"1417","서울","광진구",2017,2550,1366,1184,"5",2015,2562,1342,1220,445571,459820,0.969011787221086,0.995316159250585,1.02714556456009,0.572299364186628,0.0155353893382269,0.181008963573462
"1418","서울","광진구",2018,2480,1248,1232,"5",2016,2472,1204,1268,447106,462028,0.967703256079718,1.00323624595469,1.03671889047777,0.554678308946872,0.0203671720766158,0.252558461034721
"1419","서울","광진구",2019,2599,1350,1249,"5",2017,2609,1342,1267,459384,475293,0.966528015350531,0.996167113836719,1.03066553479615,0.565757623252007,0.0173492600820229,0.207868933734611
"1420","서울","광진구",2020,2244,1124,1120,"5",2018,2287,1180,1107,417119,431567,0.966522000060246,0.981198076082204,1.01518442003497,0.537975973283404,0.00816885314705927,0.0719245963645238
"1421","서울","구로구",2010,3539,1820,1719,"5",2008,3894,2012,1882,470657,486853,0.966733284995676,0.908834103749358,0.940108422721188,0.751927624575859,-0.0450341314353586,-0.715910249781805
"1422","서울","구로구",2011,3447,1795,1652,"5",2009,3866,2014,1852,451574,467208,0.966537388058424,0.891619244697362,0.922488106216401,0.763330041144973,-0.0591671570710597,-0.925193435014318
"1423","서울","구로구",2012,3288,1778,1510,"5",2010,3563,1938,1625,407210,420213,0.969056169133273,0.922817850126298,0.952285202365173,0.807445789641708,-0.0385271124538472,-0.619553695005658
"1424","서울","구로구",2013,3371,1726,1645,"5",2011,3774,1945,1829,420229,433401,0.969607822778443,0.893216746157923,0.921214459262901,0.802181667614562,-0.0632003164524007,-0.984916841992741
"1425","서울","구로구",2014,3665,1867,1798,"5",2012,4088,2065,2023,464047,479002,0.968778835996509,0.896526418786693,0.925419079644224,0.789790689305178,-0.0589033164968026,-0.921286458744876
"1426","서울","구로구",2015,3516,1788,1728,"5",2013,3880,1994,1886,441255,454391,0.971090976713887,0.906185567010309,0.933162379982961,0.796818166366387,-0.0532574298262704,-0.837681632975228
"1427","서울","구로구",2016,3329,1689,1640,"5",2014,3772,1909,1863,422114,434628,0.971207561408837,0.882555673382821,0.908719936346647,0.788649511743273,-0.0719879776321116,-1.1150453629365
"1428","서울","구로구",2017,3464,1761,1703,"5",2015,3918,1977,1941,445571,459820,0.969011787221086,0.884124553343543,0.912398141078364,0.777429410800972,-0.0681042615665173,-1.057534926764
"1429","서울","구로구",2018,3320,1684,1636,"5",2016,3758,1922,1836,447106,462028,0.967703256079718,0.883448642895157,0.912933419769727,0.74255322004178,-0.0646515695080151,-1.00640713500475
"1430","서울","구로구",2019,3305,1615,1690,"5",2017,3691,1824,1867,459384,475293,0.966528015350531,0.895421295041994,0.926430771608054,0.719441687128851,-0.0529287697950691,-0.832814804034178
"1431","서울","구로구",2020,3014,1551,1463,"5",2018,3325,1696,1629,417119,431567,0.966522000060246,0.906466165413534,0.937863975529819,0.722575571959081,-0.0448979734208046,-0.713894008977089
"1432","서울","금천구",2010,1994,1025,969,"5",2008,2119,1092,1027,470657,486853,0.966733284995676,0.941009910335064,0.973391446162188,0.423663092230648,-0.0112730621987133,-0.215973131656707
"1433","서울","금천구",2011,1799,926,873,"5",2009,2020,1024,996,451574,467208,0.966537388058424,0.890594059405941,0.921427427856632,0.39838431796339,-0.031302080563965,-0.512564736922867
"1434","서울","금천구",2012,1645,842,803,"5",2010,1756,899,857,407210,420213,0.969056169133273,0.936788154897494,0.966701605888708,0.40396846835785,-0.0134515012679147,-0.248231664188182
"1435","서울","금천구",2013,1661,850,811,"5",2011,1777,909,868,420229,433401,0.969607822778443,0.934721440630276,0.964020110679182,0.395260679296288,-0.0142214354939516,-0.259632923295608
"1436","서울","금천구",2014,1715,860,855,"5",2012,1836,923,913,464047,479002,0.968778835996509,0.934095860566449,0.964199284561801,0.369574633603924,-0.0132310362908307,-0.244966997879234
"1437","서울","금천구",2015,1550,797,753,"5",2013,1680,845,835,441255,454391,0.971090976713887,0.922619047619048,0.950085079300329,0.351270807129664,-0.0175336544819866,-0.308680576492566
"1438","서울","금천구",2016,1510,776,734,"5",2014,1589,817,772,422114,434628,0.971207561408837,0.950283196979232,0.978455311448305,0.357723269069493,-0.0077070364197965,-0.163167083407016
"1439","서울","금천구",2017,1610,828,782,"5",2015,1616,849,767,445571,459820,0.969011787221086,0.996287128712871,1.02814758484002,0.361334108368812,0.0101706824709041,0.101567875021558
"1440","서울","금천구",2018,1561,786,775,"5",2016,1580,807,773,447106,462028,0.967703256079718,0.987974683544304,1.02094797897726,0.349134209784704,0.00731365608681288,0.0592607571142976
"1441","서울","금천구",2019,1656,844,812,"5",2017,1790,932,858,459384,475293,0.966528015350531,0.925139664804469,0.957178322936608,0.360482733399509,-0.0154364751965626,-0.277625346553092
"1442","서울","금천구",2020,1336,676,660,"5",2018,1381,711,670,417119,431567,0.966522000060246,0.967414916727009,1.0009238451548,0.320292290689228,0.000295900480873227,-0.0446588340795607
"1443","서울","노원구",2010,5881,3089,2792,"5",2008,5948,3104,2844,470657,486853,0.966733284995676,0.988735709482179,1.02275956029237,1.24952991244154,0.0284387513793365,0.372083173567828
"1444","서울","노원구",2011,5545,2878,2667,"5",2009,5681,2921,2760,451574,467208,0.966537388058424,0.976060552719592,1.00985286733739,1.22792720572929,0.0120986038580237,0.130116717935636
"1445","서울","노원구",2012,4907,2527,2380,"5",2010,4930,2529,2401,407210,420213,0.969056169133273,0.995334685598377,1.02711764013494,1.20502934603767,0.0326775521578975,0.434851737877399
"1446","서울","노원구",2013,4883,2532,2351,"5",2011,4866,2526,2340,420229,433401,0.969607822778443,1.00349362926428,1.03494795080009,1.16198548886441,0.0406090116952474,0.552301543623614
"1447","서울","노원구",2014,5183,2664,2519,"5",2012,5225,2678,2547,464047,479002,0.968778835996509,0.991961722488038,1.02393000923444,1.11691272651262,0.0267277318595133,0.346746234094723
"1448","서울","노원구",2015,4895,2507,2388,"5",2013,4903,2495,2408,441255,454391,0.971090976713887,0.998368345910667,1.02808940650348,1.1093358715482,0.0311605862448118,0.412388362633972
"1449","서울","노원구",2016,4329,2220,2109,"5",2014,4306,2209,2097,422114,434628,0.971207561408837,1.00534138411519,1.03514575469,1.02555233894161,0.0360438109262009,0.484699617270455
"1450","서울","노원구",2017,4470,2271,2199,"5",2015,4502,2324,2178,445571,459820,0.969011787221086,0.992892047978676,1.02464393217143,1.00320712075068,0.0247229682376722,0.317059504074413
"1451","서울","노원구",2018,4236,2146,2090,"5",2016,4273,2161,2112,447106,462028,0.967703256079718,0.991340978235432,1.02442662252835,0.947426337378608,0.0231424255165636,0.293654677422568
"1452","서울","노원구",2019,4318,2217,2101,"5",2017,4402,2255,2147,459384,475293,0.966528015350531,0.980917764652431,1.0148880829871,0.939954373683019,0.013994118719484,0.158185681941468
"1453","서울","노원구",2020,3821,1979,1842,"5",2018,3759,1934,1825,417119,431567,0.966522000060246,1.01649374833732,1.05170264957648,0.916045540960733,0.0473619816003944,0.652300163024572
"1454","서울","도봉구",2010,3432,1741,1691,"5",2008,3298,1651,1647,470657,486853,0.966733284995676,1.0406306852638,1.07644031856051,0.729193446607614,0.0557397793509239,0.776359387401521
"1455","서울","도봉구",2011,3209,1631,1578,"5",2009,3155,1608,1547,451574,467208,0.966537388058424,1.01711568938193,1.05232937902704,0.710625501025303,0.0371865911894298,0.501622015890129
"1456","서울","도봉구",2012,2781,1452,1329,"5",2010,2666,1361,1305,407210,420213,0.969056169133273,1.04313578394599,1.07644511966625,0.682940006384912,0.0522074305129662,0.724052030490434
"1457","서울","도봉구",2013,2891,1517,1374,"5",2011,2723,1429,1294,420229,433401,0.969607822778443,1.06169665809769,1.09497534276834,0.687958232297152,0.0653390689227211,0.918506578621507
"1458","서울","도봉구",2014,3151,1619,1532,"5",2012,2973,1527,1446,464047,479002,0.968778835996509,1.05987218298015,1.09402904316127,0.679026046930591,0.0638481694744663,0.896429198063731
"1459","서울","도봉구",2015,2813,1464,1349,"5",2013,2703,1421,1282,441255,454391,0.971090976713887,1.04069552349242,1.07167664868442,0.637499858358546,0.045693853383931,0.627598362043203
"1460","서울","도봉구",2016,2684,1360,1324,"5",2014,2535,1279,1256,422114,434628,0.971207561408837,1.05877712031558,1.09016564778359,0.635847188200344,0.0573315736154558,0.799930827976464
"1461","서울","도봉구",2017,2737,1411,1326,"5",2015,2679,1387,1292,445571,459820,0.969011787221086,1.02164986935424,1.0543214054022,0.614267984226981,0.033367900196788,0.445074477170607
"1462","서울","도봉구",2018,2572,1313,1259,"5",2016,2578,1347,1231,447106,462028,0.967703256079718,0.99767261442979,1.03096957477593,0.575255084923933,0.0178154053677861,0.214771657376405
"1463","서울","도봉구",2019,2601,1348,1253,"5",2017,2587,1357,1230,459384,475293,0.966528015350531,1.00541167375338,1.04023024453021,0.566192988872055,0.0227780823936136,0.288259449871582
"1464","서울","도봉구",2020,2214,1137,1077,"5",2018,2191,1134,1057,417119,431567,0.966522000060246,1.01049748973072,1.04549869497821,0.530783781127208,0.0241499693568881,0.308574482254158
"1465","서울","동대문구",2010,2808,1450,1358,"5",2008,3092,1596,1496,470657,486853,0.966733284995676,0.908150064683053,0.939400844863963,0.596612819951685,-0.0361542328324004,-0.584415868318693
"1466","서울","동대문구",2011,2664,1371,1293,"5",2009,2880,1474,1406,451574,467208,0.966537388058424,0.925,0.957024540828303,0.589936533104209,-0.0253527933923126,-0.424467127731445
"1467","서울","동대문구",2012,2384,1249,1135,"5",2010,2617,1351,1266,407210,420213,0.969056169133273,0.910966755827283,0.940055679787948,0.585447312197638,-0.0350942411496605,-0.568719410857851
"1468","서울","동대문구",2013,2501,1260,1241,"5",2011,2665,1341,1324,420229,433401,0.969607822778443,0.938461538461538,0.96787744118271,0.595151691101756,-0.0191177952026255,-0.332138682663006
"1469","서울","동대문구",2014,2693,1430,1263,"5",2012,2883,1508,1375,464047,479002,0.968778835996509,0.93409642733264,0.964199869593358,0.580329147694091,-0.0207758591662239,-0.356691451232572
"1470","서울","동대문구",2015,2596,1329,1267,"5",2013,2773,1394,1379,441255,454391,0.971090976713887,0.936170212765957,0.964039657678522,0.588321945360393,-0.0211562585503976,-0.362324441423948
"1471","서울","동대문구",2016,2348,1218,1130,"5",2014,2573,1306,1267,422114,434628,0.971207561408837,0.91255343956471,0.939607016898589,0.556247838261702,-0.0335934662963354,-0.546495794364342
"1472","서울","동대문구",2017,2396,1217,1179,"5",2015,2653,1349,1304,445571,459820,0.969011787221086,0.903128533735394,0.932009853384104,0.53773697121222,-0.0365608155135064,-0.590436583256568
"1473","서울","동대문구",2018,2284,1168,1116,"5",2016,2534,1313,1221,447106,462028,0.967703256079718,0.901341752170481,0.931423705053887,0.510840829691393,-0.035031571407434,-0.56779139136585
"1474","서울","동대문구",2019,2386,1227,1159,"5",2017,2587,1304,1283,459384,475293,0.966528015350531,0.92230382682644,0.954244276604799,0.519391184716925,-0.0237651193818132,-0.400956700269342
"1475","서울","동대문구",2020,2136,1117,1019,"5",2018,2315,1213,1102,417119,431567,0.966522000060246,0.92267818574514,0.954637541295105,0.512084081521101,-0.0232293930014349,-0.393023613173297
"1476","서울","동작구",2010,3219,1675,1544,"5",2008,3477,1837,1640,470657,486853,0.966733284995676,0.925798101811907,0.957656176921691,0.6839375596241,-0.0289605310213334,-0.477890849017097
"1477","서울","동작구",2011,3075,1588,1487,"5",2009,3373,1759,1614,451574,467208,0.966537388058424,0.911651348947524,0.943213744456224,0.680951516252043,-0.0386686868148101,-0.62165014158216
"1478","서울","동작구",2012,2821,1432,1389,"5",2010,3063,1554,1509,407210,420213,0.969056169133273,0.920992491021874,0.950401556027049,0.692762947864738,-0.0343599642562053,-0.557846168916171
"1479","서울","동작구",2013,3028,1552,1476,"5",2011,3037,1541,1496,420229,433401,0.969607822778443,0.99703654922621,1.02828847478682,0.720559504460663,0.0203835293743357,0.252800681452122
"1480","서울","동작구",2014,3176,1718,1458,"5",2012,3380,1804,1576,464047,479002,0.968778835996509,0.939644970414201,0.969927227453993,0.684413432260094,-0.0205822094757896,-0.353823868233855
"1481","서울","동작구",2015,2904,1475,1429,"5",2013,3199,1645,1554,441255,454391,0.971090976713887,0.90778368240075,0.934808070684206,0.658122854131964,-0.0429042985876796,-0.684371482792724
"1482","서울","동작구",2016,2807,1412,1395,"5",2014,3047,1525,1522,422114,434628,0.971207561408837,0.921234000656383,0.948544922076222,0.66498623594574,-0.0342169185888276,-0.55572793509461
"1483","서울","동작구",2017,2950,1561,1389,"5",2015,3191,1672,1519,445571,459820,0.969011787221086,0.924475086179881,0.954039051300989,0.662071813470805,-0.030429448653993,-0.49964272076285
"1484","서울","동작구",2018,2801,1419,1382,"5",2016,3107,1614,1493,447106,462028,0.967703256079718,0.901512713228194,0.93160037187467,0.62647336425814,-0.0428505451456812,-0.683575496720907
"1485","서울","동작구",2019,2805,1427,1378,"5",2017,3149,1631,1518,459384,475293,0.966528015350531,0.890758971101937,0.921606985989832,0.610600282116922,-0.0478667964706044,-0.75785662252279
"1486","서울","동작구",2020,2545,1287,1258,"5",2018,2827,1414,1413,417119,431567,0.966522000060246,0.900247612309869,0.931430026687188,0.610137634583896,-0.0418371213205598,-0.668568620516271
"1487","서울","마포구",2010,3122,1603,1519,"5",2008,3665,1881,1784,470657,486853,0.966733284995676,0.851841746248295,0.881154874327209,0.663328071185598,-0.0788333079823428,-1.21641166457585
"1488","서울","마포구",2011,3052,1548,1504,"5",2009,3479,1780,1699,451574,467208,0.966537388058424,0.877263581488934,0.90763543379442,0.675858220358125,-0.0624253513398532,-0.973441085040293
"1489","서울","마포구",2012,2774,1427,1347,"5",2010,3121,1619,1502,407210,420213,0.969056169133273,0.888817686638898,0.917199348138776,0.681220991625942,-0.0564055421681771,-0.884299179378012
"1490","서울","마포구",2013,2813,1439,1374,"5",2011,3251,1643,1608,420229,433401,0.969607822778443,0.865272223931098,0.892394021174079,0.669396924058073,-0.0720311112363299,-1.11568408944235
"1491","서울","마포구",2014,3100,1583,1517,"5",2012,3546,1846,1700,464047,479002,0.968778835996509,0.874224478285392,0.902398406945114,0.668035780858404,-0.0652013564294449,-1.01454843192742
"1492","서울","마포구",2015,2917,1505,1412,"5",2013,3267,1699,1568,441255,454391,0.971090976713887,0.892868074686257,0.919448430782116,0.66106899638531,-0.0532501450201281,-0.837573758874341
"1493","서울","마포구",2016,2638,1363,1275,"5",2014,3054,1596,1458,422114,434628,0.971207561408837,0.863785199738048,0.889392992868629,0.62494965814922,-0.0691238112956586,-1.07263251593688
"1494","서울","마포구",2017,2676,1366,1310,"5",2015,3116,1589,1527,445571,459820,0.969011787221086,0.858793324775353,0.886256840319955,0.600577685711144,-0.0683116036061143,-1.06060526736891
"1495","서울","마포구",2018,2458,1223,1235,"5",2016,2937,1463,1474,447106,462028,0.967703256079718,0.836908409942118,0.864839923482881,0.549757775561053,-0.0743053030107133,-1.14936053712176
"1496","서울","마포구",2019,2572,1312,1260,"5",2017,3001,1538,1463,459384,475293,0.966528015350531,0.857047650783072,0.8867282036023,0.559880187381363,-0.0634186345921681,-0.988149717730907
"1497","서울","마포구",2020,2211,1092,1119,"5",2018,2659,1317,1342,417119,431567,0.966522000060246,0.831515607371192,0.860317310231285,0.530064561911589,-0.0740408437588864,-1.14544439941614
"1498","서울","서대문구",2010,2666,1342,1324,"5",2008,2833,1445,1388,470657,486853,0.966733284995676,0.941051888457466,0.973434868813557,0.566442228629342,-0.0150476121130794,-0.271867025098899
"1499","서울","서대문구",2011,2435,1235,1200,"5",2009,2765,1388,1377,451574,467208,0.966537388058424,0.880650994575045,0.911140122933158,0.539225021812593,-0.0479154691496324,-0.758577372174235
"1500","서울","서대문구",2012,2166,1096,1070,"5",2010,2329,1158,1171,407210,420213,0.969056169133273,0.930012881064835,0.959709984506514,0.531912281132585,-0.0214307540480076,-0.366389196809849
"1501","서울","서대문구",2013,2272,1152,1120,"5",2011,2358,1190,1168,420229,433401,0.969607822778443,0.963528413910093,0.993730033189162,0.540657593835742,-0.00338990516937765,-0.0992385940344241
"1502","서울","서대문구",2014,2204,1102,1102,"5",2012,2320,1164,1156,464047,479002,0.968778835996509,0.95,0.980615972089034,0.474951890649008,-0.00920648070470635,-0.185370996717122
"1503","서울","서대문구",2015,2109,1080,1029,"5",2013,2243,1185,1058,441255,454391,0.971090976713887,0.940258582255907,0.968249736433228,0.477954924023524,-0.0151751948107834,-0.273756281797664
"1504","서울","서대문구",2016,2213,1110,1103,"5",2014,2136,1074,1062,422114,434628,0.971207561408837,1.03604868913858,1.06676340908598,0.524265956589926,0.0350017825296682,0.469269161856987
"1505","서울","서대문구",2017,2288,1220,1068,"5",2015,2248,1199,1049,445571,459820,0.969011787221086,1.01779359430605,1.05034180979868,0.513498409905492,0.0258504392833871,0.333755202347866
"1506","서울","서대문구",2018,2140,1054,1086,"5",2016,2197,1073,1124,447106,462028,0.967703256079718,0.974055530268548,1.00656427902761,0.478633702075123,0.00314188517243711,-0.00251522260341019
"1507","서울","서대문구",2019,2243,1144,1099,"5",2017,2312,1179,1133,459384,475293,0.966528015350531,0.970155709342561,1.00375332523674,0.488262542883514,0.00183260812435861,-0.0219031214183336
"1508","서울","서대문구",2020,2179,1104,1075,"5",2018,2164,1108,1056,417119,431567,0.966522000060246,1.00693160813309,1.04180929980934,0.522392890278314,0.0218408809679134,0.27438128219321
"1509","서울","서초구",2010,3468,1819,1649,"5",2008,3436,1774,1662,470657,486853,0.966733284995676,1.0093131548312,1.04404510581811,0.736842328914687,0.0324542983483093,0.431545774271991
"1510","서울","서초구",2011,3431,1763,1668,"5",2009,3580,1816,1764,451574,467208,0.966537388058424,0.958379888268156,0.991560078388013,0.759786878783987,-0.0064125416987528,-0.143998082694079
"1511","서울","서초구",2012,3225,1683,1542,"5",2010,3346,1744,1602,407210,420213,0.969056169133273,0.963837417812313,0.994614603892747,0.791974656810982,-0.00426509723383278,-0.112198521205058
"1512","서울","서초구",2013,3547,1804,1743,"5",2011,3654,1901,1753,420229,433401,0.969607822778443,0.97071702244116,1.00114396732025,0.844063593897613,0.000965581167631651,-0.0347421388986319
"1513","서울","서초구",2014,3840,1982,1858,"5",2012,3906,2011,1895,464047,479002,0.968778835996509,0.98310291858679,1.01478570965637,0.827502386611701,0.0122352100283936,0.132139595074217
"1514","서울","서초구",2015,3926,1998,1928,"5",2013,4149,2101,2048,441255,454391,0.971090976713887,0.946252108941914,0.974421688217074,0.889734960510362,-0.0227579182241031,-0.386041969914437
"1515","서울","서초구",2016,3662,1865,1797,"5",2014,4030,2053,1977,422114,434628,0.971207561408837,0.908684863523573,0.935623752975555,0.86753815320032,-0.0558488504535543,-0.876055635622278
"1516","서울","서초구",2017,4031,2064,1967,"5",2015,4447,2248,2199,445571,459820,0.969011787221086,0.906453789071284,0.935441447694661,0.904681857661293,-0.0584049510275179,-0.913906615566899
"1517","서울","서초구",2018,3861,2018,1843,"5",2016,4321,2286,2035,447106,462028,0.967703256079718,0.893543161305253,0.923364839057279,0.863553609211238,-0.0661785698245712,-1.02901910064731
"1518","서울","서초구",2019,3854,1984,1870,"5",2017,4375,2243,2132,459384,475293,0.966528015350531,0.880914285714286,0.911421367744632,0.838949549831949,-0.0743130036553707,-1.14947456899886
"1519","서울","서초구",2020,3479,1831,1648,"5",2018,3904,2030,1874,417119,431567,0.966522000060246,0.891137295081967,0.922004149958739,0.834054550380107,-0.0650527936376781,-1.01234850000418
"1520","서울","성동구",2010,2581,1270,1311,"5",2008,2867,1411,1456,470657,486853,0.966733284995676,0.900244157656086,0.931222883941679,0.548382367626531,-0.037716157742587,-0.607545000659054
"1521","서울","성동구",2011,2472,1282,1190,"5",2009,2768,1467,1301,451574,467208,0.966537388058424,0.893063583815029,0.923982449979521,0.547418584772374,-0.041613419650074,-0.665256024944178
"1522","서울","성동구",2012,2192,1127,1065,"5",2010,2465,1256,1209,407210,420213,0.969056169133273,0.889249492900609,0.917644942806521,0.538297193094472,-0.0443314961243845,-0.705505559397176
"1523","서울","성동구",2013,2223,1155,1068,"5",2011,2391,1243,1148,420229,433401,0.969607822778443,0.929736511919699,0.9588789303035,0.528997284813756,-0.0217529342180858,-0.371160071352269
"1524","서울","성동구",2014,2396,1186,1210,"5",2012,2664,1338,1326,464047,479002,0.968778835996509,0.899399399399399,0.928384648777195,0.516327009979593,-0.0369769401655091,-0.596598596605281
"1525","서울","성동구",2015,2147,1107,1040,"5",2013,2443,1290,1153,441255,454391,0.971090976713887,0.87883749488334,0.905000165748911,0.48656672445638,-0.0462237581754513,-0.733526355477918
"1526","서울","성동구",2016,1995,1006,989,"5",2014,2129,1061,1068,422114,434628,0.971207561408837,0.937059652418976,0.964839741424247,0.472621140260688,-0.0166174814999329,-0.295113800003898
"1527","서울","성동구",2017,2111,1092,1019,"5",2015,2284,1168,1116,445571,459820,0.969011787221086,0.924255691768827,0.953812640834215,0.473774101097244,-0.0218823745708255,-0.373076836383144
"1528","서울","성동구",2018,2100,1069,1031,"5",2016,2330,1197,1133,447106,462028,0.967703256079718,0.901287553648069,0.931367697675517,0.46968727773727,-0.0322357192436276,-0.52639014711971
"1529","서울","성동구",2019,2102,1042,1060,"5",2017,2428,1249,1179,459384,475293,0.966528015350531,0.865733113673806,0.895714454132848,0.45756926667015,-0.0477178607467292,-0.755651168185484
"1530","서울","성동구",2020,1891,987,904,"5",2018,2392,1222,1170,417119,431567,0.966522000060246,0.790551839464883,0.817934655823257,0.45334784557884,-0.0825389315370964,-1.27128488994186
"1531","서울","성북구",2010,4427,2315,2112,"5",2008,4594,2416,2178,470657,486853,0.966733284995676,0.963648236830649,0.996808790787584,0.94060005481699,-0.00300165156013129,-0.0934892977325876
"1532","서울","성북구",2011,4336,2285,2051,"5",2009,4429,2349,2080,451574,467208,0.966537388058424,0.979002032061413,1.01289618400384,0.960196999827271,0.012382877189705,0.134326264416656
"1533","서울","성북구",2012,3986,2079,1907,"5",2010,4159,2162,1997,407210,420213,0.969056169133273,0.958403462370762,0.989007131782631,0.978856118464674,-0.0107604363140477,-0.208382118894059
"1534","서울","성북구",2013,4035,2069,1966,"5",2011,4148,2130,2018,420229,433401,0.969607822778443,0.972757955641273,1.00324887319267,0.96019075313698,0.00311953799771814,-0.00284614168802005
"1535","서울","성북구",2014,4256,2171,2085,"5",2012,4504,2276,2228,464047,479002,0.968778835996509,0.9449378330373,0.975390664955345,0.917148478494635,-0.0225704141929701,-0.383265392422048
"1536","서울","성북구",2015,3876,2005,1871,"5",2013,4090,2114,1976,441255,454391,0.971090976713887,0.947677261613692,0.975889267162768,0.878403644151341,-0.0211789555873842,-0.362660541302228
"1537","서울","성북구",2016,3592,1841,1751,"5",2014,3778,1948,1830,422114,434628,0.971207561408837,0.95076760190577,0.978954077052884,0.850954955296436,-0.0179091324206353,-0.314240689451424
"1538","서울","성북구",2017,3718,1878,1840,"5",2015,3849,1964,1885,445571,459820,0.969011787221086,0.965965185762536,0.996855970692278,0.834434916096425,-0.00262348783159339,-0.0878894133420935
"1539","서울","성북구",2018,3604,1859,1745,"5",2016,3718,1914,1804,447106,462028,0.967703256079718,0.969338353953739,1.00168966867038,0.806072832840534,0.00136199601169332,-0.028871990256921
"1540","서울","성북구",2019,3539,1827,1712,"5",2017,3685,1896,1789,459384,475293,0.966528015350531,0.960379918588874,0.993638987526474,0.770379464674434,-0.00490039338414257,-0.121606046906202
"1541","서울","성북구",2020,3137,1558,1579,"5",2018,3187,1610,1577,417119,431567,0.966522000060246,0.98431126451208,1.01840544183239,0.752063559799482,0.01384206210415,0.15593401314718
"1542","서울","송파구",2010,5705,2999,2706,"5",2008,6052,3104,2948,470657,486853,0.966733284995676,0.942663582286847,0.975102023399415,1.21213537671808,-0.0301797182462678,-0.495944689178862
"1543","서울","송파구",2011,5636,2906,2730,"5",2009,6043,3094,2949,451574,467208,0.966537388058424,0.93264934635115,0.964938716157326,1.2480789416574,-0.043759250031515,-0.69703168493182
"1544","서울","송파구",2012,5046,2619,2427,"5",2010,5452,2810,2642,407210,420213,0.969056169133273,0.925531914893617,0.955085932450558,1.23916406768007,-0.0556558986406245,-0.873198386859894
"1545","서울","송파구",2013,5184,2699,2485,"5",2011,5580,2878,2702,420229,433401,0.969607822778443,0.929032258064516,0.958152601741953,1.23361310142803,-0.0516234987518027,-0.813486226518795
"1546","서울","송파구",2014,5697,2942,2755,"5",2012,6008,3112,2896,464047,479002,0.968778835996509,0.94823568575233,0.97879479868793,1.2276773688872,-0.0260331457535259,-0.434541850080742
"1547","서울","송파구",2015,5204,2715,2489,"5",2013,5679,2956,2723,441255,454391,0.971090976713887,0.916358513822856,0.943638171702261,1.17936340664695,-0.0664710778260714,-1.0333505869007
"1548","서울","송파구",2016,5075,2599,2476,"5",2014,5486,2806,2680,422114,434628,0.971207561408837,0.925082026977762,0.952507027062098,1.20228184803157,-0.057099939272294,-0.894581877613463
"1549","서울","송파구",2017,5300,2705,2595,"5",2015,5731,2946,2785,445571,459820,0.969011787221086,0.924794974699005,0.954369169596084,1.18948495301534,-0.0542771861590535,-0.85278228155445
"1550","서울","송파구",2018,5216,2717,2499,"5",2016,5604,2917,2687,447106,462028,0.967703256079718,0.930763740185582,0.961827641209163,1.166613733656,-0.044532398011435,-0.708480533611823
"1551","서울","송파구",2019,5620,2853,2767,"5",2017,5933,3021,2912,459384,475293,0.966528015350531,0.947244227203776,0.980048391934338,1.22337739233408,-0.0244083462482408,-0.410481664767605
"1552","서울","송파구",2020,4926,2515,2411,"5",2018,5335,2734,2601,417119,431567,0.966522000060246,0.923336457357076,0.955318613854131,1.18095795204726,-0.0527668382774585,-0.830416906749574
"1553","서울","양천구",2010,4252,2217,2035,"5",2008,4597,2396,2201,470657,486853,0.966733284995676,0.924951055035893,0.95677998201958,0.903417988046497,-0.0390457416872042,-0.627233605925615
"1554","서울","양천구",2011,4106,2175,1931,"5",2009,4372,2319,2053,451574,467208,0.966537388058424,0.939158279963404,0.971672996375216,0.909264040888094,-0.0257567257821227,-0.430448596904224
"1555","서울","양천구",2012,3749,1976,1773,"5",2010,3841,1968,1873,407210,420213,0.969056169133273,0.976047904191617,1.00721499463194,0.920655190196704,0.00664252225513608,0.0493225436254734
"1556","서울","양천구",2013,3764,1877,1887,"5",2011,3919,1952,1967,420229,433401,0.969607822778443,0.960449094156673,0.990554192729669,0.895702105280692,-0.0084606294581111,-0.174326360655415
"1557","서울","양천구",2014,4100,2111,1989,"5",2012,4296,2210,2086,464047,479002,0.968778835996509,0.954376163873371,0.985133168079251,0.883531194038535,-0.0131353097585095,-0.243549470301499
"1558","서울","양천구",2015,4071,2096,1975,"5",2013,4132,2146,1986,441255,454391,0.971090976713887,0.985237173281704,1.01456732366692,0.922595777951525,0.0134397513111534,0.149976556733951
"1559","서울","양천구",2016,3616,1854,1762,"5",2014,3690,1870,1820,422114,434628,0.971207561408837,0.979945799457995,1.00899729202734,0.856640623149197,0.00770744584895718,0.0650920332937824
"1560","서울","양천구",2017,3815,1936,1879,"5",2015,3884,1991,1893,445571,459820,0.969011787221086,0.982234809474768,1.01364588380457,0.856204735047838,0.0116836703273891,0.123972342825213
"1561","서울","양천구",2018,3736,1965,1771,"5",2016,3840,2025,1815,447106,462028,0.967703256079718,0.972916666666667,1.00538740626757,0.835596033155449,0.00450169530617556,0.0176209749409675
"1562","서울","양천구",2019,3731,1899,1832,"5",2017,3878,1986,1892,459384,475293,0.966528015350531,0.962093862815884,0.995412287627236,0.812174564199014,-0.00372602329701994,-0.104215863175554
"1563","서울","양천구",2020,3575,1850,1725,"5",2018,3495,1789,1706,417119,431567,0.966522000060246,1.02288984263233,1.05832028921077,0.857069565279932,0.0499845449208755,0.691135329628797
"1564","서울","영등포구",2010,3117,1631,1486,"5",2008,3801,2016,1785,470657,486853,0.966733284995676,0.820047355958958,0.848266392278637,0.662265726420727,-0.100487967940026,-1.53707592486155
"1565","서울","영등포구",2011,2983,1555,1428,"5",2009,3706,1942,1764,451574,467208,0.966537388058424,0.804910955207771,0.832777878178798,0.660578332676372,-0.110463310419255,-1.68479174323271
"1566","서울","영등포구",2012,2571,1329,1242,"5",2010,3187,1694,1493,407210,420213,0.969056169133273,0.80671477878883,0.832474736227476,0.631369563615825,-0.105770352682684,-1.61529797957675
"1567","서울","영등포구",2013,2660,1397,1263,"5",2011,3228,1693,1535,420229,433401,0.969607822778443,0.824039653035936,0.849869022998002,0.632988204050649,-0.0950311375048637,-1.45627066177198
"1568","서울","영등포구",2014,2848,1498,1350,"5",2012,3456,1784,1672,464047,479002,0.968778835996509,0.824074074074074,0.85063178865423,0.613730936737012,-0.0916718922679711,-1.40652663941783
"1569","서울","영등포구",2015,2589,1324,1265,"5",2013,3134,1596,1538,441255,454391,0.971090976713887,0.826100829610721,0.850693549234899,0.58673556107013,-0.0876034041610514,-1.34628008131736
"1570","서울","영등포구",2016,2377,1211,1166,"5",2014,2903,1488,1415,422114,434628,0.971207561408837,0.818808129521185,0.843082531537768,0.563118020250454,-0.0883630541831648,-1.35752905095683
"1571","서울","영등포구",2017,2377,1189,1188,"5",2015,2954,1478,1476,445571,459820,0.969011787221086,0.80467163168585,0.830404379283632,0.533472779871221,-0.0904746472375459,-1.38879772135529
"1572","서울","영등포구",2018,2457,1187,1270,"5",2016,2833,1376,1457,447106,462028,0.967703256079718,0.867278503353336,0.896223607706752,0.549534114952606,-0.0570286678918446,-0.893526484246123
"1573","서울","영등포구",2019,2564,1285,1279,"5",2017,2925,1467,1458,459384,475293,0.966528015350531,0.876581196581197,0.906938218716078,0.558138724901172,-0.0519413839428401,-0.818193500603864
"1574","서울","영등포구",2020,2265,1168,1097,"5",2018,2580,1338,1242,417119,431567,0.966522000060246,0.877906976744186,0.908315565180579,0.54301050779274,-0.049785611507984,-0.786270617745471
"1575","서울","용산구",2010,1559,795,764,"5",2008,1950,999,951,470657,486853,0.966733284995676,0.79948717948718,0.826998709877622,0.331239097686851,-0.0573047912387976,-0.897615344979625
"1576","서울","용산구",2011,1522,786,736,"5",2009,1932,999,933,451574,467208,0.966537388058424,0.787784679089027,0.815058671109998,0.337043319588816,-0.0623332394182534,-0.972077082961248
"1577","서울","용산구",2012,1428,726,702,"5",2010,1785,924,861,407210,420213,0.969056169133273,0.8,0.825545541612436,0.350679010829793,-0.0611775169021983,-0.954963034233142
"1578","서울","용산구",2013,1386,727,659,"5",2011,1827,944,883,420229,433401,0.969607822778443,0.758620689655172,0.782399514353463,0.329820169479022,-0.0717690290546584,-1.11180315161723
"1579","서울","용산구",2014,1593,777,816,"5",2012,2012,995,1017,464047,479002,0.968778835996509,0.791749502982107,0.817265482650325,0.343284193195948,-0.0627298713574341,-0.977950446368089
"1580","서울","용산구",2015,1414,700,714,"5",2013,1814,910,904,441255,454391,0.971090976713887,0.779492833517089,0.802698050140313,0.320449626633126,-0.0632253361665245,-0.985287336294555
"1581","서울","용산구",2016,1286,658,628,"5",2014,1634,807,827,422114,434628,0.971207561408837,0.78702570379437,0.810357883388704,0.304657035777065,-0.057775805105286,-0.904590163026962
"1582","서울","용산구",2017,1253,632,621,"5",2015,1637,811,826,445571,459820,0.969011787221086,0.765424557116677,0.78990221503058,0.281212197382684,-0.0590820597764854,-0.923933306198152
"1583","서울","용산구",2018,1248,660,588,"5",2016,1679,880,799,447106,462028,0.967703256079718,0.74329958308517,0.76810693610391,0.279128439341006,-0.0647279490193198,-1.0075381700587
"1584","서울","용산구",2019,1245,642,603,"5",2017,1698,849,849,459384,475293,0.966528015350531,0.73321554770318,0.758607651364627,0.271015098479703,-0.0654209711376626,-1.01780050737428
"1585","서울","용산구",2020,1090,553,537,"5",2018,1501,772,729,417119,431567,0.966522000060246,0.72618254497002,0.751335763619199,0.261316315008427,-0.0649800219254153,-1.01127088958092
"1586","서울","은평구",2010,4307,2236,2071,"5",2008,4224,2196,2028,470657,486853,0.966733284995676,1.01964962121212,1.05473726521859,0.91510378046008,0.0500902783335758,0.692701040041119
"1587","서울","은평구",2011,4155,2143,2012,"5",2009,3975,2042,1933,451574,467208,0.966537388058424,1.04528301886792,1.08147189315427,0.920114975618614,0.0749635089832412,1.06102620066598
"1588","서울","은평구",2012,3852,1988,1864,"5",2010,3719,1911,1808,407210,420213,0.969056169133273,1.035762301694,1.06883618791715,0.945949264507257,0.0651155413317109,0.915196560834813
"1589","서울","은평구",2013,4137,2127,2010,"5",2011,4073,2072,2001,420229,433401,0.969607822778443,1.01571323348883,1.04755057625079,0.98446323314193,0.0468117940336115,0.644152933307477
"1590","서울","은평구",2014,4359,2270,2089,"5",2012,4524,2351,2173,464047,479002,0.968778835996509,0.963527851458886,0.994579790203383,0.939344506052189,-0.00509144429410249,-0.124435146916959
"1591","서울","은평구",2015,3960,2062,1898,"5",2013,4174,2183,1991,441255,454391,0.971090976713887,0.948730234786775,0.976973586962182,0.897440255634497,-0.0206648300030048,-0.355047320843855
"1592","서울","은평구",2016,3737,1924,1813,"5",2014,3933,2002,1931,422114,434628,0.971207561408837,0.950165268243071,0.978333886594497,0.885305865240196,-0.0191811372748507,-0.33307665808145
"1593","서울","은평구",2017,3803,1941,1862,"5",2015,4056,2080,1976,445571,459820,0.969011787221086,0.937623274161736,0.967607707694283,0.853511561569312,-0.0276471959886623,-0.45844285918111
"1594","서울","은평구",2018,3569,1837,1732,"5",2016,3835,1959,1876,447106,462028,0.967703256079718,0.930638852672751,0.961698585621051,0.798244711544913,-0.030573901472686,-0.501781791814664
"1595","서울","은평구",2019,3686,1930,1756,"5",2017,3923,2058,1865,459384,475293,0.966528015350531,0.939587050726485,0.97212603856674,0.802378837747941,-0.0223654767782503,-0.38023065973059
"1596","서울","은평구",2020,3150,1650,1500,"5",2018,3298,1743,1555,417119,431567,0.966522000060246,0.955124317768344,0.988207529377303,0.7551801764005,-0.00890544004504633,-0.180913158051706
"1597","서울","종로구",2010,1109,577,532,"5",2008,1183,624,559,470657,486853,0.966733284995676,0.937447168216399,0.969706104844204,0.23562806884844,-0.00713809201345732,-0.154742100629223
"1598","서울","종로구",2011,1065,557,508,"5",2009,1134,610,524,451574,467208,0.966537388058424,0.939153439153439,0.971667987970964,0.235841744653147,-0.00668187114646184,-0.147986338722645
"1599","서울","종로구",2012,954,490,464,"5",2010,1015,515,500,407210,420213,0.969056169133273,0.939901477832512,0.969914343224463,0.234277154293853,-0.00704838205443444,-0.15341366704003
"1600","서울","종로구",2013,988,528,460,"5",2011,1052,536,516,420229,433401,0.969607822778443,0.939163498098859,0.968601403614562,0.235109904361669,-0.00738212099327101,-0.158355704927473
"1601","서울","종로구",2014,1009,520,489,"5",2012,1067,540,527,464047,479002,0.968778835996509,0.9456419868791,0.976117511801742,0.217434871898752,-0.00519288576201177,-0.125937301803389
"1602","서울","종로구",2015,976,504,472,"5",2013,1014,527,487,441255,454391,0.971090976713887,0.962524654832347,0.991178661848421,0.221187295328098,-0.00195116792692228,-0.0779336363717782
"1603","서울","종로구",2016,876,454,422,"5",2014,873,475,398,422114,434628,0.971207561408837,1.00343642611684,1.03318432226912,0.207526876625746,0.00688663875345361,0.0529374439060364
"1604","서울","종로구",2017,926,459,467,"5",2015,964,497,467,445571,459820,0.969011787221086,0.960580912863071,0.991299513102731,0.20782322009287,-0.00180816320336619,-0.0758160088502154
"1605","서울","종로구",2018,862,443,419,"5",2016,877,443,434,447106,462028,0.967703256079718,0.982896237172178,1.01570004130606,0.192795444480727,0.00302689644196752,-0.00421798663984758
"1606","서울","종로구",2019,946,478,468,"5",2017,1046,535,511,459384,475293,0.966528015350531,0.904397705544933,0.935718045603608,0.20592793828257,-0.0132374503376232,-0.24506197769301
"1607","서울","종로구",2020,764,381,383,"5",2018,865,435,430,417119,431567,0.966522000060246,0.883236994219653,0.913830201655626,0.183161160244439,-0.0157829602427848,-0.282756130008663
"1608","서울","중구",2010,1138,570,568,"5",2008,980,483,497,470657,486853,0.966733284995676,1.16122448979592,1.20118393337529,0.241789668484693,0.048644196555257,0.671287323794206
"1609","서울","중구",2011,1067,541,526,"5",2009,937,473,464,451574,467208,0.966537388058424,1.13874066168623,1.17816514472733,0.23628463994827,0.0420976870732296,0.574345989937666
"1610","서울","중구",2012,976,495,481,"5",2010,794,396,398,407210,420213,0.969056169133273,1.22921914357683,1.26847047955563,0.239679772107758,0.0643469433575543,0.903815089072077
"1611","서울","중구",2013,951,469,482,"5",2011,841,421,420,420229,433401,0.969607822778443,1.1307966706302,1.166241282367,0.226305181222619,0.0376212635327435,0.50805868521247
"1612","서울","중구",2014,1089,531,558,"5",2012,1057,537,520,464047,479002,0.968778835996509,1.03027436140019,1.06347736255037,0.234674504953162,0.0148965186322414,0.171548505512546
"1613","서울","중구",2015,977,481,496,"5",2013,875,445,430,441255,454391,0.971090976713887,1.11657142857143,1.14981135171273,0.221413921655279,0.0331703188911934,0.442148674441377
"1614","서울","중구",2016,883,443,440,"5",2014,767,393,374,422114,434628,0.971207561408837,1.15123859191656,1.18536823400198,0.209185196416134,0.0387762904390151,0.525162433284867
"1615","서울","중구",2017,868,456,412,"5",2015,838,426,412,445571,459820,0.969011787221086,1.03579952267303,1.06892355318347,0.194806214946664,0.0134267365163474,0.149783832416996
"1616","서울","중구",2018,898,439,459,"5",2016,843,431,412,447106,462028,0.967703256079718,1.06524317912218,1.10079528246873,0.200847226384795,0.0202444529165163,0.250741224062489
"1617","서울","중구",2019,919,459,460,"5",2017,862,438,424,459384,475293,0.966528015350531,1.0661252900232,1.1030464436528,0.200050502411926,0.0206144928245047,0.25622081014711
"1618","서울","중구",2020,907,455,452,"5",2018,788,409,379,417119,431567,0.966522000060246,1.1510152284264,1.19088363053779,0.217443942855636,0.0415064892507366,0.565591476460996
"1619","서울","중랑구",2010,3259,1645,1614,"5",2008,3561,1794,1767,470657,486853,0.966733284995676,0.915192361696153,0.946685477680895,0.69243631774307,-0.0369169115168717,-0.595709686677863
"1620","서울","중랑구",2011,3043,1525,1518,"5",2009,3372,1699,1673,451574,467208,0.966537388058424,0.902431791221827,0.933674995268034,0.67386519153007,-0.044694112016939,-0.710875209956505
"1621","서울","중랑구",2012,2670,1410,1260,"5",2010,2964,1549,1415,407210,420213,0.969056169133273,0.90080971659919,0.929574306724529,0.655681343778394,-0.0461768132033856,-0.73283118987518
"1622","서울","중랑구",2013,2747,1452,1295,"5",2011,3061,1637,1424,420229,433401,0.969607822778443,0.897419144070565,0.925548580558046,0.653691201701929,-0.0486682378434254,-0.769724442450705
"1623","서울","중랑구",2014,2883,1481,1402,"5",2012,3176,1609,1567,464047,479002,0.968778835996509,0.907745591939547,0.936999816894036,0.621273276198316,-0.0391403301593361,-0.628634281000033
"1624","서울","중랑구",2015,2812,1423,1389,"5",2013,3015,1539,1476,441255,454391,0.971090976713887,0.932669983416252,0.960435227780975,0.637273232031365,-0.0252135702666027,-0.422405498469768
"1625","서울","중랑구",2016,2563,1281,1282,"5",2014,2911,1441,1470,422114,434628,0.971207561408837,0.880453452421848,0.906555392901451,0.607181946109345,-0.0567378783915202,-0.88922044572127
"1626","서울","중랑구",2017,2652,1358,1294,"5",2015,2911,1517,1394,445571,459820,0.969011787221086,0.911027138440399,0.9401610490756,0.595191338754093,-0.0356156253103343,-0.576440117003033
"1627","서울","중랑구",2018,2647,1368,1279,"5",2016,2981,1532,1449,447106,462028,0.967703256079718,0.887957061388796,0.917592305089492,0.592029630557407,-0.0487877971729554,-0.771494888351907
"1628","서울","중랑구",2019,2717,1416,1301,"5",2017,3050,1584,1466,459384,475293,0.966528015350531,0.890819672131148,0.921669789165991,0.591444194834822,-0.0463279484779624,-0.735069215368073
"1629","서울","중랑구",2020,2369,1218,1151,"5",2018,2714,1389,1325,417119,431567,0.966522000060246,0.872881355932203,0.903115868938104,0.567943440600884,-0.0550247067349199,-0.863851637202471
"1630","세종","세종시",2014,1504,741,763,"5",2012,1281,635,646,464047,479002,0.968778835996509,1.17408274785324,1.2119203106306,0.324105101422916,0.0686844537705062,0.968045355018009
"1631","세종","세종시",2015,2578,1287,1291,"5",2013,1455,749,706,441255,454391,0.971090976713887,1.77182130584192,1.82456777822986,0.584242671471145,0.481747681562041,7.08472484339759
"1632","세종","세종시",2016,3248,1649,1599,"5",2014,1952,981,971,422114,434628,0.971207561408837,1.66393442622951,1.71326345916809,0.769460382740208,0.548827974286082,8.07805618584938
"1633","세종","세종시",2017,3839,1968,1871,"5",2015,3163,1617,1546,445571,459820,0.969011787221086,1.2137211508062,1.25253497100059,0.861591082004888,0.217581878908474,3.17293256098732
"1634","세종","세종시",2018,4442,2310,2132,"5",2016,3627,1827,1800,447106,462028,0.967703256079718,1.22470361180039,1.26557764904275,0.99350042271855,0.263851506588573,3.8580975999548
"1635","세종","세종시",2019,5004,2576,2428,"5",2017,4338,2191,2147,459384,475293,0.966528015350531,1.15352697095436,1.19347494602731,1.08928478135939,0.210749314281876,3.07175529539535
"1636","세종","세종시",2020,4879,2489,2390,"5",2018,4502,2278,2224,417119,431567,0.966522000060246,1.08374055975122,1.1212787289722,1.16969018433588,0.141858538847516,2.05161415310374
"1637","울산","남구",2010,3139,1664,1475,"5",2008,3264,1744,1520,470657,486853,0.966733284995676,0.961703431372549,0.994797061711649,0.66694004338616,-0.00347004788776829,-0.100425355016136
"1638","울산","남구",2011,2933,1576,1357,"5",2009,3061,1641,1420,451574,467208,0.966537388058424,0.958183600130676,0.991356994534346,0.64950595029829,-0.00561368347840263,-0.132168514333166
"1639","울산","남구",2012,2648,1402,1246,"5",2010,2800,1479,1321,407210,420213,0.969056169133273,0.945714285714286,0.975912765263272,0.65027872596449,-0.0156634163166068,-0.28098591220176
"1640","울산","남구",2013,2734,1383,1351,"5",2011,2869,1484,1385,420229,433401,0.969607822778443,0.952945277100035,0.982815169920287,0.650597650328749,-0.0111804100711601,-0.214601130156624
"1641","울산","남구",2014,2968,1563,1405,"5",2012,3140,1649,1491,464047,479002,0.968778835996509,0.945222929936306,0.975684949768774,0.639590386318627,-0.0155516723707465,-0.279331197243838
"1642","울산","남구",2015,2840,1482,1358,"5",2013,2960,1549,1411,441255,454391,0.971090976713887,0.959459459459459,0.988022216730107,0.643618769192417,-0.00770912612582218,-0.163198027972215
"1643","울산","남구",2016,2702,1411,1291,"5",2014,2877,1492,1385,422114,434628,0.971207561408837,0.939172749391727,0.967015483311683,0.640111439089914,-0.021113766445044,-0.361695214294183
"1644","울산","남구",2017,2649,1410,1239,"5",2015,2833,1495,1338,445571,459820,0.969011787221086,0.935051182492058,0.964953362614484,0.594518045384462,-0.0208358583557352,-0.357579924926456
"1645","울산","남구",2018,2678,1414,1264,"5",2016,2886,1490,1396,447106,462028,0.967703256079718,0.927927927927928,0.958897184749667,0.598963109419243,-0.024619070028224,-0.413602082505172
"1646","울산","남구",2019,2817,1450,1367,"5",2017,2982,1514,1468,459384,475293,0.966528015350531,0.94466800804829,0.977382955325601,0.613212475837208,-0.0138690539609091,-0.25441482410346
"1647","울산","남구",2020,2519,1270,1249,"5",2018,2644,1344,1300,417119,431567,0.966522000060246,0.952723146747352,0.985723187561139,0.60390440138186,-0.00862182986953153,-0.176713431650152
"1648","울산","동구",2010,1672,903,769,"5",2008,1732,930,802,470657,486853,0.966733284995676,0.965357967667437,0.998577355978546,0.35524808937294,-0.000505391570479441,-0.0565244428409971
"1649","울산","동구",2011,1581,825,756,"5",2009,1678,882,796,451574,467208,0.966537388058424,0.942193087008343,0.974812871854877,0.350108730794953,-0.00881823346725897,-0.17962179476949
"1650","울산","동구",2012,1500,801,699,"5",2010,1557,844,713,407210,420213,0.969056169133273,0.963391136801541,0.994154072269311,0.36836030549348,-0.00215340772476938,-0.080928422496506
"1651","울산","동구",2013,1650,883,767,"5",2011,1640,865,775,420229,433401,0.969607822778443,1.00609756097561,1.03763350226755,0.392643058903598,0.0147765334475863,0.169771753508227
"1652","울산","동구",2014,1879,950,929,"5",2012,1924,986,938,464047,479002,0.968778835996509,0.976611226611227,1.00808480772256,0.404915881365465,0.00327366704465067,-0.000563784129889759
"1653","울산","동구",2015,1775,941,834,"5",2013,1850,986,864,441255,454391,0.971090976713887,0.959459459459459,0.988022216730107,0.402261730745261,-0.0048182038286389,-0.120388976166218
"1654","울산","동구",2016,1772,900,872,"5",2014,1861,955,906,422114,434628,0.971207561408837,0.952176249328318,0.980404485264806,0.419791809795458,-0.00822603659456077,-0.170852487262544
"1655","울산","동구",2017,1890,997,893,"5",2015,1944,1018,926,445571,459820,0.969011787221086,0.972222222222222,1.00331310211442,0.424174822867736,0.00140533450252491,-0.028230229770653
"1656","울산","동구",2018,1869,975,894,"5",2016,2014,1054,960,447106,462028,0.967703256079718,0.928003972194637,0.958975766966098,0.418021677186171,-0.0171490186981082,-0.302984853292211
"1657","울산","동구",2019,1920,981,939,"5",2017,2088,1071,1017,459384,475293,0.966528015350531,0.919540229885057,0.95138497310041,0.417950995245807,-0.0203186988765855,-0.349921778266321
"1658","울산","동구",2020,1680,867,813,"5",2018,1833,934,899,417119,431567,0.966522000060246,0.916530278232406,0.948276685036943,0.402762760746933,-0.0208322251295039,-0.357526123767528
"1659","울산","북구",2010,2132,1161,971,"5",2008,2166,1181,985,470657,486853,0.966733284995676,0.984302862419206,1.01817417243848,0.452983807741094,0.00823260583372584,0.0728686522005939
"1660","울산","북구",2011,2142,1117,1025,"5",2009,2139,1135,1004,451574,467208,0.966537388058424,1.00140252454418,1.03607220674183,0.474340861077033,0.0171105216068704,0.2043336717316
"1661","울산","북구",2012,2068,1054,1014,"5",2010,2129,1086,1043,407210,420213,0.969056169133273,0.971348050728041,1.00236506579058,0.507846074507011,0.00120108937769735,-0.0312547109676691
"1662","울산","북구",2013,2248,1152,1096,"5",2011,2290,1169,1121,420229,433401,0.969607822778443,0.981659388646288,1.0124293199629,0.534946422069871,0.00664902024291556,0.0494187664453526
"1663","울산","북구",2014,2526,1284,1242,"5",2012,2614,1325,1289,464047,479002,0.968778835996509,0.966335118592196,0.997477528086377,0.54434141369301,-0.00137308592746244,-0.0693733432476419
"1664","울산","북구",2015,2349,1211,1138,"5",2013,2405,1234,1171,441255,454391,0.971090976713887,0.976715176715177,1.00579163037877,0.532345242546827,0.00308314687872999,-0.0033850248325307
"1665","울산","북구",2016,2278,1223,1055,"5",2014,2364,1266,1098,422114,434628,0.971207561408837,0.963620981387479,0.992188508077148,0.539664640357818,-0.00421558597920406,-0.111465353846514
"1666","울산","북구",2017,2446,1225,1221,"5",2015,2457,1235,1222,445571,459820,0.969011787221086,0.995522995522996,1.02735901528911,0.548958527372742,0.015018964743478,0.173361699151295
"1667","울산","북구",2018,2599,1328,1271,"5",2016,2499,1288,1211,447106,462028,0.967703256079718,1.04001600640256,1.07472616204247,0.581293921351984,0.0434378637612536,0.594191453554141
"1668","울산","북구",2019,2828,1459,1369,"5",2017,2714,1395,1319,459384,475293,0.966528015350531,1.04200442151805,1.0780902415334,0.61560698674747,0.0480728982847603,0.662827484772521
"1669","울산","북구",2020,2713,1396,1317,"5",2018,2590,1317,1273,417119,431567,0.966522000060246,1.04749034749035,1.08377289645249,0.650413910658589,0.0544870571888621,0.757808958707371
"1670","울산","울주군",2010,2381,1248,1133,"5",2008,2398,1241,1157,470657,486853,0.966733284995676,0.992910758965805,1.02707827937283,0.505888577031681,0.0136985922203883,0.153809497489135
"1671","울산","울주군",2011,2323,1228,1095,"5",2009,2290,1212,1078,451574,467208,0.966537388058424,1.01441048034935,1.04953051261378,0.51442288528569,0.0254796292084619,0.328264211558136
"1672","울산","울주군",2012,2213,1157,1056,"5",2010,2172,1159,1013,407210,420213,0.969056169133273,1.01887661141805,1.05141130501169,0.543454237371381,0.027939691557398,0.36469304834984
"1673","울산","울주군",2013,2145,1160,985,"5",2011,2093,1128,965,420229,433401,0.969607822778443,1.02484472049689,1.05696828802409,0.510435976574677,0.029078663731363,0.3815590564222
"1674","울산","울주군",2014,2461,1243,1218,"5",2012,2409,1212,1197,464047,479002,0.968778835996509,1.02158572021586,1.05450870958079,0.530334211836301,0.0289078335337412,0.379029386639257
"1675","울산","울주군",2015,2325,1222,1103,"5",2013,2230,1155,1075,441255,454391,0.971090976713887,1.04260089686099,1.07363874432145,0.526906210694496,0.0388007117307151,0.525524066090624
"1676","울산","울주군",2016,2179,1093,1086,"5",2014,2115,1076,1039,422114,434628,0.971207561408837,1.03026004728132,1.06080315703764,0.516211260465182,0.0313872743346636,0.41574518138753
"1677","울산","울주군",2017,2320,1183,1137,"5",2015,2301,1179,1122,445571,459820,0.969011787221086,1.00825727944372,1.04050053130435,0.520680205848226,0.0210878249765124,0.263229957586487
"1678","울산","울주군",2018,2262,1199,1063,"5",2016,2202,1151,1051,447106,462028,0.967703256079718,1.02724795640327,1.06153198302212,0.505920296305574,0.0311302790828227,0.41193957130224
"1679","울산","울주군",2019,2328,1143,1185,"5",2017,2272,1118,1154,459384,475293,0.966528015350531,1.02464788732394,1.060132630457,0.506765581735542,0.0304731474548306,0.40220870377478
"1680","울산","울주군",2020,2032,1016,1016,"5",2018,2016,991,1025,417119,431567,0.966522000060246,1.00793650793651,1.0428490069276,0.487151148712957,0.0208739429459913,0.260062772175149
"1681","울산","중구",2010,2069,1134,935,"5",2008,2159,1156,1003,470657,486853,0.966733284995676,0.958314034275127,0.991291030472188,0.439598263703716,-0.00382844788307472,-0.105732576168808
"1682","울산","중구",2011,1893,1003,890,"5",2009,1910,988,922,451574,467208,0.966537388058424,0.991099476439791,1.02541245551888,0.419200396834184,0.0106529114380445,0.108708767343977
"1683","울산","중구",2012,1696,894,802,"5",2010,1720,914,806,407210,420213,0.969056169133273,0.986046511627907,1.01753287687114,0.416492718744628,0.00730231555547675,0.0590928254497388
"1684","울산","중구",2013,1774,949,825,"5",2011,1778,940,838,420229,433401,0.969607822778443,0.997750281214848,1.02902457857215,0.422150779693929,0.0122527484745213,0.132399306049364
"1685","울산","중구",2014,2023,1048,975,"5",2012,1976,1037,939,464047,479002,0.968778835996509,1.02378542510121,1.05677930510128,0.435947220863404,0.0247527802614567,0.317500963352609
"1686","울산","중구",2015,2063,1059,1004,"5",2013,1978,1026,952,441255,454391,0.971090976713887,1.04297269969666,1.07402161559159,0.467530112973224,0.0346073342999961,0.463428135027844
"1687","울산","중구",2016,2079,1113,966,"5",2014,2002,1059,943,422114,434628,0.971207561408837,1.03846153846154,1.06924778978774,0.492520977745348,0.0341059891329614,0.456004168202727
"1688","울산","중구",2017,2179,1146,1033,"5",2015,2254,1192,1062,445571,459820,0.969011787221086,0.966725820763088,0.997640930184601,0.489035417475554,-0.00115366869202742,-0.0661241919964932
"1689","울산","중구",2018,2181,1134,1047,"5",2016,2300,1205,1095,447106,462028,0.967703256079718,0.948260869565217,0.979908730912755,0.487803787021422,-0.00980059714682444,-0.194168729390259
"1690","울산","중구",2019,2188,1187,1001,"5",2017,2342,1262,1080,459384,475293,0.966528015350531,0.934244235695986,0.966598195663437,0.476289988332201,-0.0159089449977359,-0.284621724219452
"1691","울산","중구",2020,1911,974,937,"5",2018,2110,1100,1010,417119,431567,0.966522000060246,0.905687203791469,0.93705803254868,0.458142640349636,-0.0288363991569485,-0.476052692585703
"1692","인천","강화군",2010,430,230,200,"5",2008,436,239,197,470657,486853,0.966733284995676,0.986238532110092,1.02017645137201,0.0913616497789261,0.00184335388403078,-0.0217439971890352
"1693","인천","강화군",2011,381,188,193,"5",2009,402,198,204,451574,467208,0.966537388058424,0.947761194029851,0.980573753006813,0.0843715537209848,-0.00163902264178282,-0.0733113593581232
"1694","인천","강화군",2012,411,203,208,"5",2010,403,200,203,407210,420213,0.969056169133273,1.01985111662531,1.05241692804811,0.100930723705214,0.0052904784823,0.0293013510905826
"1695","인천","강화군",2013,377,183,194,"5",2011,387,187,200,420229,433401,0.969607822778443,0.974160206718346,1.00469507756946,0.089712989822216,0.000421209446203766,-0.0428032470256237
"1696","인천","강화군",2014,422,217,205,"5",2012,433,217,216,464047,479002,0.968778835996509,0.97459584295612,1.0060044736151,0.090939064362015,0.000546041212543815,-0.0409547263796375
"1697","인천","강화군",2015,382,186,196,"5",2013,364,174,190,441255,454391,0.971090976713887,1.04945054945055,1.08069230856395,0.0865712569829237,0.00698563458123487,0.0544033835212917
"1698","인천","강화군",2016,394,210,184,"5",2014,386,201,185,422114,434628,0.971207561408837,1.02072538860104,1.05098583367737,0.0933397139161459,0.00475900312922231,0.0214312136103462
"1699","인천","강화군",2017,402,213,189,"5",2015,394,205,189,445571,459820,0.969011787221086,1.02030456852792,1.05293308294415,0.0902213115305978,0.00477569216657908,0.0216783464597812
"1700","인천","강화군",2018,386,204,182,"5",2016,389,200,189,447106,462028,0.967703256079718,0.992287917737789,1.0254051657919,0.0863329948602792,0.00219330404773704,-0.0165619019448238
"1701","인천","강화군",2019,353,183,170,"5",2017,395,210,185,459384,475293,0.966528015350531,0.893670886075949,0.92461974395211,0.0768420319384219,-0.00579237204275836,-0.134814551556684
"1702","인천","강화군",2020,334,166,168,"5",2018,328,156,172,417119,431567,0.966522000060246,1.01829268292683,1.05356389493809,0.0800730726723069,0.00428902565198982,0.0144717425134924
"1703","인천","계양구",2010,3450,1737,1713,"5",2008,3590,1823,1767,470657,486853,0.966733284995676,0.96100278551532,0.994072305599386,0.733017887761151,-0.00434510602883161,-0.113383299036471
"1704","인천","계양구",2011,3241,1688,1553,"5",2009,3437,1768,1669,451574,467208,0.966537388058424,0.942973523421589,0.975620327854911,0.717711825747275,-0.0174975790063719,-0.308146367425092
"1705","인천","계양구",2012,2837,1446,1391,"5",2010,3000,1512,1488,407210,420213,0.969056169133273,0.945666666666667,0.9758636256477,0.696692124456669,-0.0168156219241852,-0.298047882215289
"1706","인천","계양구",2013,2919,1512,1407,"5",2011,3054,1575,1479,420229,433401,0.969607822778443,0.955795677799607,0.985754915900682,0.694621266024001,-0.00989493835168696,-0.195565742907479
"1707","인천","계양구",2014,3228,1646,1582,"5",2012,3378,1716,1662,464047,479002,0.968778835996509,0.955595026642984,0.986391311552585,0.695619193745461,-0.00946646488572371,-0.189220867149391
"1708","인천","계양구",2015,2964,1488,1476,"5",2013,3122,1571,1551,441255,454391,0.971090976713887,0.949391415759129,0.977654451050314,0.67172043376279,-0.0150099618331507,-0.271309496179652
"1709","인천","계양구",2016,2720,1426,1294,"5",2014,2875,1488,1387,422114,434628,0.971207561408837,0.946086956521739,0.974134669163142,0.644375689979484,-0.0166669904045482,-0.295846932563219
"1710","인천","계양구",2017,2836,1430,1406,"5",2015,3011,1530,1481,445571,459820,0.969011787221086,0.941879774161408,0.972000327119356,0.636486665424814,-0.0178214184247866,-0.312941812274386
"1711","인천","계양구",2018,2606,1319,1287,"5",2016,2854,1432,1422,447106,462028,0.967703256079718,0.913104414856342,0.943578942325189,0.582859545611108,-0.0328855520392384,-0.536012932844405
"1712","인천","계양구",2019,2465,1258,1207,"5",2017,2761,1395,1366,459384,475293,0.966528015350531,0.892792466497646,0.923710903686383,0.53658812670881,-0.0409358232792315,-0.655222113561913
"1713","인천","계양구",2020,2091,1085,1006,"5",2018,2256,1180,1076,417119,431567,0.966522000060246,0.92686170212766,0.9589659646339,0.501295793286808,-0.0205701893106082,-0.353645872486799
"1714","인천","남동구",2010,4753,2476,2277,"5",2008,4772,2454,2318,470657,486853,0.966733284995676,0.996018440905281,1.03029290122118,1.00986493348659,0.0305917386768466,0.403964813848013
"1715","인천","남동구",2011,4547,2375,2172,"5",2009,4580,2379,2201,451574,467208,0.966537388058424,0.992794759825327,1.02716643152279,1.00692245346278,0.0273544898807546,0.356027326370114
"1716","인천","남동구",2012,4400,2279,2121,"5",2010,4403,2264,2139,407210,420213,0.969056169133273,0.99931864637747,1.03122881645887,1.08052356278087,0.0337434720215664,0.450635980404187
"1717","인천","남동구",2013,4671,2497,2174,"5",2011,4872,2563,2309,420229,433401,0.969607822778443,0.958743842364532,0.988795490136641,1.11153680493255,-0.0124542250943531,-0.233463903940706
"1718","인천","남동구",2014,5134,2624,2510,"5",2012,5453,2786,2667,464047,479002,0.968778835996509,0.941500091692646,0.971842134354841,1.10635345126679,-0.031152551836828,-0.510350501336968
"1719","인천","남동구",2015,4980,2508,2472,"5",2013,5211,2607,2604,441255,454391,0.971090976713887,0.955670696603339,0.984120663789165,1.12859910935853,-0.0179214047047534,-0.314422418599627
"1720","인천","남동구",2016,5079,2599,2480,"5",2014,5134,2652,2482,422114,434628,0.971207561408837,0.989287105570705,1.01861553068599,1.20322945934037,0.0223987549226333,0.282642332672529
"1721","인천","남동구",2017,5243,2696,2547,"5",2015,5502,2822,2680,445571,459820,0.969011787221086,0.9529262086514,0.983400017644969,1.17669237899235,-0.0195330727285723,-0.338288151688668
"1722","인천","남동구",2018,5242,2696,2546,"5",2016,5525,2862,2663,447106,462028,0.967703256079718,0.948778280542986,0.980443410293566,1.17242890947561,-0.0229287111425768,-0.388571087664216
"1723","인천","남동구",2019,5246,2679,2567,"5",2017,5750,2969,2781,459384,475293,0.966528015350531,0.912347826086957,0.943943488028203,1.14196402138516,-0.0640145198361391,-0.99697364298979
"1724","인천","남동구",2020,4656,2338,2318,"5",2018,5054,2546,2508,417119,431567,0.966522000060246,0.921250494657697,0.953160398418529,1.1162282226415,-0.0522836852225218,-0.823262330447347
"1725","인천","동구",2010,796,377,419,"5",2008,674,333,341,470657,486853,0.966733284995676,1.18100890207715,1.22164915639833,0.1691252865675,0.0374864770933117,0.506062754822364
"1726","인천","동구",2011,859,429,430,"5",2009,745,390,355,451574,467208,0.966537388058424,1.15302013422819,1.19293898867624,0.190223529255449,0.0367015353569709,0.494439263077725
"1727","인천","동구",2012,742,382,360,"5",2010,685,363,322,407210,420213,0.969056169133273,1.08321167883212,1.11780071510297,0.182215564450775,0.0214651237951925,0.268817034309703
"1728","인천","동구",2013,747,394,353,"5",2011,668,351,317,420229,433401,0.969607822778443,1.11826347305389,1.15331523403913,0.17776022121272,0.0272533499180758,0.354529636201757
"1729","인천","동구",2014,839,415,424,"5",2012,770,383,387,464047,479002,0.968778835996509,1.08961038961039,1.12472563305906,0.180800651658129,0.0225504757355501,0.284889028872745
"1730","인천","동구",2015,754,378,376,"5",2013,661,346,315,441255,454391,0.971090976713887,1.14069591527988,1.17465401556909,0.170876250694043,0.0298442233491054,0.392895535914729
"1731","인천","동구",2016,704,332,372,"5",2014,626,304,322,422114,434628,0.971207561408837,1.12460063897764,1.15794057178291,0.166779590347631,0.0263412638612246,0.341023379289452
"1732","인천","동구",2017,714,361,353,"5",2015,649,335,314,445571,459820,0.969011787221086,1.10015408320493,1.13533612048201,0.160243821972256,0.0216867771969355,0.272099298923814
"1733","인천","동구",2018,663,345,318,"5",2016,633,335,298,447106,462028,0.967703256079718,1.04739336492891,1.08234973722423,0.14828698339991,0.0122113941167556,0.131786926793886
"1734","인천","동구",2019,658,325,333,"5",2017,635,329,306,459384,475293,0.966528015350531,1.03622047244094,1.07210598760051,0.143235288995699,0.0103281219722797,0.103899254103336
"1735","인천","동구",2020,539,286,253,"5",2018,468,240,228,417119,431567,0.966522000060246,1.1517094017094,1.19160184831552,0.129219719072974,0.0247587370131941,0.317589171497798
"1736","인천","미추홀구",2020,2815,1453,1362,"5",2018,3233,1679,1554,417119,431567,0.966522000060246,0.870708320445407,0.900867564722928,0.674867363989653,-0.0669012452813127,-1.03972054741283
"1737","인천","부평구",2010,5382,2831,2551,"5",2008,5759,2995,2764,470657,486853,0.966733284995676,0.934537246049661,0.966696047973398,1.1435079049074,-0.0380833324070755,-0.612982157945936
"1738","인천","부평구",2011,4839,2526,2313,"5",2009,5257,2771,2486,451574,467208,0.966537388058424,0.920486969754613,0.952355264397669,1.07158516655078,-0.0510553919356911,-0.805073646856603
"1739","인천","부평구",2012,4485,2343,2142,"5",2010,4874,2549,2325,407210,420213,0.969056169133273,0.920188756668034,0.949572156886483,1.10139731342551,-0.0555410909270702,-0.871498303339123
"1740","인천","부평구",2013,4448,2329,2119,"5",2011,4737,2444,2293,420229,433401,0.969607822778443,0.938990922524805,0.968423418691173,1.058470500608,-0.0334228798254435,-0.543969733709952
"1741","인천","부평구",2014,5006,2590,2416,"5",2012,5363,2790,2573,464047,479002,0.968778835996509,0.933432780160358,0.963514834838652,1.07877003837973,-0.0393591030213986,-0.631873890309112
"1742","인천","부평구",2015,4537,2358,2179,"5",2013,4785,2506,2279,441255,454391,0.971090976713887,0.948171368861024,0.976398083802177,1.0282036464176,-0.0242675762970442,-0.408397129967285
"1743","인천","부평구",2016,4474,2305,2169,"5",2014,4651,2375,2276,422114,434628,0.971207561408837,0.961943668028381,0.990461469053003,1.05990324888537,-0.0101099199403162,-0.198749210679661
"1744","인천","부평구",2017,4338,2237,2101,"5",2015,4715,2403,2312,445571,459820,0.969011787221086,0.920042417815482,0.94946462978945,0.973582212486899,-0.0492003375384314,-0.777603825245484
"1745","인천","부평구",2018,4209,2171,2038,"5",2016,4633,2361,2272,447106,462028,0.967703256079718,0.908482624649255,0.938802901552308,0.941387500950558,-0.0576101835730982,-0.902137623656213
"1746","인천","부평구",2019,4246,2170,2076,"5",2017,4586,2330,2256,459384,475293,0.966528015350531,0.925861317051897,0.957924966837215,0.924281211361301,-0.0388891626197656,-0.624914968231255
"1747","인천","부평구",2020,3626,1832,1794,"5",2018,3963,2004,1959,417119,431567,0.966522000060246,0.914963411556901,0.946655545864315,0.869296291945464,-0.0463721361760057,-0.735723550995346
"1748","인천","서구",2010,4697,2443,2254,"5",2008,4835,2489,2346,470657,486853,0.966733284995676,0.971458117890383,1.00488742134779,0.997966672120037,0.0048774836177016,0.0231856839308566
"1749","인천","서구",2011,4511,2310,2201,"5",2009,4586,2346,2240,451574,467208,0.966537388058424,0.983645878761448,1.01770080590198,0.998950338150558,0.0176822260413155,0.21279952526759
"1750","인천","서구",2012,4547,2382,2165,"5",2010,4223,2216,2007,407210,420213,0.969056169133273,1.07672270897466,1.11110453993362,1.11662287271924,0.124061870552829,1.78807939959491
"1751","인천","서구",2013,5127,2642,2485,"5",2011,4876,2527,2349,420229,433401,0.969607822778443,1.05147662018048,1.08443495965971,1.22004906848409,0.103014793880315,1.47641229027263
"1752","인천","서구",2014,5649,2854,2795,"5",2012,5698,2911,2787,464047,479002,0.968778835996509,0.991400491400491,1.02335069116236,1.21733358905456,0.0284255806795764,0.371888140595514
"1753","인천","서구",2015,5471,2745,2726,"5",2013,5617,2828,2789,441255,454391,0.971090976713887,0.97400747730105,1.00300332374319,1.23987263600412,0.00372373892624346,0.00610092301713418
"1754","인천","서구",2016,5111,2657,2454,"5",2014,5396,2820,2576,422114,434628,0.971207561408837,0.947183098591549,0.975263307482452,1.21081034981071,-0.0299514433203319,-0.492564372405933
"1755","인천","서구",2017,5554,2862,2692,"5",2015,5796,2974,2822,445571,459820,0.969011787221086,0.958247066942719,0.988891032678521,1.2464904583108,-0.0138472217679106,-0.254091530917054
"1756","인천","서구",2018,5863,3035,2828,"5",2016,5899,3056,2843,447106,462028,0.967703256079718,0.993897270723851,1.02706823034806,1.31132214732077,0.0354951699441913,0.476575289527498
"1757","인천","서구",2019,5921,3095,2826,"5",2017,5984,3119,2865,459384,475293,0.966528015350531,0.98947192513369,1.02373848395366,1.28889991815126,0.0305965300249038,0.404035764584877
"1758","인천","서구",2020,5318,2705,2613,"5",2018,5701,2891,2810,417119,431567,0.966522000060246,0.932818803718646,0.96512940591161,1.27493592955488,-0.0444577732882124,-0.707375483626371
"1759","인천","연수구",2010,2810,1408,1402,"5",2008,2742,1396,1346,470657,486853,0.966733284995676,1.02479941648432,1.06006427252466,0.597037757857633,0.0358606385954738,0.481987184008876
"1760","인천","연수구",2011,2675,1400,1275,"5",2009,2590,1339,1251,451574,467208,0.966537388058424,1.03281853281853,1.06857587257256,0.592372457227387,0.0406224581423193,0.552500659888298
"1761","인천","연수구",2012,2614,1304,1310,"5",2010,2447,1236,1211,407210,420213,0.969056169133273,1.06824683285656,1.10235801275792,0.641929225706638,0.0657065998745629,0.923949011845337
"1762","인천","연수구",2013,2738,1409,1329,"5",2011,2584,1325,1259,420229,433401,0.969607822778443,1.05959752321981,1.09281041089737,0.651549512289728,0.0604705779555903,0.846413502224401
"1763","인천","연수구",2014,3203,1673,1530,"5",2012,2934,1527,1407,464047,479002,0.968778835996509,1.09168370824813,1.12686576923947,0.690231808415958,0.0875667893282414,1.24765677241823
"1764","인천","연수구",2015,3134,1630,1504,"5",2013,2896,1535,1361,441255,454391,0.971090976713887,1.08218232044199,1.11439849240905,0.710246909383463,0.0812511756716561,1.1541345658633
"1765","인천","연수구",2016,3226,1686,1540,"5",2014,3011,1577,1434,422114,434628,0.971207561408837,1.07140484888741,1.10316773824663,0.764248520541844,0.0788457913226361,1.11851540608482
"1766","인천","연수구",2017,3514,1827,1687,"5",2015,3317,1715,1602,445571,459820,0.969011787221086,1.05939101597829,1.09326948335313,0.788650966961494,0.0735570682344476,1.04019949254732
"1767","인천","연수구",2018,3667,1873,1794,"5",2016,3446,1760,1686,447106,462028,0.967703256079718,1.06413232733604,1.09964735640858,0.820163451172653,0.0817271197322963,1.16118239069365
"1768","인천","연수구",2019,3981,2017,1964,"5",2017,3710,1896,1814,459384,475293,0.966528015350531,1.07304582210243,1.11020664177361,0.866595266704979,0.0955045541204622,1.36519994697712
"1769","인천","연수구",2020,3979,2025,1954,"5",2018,3634,1869,1765,417119,431567,0.966522000060246,1.09493670886076,1.1328626857873,0.953924419650028,0.126740960432791,1.82775161685788
"1770","인천","옹진군",2010,119,64,55,"5",2008,148,76,72,470657,486853,0.966733284995676,0.804054054054054,0.831722737319063,0.0252838054039354,-0.00425468956353172,-0.112044403435261
"1771","인천","옹진군",2011,114,53,61,"5",2009,144,71,73,451574,467208,0.966537388058424,0.791666666666667,0.819075057465664,0.025245031822027,-0.0045674559316777,-0.116675877505035
"1772","인천","옹진군",2012,90,51,39,"5",2010,115,65,50,407210,420213,0.969056169133273,0.782608695652174,0.80759889940347,0.0221016183296088,-0.00425237569158118,-0.112010139399767
"1773","인천","옹진군",2013,122,57,65,"5",2011,142,67,75,420229,433401,0.969607822778443,0.859154929577465,0.886084981364453,0.0290317898098418,-0.0033071568772114,-0.0980132494689012
"1774","인천","옹진군",2014,118,50,68,"5",2012,148,65,83,464047,479002,0.968778835996509,0.797297297297297,0.822992067613841,0.0254284587552554,-0.00450103890803448,-0.115692367914095
"1775","인천","옹진군",2015,107,55,52,"5",2013,149,73,76,441255,454391,0.971090976713887,0.718120805369127,0.739498999155779,0.0242490170083059,-0.00631689320015222,-0.142581710647087
"1776","인천","옹진군",2016,114,62,52,"5",2014,135,70,65,422114,434628,0.971207561408837,0.844444444444444,0.869478861160729,0.0270069223006107,-0.00352497425521941,-0.101238709879399
"1777","인천","옹진군",2017,111,57,54,"5",2015,134,67,67,445571,459820,0.969011787221086,0.828358208955224,0.85484843412563,0.0249118546763591,-0.00361599471510827,-0.102586549489819
"1778","인천","옹진군",2018,108,63,45,"5",2016,136,75,61,447106,462028,0.967703256079718,0.794117647058823,0.820621034464521,0.0241553457122025,-0.00433296092600675,-0.113203453200931
"1779","인천","옹진군",2019,102,47,55,"5",2017,120,57,63,459384,475293,0.966528015350531,0.85,0.879436484509691,0.0222036466224335,-0.00267694969350511,-0.0886810816683068
"1780","인천","옹진군",2020,97,52,45,"5",2018,134,71,63,417119,431567,0.966522000060246,0.723880597014925,0.748954081717544,0.0232547546383646,-0.00583801123262144,-0.135490381012611
"1781","인천","중구",2010,938,490,448,"5",2008,856,437,419,470657,486853,0.966733284995676,1.09579439252336,1.1335022901671,0.199295877889843,0.0266064561191571,0.344950371419072
"1782","인천","중구",2011,1006,515,491,"5",2009,904,450,454,451574,467208,0.966537388058424,1.11283185840708,1.15135934952556,0.22277633344701,0.0337192809202285,0.450277756279164
"1783","인천","중구",2012,877,477,400,"5",2010,789,418,371,407210,420213,0.969056169133273,1.11153358681876,1.14702699618838,0.215367991945188,0.0316649089308245,0.419856420842762
"1784","인천","중구",2013,1066,572,494,"5",2011,846,444,402,420229,433401,0.969607822778443,1.26004728132388,1.29954322946072,0.253671212600749,0.0759854942436456,1.07615985541701
"1785","인천","중구",2014,1343,668,675,"5",2012,1059,555,504,464047,479002,0.968778835996509,1.26817752596789,1.30904751306155,0.289410339900915,0.0894415458006758,1.27541834422881
"1786","인천","중구",2015,1244,623,621,"5",2013,1091,540,551,441255,454391,0.971090976713887,1.14023831347388,1.17418279112465,0.281923151012453,0.049106161326006,0.678128141972823
"1787","인천","중구",2016,1201,612,589,"5",2014,1064,535,529,422114,434628,0.971207561408837,1.12875939849624,1.16222262196853,0.284520295465206,0.0461556283336266,0.63443636933364
"1788","인천","중구",2017,1244,643,601,"5",2015,1206,626,580,445571,459820,0.969011787221086,1.03150912106136,1.06449594800028,0.27919231727379,0.0180067731769692,0.217605450060941
"1789","인천","중구",2018,1345,690,655,"5",2016,1251,637,614,447106,462028,0.967703256079718,1.07513988808953,1.11102229049538,0.300823518360299,0.0333981160432403,0.445521916293201
"1790","인천","중구",2019,1442,746,696,"5",2017,1226,618,608,459384,475293,0.966528015350531,1.17618270799347,1.21691527748102,0.313898612054403,0.0680894045346891,0.95923380944723
"1791","인천","중구",2020,1391,714,677,"5",2018,1129,562,567,417119,431567,0.966522000060246,1.23206377325066,1.27473950222951,0.333477976308919,0.0916195732156155,1.3076707809449
"1792","전남","강진군",2010,257,130,127,"5",2008,298,152,146,470657,486853,0.966733284995676,0.86241610738255,0.892093114789575,0.0546045209143814,-0.00589220377027843,-0.136292869254622
"1793","전남","강진군",2011,231,119,112,"5",2009,266,138,128,451574,467208,0.966537388058424,0.868421052631579,0.898486766638236,0.0511544065867388,-0.00519284921332218,-0.125936760586924
"1794","전남","강진군",2012,227,122,105,"5",2010,268,143,125,407210,420213,0.969056169133273,0.847014925373134,0.874061744151226,0.0557451928980133,-0.00702045236552924,-0.153000081555414
"1795","전남","강진군",2013,223,117,106,"5",2011,297,148,149,420229,433401,0.969607822778443,0.750841750841751,0.7743767461469,0.0530663043245468,-0.0119729922516631,-0.226337762323708
"1796","전남","강진군",2014,249,119,130,"5",2012,304,149,155,464047,479002,0.968778835996509,0.819078947368421,0.845475682306681,0.0536583578818525,-0.00829152114023718,-0.171822188631233
"1797","전남","강진군",2015,239,128,111,"5",2013,293,155,138,441255,454391,0.971090976713887,0.815699658703072,0.839982739272637,0.0541636921961224,-0.00866712565610356,-0.177384175957547
"1798","전남","강진군",2016,194,96,98,"5",2014,249,119,130,422114,434628,0.971207561408837,0.779116465863454,0.80221416803352,0.0459591484764779,-0.00909006841789117,-0.183647152523184
"1799","전남","강진군",2017,219,117,102,"5",2015,258,142,116,445571,459820,0.969011787221086,0.848837209302326,0.875982336331124,0.0491504159830869,-0.0060955197585758,-0.139303591709698
"1800","전남","강진군",2018,223,118,105,"5",2016,296,153,143,447106,462028,0.967703256079718,0.753378378378378,0.778522107521271,0.0498763156835292,-0.0110465012821918,-0.212618196097895
"1801","전남","강진군",2019,192,98,94,"5",2017,223,113,110,459384,475293,0.966528015350531,0.860986547085202,0.890803508445586,0.0417950995245807,-0.00456387823225179,-0.116622898592312
"1802","전남","강진군",2020,181,95,86,"5",2018,211,109,102,417119,431567,0.966522000060246,0.85781990521327,0.887532725752544,0.0433928926757112,-0.00488028036094965,-0.121308211349474
"1803","전남","고흥군",2010,415,227,188,"5",2008,442,235,207,470657,486853,0.966733284995676,0.938914027149321,0.971223440551672,0.0881746154843124,-0.00253736206431774,-0.0866140548045338
"1804","전남","고흥군",2011,371,206,165,"5",2009,399,215,184,451574,467208,0.966537388058424,0.929824561403509,0.962016133976293,0.0821570772453684,-0.00312064341498743,-0.0952513404149493
"1805","전남","고흥군",2012,384,203,181,"5",2010,404,209,195,407210,420213,0.969056169133273,0.95049504950495,0.980846188054379,0.0943002382063309,-0.00180620902903131,-0.0757870712511587
"1806","전남","고흥군",2013,350,179,171,"5",2011,360,187,173,420229,433401,0.969607822778443,0.972222222222222,1.00269634730905,0.0832879215856117,0.000224573163243454,-0.0457150557699779
"1807","전남","고흥군",2014,388,203,185,"5",2012,404,210,194,464047,479002,0.968778835996509,0.96039603960396,0.991347048385996,0.0836122203138906,-0.000723492496715541,-0.0597541020605736
"1808","전남","고흥군",2015,312,157,155,"5",2013,343,170,173,441255,454391,0.971090976713887,0.909620991253644,0.936700075549817,0.0707074140802937,-0.00447577396935037,-0.115318242303712
"1809","전남","고흥군",2016,319,164,155,"5",2014,356,186,170,422114,434628,0.971207561408837,0.896067415730337,0.922632248075271,0.0755720018762704,-0.00584683589361844,-0.135621057430361
"1810","전남","고흥군",2017,326,168,158,"5",2015,346,185,161,445571,459820,0.969011787221086,0.942196531791908,0.972327214402542,0.0731645461666042,-0.00202466679940378,-0.079022014652581
"1811","전남","고흥군",2018,292,157,135,"5",2016,323,169,154,447106,462028,0.967703256079718,0.904024767801858,0.934196265355322,0.0653088976663252,-0.00429756937197128,-0.112679371709126
"1812","전남","고흥군",2019,310,148,162,"5",2017,332,162,170,459384,475293,0.966528015350531,0.933734939759036,0.9660712622183,0.067481671107396,-0.00228956792407375,-0.0829446956532128
"1813","전남","고흥군",2020,260,145,115,"5",2018,285,151,134,417119,431567,0.966522000060246,0.912280701754386,0.943879913439654,0.0623323320203587,-0.00349809586849075,-0.100840692177211
"1814","전남","곡성군",2010,196,98,98,"5",2008,243,127,116,470657,486853,0.966733284995676,0.806584362139918,0.834340117029823,0.0416439147829523,-0.00689872604936391,-0.151197546710409
"1815","전남","곡성군",2011,188,98,90,"5",2009,194,108,86,451574,467208,0.966537388058424,0.969072164948454,1.00262253371814,0.0416321577415883,0.000109181737436397,-0.0474237829571995
"1816","전남","곡성군",2012,160,85,75,"5",2010,187,96,91,407210,420213,0.969056169133273,0.855614973262032,0.882936408141643,0.0392917659193045,-0.00459963524897158,-0.117152391890239
"1817","전남","곡성군",2013,177,102,75,"5",2011,198,112,86,420229,433401,0.969607822778443,0.893939393939394,0.921959758304942,0.042119891773295,-0.00328704653415765,-0.0977154535999277
"1818","전남","곡성군",2014,154,80,74,"5",2012,171,86,85,464047,479002,0.968778835996509,0.900584795321637,0.929608246855717,0.0331862936297401,-0.00233604138895835,-0.0836328791328543
"1819","전남","곡성군",2015,177,105,72,"5",2013,191,109,82,441255,454391,0.971090976713887,0.926701570680628,0.954289137580631,0.0401128599109359,-0.0018335934206362,-0.076192581921588
"1820","전남","곡성군",2016,152,84,68,"5",2014,167,89,78,422114,434628,0.971207561408837,0.910179640718563,0.937162844364858,0.0360092297341476,-0.00226271757310623,-0.0825470931072372
"1821","전남","곡성군",2017,155,73,82,"5",2015,167,81,86,445571,459820,0.969011787221086,0.92814371257485,0.95782499739922,0.0347868240976186,-0.00146713439678995,-0.0707660219092714
"1822","전남","곡성군",2018,169,83,86,"5",2016,190,90,100,447106,462028,0.967703256079718,0.889473684210526,0.919159544645836,0.0377986428274279,-0.00305565949793869,-0.094289052402502
"1823","전남","곡성군",2019,129,70,59,"5",2017,143,78,65,459384,475293,0.966528015350531,0.902097902097902,0.933338597299467,0.0280810824930777,-0.00187192434833795,-0.0767601899376715
"1824","전남","곡성군",2020,113,65,48,"5",2018,132,71,61,417119,431567,0.966522000060246,0.856060606060606,0.885712488704081,0.027090590455002,-0.00309611616263916,-0.0948881385338546
"1825","전남","광양시",2010,1497,806,691,"5",2008,1534,820,714,470657,486853,0.966733284995676,0.975880052151239,1.00946152087398,0.318066022602447,0.0030093883121583,-0.0044772486880733
"1826","전남","광양시",2011,1518,791,727,"5",2009,1523,800,723,451574,467208,0.966537388058424,0.996717005909389,1.03122447017967,0.336157528998569,0.0104963407398872,0.106390253582729
"1827","전남","광양시",2012,1418,726,692,"5",2010,1421,730,691,407210,420213,0.969056169133273,0.997888810696692,1.02975332336949,0.348223275459836,0.0103607997195389,0.104383149286781
"1828","전남","광양시",2013,1462,730,732,"5",2011,1535,777,758,420229,433401,0.969607822778443,0.952442996742671,0.982297145678357,0.347905546737612,-0.00615892121158742,-0.140242446444463
"1829","전남","광양시",2014,1610,845,765,"5",2012,1681,881,800,464047,479002,0.968778835996509,0.957763236168947,0.988629396702054,0.34694761522001,-0.0039450036978352,-0.107458545738185
"1830","전남","광양시",2015,1533,785,748,"5",2013,1596,830,766,441255,454391,0.971090976713887,0.960526315789474,0.989120832982957,0.347418159567597,-0.00377962018268953,-0.105009530946391
"1831","전남","광양시",2016,1459,747,712,"5",2014,1526,772,754,422114,434628,0.971207561408837,0.956094364351245,0.984438756803264,0.345641224882378,-0.00537860715921244,-0.128687481883287
"1832","전남","광양시",2017,1652,866,786,"5",2015,1700,880,820,445571,459820,0.969011787221086,0.971764705882353,1.00284095477224,0.370760215543651,0.00105331300370691,-0.0334429975418268
"1833","전남","광양시",2018,1606,802,804,"5",2016,1707,855,852,447106,462028,0.967703256079718,0.94083186877563,0.972231789926028,0.359198937164789,-0.00997431154553932,-0.196741108696779
"1834","전남","광양시",2019,1648,835,813,"5",2017,1746,885,861,459384,475293,0.966528015350531,0.943871706758305,0.97655907719963,0.358741270919318,-0.00840922643692628,-0.173565179838127
"1835","전남","광양시",2020,1444,733,711,"5",2018,1554,788,766,417119,431567,0.966522000060246,0.929214929214929,0.961400701853666,0.346184182451531,-0.0133624664719915,-0.24691322847826
"1836","전남","구례군",2010,180,100,80,"5",2008,206,109,97,470657,486853,0.966733284995676,0.87378640776699,0.903854683943047,0.0382444115353644,-0.00367702103447981,-0.103490233020175
"1837","전남","구례군",2011,151,76,75,"5",2009,154,80,74,451574,467208,0.966537388058424,0.980519480519481,1.01446616823499,0.0334385947818076,0.00048372833765514,-0.041877461346222
"1838","전남","구례군",2012,171,91,80,"5",2010,176,91,85,407210,420213,0.969056169133273,0.971590909090909,1.00261567908897,0.0419930748262567,0.000109840407704461,-0.0474140293053438
"1839","전남","구례군",2013,162,83,79,"5",2011,174,88,86,420229,433401,0.969607822778443,0.931034482758621,0.960217585797432,0.038550409419626,-0.00153362835521015,-0.0717506707576923
"1840","전남","구례군",2014,184,98,86,"5",2012,188,100,88,464047,479002,0.968778835996509,0.978723404255319,1.0102650552317,0.039651156025144,0.000407021306599001,-0.043013346343742
"1841","전남","구례군",2015,170,97,73,"5",2013,164,93,71,441255,454391,0.971090976713887,1.03658536585366,1.06744413315568,0.0385264756206729,0.00259838475177974,-0.0105634284258815
"1842","전남","구례군",2016,170,87,83,"5",2014,163,85,78,422114,434628,0.971207561408837,1.04294478527607,1.07386394702609,0.0402734806237178,0.0029747582393464,-0.00499005409363345
"1843","전남","구례군",2017,155,80,75,"5",2015,173,86,87,445571,459820,0.969011787221086,0.895953757225434,0.92460563332757,0.0347868240976186,-0.00262273057138517,-0.087878199761045
"1844","전남","구례군",2018,158,75,83,"5",2016,177,93,84,447106,462028,0.967703256079718,0.892655367231638,0.922447415179621,0.0353383761345184,-0.00274058241258671,-0.0896233610129904
"1845","전남","구례군",2019,136,59,77,"5",2017,150,67,83,459384,475293,0.966528015350531,0.906666666666667,0.938065583477004,0.0296048621632447,-0.00183355986432428,-0.0761920850165355
"1846","전남","구례군",2020,139,70,69,"5",2018,159,79,80,417119,431567,0.966522000060246,0.874213836477987,0.904494503408609,0.0333238236570379,-0.00318260832668935,-0.096168922709633
"1847","전남","나주시",2010,670,326,344,"5",2008,747,379,368,470657,486853,0.966733284995676,0.896921017402945,0.927785389542015,0.142354198492745,-0.0102800529912123,-0.201268557047711
"1848","전남","나주시",2011,576,311,265,"5",2009,664,362,302,451574,467208,0.966537388058424,0.867469879518072,0.897502662841261,0.127553844995505,-0.0130739294563978,-0.242640544961124
"1849","전남","나주시",2012,551,309,242,"5",2010,611,344,267,407210,420213,0.969056169133273,0.901800327332242,0.93059654956721,0.135311018884605,-0.00939105159216802,-0.188104139939589
"1850","전남","나주시",2013,552,290,262,"5",2011,560,305,255,420229,433401,0.969607822778443,0.985714285714286,1.0166113170268,0.131356950615022,0.00218201195034046,-0.0167291163950079
"1851","전남","나주시",2014,597,315,282,"5",2012,629,333,296,464047,479002,0.968778835996509,0.94912559618442,0.97971338856523,0.128650761668538,-0.0026098880127568,-0.0876880259337584
"1852","전남","나주시",2015,630,333,297,"5",2013,561,299,262,441255,454391,0.971090976713887,1.12299465240642,1.15642579257256,0.14277458612367,0.0223336277936141,0.281677923963627
"1853","전남","나주시",2016,728,369,359,"5",2014,600,318,282,422114,434628,0.971207561408837,1.21333333333333,1.24930383735199,0.172465258200391,0.0429962506792602,0.587652005114561
"1854","전남","나주시",2017,914,479,435,"5",2015,746,396,350,445571,459820,0.969011787221086,1.22520107238606,1.26438201118241,0.205130046614344,0.0542326942778419,0.754042328574836
"1855","전남","나주시",2018,1006,475,531,"5",2016,925,439,486,447106,462028,0.967703256079718,1.08756756756757,1.12386473925223,0.225002572096997,0.0278698849238759,0.363659345094045
"1856","전남","나주시",2019,1145,584,561,"5",2017,1157,609,548,459384,475293,0.966528015350531,0.989628349178911,1.02390032514474,0.249246817477317,0.00595707997900006,0.039172449332826
"1857","전남","나주시",2020,989,520,469,"5",2018,1074,561,513,417119,431567,0.966522000060246,0.920856610800745,0.952752871371108,0.237102601415903,-0.0112024171073422,-0.21492701243749
"1858","전남","담양군",2010,241,125,116,"5",2008,293,146,147,470657,486853,0.966733284995676,0.822525597269625,0.850829913519843,0.0512050176667934,-0.00763825691357356,-0.162148589949769
"1859","전남","담양군",2011,227,126,101,"5",2009,263,146,117,451574,467208,0.966537388058424,0.863117870722434,0.89299998260415,0.0502686159964923,-0.00537874278608995,-0.128689490258964
"1860","전남","담양군",2012,218,109,109,"5",2010,257,128,129,407210,420213,0.969056169133273,0.848249027237354,0.875335253266104,0.0535350310650524,-0.00667393108911601,-0.147868761599735
"1861","전남","담양군",2013,212,113,99,"5",2011,241,129,112,420229,433401,0.969607822778443,0.879668049792531,0.907241081524913,0.0504486839318562,-0.00467956536001047,-0.118336004562104
"1862","전남","담양군",2014,233,117,116,"5",2012,285,142,143,464047,479002,0.968778835996509,0.817543859649123,0.843891122794995,0.0502104312709704,-0.00783829404969025,-0.165110758850499
"1863","전남","담양군",2015,241,136,105,"5",2013,258,152,106,441255,454391,0.971090976713887,0.934108527131783,0.961916596416897,0.0546169448504833,-0.00207999915321702,-0.079841381400434
"1864","전남","담양군",2016,246,132,114,"5",2014,264,136,128,422114,434628,0.971207561408837,0.931818181818182,0.959442882082264,0.0582780954907916,-0.00236359159084112,-0.0840408451376184
"1865","전남","담양군",2017,269,130,139,"5",2015,285,132,153,445571,459820,0.969011787221086,0.943859649122807,0.9740435168798,0.060371972143609,-0.0015670440758788,-0.0722454939214393
"1866","전남","담양군",2018,221,125,96,"5",2016,243,131,112,447106,462028,0.967703256079718,0.909465020576132,0.939818084585644,0.0494289944666366,-0.00297473156400779,-0.0930906638745309
"1867","전남","담양군",2019,242,126,116,"5",2017,275,138,137,459384,475293,0.966528015350531,0.88,0.910475419257092,0.0526792400257736,-0.00471608687716239,-0.118876818655002
"1868","전남","담양군",2020,198,98,100,"5",2018,248,126,122,417119,431567,0.966522000060246,0.798387096774194,0.826041307620963,0.0474684682308885,-0.00825755266268124,-0.171319180191027
"1869","전남","목포시",2010,2887,1481,1406,"5",2008,2749,1421,1328,470657,486853,0.966733284995676,1.05020007275373,1.08633900275651,0.61339786723665,0.0529601601501829,0.735198522413415
"1870","전남","목포시",2011,2736,1421,1315,"5",2009,2605,1357,1248,451574,467208,0.966537388058424,1.05028790786948,1.08665005704466,0.605880763728647,0.0524996027393488,0.728378544554015
"1871","전남","목포시",2012,2501,1261,1240,"5",2010,2373,1194,1179,407210,420213,0.969056169133273,1.05394016013485,1.08759450040703,0.614179416026129,0.053798739107089,0.747616279211855
"1872","전남","목포시",2013,2638,1350,1288,"5",2011,2531,1307,1224,420229,433401,0.969607822778443,1.04227578032398,1.07494572118582,0.627752963265267,0.0470473985584488,0.647641787476721
"1873","전남","목포시",2014,2741,1424,1317,"5",2012,2660,1381,1279,464047,479002,0.968778835996509,1.03045112781955,1.06365982568106,0.590672927526738,0.0376021356008745,0.507775436981577
"1874","전남","목포시",2015,2631,1358,1273,"5",2013,2500,1308,1192,441255,454391,0.971090976713887,1.0524,1.08372956317775,0.596253866811708,0.0499240758111912,0.690239897312385
"1875","전남","목포시",2016,2538,1292,1246,"5",2014,2394,1213,1181,422114,434628,0.971207561408837,1.06015037593985,1.09157961497128,0.601259375429386,0.0550631020996928,0.766339086429711
"1876","전남","목포시",2017,2756,1430,1326,"5",2015,2579,1326,1253,445571,459820,0.969011787221086,1.06863125242342,1.10280521508208,0.618532175567979,0.0635883333444523,0.892581519984774
"1877","전남","목포시",2018,2756,1360,1396,"5",2016,2639,1333,1306,447106,462028,0.967703256079718,1.04433497536946,1.0791892750265,0.616408636878056,0.0488129530744488,0.673786286350107
"1878","전남","목포시",2019,2762,1389,1373,"5",2017,2596,1327,1269,459384,475293,0.966528015350531,1.06394453004622,1.10079016143196,0.601239921285896,0.0605990687257455,0.848316205746224
"1879","전남","목포시",2020,2389,1210,1179,"5",2018,2245,1137,1108,417119,431567,0.966522000060246,1.0641425389755,1.10100187984254,0.572738235371681,0.0578476384302384,0.807572764742736
"1880","전남","무안군",2010,613,327,286,"5",2008,610,308,302,470657,486853,0.966733284995676,1.00491803278689,1.03949874115628,0.130243468173213,0.00514445303667054,0.0271389924298064
"1881","전남","무안군",2011,574,298,276,"5",2009,667,344,323,451574,467208,0.966537388058424,0.860569715142429,0.890363607010731,0.127110949700381,-0.0139359860345902,-0.255405960604255
"1882","전남","무안군",2012,529,252,277,"5",2010,659,332,327,407210,420213,0.969056169133273,0.802731411229135,0.828364172065589,0.129908401070701,-0.0222969359734052,-0.379215700986006
"1883","전남","무안군",2013,577,293,284,"5",2011,665,331,334,420229,433401,0.969607822778443,0.867669172932331,0.894866102096821,0.137306087871137,-0.014435524223729,-0.262803169529154
"1884","전남","무안군",2014,775,394,381,"5",2012,785,407,378,464047,479002,0.968778835996509,0.987261146496815,1.01907794618706,0.167008945214601,0.00318618766956215,-0.00185918702043768
"1885","전남","무안군",2015,787,408,379,"5",2013,853,437,416,441255,454391,0.971090976713887,0.922626025791325,0.950092265210243,0.178354919490997,-0.00890129002040513,-0.180851704092866
"1886","전남","무안군",2016,790,413,377,"5",2014,878,453,425,422114,434628,0.971207561408837,0.899772209567198,0.926446874303558,0.187153233486688,-0.0137657053071419,-0.252884427427801
"1887","전남","무안군",2017,819,407,412,"5",2015,948,481,467,445571,459820,0.969011787221086,0.863924050632911,0.891551642638379,0.183809089909352,-0.0199337938688037,-0.344222068372848
"1888","전남","무안군",2018,777,382,395,"5",2016,888,436,452,447106,462028,0.967703256079718,0.875,0.904202806493315,0.17378429276279,-0.0166480475222194,-0.295566424563486
"1889","전남","무안군",2019,827,438,389,"5",2017,999,509,490,459384,475293,0.966528015350531,0.827827827827828,0.856496464334352,0.180023683889731,-0.0258340351417314,-0.431593401240128
"1890","전남","무안군",2020,702,362,340,"5",2018,811,415,396,417119,431567,0.966522000060246,0.865598027127004,0.895580263121842,0.168297296454968,-0.0175735594131332,-0.309271492501077
"1891","전남","보성군",2010,290,164,126,"5",2008,334,180,154,470657,486853,0.966733284995676,0.868263473053892,0.898141696918789,0.0616159963625315,-0.00627610083214552,-0.141977653389308
"1892","전남","보성군",2011,244,126,118,"5",2009,285,148,137,451574,467208,0.966537388058424,0.856140350877193,0.885780893170624,0.0540332260050402,-0.00617162681340548,-0.140430592202302
"1893","전남","보성군",2012,229,122,107,"5",2010,284,140,144,407210,420213,0.969056169133273,0.806338028169014,0.832085955234365,0.0562363399720046,-0.00944287130751463,-0.188871491203581
"1894","전남","보성군",2013,252,136,116,"5",2011,315,165,150,420229,433401,0.969607822778443,0.8,0.825075851500016,0.0599673035416404,-0.0104897295098615,-0.20437346684003
"1895","전남","보성군",2014,256,127,129,"5",2012,332,175,157,464047,479002,0.968778835996509,0.771084337349398,0.79593433371843,0.0551668257741134,-0.0112576550582338,-0.215744981257918
"1896","전남","보성군",2015,222,105,117,"5",2013,287,135,152,441255,454391,0.971090976713887,0.773519163763066,0.796546546422054,0.0503110446340551,-0.0102359557839127,-0.200615561415962
"1897","전남","보성군",2016,214,101,113,"5",2014,236,118,118,422114,434628,0.971207561408837,0.906779661016949,0.933662068797705,0.0506972050204447,-0.00336314769879489,-0.098842366870003
"1898","전남","보성군",2017,224,108,116,"5",2015,281,135,146,445571,459820,0.969011787221086,0.797153024911032,0.822645333548617,0.0502725715991391,-0.00891607516761859,-0.181070643956326
"1899","전남","보성군",2018,238,122,116,"5",2016,293,151,142,447106,462028,0.967703256079718,0.812286689419795,0.83939646200062,0.053231224810224,-0.00854912303656235,-0.175636781965635
"1900","전남","보성군",2019,200,110,90,"5",2017,266,151,115,459384,475293,0.966528015350531,0.75187969924812,0.77791816409526,0.0435365620047716,-0.00966867961900023,-0.192215282115578
"1901","전남","보성군",2020,170,85,85,"5",2018,212,109,103,417119,431567,0.966522000060246,0.80188679245283,0.829662224349623,0.040755755551773,-0.0069422447456395,-0.151841975695998
"1902","전남","순천시",2010,2966,1552,1414,"5",2008,2934,1530,1404,470657,486853,0.966733284995676,1.01090661213361,1.04569339633126,0.630182914521616,0.0287951976744256,0.377361464142221
"1903","전남","순천시",2011,2832,1440,1392,"5",2009,2806,1436,1370,451574,467208,0.966537388058424,1.00926585887384,1.04420777855397,0.627139737894564,0.0277244546552369,0.361505799870643
"1904","전남","순천시",2012,2519,1275,1244,"5",2010,2514,1291,1223,407210,420213,0.969056169133273,1.00198886237072,1.03398429759433,0.618599739692051,0.0210226776454727,0.262265249724148
"1905","전남","순천시",2013,2593,1314,1279,"5",2011,2502,1277,1225,420229,433401,0.969607822778443,1.03637090327738,1.06885575686428,0.61704451620426,0.042487067182197,0.580111967554308
"1906","전남","순천시",2014,2872,1524,1348,"5",2012,2754,1454,1300,464047,479002,0.968778835996509,1.04284676833696,1.07645494470806,0.618902826653335,0.0473181813914448,0.651651565372583
"1907","전남","순천시",2015,2710,1400,1310,"5",2013,2611,1339,1272,441255,454391,0.971090976713887,1.03791650708541,1.06881490197515,0.614157346658961,0.0422631776076558,0.576796589481124
"1908","전남","순천시",2016,2712,1397,1315,"5",2014,2598,1339,1259,422114,434628,0.971207561408837,1.04387990762125,1.07482679202682,0.642480467361897,0.0480747523125802,0.662854939392478
"1909","전남","순천시",2017,2761,1474,1287,"5",2015,2706,1450,1256,445571,459820,0.969011787221086,1.02032520325203,1.05295437755004,0.619654331184031,0.0328134094040377,0.436863524874891
"1910","전남","순천시",2018,2747,1408,1339,"5",2016,2666,1369,1297,447106,462028,0.967703256079718,1.03038259564891,1.06477123971156,0.614395691402039,0.0397951706055495,0.540250107511107
"1911","전남","순천시",2019,2857,1467,1390,"5",2017,2790,1429,1361,459384,475293,0.966528015350531,1.02401433691756,1.05947713946624,0.621919788238162,0.0369900099818556,0.498711022707319
"1912","전남","순천시",2020,2627,1330,1297,"5",2018,2569,1301,1268,417119,431567,0.966522000060246,1.02257687816271,1.05799648440384,0.629796293144163,0.0365259708929326,0.491839487828271
"1913","전남","신안군",2010,180,85,95,"5",2008,245,121,124,470657,486853,0.966733284995676,0.73469387755102,0.75997577507048,0.0382444115353644,-0.00917958523666143,-0.184972726073182
"1914","전남","신안군",2011,183,90,93,"5",2009,242,121,121,451574,467208,0.966537388058424,0.756198347107438,0.78237878477364,0.0405249195037801,-0.00881908222936303,-0.179634363319298
"1915","전남","신안군",2012,163,73,90,"5",2010,195,94,101,407210,420213,0.969056169133273,0.835897435897436,0.862589251812994,0.0400284865302915,-0.00550034428292085,-0.130490176767416
"1916","전남","신안군",2013,145,62,83,"5",2011,193,92,101,420229,433401,0.969607822778443,0.751295336787565,0.774844549659989,0.0345049960854677,-0.00776898793260381,-0.164084467289596
"1917","전남","신안군",2014,174,98,76,"5",2012,206,118,88,464047,479002,0.968778835996509,0.844660194174757,0.871881344626939,0.0374962018933427,-0.00480396296817189,-0.120178096152567
"1918","전남","신안군",2015,173,87,86,"5",2013,233,117,116,441255,454391,0.971090976713887,0.742489270386266,0.764592904465866,0.0392063546022141,-0.00922945406338854,-0.185711188393302
"1919","전남","신안군",2016,156,75,81,"5",2014,193,98,95,422114,434628,0.971207561408837,0.808290155440414,0.83225274138919,0.036956841042941,-0.00619940877186883,-0.140841990080511
"1920","전남","신안군",2017,160,89,71,"5",2015,210,114,96,445571,459820,0.969011787221086,0.761904761904762,0.786269859616195,0.0359089797136708,-0.00767483127524206,-0.162690186569285
"1921","전남","신안군",2018,177,80,97,"5",2016,224,102,122,447106,462028,0.967703256079718,0.790178571428571,0.816550493618963,0.0395879276949985,-0.00726238579429567,-0.15658265473483
"1922","전남","신안군",2019,177,87,90,"5",2017,229,111,118,459384,475293,0.966528015350531,0.77292576419214,0.799693078644826,0.0385298573742229,-0.00771779711088454,-0.163326428742137
"1923","전남","신안군",2020,143,76,67,"5",2018,197,108,89,417119,431567,0.966522000060246,0.725888324873096,0.751031352445004,0.0342827826111973,-0.00853533802113172,-0.175432652148555
"1924","전남","여수시",2010,2940,1518,1422,"5",2008,2994,1546,1448,470657,486853,0.966733284995676,0.981963927855711,1.01575475169462,0.624658721744285,0.00984134305496239,0.0966909856867798
"1925","전남","여수시",2011,2771,1469,1302,"5",2009,2844,1513,1331,451574,467208,0.966537388058424,0.974331926863572,1.00806439450915,0.613631431393304,0.00494856594597143,0.0242382777955754
"1926","전남","여수시",2012,2413,1240,1173,"5",2010,2486,1272,1214,407210,420213,0.969056169133273,0.970635559131134,1.001629822964,0.592568944770512,0.000965782473941638,-0.034739157935684
"1927","전남","여수시",2013,2482,1276,1206,"5",2011,2507,1294,1213,420229,433401,0.969607822778443,0.990027921818907,1.02106016325441,0.590630346787109,0.0124387715263434,0.135153953059531
"1928","전남","여수시",2014,2677,1339,1338,"5",2012,2799,1410,1389,464047,479002,0.968778835996509,0.956413004644516,0.987235650808501,0.576881221083209,-0.00736351334792444,-0.158080161148796
"1929","전남","여수시",2015,2485,1292,1193,"5",2013,2597,1334,1263,441255,454391,0.971090976713887,0.956873315363881,0.985359084070457,0.563166423043365,-0.00824527225411946,-0.171137330735291
"1930","전남","여수시",2016,2367,1182,1185,"5",2014,2437,1230,1207,422114,434628,0.971207561408837,0.971276159212146,1.00007063145514,0.56074899197847,3.96065172738268e-05,-0.0484540594219993
"1931","전남","여수시",2017,2477,1287,1190,"5",2015,2562,1337,1225,445571,459820,0.969011787221086,0.966822794691647,0.99774100526092,0.555915892192266,-0.00125581107583353,-0.0676367261120604
"1932","전남","여수시",2018,2614,1311,1303,"5",2016,2701,1351,1350,447106,462028,0.967703256079718,0.967789707515735,1.00008933672122,0.584648830478678,5.22306095829425e-05,-0.0482671206647068
"1933","전남","여수시",2019,2486,1209,1277,"5",2017,2583,1266,1317,459384,475293,0.966528015350531,0.962446767324816,0.995777413628062,0.541159465719311,-0.00228509258499135,-0.0828784244072458
"1934","전남","여수시",2020,2306,1202,1104,"5",2018,2370,1236,1134,417119,431567,0.966522000060246,0.972995780590717,1.0066980167343,0.552839837072874,0.00370293048010132,0.00579278957135841
"1935","전남","영광군",2010,424,226,198,"5",2008,445,237,208,470657,486853,0.966733284995676,0.952808988764045,0.985596548243714,0.0900868360610806,-0.00129756139708225,-0.0682549688323836
"1936","전남","영광군",2011,397,207,190,"5",2009,419,213,206,451574,467208,0.966537388058424,0.947494033412888,0.980297342988676,0.0879147160819711,-0.001732153497211,-0.0746904499060242
"1937","전남","영광군",2012,361,191,170,"5",2010,376,206,170,407210,420213,0.969056169133273,0.960106382978723,0.990764429927159,0.0886520468554308,-0.000818752190834138,-0.0611647166538886
"1938","전남","영광군",2013,373,183,190,"5",2011,398,200,198,420229,433401,0.969607822778443,0.937185929648241,0.966561848647945,0.0887611278612376,-0.00296800802760314,-0.0929911011091995
"1939","전남","영광군",2014,425,219,206,"5",2012,452,221,231,464047,479002,0.968778835996509,0.940265486725664,0.970567741355006,0.0915855506015554,-0.00269556961344919,-0.0889568072103894
"1940","전남","영광군",2015,391,199,192,"5",2013,405,207,198,441255,454391,0.971090976713887,0.965432098765432,0.994172659324254,0.0886108939275476,-0.000516365866498249,-0.056686951258211
"1941","전남","영광군",2016,373,184,189,"5",2014,395,192,203,422114,434628,0.971207561408837,0.944303797468354,0.972298646541162,0.0883647545449807,-0.002447823298954,-0.0852881562672967
"1942","전남","영광군",2017,387,200,187,"5",2015,413,210,203,445571,459820,0.969011787221086,0.937046004842615,0.967011977769494,0.0868548446824412,-0.00286516954721151,-0.0914682591293147
"1943","전남","영광군",2018,372,186,186,"5",2016,416,210,206,447106,462028,0.967703256079718,0.894230769230769,0.924075395647014,0.0832017463420307,-0.00631705967249617,-0.142584175785359
"1944","전남","영광군",2019,375,193,182,"5",2017,439,227,212,459384,475293,0.966528015350531,0.854214123006834,0.883796547477246,0.0816310537589468,-0.00948581027986018,-0.189507335582182
"1945","전남","영광군",2020,312,152,160,"5",2018,343,168,175,417119,431567,0.966522000060246,0.909620991253644,0.941128076957323,0.0747987984244304,-0.00440354910452779,-0.114248729649261
"1946","전남","영암군",2010,570,300,270,"5",2008,662,344,318,470657,486853,0.966733284995676,0.861027190332326,0.890656403059689,0.121107303195321,-0.0132423081471172,-0.245133912597139
"1947","전남","영암군",2011,480,246,234,"5",2009,531,267,264,451574,467208,0.966537388058424,0.903954802259887,0.935250734661954,0.106294870829587,-0.00688251479541826,-0.150957488923081
"1948","전남","영암군",2012,458,227,231,"5",2010,491,240,251,407210,420213,0.969056169133273,0.932790224032587,0.962576013387209,0.112472679944009,-0.00420917606852935,-0.111370435280764
"1949","전남","영암군",2013,471,252,219,"5",2011,503,268,235,420229,433401,0.969607822778443,0.936381709741551,0.965732420617563,0.112081745905209,-0.00384077012512889,-0.105915045098871
"1950","전남","영암군",2014,497,239,258,"5",2012,588,293,295,464047,479002,0.968778835996509,0.845238095238095,0.872477869903777,0.107101220350525,-0.0136577757550039,-0.25128619637421
"1951","전남","영암군",2015,445,243,202,"5",2013,503,260,243,441255,454391,0.971090976713887,0.884691848906561,0.911028801750691,0.100848715595291,-0.00897263106841682,-0.181908129104082
"1952","전남","영암군",2016,453,235,218,"5",2014,503,263,240,422114,434628,0.971207561408837,0.900596421471173,0.927295520809954,0.107316980720848,-0.00780242519155744,-0.164579609394311
"1953","전남","영암군",2017,448,244,204,"5",2015,539,297,242,445571,459820,0.969011787221086,0.831168831168831,0.857748937763122,0.100545143198278,-0.0143026534227141,-0.260835606094574
"1954","전남","영암군",2018,413,196,217,"5",2016,503,243,260,447106,462028,0.967703256079718,0.821073558648111,0.848476589790944,0.0923718312883298,-0.0139964948840634,-0.256301981391234
"1955","전남","영암군",2019,414,212,202,"5",2017,455,231,224,459384,475293,0.966528015350531,0.90989010989011,0.941400658272817,0.0901206833498772,-0.00528101272030666,-0.127242294167531
"1956","전남","영암군",2020,412,204,208,"5",2018,454,232,222,417119,431567,0.966522000060246,0.907488986784141,0.938922224975298,0.0987727722784146,-0.00603282116378712,-0.138375144966218
"1957","전남","완도군",2010,358,180,178,"5",2008,374,189,185,470657,486853,0.966733284995676,0.957219251336898,0.990158574441946,0.0760638851647803,-0.000748577063505562,-0.0601255567068265
"1958","전남","완도군",2011,402,220,182,"5",2009,397,220,177,451574,467208,0.966537388058424,1.01259445843829,1.04765161798074,0.0890219543197793,0.00424204015914513,0.0137759768752119
"1959","전남","완도군",2012,359,177,182,"5",2010,364,178,186,407210,420213,0.969056169133273,0.986263736263736,1.01775703790819,0.0881608997814396,0.00156547643943902,-0.0258588327668842
"1960","전남","완도군",2013,369,200,169,"5",2011,367,201,166,420229,433401,0.969607822778443,1.00544959128065,1.03696522208279,0.0878092659002591,0.00324588901492942,-0.000975123830913349
"1961","전남","완도군",2014,376,186,190,"5",2012,398,200,198,464047,479002,0.968778835996509,0.944723618090452,0.975169546430777,0.0810262753557291,-0.0020119191681075,-0.0788332465182392
"1962","전남","완도군",2015,308,170,138,"5",2013,328,171,157,441255,454391,0.971090976713887,0.939024390243902,0.966978802976322,0.069800908771572,-0.00230490956097783,-0.0831718760688384
"1963","전남","완도군",2016,323,150,173,"5",2014,336,162,174,422114,434628,0.971207561408837,0.961309523809524,0.98980852498208,0.0765196131850638,-0.000779847726156492,-0.0605886156478212
"1964","전남","완도군",2017,390,198,192,"5",2015,411,205,206,445571,459820,0.969011787221086,0.948905109489051,0.979250326985498,0.0875281380520725,-0.00181618024414866,-0.0759347259511634
"1965","전남","완도군",2018,354,186,168,"5",2016,383,203,180,447106,462028,0.967703256079718,0.924281984334204,0.955129559115654,0.079175855389997,-0.00355265553874441,-0.101648616953565
"1966","전남","완도군",2019,387,191,196,"5",2017,413,209,204,459384,475293,0.966528015350531,0.937046004842615,0.969496993320753,0.0842432474792331,-0.00256967234054047,-0.087092508441988
"1967","전남","완도군",2020,315,162,153,"5",2018,357,180,177,417119,431567,0.966522000060246,0.882352941176471,0.912915527139032,0.07551801764005,-0.00657644675768904,-0.146425204365977
"1968","전남","장성군",2010,363,195,168,"5",2008,390,205,185,470657,486853,0.966733284995676,0.930769230769231,0.962798369742068,0.0771262299296515,-0.00286922148903117,-0.0915282606684228
"1969","전남","장성군",2011,325,172,153,"5",2009,332,180,152,451574,467208,0.966537388058424,0.978915662650602,1.01280682438684,0.071970485457533,0.000921713368290215,-0.0353917374355598
"1970","전남","장성군",2012,331,177,154,"5",2010,321,168,153,407210,420213,0.969056169133273,1.03115264797508,1.0640793390721,0.0812848407455613,0.00520867887155677,0.0280900546896281
"1971","전남","장성군",2013,343,175,168,"5",2011,344,158,186,420229,433401,0.969607822778443,0.997093023255814,1.02834671898439,0.0816221631538994,0.00231372052182196,-0.014778763365686
"1972","전남","장성군",2014,340,184,156,"5",2012,341,179,162,464047,479002,0.968778835996509,0.997067448680352,1.02920027939581,0.0732684404812444,0.00213945893294738,-0.0173592455160351
"1973","전남","장성군",2015,346,181,165,"5",2013,346,177,169,441255,454391,0.971090976713887,1,1.02976963433842,0.0784127092044283,0.00233431768050077,-0.0144737586847243
"1974","전남","장성군",2016,309,154,155,"5",2014,321,160,161,422114,434628,0.971207561408837,0.962616822429907,0.991154579803241,0.073202973604287,-0.000647511061182155,-0.0586289617504338
"1975","전남","장성군",2017,339,187,152,"5",2015,347,184,163,445571,459820,0.969011787221086,0.976945244956772,1.00818716329389,0.0760821507683399,0.00062289699209097,-0.0398166387003422
"1976","전남","장성군",2018,366,191,175,"5",2016,379,195,184,447106,462028,0.967703256079718,0.965699208443272,0.997929068003176,0.0818597826913528,-0.000169526043228578,-0.0515509142304427
"1977","전남","장성군",2019,322,157,165,"5",2017,333,158,175,459384,475293,0.966528015350531,0.966966966966967,1.00045415301933,0.0700938648276823,3.18333403478176e-05,-0.0485691653638114
"1978","전남","장성군",2020,271,138,133,"5",2018,305,157,148,417119,431567,0.966522000060246,0.888524590163934,0.919300947219567,0.064969469144297,-0.00524297461959231,-0.126679022361274
"1979","전남","장흥군",2010,300,146,154,"5",2008,297,143,154,470657,486853,0.966733284995676,1.01010101010101,1.04486007234718,0.063740685892274,0.00285941178058634,-0.00669811540455449
"1980","전남","장흥군",2011,275,149,126,"5",2009,289,152,137,451574,467208,0.966537388058424,0.951557093425606,0.98450107071087,0.060898103079451,-0.000943855393470574,-0.0630172567543186
"1981","전남","장흥군",2012,268,135,133,"5",2010,264,137,127,407210,420213,0.969056169133273,1.01515151515152,1.04756725924305,0.0658137079148351,0.00313057770613153,-0.00268266463785784
"1982","전남","장흥군",2013,246,147,99,"5",2011,257,159,98,420229,433401,0.969607822778443,0.957198443579767,0.987201651113832,0.0585395106001728,-0.000749209080286556,-0.0601349156713155
"1983","전남","장흥군",2014,258,133,125,"5",2012,263,136,127,464047,479002,0.968778835996509,0.980988593155893,1.01260324514297,0.0555978166004737,0.000700712912029598,-0.0386643331709858
"1984","전남","장흥군",2015,240,116,124,"5",2013,257,122,135,441255,454391,0.971090976713887,0.933852140077821,0.96165257681409,0.0543903185233029,-0.00208572856162955,-0.0799262230240876
"1985","전남","장흥군",2016,243,129,114,"5",2014,260,141,119,422114,434628,0.971207561408837,0.934615384615385,0.962323010808965,0.0575673870091966,-0.00216896581810164,-0.081158808219468
"1986","전남","장흥군",2017,230,110,120,"5",2015,252,123,129,445571,459820,0.969011787221086,0.912698412698413,0.9418857693319,0.0516191583384017,-0.00299980767457104,-0.0934619933001752
"1987","전남","장흥군",2018,233,129,104,"5",2016,240,140,100,447106,462028,0.967703256079718,0.970833333333333,1.00323454244258,0.0521129217679924,0.000168561457265557,-0.0465444824291746
"1988","전남","장흥군",2019,245,128,117,"5",2017,246,130,116,459384,475293,0.966528015350531,0.995934959349594,1.03042534053025,0.0533322884558452,0.00162265303752638,-0.0250121562747497
"1989","전남","장흥군",2020,221,100,121,"5",2018,242,114,128,417119,431567,0.966522000060246,0.913223140495868,0.94485499599486,0.0529824822173049,-0.00292171919407552,-0.0923056516682187
"1990","전남","진도군",2010,229,102,127,"5",2008,254,119,135,470657,486853,0.966733284995676,0.901574803149606,0.93259931890484,0.0486553902311025,-0.0032794064405271,-0.0976023183681883
"1991","전남","진도군",2011,210,104,106,"5",2009,211,100,111,451574,467208,0.966537388058424,0.995260663507109,1.02971770756472,0.0465040059879444,0.00138199245053756,-0.0285758810922947
"1992","전남","진도군",2012,197,110,87,"5",2010,199,110,89,407210,420213,0.969056169133273,0.989949748743719,1.02156075186966,0.0483779867881437,0.00104306576909286,-0.0335947395647405
"1993","전남","진도군",2013,201,111,90,"5",2011,219,117,102,420229,433401,0.969607822778443,0.917808219178082,0.946576747440086,0.0478310635391655,-0.00255529098766212,-0.0868795480033731
"1994","전남","진도군",2014,241,113,128,"5",2012,272,124,148,464047,479002,0.968778835996509,0.886029411764706,0.914583782018023,0.0519343945764114,-0.00443603956790074,-0.114729851515141
"1995","전남","진도군",2015,183,99,84,"5",2013,208,114,94,441255,454391,0.971090976713887,0.879807692307692,0.905999245595822,0.0414726178740184,-0.00389845736727391,-0.106769283256686
"1996","전남","진도군",2016,208,108,100,"5",2014,217,109,108,422114,434628,0.971207561408837,0.95852534562212,0.986941806993018,0.0492757880572547,-0.000643452751022785,-0.0585688659083468
"1997","전남","진도군",2017,185,102,83,"5",2015,215,122,93,445571,459820,0.969011787221086,0.86046511627907,0.887982094363057,0.0415197577939318,-0.00465095631062937,-0.11791235904307
"1998","전남","진도군",2018,202,89,113,"5",2016,225,102,123,447106,462028,0.967703256079718,0.897777777777778,0.927740784313141,0.0451794429061565,-0.0032646311095681,-0.0973835238647556
"1999","전남","진도군",2019,199,105,94,"5",2017,230,125,105,459384,475293,0.966528015350531,0.865217391304348,0.895180871700402,0.0433188791947478,-0.00454064715610906,-0.116278890611513
"2000","전남","진도군",2020,171,93,78,"5",2018,194,99,95,417119,431567,0.966522000060246,0.881443298969072,0.911974377111054,0.0409954952903128,-0.00360865400857065,-0.102477847610572
"2001","전남","함평군",2010,209,106,103,"5",2008,252,139,113,470657,486853,0.966733284995676,0.829365079365079,0.857904752259346,0.0444060111716175,-0.00630988315860525,-0.14247790528641
"2002","전남","함평군",2011,204,110,94,"5",2009,244,127,117,451574,467208,0.966537388058424,0.836065573770492,0.865011104691953,0.0451753201025746,-0.00609816655583395,-0.139342785734752
"2003","전남","함평군",2012,167,84,83,"5",2010,191,96,95,407210,420213,0.969056169133273,0.87434554973822,0.902265088018827,0.0410107806782741,-0.00400818503987031,-0.108394141048716
"2004","전남","함평군",2013,165,77,88,"5",2011,188,89,99,420229,433401,0.969607822778443,0.877659574468085,0.905169650914246,0.0392643058903598,-0.00372344783419266,-0.104177725477524
"2005","전남","함평군",2014,192,97,95,"5",2012,220,110,110,464047,479002,0.968778835996509,0.872727272727273,0.900852950435859,0.0413751193305851,-0.00410222100699176,-0.109786634576491
"2006","전남","함평군",2015,162,87,75,"5",2013,207,109,98,441255,454391,0.971090976713887,0.782608695652174,0.805906670351808,0.0367134650032294,-0.00712583866539917,-0.154560651887993
"2007","전남","함평군",2016,166,94,72,"5",2014,203,115,88,422114,434628,0.971207561408837,0.817733990147783,0.84197654820724,0.0393258693149244,-0.00621440961389535,-0.141064123973239
"2008","전남","함평군",2017,167,87,80,"5",2015,224,119,105,445571,459820,0.969011787221086,0.745535714285714,0.769377343101003,0.0374799975761439,-0.00864373662157825,-0.177037828914023
"2009","전남","함평군",2018,164,89,75,"5",2016,210,118,92,447106,462028,0.967703256079718,0.780952380952381,0.807016382394033,0.0366803397851964,-0.00707870466676326,-0.153862687161858
"2010","전남","함평군",2019,162,87,75,"5",2017,219,119,100,459384,475293,0.966528015350531,0.73972602739726,0.765343596511254,0.035264615223865,-0.00827506777884663,-0.171578545693878
"2011","전남","함평군",2020,152,78,74,"5",2018,181,91,90,417119,431567,0.966522000060246,0.839779005524862,0.868866932643558,0.0364404402580559,-0.00477854670685806,-0.119801729742319
"2012","전남","해남군",2010,557,290,267,"5",2008,607,313,294,470657,486853,0.966733284995676,0.917627677100494,0.949204595872168,0.118345206806655,-0.00601139260633594,-0.138057828853312
"2013","전남","해남군",2011,537,278,259,"5",2009,581,301,280,451574,467208,0.966537388058424,0.924268502581756,0.956267718146343,0.118917386740601,-0.00520052867424024,-0.126050478773194
"2014","전남","해남군",2012,493,233,260,"5",2010,515,252,263,407210,420213,0.969056169133273,0.957281553398058,0.987849398094492,0.121067753738857,-0.00147104607927487,-0.070823946474836
"2015","전남","해남군",2013,495,255,240,"5",2011,525,262,263,420229,433401,0.969607822778443,0.942857142857143,0.972410824982161,0.117792917671079,-0.00324980942148931,-0.0971640429006924
"2016","전남","해남군",2014,499,239,260,"5",2012,547,277,270,464047,479002,0.968778835996509,0.912248628884826,0.941647974737666,0.107532211176885,-0.00627472230310824,-0.141957240000463
"2017","전남","해남군",2015,517,274,243,"5",2013,543,291,252,441255,454391,0.971090976713887,0.952117863720074,0.980462064370099,0.117165811152282,-0.0022891780763184,-0.0829389227506442
"2018","전남","해남군",2016,441,221,220,"5",2014,474,236,238,422114,434628,0.971207561408837,0.930379746835443,0.957961803227552,0.104474146794468,-0.00439190474057945,-0.114076298802539
"2019","전남","해남군",2017,479,264,215,"5",2015,538,282,256,445571,459820,0.969011787221086,0.890334572490706,0.918806751612373,0.107502508017802,-0.00872847783578227,-0.178292684858265
"2020","전남","해남군",2018,415,205,210,"5",2016,475,233,242,447106,462028,0.967703256079718,0.873684210526316,0.902843103024904,0.0928191525052225,-0.00901802083726564,-0.182580265109953
"2021","전남","해남군",2019,455,211,244,"5",2017,519,248,271,459384,475293,0.966528015350531,0.876685934489403,0.907046583819357,0.0990456785608554,-0.00920663418016134,-0.185373269396229
"2022","전남","해남군",2020,376,173,203,"5",2018,431,190,241,417119,431567,0.966522000060246,0.872389791183295,0.902607277567315,0.0901421416909803,-0.0087791885851974,-0.179043614449472
"2023","전남","화순군",2010,659,347,312,"5",2008,715,378,337,470657,486853,0.966733284995676,0.921678321678322,0.953394629090943,0.140017040010029,-0.00652554608325566,-0.145671462347072
"2024","전남","화순군",2011,635,328,307,"5",2009,687,349,338,451574,467208,0.966537388058424,0.924308588064047,0.956309191433136,0.140619256201641,-0.00614376900352069,-0.140018071109043
"2025","전남","화순군",2012,561,296,265,"5",2010,593,332,261,407210,420213,0.969056169133273,0.946037099494098,0.976245887109141,0.137766754254562,-0.00327252703317009,-0.0975004474509976
"2026","전남","화순군",2013,513,269,244,"5",2011,562,298,264,420229,433401,0.969607822778443,0.912811387900356,0.941423291413496,0.122076296495482,-0.00715082764513549,-0.154930691072081
"2027","전남","화순군",2014,611,298,313,"5",2012,653,327,326,464047,479002,0.968778835996509,0.935681470137825,0.965835994110421,0.13166769745306,-0.0044982959912536,-0.115651750542024
"2028","전남","화순군",2015,484,242,242,"5",2013,523,267,256,441255,454391,0.971090976713887,0.925430210325048,0.952979929292153,0.109687142355327,-0.00515749718928922,-0.125413264459149
"2029","전남","화순군",2016,491,262,229,"5",2014,532,275,257,422114,434628,0.971207561408837,0.922932330827068,0.950293600976766,0.116319288154385,-0.00578181295110035,-0.134658191525059
"2030","전남","화순군",2017,450,237,213,"5",2015,480,256,224,445571,459820,0.969011787221086,0.9375,0.967480491324615,0.100994005444699,-0.00328427543622077,-0.0976744189186238
"2031","전남","화순군",2018,470,238,232,"5",2016,491,257,234,447106,462028,0.967703256079718,0.957230142566191,0.989177350135253,0.10512048596977,-0.0011376822132629,-0.0658874627013846
"2032","전남","화순군",2019,450,226,224,"5",2017,470,231,239,459384,475293,0.966528015350531,0.957446808510638,0.990604300448964,0.0979572645107361,-0.000920377026184252,-0.0626695868627896
"2033","전남","화순군",2020,378,199,179,"5",2018,396,214,182,417119,431567,0.966522000060246,0.954545454545455,0.987608615723135,0.09062162116806,-0.00112292733168595,-0.0656689710143426
"2034","전북","고창군",2010,366,202,164,"5",2008,383,207,176,470657,486853,0.966733284995676,0.955613577023499,0.988497646512474,0.0777636367885743,-0.000894464838817774,-0.0622858767324762
"2035","전북","고창군",2011,343,180,163,"5",2009,359,188,171,451574,467208,0.966537388058424,0.955431754874652,0.988509877299128,0.0759565431136425,-0.000872750000309853,-0.0619643213425059
"2036","전북","고창군",2012,321,169,152,"5",2010,334,179,155,407210,420213,0.969056169133273,0.961077844311377,0.991766911892185,0.0788291053756047,-0.000649006970017559,-0.058651113310472
"2037","전북","고창군",2013,335,176,159,"5",2011,349,187,162,420229,433401,0.969607822778443,0.959885386819484,0.989972816090635,0.0797184392319426,-0.00079935145114625,-0.060877428658918
"2038","전북","고창군",2014,394,205,189,"5",2012,394,210,184,464047,479002,0.968778835996509,1,1.03222733904109,0.0849051927929714,0.00273626843448808,-0.00852163376332208
"2039","전북","고창군",2015,351,177,174,"5",2013,361,185,176,441255,454391,0.971090976713887,0.972299168975069,1.00124415970301,0.0795458408403304,9.89677297154057e-05,-0.0475750329531267
"2040","전북","고창군",2016,346,171,175,"5",2014,371,184,187,422114,434628,0.971207561408837,0.932614555256065,0.960262864822851,0.0819683782106256,-0.00325718852520732,-0.0972733133690318
"2041","전북","고창군",2017,348,194,154,"5",2015,373,212,161,445571,459820,0.969011787221086,0.932975871313673,0.962811684664067,0.0781020308772339,-0.00290448295263934,-0.0920504157688307
"2042","전북","고창군",2018,362,196,166,"5",2016,385,211,174,447106,462028,0.967703256079718,0.94025974025974,0.97164056682918,0.0809651402575676,-0.00229612548430057,-0.0830418006275473
"2043","전북","고창군",2019,324,171,153,"5",2017,357,186,171,459384,475293,0.966528015350531,0.907563025210084,0.938992983954984,0.07052923044773,-0.00430277789356727,-0.112756499991354
"2044","전북","고창군",2020,273,146,127,"5",2018,296,157,139,417119,431567,0.966522000060246,0.922297297297297,0.954243459786542,0.0654489486213766,-0.00299471744952255,-0.0933866167644525
"2045","전북","군산시",2010,2729,1395,1334,"5",2008,2679,1397,1282,470657,486853,0.966733284995676,1.01866368047779,1.05371739681265,0.579827772666719,0.0311468385473359,0.412184785424708
"2046","전북","군산시",2011,2645,1358,1287,"5",2009,2649,1358,1291,451574,467208,0.966537388058424,0.998489996224991,1.033058843415,0.585729027800538,0.0193635242136785,0.237696348206117
"2047","전북","군산시",2012,2525,1277,1248,"5",2010,2513,1266,1247,407210,420213,0.969056169133273,1.00477516912057,1.03685957648796,0.620073180914025,0.022855634840035,0.289407853860082
"2048","전북","군산시",2013,2525,1302,1223,"5",2011,2570,1332,1238,420229,433401,0.969607822778443,0.982490272373541,1.01328624758635,0.600862862867627,0.00798321276150342,0.069175615912753
"2049","전북","군산시",2014,2801,1417,1384,"5",2012,2849,1458,1391,464047,479002,0.968778835996509,0.983151983151983,1.01483635544194,0.603602652317545,0.00895526349548134,0.0835698354562746
"2050","전북","군산시",2015,2618,1379,1239,"5",2013,2653,1401,1252,441255,454391,0.971090976713887,0.986807387862797,1.01618428296192,0.593307724558362,0.00960226009774824,0.0931506225606994
"2051","전북","군산시",2016,2597,1327,1270,"5",2014,2657,1355,1302,422114,434628,0.971207561408837,0.977418140760256,1.00639469830981,0.615236642234088,0.00393425271622955,0.00921823120288916
"2052","전북","군산시",2017,2708,1366,1342,"5",2015,2779,1403,1376,445571,459820,0.969011787221086,0.97445124145376,1.00561340357714,0.607759481653878,0.00341159924835421,0.00147872903617263
"2053","전북","군산시",2018,2721,1402,1319,"5",2016,2846,1464,1382,447106,462028,0.967703256079718,0.956078706957133,0.987987485781873,0.608580515582435,-0.00731058209630898,-0.157296350150219
"2054","전북","군산시",2019,2706,1416,1290,"5",2017,2780,1457,1323,459384,475293,0.966528015350531,0.973381294964029,1.0070906166243,0.58904968392456,0.00417672548137499,0.0128087909266037
"2055","전북","군산시",2020,2503,1277,1226,"5",2018,2589,1313,1276,417119,431567,0.966522000060246,0.966782541521823,1.00026956599184,0.600068565565222,0.000161758078046146,-0.0466452275144865
"2056","전북","김제시",2010,640,320,320,"5",2008,722,363,359,470657,486853,0.966733284995676,0.886426592797784,0.916929836342346,0.135980129903518,-0.0112958916452743,-0.216311192268535
"2057","전북","김제시",2011,632,321,311,"5",2009,699,332,367,451574,467208,0.966537388058424,0.90414878397711,0.9354514322445,0.139954913258956,-0.00903388920121094,-0.182815245349606
"2058","전북","김제시",2012,552,299,253,"5",2010,583,319,264,407210,420213,0.969056169133273,0.946826758147513,0.977060761085044,0.135556592421601,-0.00310956506005639,-0.0950872910834851
"2059","전북","김제시",2013,645,347,298,"5",2011,637,344,293,420229,433401,0.969607822778443,1.01255886970173,1.04429733951631,0.15348774120777,0.00679909858387164,0.0516411407648583
"2060","전북","김제시",2014,669,335,334,"5",2012,692,328,364,464047,479002,0.968778835996509,0.966763005780347,0.997919204940012,0.144166431417507,-0.000299980798309669,-0.0534827006274851
"2061","전북","김제시",2015,606,316,290,"5",2013,616,321,295,441255,454391,0.971090976713887,0.983766233766234,1.01305259481994,0.13733555427134,0.00179258534427571,-0.0224957825450813
"2062","전북","김제시",2016,591,299,292,"5",2014,614,324,290,422114,434628,0.971207561408837,0.962540716612378,0.99107621775114,0.140009570874219,-0.00124941492323791,-0.0675420112772509
"2063","전북","김제시",2017,602,299,303,"5",2015,581,278,303,445571,459820,0.969011787221086,1.03614457831325,1.06927964342383,0.135107536172686,0.00936020192991611,0.0895662022333572
"2064","전북","김제시",2018,658,318,340,"5",2016,647,317,330,447106,462028,0.967703256079718,1.01700154559505,1.05094360198296,0.147168680357678,0.00749730267649847,0.0619802132475548
"2065","전북","김제시",2019,607,316,291,"5",2017,619,327,292,459384,475293,0.966528015350531,0.980613893376414,1.01457368829684,0.132133465684482,0.00192567194246689,-0.0205250235654294
"2066","전북","김제시",2020,490,268,222,"5",2018,519,283,236,417119,431567,0.966522000060246,0.944123314065511,0.976825477336948,0.117472471884522,-0.00272236846197265,-0.0893536471032844
"2067","전북","남원시",2010,783,412,371,"5",2008,812,420,392,470657,486853,0.966733284995676,0.964285714285714,0.997468204780005,0.166363190178835,-0.00042119752967788,-0.0552776894924405
"2068","전북","남원시",2011,780,405,375,"5",2009,789,412,377,451574,467208,0.966537388058424,0.988593155893536,1.02281936333515,0.172729165098079,0.00394156957695024,0.00932657997101567
"2069","전북","남원시",2012,729,371,358,"5",2010,717,370,347,407210,420213,0.969056169133273,1.01673640167364,1.04920275424593,0.179023108469831,0.00880843001038368,0.0813955112703477
"2070","전북","남원시",2013,697,354,343,"5",2011,693,347,346,420229,433401,0.969607822778443,1.00577200577201,1.03729774259652,0.165861946700489,0.00618627619459261,0.0425664086504457
"2071","전북","남원시",2014,729,365,364,"5",2012,722,362,360,464047,479002,0.968778835996509,1.00969529085873,1.04223508332542,0.157096156208315,0.00663496924756144,0.0492106979723167
"2072","전북","남원시",2015,729,382,347,"5",2013,731,393,338,441255,454391,0.971090976713887,0.997264021887825,1.02695220715829,0.165210592514532,0.00445279011419532,0.0168967822156549
"2073","전북","남원시",2016,616,332,284,"5",2014,627,342,285,422114,434628,0.971207561408837,0.982456140350877,1.01158205453603,0.145932141554177,0.00169019402203989,-0.024012002964547
"2074","전북","남원시",2017,686,348,338,"5",2015,700,356,344,445571,459820,0.969011787221086,0.98,1.01133960693133,0.153959750522363,0.00174584305416934,-0.0231879468141259
"2075","전북","남원시",2018,638,327,311,"5",2016,670,332,338,447106,462028,0.967703256079718,0.952238805970149,0.984019429497202,0.142695468188752,-0.00228035498982008,-0.0828082696482196
"2076","전북","남원시",2019,572,310,262,"5",2017,582,321,261,459384,475293,0.966528015350531,0.982817869415808,1.01685399057923,0.124514567333647,0.00209856734481777,-0.0179647720348127
"2077","전북","남원시",2020,531,276,255,"5",2018,576,301,275,417119,431567,0.966522000060246,0.921875,0.953806535125468,0.127301801164656,-0.00588051128056421,-0.13611972575699
"2078","전북","무주군",2010,161,84,77,"5",2008,187,101,86,470657,486853,0.966733284995676,0.86096256684492,0.890589555782979,0.0342075014288537,-0.00374265792688526,-0.10446219035369
"2079","전북","무주군",2011,177,90,87,"5",2009,197,94,103,451574,467208,0.966537388058424,0.898477157360406,0.929583447532499,0.0391962336184103,-0.00276006364111922,-0.0899118408944127
"2080","전북","무주군",2012,183,88,95,"5",2010,176,83,93,407210,420213,0.969056169133273,1.03977272727273,1.07297467411275,0.0449399572702046,0.00327947873643426,-0.000477724046266372
"2081","전북","무주군",2013,170,89,81,"5",2011,190,106,84,420229,433401,0.969607822778443,0.894736842105263,0.922782202335544,0.0404541333415828,-0.00312377908306128,-0.0952977736854494
"2082","전북","무주군",2014,210,100,110,"5",2012,213,102,111,464047,479002,0.968778835996509,0.985915492957746,1.01768892581516,0.0452540367678274,0.000800495299222522,-0.0371867461092962
"2083","전북","무주군",2015,167,83,84,"5",2013,197,97,100,441255,454391,0.971090976713887,0.847715736040609,0.872951923525464,0.0378465966391316,-0.00480833730410932,-0.120242871734376
"2084","전북","무주군",2016,178,75,103,"5",2014,187,79,108,422114,434628,0.971207561408837,0.951871657754011,0.980090863762657,0.0421687032413045,-0.000839542457783219,-0.0614725809004478
"2085","전북","무주군",2017,164,90,74,"5",2015,181,102,79,445571,459820,0.969011787221086,0.906077348066298,0.935052968410972,0.0368067042065125,-0.00239048618078837,-0.0844391027786054
"2086","전북","무주군",2018,165,85,80,"5",2016,179,91,88,447106,462028,0.967703256079718,0.921787709497207,0.952552038763907,0.0369040003936427,-0.00175101958013432,-0.0749698206528712
"2087","전북","무주군",2019,155,84,71,"5",2017,155,81,74,459384,475293,0.966528015350531,1,1.0346311582467,0.033740835553698,0.00116848421543585,-0.0317375313055784
"2088","전북","무주군",2020,123,65,58,"5",2018,137,72,65,417119,431567,0.966522000060246,0.897810218978102,0.928908207906431,0.0294879878404005,-0.00209635390080744,-0.0800835640552755
"2089","전북","부안군",2010,399,203,196,"5",2008,432,218,214,470657,486853,0.966733284995676,0.923611111111111,0.955393928652453,0.0847751122367244,-0.0037814847049276,-0.105037140968688
"2090","전북","부안군",2011,395,204,191,"5",2009,391,203,188,451574,467208,0.966537388058424,1.01023017902813,1.04520548455707,0.0874718207868478,0.00395420604375895,0.0095137019710729
"2091","전북","부안군",2012,330,162,168,"5",2010,354,173,181,407210,420213,0.969056169133273,0.932203389830508,0.96197044043822,0.0810392672085656,-0.00308188763915117,-0.0946774412073599
"2092","전북","부안군",2013,313,166,147,"5",2011,325,177,148,420229,433401,0.969607822778443,0.963076923076923,0.993264390459634,0.0744831984465613,-0.000501689742053633,-0.0564696258142608
"2093","전북","부안군",2014,353,177,176,"5",2012,382,191,191,464047,479002,0.968778835996509,0.924083769633508,0.953864530579854,0.076069880852586,-0.00350951966186863,-0.101009856793988
"2094","전북","부안군",2015,335,173,162,"5",2013,361,188,173,441255,454391,0.971090976713887,0.92797783933518,0.955603400286346,0.0759198196054436,-0.00337058184135566,-0.0989524523587508
"2095","전북","부안군",2016,317,156,161,"5",2014,334,170,164,422114,434628,0.971207561408837,0.949101796407186,0.977238887051513,0.0750981962218737,-0.00170931852643373,-0.0743523074910776
"2096","전북","부안군",2017,341,182,159,"5",2015,370,192,178,445571,459820,0.969011787221086,0.921621621621622,0.951094335255333,0.0765310130147608,-0.00374280006506963,-0.104464295149418
"2097","전북","부안군",2018,328,173,155,"5",2016,372,199,173,447106,462028,0.967703256079718,0.881720430107527,0.911147528509392,0.0733606795703927,-0.00651827769005992,-0.145563831290655
"2098","전북","부안군",2019,306,167,139,"5",2017,342,187,155,459384,475293,0.966528015350531,0.894736842105263,0.925722615273359,0.0666109398673006,-0.00494768640752662,-0.122306366485903
"2099","전북","부안군",2020,279,146,133,"5",2018,312,160,152,417119,431567,0.966522000060246,0.894230769230769,0.92520477461975,0.0668873870526157,-0.00500285718969642,-0.123123340665522
"2100","전북","순창군",2010,211,102,109,"5",2008,254,130,124,470657,486853,0.966733284995676,0.830708661417323,0.859294568947254,0.044830949077566,-0.00630795801446263,-0.142449397569197
"2101","전북","순창군",2011,201,109,92,"5",2009,227,116,111,451574,467208,0.966537388058424,0.885462555066079,0.916118265062454,0.0445109771598896,-0.00373365798793701,-0.104328918403399
"2102","전북","순창군",2012,188,103,85,"5",2010,207,106,101,407210,420213,0.969056169133273,0.908212560386473,0.937213537579335,0.0461678249551828,-0.00289871440659241,-0.0919649945913716
"2103","전북","순창군",2013,177,96,81,"5",2011,202,110,92,420229,433401,0.969607822778443,0.876237623762376,0.903703129427616,0.042119891773295,-0.00405601376661581,-0.109102393374646
"2104","전북","순창군",2014,208,111,97,"5",2012,242,126,116,464047,479002,0.968778835996509,0.859504132231405,0.887203663308043,0.0448230459414671,-0.00505587538157278,-0.123908439083735
"2105","전북","순창군",2015,187,85,102,"5",2013,206,93,113,441255,454391,0.971090976713887,0.907766990291262,0.934790881656722,0.0423791231827401,-0.00276350525890765,-0.0899628046973295
"2106","전북","순창군",2016,181,94,87,"5",2014,211,116,95,422114,434628,0.971207561408837,0.85781990521327,0.883250851104283,0.0428794117228995,-0.00500613482379756,-0.123171876182431
"2107","전북","순창군",2017,192,104,88,"5",2015,220,115,105,445571,459820,0.969011787221086,0.872727272727273,0.900636384651278,0.0430907756564049,-0.0042816552574011,-0.112443713989877
"2108","전북","순창군",2018,160,72,88,"5",2016,194,90,104,447106,462028,0.967703256079718,0.824742268041237,0.852267741024627,0.0357856973514111,-0.00528670190873299,-0.127326540209811
"2109","전북","순창군",2019,153,87,66,"5",2017,192,106,86,459384,475293,0.966528015350531,0.796875,0.824471704227835,0.0333054699336503,-0.0058460523773447,-0.135609455047002
"2110","전북","순창군",2020,133,74,59,"5",2018,167,87,80,417119,431567,0.966522000060246,0.796407185628742,0.82399281711032,0.0318853852257989,-0.00561205682894509,-0.132144426753585
"2111","전북","완주군",2010,854,446,408,"5",2008,859,448,411,470657,486853,0.966733284995676,0.994179278230501,1.02839045025221,0.181448485840007,0.00515140421057931,0.0272419260729082
"2112","전북","완주군",2011,843,466,377,"5",2009,823,439,384,451574,467208,0.966537388058424,1.02430133657351,1.05976380140982,0.186680366894462,0.0111567283741926,0.116169336360764
"2113","전북","완주군",2012,876,469,407,"5",2010,860,437,423,407210,420213,0.969056169133273,1.01860465116279,1.05113066054142,0.215122418408192,0.0109993513504776,0.113838882454115
"2114","전북","완주군",2013,871,444,427,"5",2011,837,415,422,420229,433401,0.969607822778443,1.04062126642772,1.07323934685859,0.207267942003051,0.015180168697028,0.175748822598224
"2115","전북","완주군",2014,916,475,441,"5",2012,926,482,444,464047,479002,0.968778835996509,0.989200863930886,1.02108017555252,0.197393798472999,0.00416109592479034,0.0125773469690166
"2116","전북","완주군",2015,904,477,427,"5",2013,927,486,441,441255,454391,0.971090976713887,0.975188781014024,1.00421979443574,0.204870199771107,0.000864510129043436,-0.036238808432512
"2117","전북","완주군",2016,848,443,405,"5",2014,927,471,456,422114,434628,0.971207561408837,0.914778856526429,0.941898408615608,0.200893597464192,-0.0116722377116049,-0.221884160544517
"2118","전북","완주군",2017,898,504,394,"5",2015,1019,553,466,445571,459820,0.969011787221086,0.881256133464181,0.90943799145254,0.201539148642977,-0.0182517901020532,-0.319314796925649
"2119","전북","완주군",2018,829,451,378,"5",2016,996,543,453,447106,462028,0.967703256079718,0.832329317269076,0.860108005258701,0.185414644401999,-0.0259380244596442,-0.433133284931273
"2120","전북","완주군",2019,822,445,377,"5",2017,1036,538,498,459384,475293,0.966528015350531,0.793436293436293,0.820913911272957,0.178935269839611,-0.032044817610894,-0.523563257620291
"2121","전북","완주군",2020,702,343,359,"5",2018,893,436,457,417119,431567,0.966522000060246,0.786114221724524,0.813343329666085,0.168297296454968,-0.0314138129824842,-0.514219281182829
"2122","전북","익산시",2010,3100,1563,1537,"5",2008,3206,1622,1584,470657,486853,0.966733284995676,0.966936993137867,1.00021071803914,0.658653754220165,0.000138790227564523,-0.0469853376247091
"2123","전북","익산시",2011,2858,1466,1392,"5",2009,2958,1514,1444,451574,467208,0.966537388058424,0.966193373901285,0.999644075685649,0.632897376731167,-0.00022526356486748,-0.0523762807419199
"2124","전북","익산시",2012,2678,1414,1264,"5",2010,2746,1455,1291,407210,420213,0.969056169133273,0.97523670793882,1.0063778953196,0.65764593207436,0.00419439691213285,0.0130704711507787
"2125","전북","익산시",2013,2643,1329,1314,"5",2011,2694,1374,1320,420229,433401,0.969607822778443,0.981069042316258,1.01182046933674,0.62894279071649,0.00743439897222759,0.0610487292233923
"2126","전북","익산시",2014,2933,1492,1441,"5",2012,2943,1495,1448,464047,479002,0.968778835996509,0.99660210669385,1.02871994067534,0.632048046857323,0.018152382409704,0.219761645401664
"2127","전북","익산시",2015,2674,1393,1281,"5",2013,2717,1397,1320,441255,454391,0.971090976713887,0.984173721015826,1.01347221281595,0.605998798880466,0.0081641447847282,0.0718548744881702
"2128","전북","익산시",2016,2534,1282,1252,"5",2014,2550,1273,1277,422114,434628,0.971207561408837,0.993725490196078,1.02318549574982,0.600311764120593,0.0139185258555873,0.157066295637009
"2129","전북","익산시",2017,2651,1344,1307,"5",2015,2711,1386,1325,445571,459820,0.969011787221086,0.977867945407599,1.00913937095844,0.594966907630883,0.00543762327683321,0.031480285176183
"2130","전북","익산시",2018,2610,1309,1301,"5",2016,2707,1357,1350,447106,462028,0.967703256079718,0.964166974510528,0.996345696320672,0.583754188044893,-0.00213321507719555,-0.0806294078543863
"2131","전북","익산시",2019,2591,1322,1269,"5",2017,2767,1427,1340,459384,475293,0.966528015350531,0.936393205637875,0.968821586923451,0.564016160771816,-0.0175851288423931,-0.30944281370782
"2132","전북","익산시",2020,2153,1149,1004,"5",2018,2286,1195,1091,417119,431567,0.966522000060246,0.941819772528434,0.97444214665546,0.516159657076278,-0.0131919328179238,-0.244387949940417
"2133","전북","임실군",2010,214,122,92,"5",2008,204,112,92,470657,486853,0.966733284995676,1.04901960784314,1.08511791631115,0.0454683559364888,0.00387017171540744,0.00826931365963779
"2134","전북","임실군",2011,173,97,76,"5",2009,161,89,72,451574,467208,0.966537388058424,1.07453416149068,1.11173574324859,0.0383104430281637,0.00428064582593467,0.0143476532537879
"2135","전북","임실군",2012,149,80,69,"5",2010,152,79,73,407210,420213,0.969056169133273,0.980263157894737,1.01156484950866,0.0365904570123523,0.000423163128800915,-0.0427743167082661
"2136","전북","임실군",2013,166,82,84,"5",2011,182,98,84,420229,433401,0.969607822778443,0.912087912087912,0.940677138386007,0.0395022713806044,-0.00234338777855,-0.0837416651673052
"2137","전북","임실군",2014,163,84,79,"5",2012,171,82,89,464047,479002,0.968778835996509,0.953216374269006,0.98393600154209,0.0351257523483613,-0.000564260031556995,-0.0573961726008954
"2138","전북","임실군",2015,203,103,100,"5",2013,209,111,98,441255,454391,0.971090976713887,0.971291866028708,1.00020686971627,0.046005144417627,9.51707117243248e-06,-0.048899626796198
"2139","전북","임실군",2016,163,84,79,"5",2014,196,104,92,422114,434628,0.971207561408837,0.831632653061224,0.856287251156545,0.0386151608333294,-0.00554949091038988,-0.131217944692365
"2140","전북","임실군",2017,164,78,86,"5",2015,192,92,100,445571,459820,0.969011787221086,0.854166666666667,0.881482225429094,0.0368067042065125,-0.00436224867184549,-0.113637148921536
"2141","전북","임실군",2018,158,91,67,"5",2016,183,96,87,447106,462028,0.967703256079718,0.863387978142076,0.892203237632748,0.0353383761345184,-0.00380936253461726,-0.105449958517117
"2142","전북","임실군",2019,144,69,75,"5",2017,190,97,93,459384,475293,0.966528015350531,0.757894736842105,0.784141509408022,0.0313463246434356,-0.00676637032313813,-0.149237610552201
"2143","전북","임실군",2020,139,64,75,"5",2018,180,84,96,417119,431567,0.966522000060246,0.772222222222222,0.798970144677605,0.0333238236570379,-0.00669908344856335,-0.148241220126093
"2144","전북","장수군",2010,150,73,77,"5",2008,180,88,92,470657,486853,0.966733284995676,0.833333333333333,0.862009559686424,0.031870342946137,-0.00439780265608211,-0.114163635695179
"2145","전북","장수군",2011,162,82,80,"5",2009,182,92,90,451574,467208,0.966537388058424,0.89010989010989,0.920926496074755,0.0358745189049857,-0.00283672391144965,-0.0910470334546675
"2146","전북","장수군",2012,156,81,75,"5",2010,158,78,80,407210,420213,0.969056169133273,0.987341772151899,1.01886949755965,0.0383094717713219,0.000722880484100506,-0.0383360736594377
"2147","전북","장수군",2013,134,71,63,"5",2011,144,73,71,420229,433401,0.969607822778443,0.930555555555556,0.959723646710087,0.031887375692777,-0.00128430720889046,-0.0680586995554467
"2148","전북","장수군",2014,179,76,103,"5",2012,193,88,105,464047,479002,0.968778835996509,0.927461139896373,0.957350744499248,0.0385736789592434,-0.00164513868953675,-0.0734019263738473
"2149","전북","장수군",2015,187,92,95,"5",2013,190,96,94,441255,454391,0.971090976713887,0.984210526315789,1.01351011379624,0.0423791231827401,0.000572546776783499,-0.0405622294682576
"2150","전북","장수군",2016,146,78,68,"5",2014,143,74,69,422114,434628,0.971207561408837,1.02097902097902,1.05124698524586,0.0345878127709576,0.00177252113075975,-0.0227928953234803
"2151","전북","장수군",2017,165,90,75,"5",2015,195,107,88,445571,459820,0.969011787221086,0.846153846153846,0.873213161400678,0.037031135329723,-0.00469506057819924,-0.118565459223972
"2152","전북","장수군",2018,161,78,83,"5",2016,186,92,94,447106,462028,0.967703256079718,0.865591397849462,0.894480195670806,0.0360093579598574,-0.00379970040594406,-0.105306880798518
"2153","전북","장수군",2019,150,76,74,"5",2017,160,81,79,459384,475293,0.966528015350531,0.9375,0.969966710856277,0.0326524215035787,-0.000980659616259692,-0.063562257179129
"2154","전북","장수군",2020,136,75,61,"5",2018,162,91,71,417119,431567,0.966522000060246,0.839506172839506,0.868584649689482,0.0326046044414184,-0.00428474551440486,-0.11248947480894
"2155","전북","전주시",2010,6857,3544,3313,"5",2008,6849,3544,3305,470657,486853,0.966733284995676,1.00116805373047,1.03561971980198,1.45689961054441,0.051894355907208,0.719415992008839
"2156","전북","전주시",2011,6546,3346,3200,"5",2009,6566,3391,3175,451574,467208,0.966537388058424,0.99695400548279,1.03146967494498,1.4495963009385,0.0456183243919768,0.626479921560532
"2157","전북","전주시",2012,5995,3233,2762,"5",2010,6122,3283,2839,407210,420213,0.969056169133273,0.979255145377328,1.01052464920911,1.47221335428894,0.0154945291148629,0.18040390150711
"2158","전북","전주시",2013,5965,3098,2867,"5",2011,5998,3099,2899,420229,433401,0.969607822778443,0.994498166055352,1.02567052646665,1.41946414930907,0.0364383920133051,0.490542611465065
"2159","전북","전주시",2014,6669,3510,3159,"5",2012,6682,3553,3129,464047,479002,0.968778835996509,0.998054474708171,1.03021911464607,1.43713891049829,0.0434290654986714,0.594061168046624
"2160","전북","전주시",2015,6339,3241,3098,"5",2013,6286,3236,3050,441255,454391,0.971090976713887,1.00843143493478,1.03845207000815,1.43658428799674,0.0552396396146634,0.768953270709739
"2161","전북","전주시",2016,6041,3100,2941,"5",2014,6025,3114,2911,422114,434628,0.971207561408837,1.00265560165975,1.03238034947473,1.43112997910517,0.046340488867182,0.637173801662959
"2162","전북","전주시",2017,6505,3346,3159,"5",2015,6378,3300,3078,445571,459820,0.969011787221086,1.01991219818125,1.05252816491132,1.45992445648393,0.0766871526082561,1.08655007908715
"2163","전북","전주시",2018,6532,3266,3266,"5",2016,6376,3231,3145,447106,462028,0.967703256079718,1.02446675031368,1.05865795519167,1.46095109437136,0.0856964038308578,1.21995992642112
"2164","전북","전주시",2019,6708,3435,3273,"5",2017,6461,3309,3152,459384,475293,0.966528015350531,1.03822937625755,1.07418446208309,1.46021628964004,0.10832535997191,1.55505165707808
"2165","전북","전주시",2020,6166,3157,3009,"5",2018,5957,3061,2896,417119,431567,0.966522000060246,1.03508477421521,1.07093762392443,1.47823522783666,0.104862494664124,1.5037732188777
"2166","전북","정읍시",2010,1069,554,515,"5",2008,1114,595,519,470657,486853,0.966733284995676,0.959605026929982,0.992626448084152,0.22712931072947,-0.00167474976427459,-0.0738404099794836
"2167","전북","정읍시",2011,982,519,463,"5",2009,998,522,476,451574,467208,0.966537388058424,0.983967935871743,1.01803401299181,0.21746158990553,0.0039217051375769,0.00903242546708496
"2168","전북","정읍시",2012,935,468,467,"5",2010,968,491,477,407210,420213,0.969056169133273,0.965909090909091,0.996752429503651,0.229611257090936,-0.000745678744158064,-0.0600826381187973
"2169","전북","정읍시",2013,855,453,402,"5",2011,874,462,412,420229,433401,0.969607822778443,0.978260869565217,1.00892427493208,0.203460494159137,0.00181573738769384,-0.0221529448883699
"2170","전북","정읍시",2014,963,488,475,"5",2012,993,501,492,464047,479002,0.968778835996509,0.969788519637462,1.00104222305797,0.207522082892466,0.000216284299829336,-0.0458377980462589
"2171","전북","정읍시",2015,866,453,413,"5",2013,875,459,416,441255,454391,0.971090976713887,0.989714285714286,1.01917771809951,0.196258399338251,0.00376378825717036,0.00669397731130029
"2172","전북","정읍시",2016,812,458,354,"5",2014,825,457,368,422114,434628,0.971207561408837,0.984242424242424,1.01342129463518,0.192365095685052,0.00258178862671456,-0.0108091854212827
"2173","전북","정읍시",2017,829,434,395,"5",2015,852,436,416,445571,459820,0.969011787221086,0.973004694835681,1.00412059756883,0.186053401141457,0.000766651192416718,-0.037687912855628
"2174","전북","정읍시",2018,873,455,418,"5",2016,904,467,437,447106,462028,0.967703256079718,0.96570796460177,0.997938116395277,0.195255711173637,-0.000402594549597523,-0.0550022147974679
"2175","전북","정읍시",2019,858,446,412,"5",2017,866,444,422,459384,475293,0.966528015350531,0.990762124711316,1.02507336463703,0.18677185100047,0.00468299872406717,0.020305733163867
"2176","전북","정읍시",2020,698,365,333,"5",2018,734,378,356,417119,431567,0.966522000060246,0.950953678474114,0.983892429158197,0.167338337500809,-0.00269541412584377,-0.0889545047351684
"2177","전북","진안군",2010,159,84,75,"5",2008,182,97,85,470657,486853,0.966733284995676,0.873626373626374,0.903689142792141,0.0337825635229052,-0.00325362765156994,-0.0972205836141832
"2178","전북","진안군",2011,156,82,74,"5",2009,191,95,96,451574,467208,0.966537388058424,0.816753926701571,0.845030866671658,0.0345458330196158,-0.00535353780315548,-0.128316252479013
"2179","전북","진안군",2012,140,71,69,"5",2010,169,92,77,407210,420213,0.969056169133273,0.828402366863905,0.854854850782108,0.0343802951793915,-0.00499013307396794,-0.12293492075194
"2180","전북","진안군",2013,169,88,81,"5",2011,199,105,94,420229,433401,0.969607822778443,0.849246231155779,0.875865696630042,0.0402161678513382,-0.00499220598043519,-0.122965616547684
"2181","전북","진안군",2014,163,81,82,"5",2012,194,97,97,464047,479002,0.968778835996509,0.84020618556701,0.867283795173698,0.0351257523483613,-0.00466175654334307,-0.118072289914339
"2182","전북","진안군",2015,135,68,67,"5",2013,173,88,85,441255,454391,0.971090976713887,0.780346820809249,0.803577460321889,0.0305945541693579,-0.0060094600302648,-0.138029211083396
"2183","전북","진안군",2016,152,80,72,"5",2014,177,93,84,422114,434628,0.971207561408837,0.858757062146893,0.884215791010911,0.0360092297341476,-0.00416930018107467,-0.110779949353999
"2184","전북","진안군",2017,166,85,81,"5",2015,188,99,89,445571,459820,0.969011787221086,0.882978723404255,0.911215668424886,0.0372555664529334,-0.00330771056497595,-0.0980214485298791
"2185","전북","진안군",2018,146,85,61,"5",2016,176,97,79,447106,462028,0.967703256079718,0.829545454545455,0.857231232130026,0.0326544488331626,-0.00466203542538374,-0.118076419626071
"2186","전북","진안군",2019,148,67,81,"5",2017,185,86,99,459384,475293,0.966528015350531,0.8,0.827704926597356,0.032217055883531,-0.00555084000827004,-0.131237922261842
"2187","전북","진안군",2020,116,50,66,"5",2018,141,62,79,417119,431567,0.966522000060246,0.822695035460993,0.851191214902209,0.0278098096706216,-0.00413834399088601,-0.110321547151078
"2188","제주","서귀포시",2010,1382,729,653,"5",2008,1497,784,713,470657,486853,0.966733284995676,0.923179692718771,0.954947664518347,0.293632093010409,-0.0132288115624848,-0.2449340538907
"2189","제주","서귀포시",2011,1385,763,622,"5",2009,1421,791,630,451574,467208,0.966537388058424,0.97466572836031,1.00840975258931,0.306704991872871,0.00257931309955612,-0.0108458432624416
"2190","제주","서귀포시",2012,1289,706,583,"5",2010,1327,734,593,407210,420213,0.969056169133273,0.971363978899774,1.00238150257953,0.316544289187397,0.000753851041235475,-0.0378774587094118
"2191","제주","서귀포시",2013,1314,703,611,"5",2011,1362,740,622,420229,433401,0.969607822778443,0.964757709251101,0.994997860564446,0.312686654181411,-0.00156410224385225,-0.0722019309935281
"2192","제주","서귀포시",2014,1431,720,711,"5",2012,1483,735,748,464047,479002,0.968778835996509,0.964935940660823,0.996033258373431,0.308373936260767,-0.00122323972951461,-0.067154406523839
"2193","제주","서귀포시",2015,1407,723,684,"5",2013,1403,709,694,441255,454391,0.971090976713887,1.00285103349964,1.03270554206284,0.318863242342863,0.0104285951847367,0.105387070971114
"2194","제주","서귀포시",2016,1412,708,704,"5",2014,1375,695,680,422114,434628,0.971207561408837,1.02690909090909,1.05735285814646,0.334506792004056,0.0191849205908373,0.23505156880461
"2195","제주","서귀포시",2017,1515,769,746,"5",2015,1502,765,737,445571,459820,0.969011787221086,1.008655126498,1.04091110118547,0.34001315166382,0.0139103124521095,0.15694467077863
"2196","제주","서귀포시",2018,1618,882,736,"5",2016,1610,865,745,447106,462028,0.967703256079718,1.00496894409938,1.03850941679232,0.361882864466144,0.0139358980577261,0.157323544855388
"2197","제주","서귀포시",2019,1624,828,796,"5",2017,1712,886,826,459384,475293,0.966528015350531,0.948598130841122,0.9814491828228,0.353516883478745,-0.00655802707446771,-0.146152443948293
"2198","제주","서귀포시",2020,1437,706,731,"5",2018,1535,763,772,417119,431567,0.966522000060246,0.936156351791531,0.968582558631028,0.344506004281752,-0.0108234971907809,-0.209315930342963
"2199","제주","제주시",2010,5083,2663,2420,"5",2008,5156,2694,2462,470657,486853,0.966733284995676,0.985841737781226,1.01976600276635,1.0799796879681,0.0213468814999818,0.267066091177725
"2200","제주","제주시",2011,4633,2438,2195,"5",2009,4692,2466,2226,451574,467208,0.966537388058424,0.987425404944587,1.02161118353437,1.02596695115308,0.022172360081569,0.279289856374851
"2201","제주","제주시",2012,4458,2348,2110,"5",2010,4384,2308,2076,407210,420213,0.969056169133273,1.0168795620438,1.04935048600258,1.09476682792662,0.0540272750176787,0.751000460670312
"2202","제주","제주시",2013,4623,2403,2220,"5",2011,4588,2380,2208,420229,433401,0.969607822778443,1.00762859633827,1.03921252764946,1.10011446140081,0.0431382687352479,0.58975502196911
"2203","제주","제주시",2014,5147,2655,2492,"5",2012,4960,2559,2401,464047,479002,0.968778835996509,1.03770161290323,1.07114397460574,1.10915489163813,0.0789096874445383,1.11946158592348
"2204","제주","제주시",2015,4796,2467,2329,"5",2013,4684,2419,2265,441255,454391,0.971090976713887,1.02391118701964,1.05439264865223,1.08689986515734,0.0591193624856643,0.826404575277632
"2205","제주","제주시",2016,4774,2502,2272,"5",2014,4672,2448,2224,422114,434628,0.971207561408837,1.02183219178082,1.05212544916614,1.13097409704487,0.058952532803731,0.823934145510764
"2206","제주","제주시",2017,5048,2629,2419,"5",2015,4977,2585,2392,445571,459820,0.969011787221086,1.01426562186056,1.04670101564941,1.13292830996631,0.0529089027333935,0.734439497719836
"2207","제주","제주시",2018,5182,2667,2515,"5",2016,5084,2602,2482,447106,462028,0.967703256079718,1.01927616050354,1.05329413133604,1.15900927296883,0.0617683924132845,0.865631661912793
"2208","제주","제주시",2019,5533,2821,2712,"5",2017,5461,2771,2690,459384,475293,0.966528015350531,1.01318439846182,1.04827214769803,1.20443898786201,0.058140856715346,0.811914768943219
"2209","제주","제주시",2020,4989,2567,2422,"5",2018,4976,2529,2447,417119,431567,0.966522000060246,1.00261254019293,1.03734062973262,1.19606155557527,0.0446616916841567,0.612314013611958
"2210","충남","계룡시",2010,579,301,278,"5",2008,572,283,289,470657,486853,0.966733284995676,1.01223776223776,1.04707035326945,0.123019523772089,0.00579057244299217,0.0367067899334032
"2211","충남","계룡시",2011,550,290,260,"5",2009,573,298,275,451574,467208,0.966537388058424,0.959860383944154,0.993091830490197,0.121796206158902,-0.000841388837796647,-0.0614999222709597
"2212","충남","계룡시",2012,487,242,245,"5",2010,516,269,247,407210,420213,0.969056169133273,0.943798449612403,0.973935752822811,0.119594312516883,-0.00311713572242606,-0.0951993981705225
"2213","충남","계룡시",2013,532,275,257,"5",2011,584,306,278,420229,433401,0.969607822778443,0.910958904109589,0.939512741862175,0.12659764081013,-0.00765754417932193,-0.162434197611872
"2214","충남","계룡시",2014,484,243,241,"5",2012,544,273,271,464047,479002,0.968778835996509,0.889705882352941,0.91837873547038,0.104299779979183,-0.00851307993206204,-0.175103052252696
"2215","충남","계룡시",2015,441,229,212,"5",2013,483,243,240,441255,454391,0.971090976713887,0.91304347826087,0.940224448743776,0.099942210286569,-0.00597410071364515,-0.137505606966304
"2216","충남","계룡시",2016,455,260,195,"5",2014,485,278,207,422114,434628,0.971207561408837,0.938144329896907,0.965956575272161,0.107790786375245,-0.00366956752232021,-0.103379860704569
"2217","충남","계룡시",2017,480,249,231,"5",2015,496,248,248,445571,459820,0.969011787221086,0.967741935483871,0.998689539431861,0.107726939141012,-0.000141171905870654,-0.0511310434728467
"2218","충남","계룡시",2018,508,273,235,"5",2016,511,273,238,447106,462028,0.967703256079718,0.99412915851272,1.02730785730747,0.11361958909073,0.0031027075262234,-0.00309536890759624
"2219","충남","계룡시",2019,475,230,245,"5",2017,523,269,254,459384,475293,0.966528015350531,0.908221797323136,0.939674570109332,0.103399334761333,-0.00623760931988653,-0.141407667421857
"2220","충남","계룡시",2020,419,194,225,"5",2018,487,244,243,417119,431567,0.966522000060246,0.860369609856263,0.890170746038511,0.100450950448193,-0.0110324529474476,-0.212410167023423
"2221","충남","공주시",2010,981,496,485,"5",2008,1030,529,501,470657,486853,0.966733284995676,0.952427184466019,0.985201605497921,0.208432042867736,-0.00308445959723102,-0.094715527006757
"2222","충남","공주시",2011,925,503,422,"5",2009,938,509,429,451574,467208,0.966537388058424,0.986140724946695,1.02028202646941,0.204839073994517,0.00415455152072539,0.0124804368123759
"2223","충남","공주시",2012,832,413,419,"5",2010,859,431,428,407210,420213,0.969056169133273,0.968568102444703,0.999496348401552,0.204317182780384,-0.000102904675697711,-0.0505643786958163
"2224","충남","공주시",2013,887,436,451,"5",2011,941,473,468,420229,433401,0.969607822778443,0.942614240170032,0.972160308555411,0.211075389846964,-0.00587627372488572,-0.13605697563024
"2225","충남","공주시",2014,871,466,405,"5",2012,912,491,421,464047,479002,0.968778835996509,0.955043859649123,0.985822381913145,0.187696504879894,-0.00266108936242467,-0.0884462203800792
"2226","충남","공주시",2015,797,395,402,"5",2013,860,421,439,441255,454391,0.971090976713887,0.926744186046512,0.954333021590374,0.180621182762802,-0.00824842365354996,-0.171183996957213
"2227","충남","공주시",2016,731,380,351,"5",2014,781,398,383,422114,434628,0.971207561408837,0.935979513444302,0.963727580628148,0.173175966681986,-0.00628151128861486,-0.14205777194231
"2228","충남","공주시",2017,749,390,359,"5",2015,769,409,360,445571,459820,0.969011787221086,0.973992197659298,1.00513967993361,0.168098911284621,0.000863974601191158,-0.0362467385797851
"2229","충남","공주시",2018,735,364,371,"5",2016,774,382,392,447106,462028,0.967703256079718,0.949612403100775,0.981305371388094,0.164390547208045,-0.00307322022736246,-0.0945490933508132
"2230","충남","공주시",2019,734,389,345,"5",2017,745,393,352,459384,475293,0.966528015350531,0.985234899328859,1.01935472503768,0.159779182557512,0.00309248214514655,-0.00324678732125655
"2231","충남","공주시",2020,670,353,317,"5",2018,696,376,320,417119,431567,0.966522000060246,0.96264367816092,0.995987342348043,0.160625624821694,-0.000644535642541075,-0.0585849014687463
"2232","충남","금산군",2010,412,206,206,"5",2008,438,216,222,470657,486853,0.966733284995676,0.940639269406393,0.973008050933717,0.0875372086253896,-0.0023627998766211,-0.0840291213582925
"2233","충남","금산군",2011,370,191,179,"5",2009,384,197,187,451574,467208,0.966537388058424,0.963541666666667,0.996900563362815,0.0819356295978068,-0.000253954292266229,-0.0528011357567923
"2234","충남","금산군",2012,371,183,188,"5",2010,374,183,191,407210,420213,0.969056169133273,0.991978609625668,1.02365439818922,0.0911077822253874,0.00215509975889578,-0.0171276346806397
"2235","충남","금산군",2013,377,201,176,"5",2011,403,216,187,420229,433401,0.969607822778443,0.935483870967742,0.96480643925405,0.089712989822216,-0.00315731955700893,-0.0957944442075944
"2236","충남","금산군",2014,454,221,233,"5",2012,459,230,229,464047,479002,0.968778835996509,0.989106753812636,1.02098303251559,0.0978349175837792,0.00205287325682018,-0.0186414144275268
"2237","충남","금산군",2015,378,200,178,"5",2013,395,201,194,441255,454391,0.971090976713887,0.956962025316456,0.985450434885881,0.085664751674202,-0.0012463848824686,-0.0674971421459034
"2238","충남","금산군",2016,377,190,187,"5",2014,385,196,189,422114,434628,0.971207561408837,0.979220779220779,1.00825077782582,0.0893123658537741,0.000736896487757967,-0.0381285233467676
"2239","충남","금산군",2017,400,218,182,"5",2015,427,232,195,445571,459820,0.969011787221086,0.936768149882904,0.966725237233027,0.0897724492841769,-0.00298715695294114,-0.0932746602133726
"2240","충남","금산군",2018,370,187,183,"5",2016,387,192,195,447106,462028,0.967703256079718,0.956072351421189,0.98798091813223,0.0827544251251381,-0.00099463221049926,-0.0637691646810182
"2241","충남","금산군",2019,322,179,143,"5",2017,323,175,148,459384,475293,0.966528015350531,0.996904024767802,1.0314279658063,0.0700938648276823,0.00220290758703606,-0.0164196918232397
"2242","충남","금산군",2020,298,167,131,"5",2018,322,179,143,417119,431567,0.966522000060246,0.925465838509317,0.957521751653486,0.0714424420848727,-0.00303474979736268,-0.0939794195714576
"2243","충남","논산시",2010,1068,545,523,"5",2008,1017,526,491,470657,486853,0.966733284995676,1.05014749262537,1.08628461326856,0.226916841776495,0.019579431936807,0.24089353026588
"2244","충남","논산시",2011,985,489,496,"5",2009,1017,501,516,451574,467208,0.966537388058424,0.968534906588004,1.00206667486872,0.218125932848215,0.000450795383633883,-0.0423651356556264
"2245","충남","논산시",2012,939,483,456,"5",2010,914,466,448,407210,420213,0.969056169133273,1.027352297593,1.06015763617899,0.230593551238918,0.0138719629606521,0.156376787868689
"2246","충남","논산시",2013,999,518,481,"5",2011,980,516,464,420229,433401,0.969607822778443,1.01938775510204,1.05134027506188,0.23772752475436,0.0122049965106692,0.131692190435646
"2247","충남","논산시",2014,1065,564,501,"5",2012,1047,550,497,464047,479002,0.968778835996509,1.01719197707736,1.04997336779251,0.229502615036839,0.0114690185905791,0.120793759530082
"2248","충남","논산시",2015,1009,512,497,"5",2013,983,487,496,441255,454391,0.971090976713887,1.0264496439471,1.05700667451421,0.228665964125052,0.0130354861893545,0.143990160434296
"2249","충남","논산시",2016,919,467,452,"5",2014,896,446,450,422114,434628,0.971207561408837,1.02566964285714,1.05607666539303,0.217713698195274,0.012208658205176,0.1317464131555
"2250","충남","논산시",2017,918,495,423,"5",2015,892,465,427,445571,459820,0.969011787221086,1.02914798206278,1.06205930168729,0.206027771107186,0.0127859396031009,0.140294850896108
"2251","충남","논산시",2018,909,465,444,"5",2016,907,474,433,447106,462028,0.967703256079718,1.00220507166483,1.03565330112134,0.203307493077704,0.00724858327092405,0.0582971526793872
"2252","충남","논산시",2019,905,466,439,"5",2017,930,473,457,459384,475293,0.966528015350531,0.973118279569892,1.00681849270243,0.197002943071591,0.00134326312969078,-0.0291493885518885
"2253","충남","논산시",2020,794,409,385,"5",2018,811,414,397,417119,431567,0.966522000060246,0.979038224414303,1.01294975629451,0.190353352400634,0.00246502952343026,-0.0125381653064181
"2254","충남","당진시",2014,1773,923,850,"5",2012,1741,902,839,464047,479002,0.968778835996509,1.01838024124067,1.05119992654787,0.382073367568371,0.0195621283553998,0.24063729718981
"2255","충남","당진시",2015,1734,925,809,"5",2013,1769,945,824,441255,454391,0.971090976713887,0.980214810627473,1.00939544711296,0.392970051330863,0.00369212933425544,0.00563284517834201
"2256","충남","당진시",2016,1691,845,846,"5",2014,1738,867,871,422114,434628,0.971207561408837,0.972957422324511,1.00180173732702,0.400602680792393,0.000721780803287684,-0.0383523578373044
"2257","충남","당진시",2017,1862,989,873,"5",2015,1918,1011,907,445571,459820,0.969011787221086,0.970802919708029,1.00184841145439,0.417890751417844,0.000772434051606227,-0.0376022797277948
"2258","충남","당진시",2018,1865,967,898,"5",2016,1926,978,948,447106,462028,0.967703256079718,0.968328141225338,1.00064574045989,0.417127034752385,0.000269355803254145,-0.0450519101855757
"2259","충남","당진시",2019,1871,975,896,"5",2017,1907,990,917,459384,475293,0.966528015350531,0.981122181436812,1.01509957896149,0.407284537554638,0.00614982503460149,0.0420266364130636
"2260","충남","당진시",2020,1703,850,853,"5",2018,1775,897,878,417119,431567,0.966522000060246,0.95943661971831,0.992669199106183,0.408276774733349,-0.00299299574514009,-0.0933611216025192
"2261","충남","보령시",2010,900,435,465,"5",2008,916,455,461,470657,486853,0.966733284995676,0.982532751091703,1.01634314897526,0.191222057676822,0.00312517057596804,-0.00276273393460644
"2262","충남","보령시",2011,888,471,417,"5",2009,920,474,446,451574,467208,0.966537388058424,0.965217391304348,0.998634303473012,0.196645511034736,-0.000268558091468014,-0.0530173902016809
"2263","충남","보령시",2012,779,426,353,"5",2010,807,449,358,407210,420213,0.969056169133273,0.965303593556382,0.996127597453667,0.191301785319614,-0.000740797520589685,-0.0600103564968322
"2264","충남","보령시",2013,813,434,379,"5",2011,854,451,403,420229,433401,0.969607822778443,0.951990632318501,0.981830601975282,0.193465943568864,-0.00351515973293035,-0.101093375501671
"2265","충남","보령시",2014,828,422,406,"5",2012,872,450,422,464047,479002,0.968778835996509,0.94954128440367,0.980142473309657,0.178430202113148,-0.00354318250082506,-0.101508339308799
"2266","충남","보령시",2015,836,424,412,"5",2013,869,436,433,441255,454391,0.971090976713887,0.962025316455696,0.990664458350886,0.189459609522838,-0.00176870807552531,-0.0752317535717535
"2267","충남","보령시",2016,768,388,380,"5",2014,801,393,408,422114,434628,0.971207561408837,0.958801498127341,0.987226146320875,0.181941371288325,-0.00232409245501639,-0.0834559381847541
"2268","충남","보령시",2017,797,412,385,"5",2015,836,437,399,445571,459820,0.969011787221086,0.953349282296651,0.983836620843021,0.178871605198723,-0.00289116957524432,-0.0918532700125538
"2269","충남","보령시",2018,811,401,410,"5",2016,835,416,419,447106,462028,0.967703256079718,0.97125748502994,1.00367285004767,0.181388753449965,0.000666213691755331,-0.0391752008997471
"2270","충남","보령시",2019,726,374,352,"5",2017,786,409,377,459384,475293,0.966528015350531,0.923664122137405,0.95565168051794,0.158037720077321,-0.00700870730020537,-0.152826159513163
"2271","충남","보령시",2020,644,341,303,"5",2018,686,359,327,417119,431567,0.966522000060246,0.938775510204082,0.971292438398263,0.154392391619658,-0.00443222909326088,-0.114673425644953
"2272","충남","부여군",2010,536,279,257,"5",2008,555,288,267,470657,486853,0.966733284995676,0.965765765765766,0.998999187009564,0.113883358794196,-0.000113975944875725,-0.0507283231007771
"2273","충남","부여군",2011,451,248,203,"5",2009,470,258,212,451574,467208,0.966537388058424,0.959574468085106,0.992796015902391,0.0998728890502996,-0.000719482704500618,-0.0596947246768137
"2274","충남","부여군",2012,451,220,231,"5",2010,475,232,243,407210,420213,0.969056169133273,0.949473684210526,0.979792208597917,0.11075366518504,-0.00223808696307539,-0.0821823606957674
"2275","충남","부여군",2013,455,243,212,"5",2011,460,241,219,420229,433401,0.969607822778443,0.989130434782609,1.02013454465355,0.108274298061295,0.00218005368914711,-0.0167581145126527
"2276","충남","부여군",2014,442,230,212,"5",2012,453,235,218,464047,479002,0.968778835996509,0.975717439293598,1.00716221601802,0.0952489726256177,0.000682193717438748,-0.0389385671624761
"2277","충남","부여군",2015,408,210,198,"5",2013,432,227,205,441255,454391,0.971090976713887,0.944444444444444,0.972560210208509,0.0924635414896148,-0.00253718014185186,-0.0866113608793894
"2278","충남","부여군",2016,377,200,177,"5",2014,404,204,200,422114,434628,0.971207561408837,0.933168316831683,0.960833043225102,0.0893123658537741,-0.00349809357285864,-0.100840658183273
"2279","충남","부여군",2017,380,212,168,"5",2015,415,231,184,445571,459820,0.969011787221086,0.91566265060241,0.944944801165246,0.0852838268199681,-0.00469531804296204,-0.118569271786621
"2280","충남","부여군",2018,359,198,161,"5",2016,380,212,168,447106,462028,0.967703256079718,0.944736842105263,0.976267090319098,0.0802941584322286,-0.00190561400997614,-0.0772590696453001
"2281","충남","부여군",2019,370,190,180,"5",2017,398,214,184,459384,475293,0.966528015350531,0.92964824120603,0.961843036560998,0.0805426397088275,-0.0030732625586504,-0.0945497201965434
"2282","충남","부여군",2020,314,176,138,"5",2018,339,183,156,417119,431567,0.966522000060246,0.926253687315634,0.958336889649588,0.0752782779015101,-0.00313632719919963,-0.095483587380393
"2283","충남","서산시",2010,1714,911,803,"5",2008,1706,907,799,470657,486853,0.966733284995676,1.00468933177022,1.03926217020108,0.364171785397859,0.0142981746207208,0.162688170590383
"2284","충남","서산시",2011,1711,912,799,"5",2009,1727,912,815,451574,467208,0.966537388058424,0.990735379270411,1.0250357528958,0.378896924977966,0.0094859697867287,0.0914285845959221
"2285","충남","서산시",2012,1492,762,730,"5",2010,1557,803,754,407210,420213,0.969056169133273,0.9582530507386,0.988851917217208,0.366395717197515,-0.0040846097865783,-0.109525845952812
"2286","충남","서산시",2013,1599,831,768,"5",2011,1608,816,792,420229,433401,0.969607822778443,0.994402985074627,1.02557236205576,0.380506818901123,0.00973045813762357,0.0950489913047495
"2287","충남","서산시",2014,1873,967,906,"5",2012,1892,974,918,464047,479002,0.968778835996509,0.989957716701903,1.0218614196744,0.403622908886384,0.00882376980136603,0.0816226643513892
"2288","충남","서산시",2015,1724,901,823,"5",2013,1742,916,826,441255,454391,0.971090976713887,0.989667049368542,1.01912907554503,0.390703788059059,0.00747380227751016,0.0616322171084913
"2289","충남","서산시",2016,1641,884,757,"5",2014,1672,891,781,422114,434628,0.971207561408837,0.981459330143541,1.01055569287355,0.388757539432476,0.00410360518852724,0.0117260186889552
"2290","충남","서산시",2017,1716,889,827,"5",2015,1779,918,861,445571,459820,0.969011787221086,0.964586846543002,0.99543355329993,0.385123807429119,-0.00175864733955318,-0.0750827732384332
"2291","충남","서산시",2018,1716,904,812,"5",2016,1747,916,831,447106,462028,0.967703256079718,0.98225529479107,1.01503770770629,0.383801604093884,0.00577149633956922,0.036424309183061
"2292","충남","서산시",2019,1834,948,886,"5",2017,1837,966,871,459384,475293,0.966528015350531,0.998366902558519,1.03294150474929,0.399230273583756,0.0131512459533183,0.145704342007908
"2293","충남","서산시",2020,1655,816,839,"5",2018,1685,838,847,417119,431567,0.966522000060246,0.982195845697329,1.01621674999235,0.396769267283437,0.00643430801218366,0.0462392873504842
"2294","충남","서천군",2010,405,215,190,"5",2008,403,213,190,470657,486853,0.966733284995676,1.00496277915633,1.03954502731415,0.0860499259545699,0.00340284667225399,0.00134912005841654
"2295","충남","서천군",2011,339,164,175,"5",2009,356,170,186,451574,467208,0.966537388058424,0.952247191011236,0.985215060251426,0.0750707525233959,-0.00110991655293851,-0.065476306167564
"2296","충남","서천군",2012,360,180,180,"5",2010,381,196,185,407210,420213,0.969056169133273,0.94488188976378,0.975053789306027,0.0884064733184352,-0.00220540651011282,-0.0816984254460095
"2297","충남","서천군",2013,310,160,150,"5",2011,325,171,154,420229,433401,0.969607822778443,0.953846153846154,0.983744284480788,0.0737693019758275,-0.00119917278696992,-0.0667980209540119
"2298","충남","서천군",2014,328,166,162,"5",2012,345,170,175,464047,479002,0.968778835996509,0.950724637681159,0.981363962914426,0.0706824955230828,-0.00131724160786907,-0.0685463952619168
"2299","충남","서천군",2015,315,154,161,"5",2013,325,154,171,441255,454391,0.971090976713887,0.969230769230769,0.998084414820316,0.071387293061835,-0.000136748440607013,-0.0510655403793122
"2300","충남","서천군",2016,293,149,144,"5",2014,305,160,145,422114,434628,0.971207561408837,0.960655737704918,0.989135356721675,0.0694125283691136,-0.000754142359777043,-0.0602079681423167
"2301","충남","서천군",2017,316,154,162,"5",2015,339,166,173,445571,459820,0.969011787221086,0.932153392330384,0.961962903468486,0.0709202349344998,-0.0026975998222412,-0.088986870734905
"2302","충남","서천군",2018,306,156,150,"5",2016,328,168,160,447106,462028,0.967703256079718,0.932926829268293,0.964062922602628,0.0684401461845737,-0.00245953883052246,-0.0854616409708938
"2303","충남","서천군",2019,266,133,133,"5",2017,298,153,145,459384,475293,0.966528015350531,0.89261744966443,0.92352982581752,0.0579036274663462,-0.00442790047814892,-0.114609327101469
"2304","충남","서천군",2020,261,127,134,"5",2018,286,138,148,417119,431567,0.966522000060246,0.912587412587413,0.944197247999041,0.0625720717588985,-0.00349169380254804,-0.100745889776997
"2305","충남","아산시",2010,3124,1649,1475,"5",2008,3033,1583,1450,470657,486853,0.966733284995676,1.03000329706561,1.06544722629491,0.663753009091547,0.0434407933899429,0.594234835773876
"2306","충남","아산시",2011,3259,1634,1625,"5",2009,3380,1706,1674,451574,467208,0.966537388058424,0.964201183431953,0.997582913340617,0.721697883403385,-0.00174440632607935,-0.0748718909590427
"2307","충남","아산시",2012,2953,1548,1405,"5",2010,3091,1598,1493,407210,420213,0.969056169133273,0.955354254286639,0.98586055660851,0.725178654748164,-0.0102536225375287,-0.200877172380576
"2308","충남","아산시",2013,3235,1662,1573,"5",2011,3401,1765,1636,420229,433401,0.969607822778443,0.95119082622758,0.981005726110905,0.769818360941296,-0.0146221407925733,-0.265566605395728
"2309","충남","아산시",2014,3701,1934,1767,"5",2012,3822,1996,1826,464047,479002,0.968778835996509,0.968341182626897,0.999548242226863,0.797548524179663,-0.000360298745252456,-0.0543758945116725
"2310","충남","아산시",2015,3494,1782,1712,"5",2013,3706,1878,1828,441255,454391,0.971090976713887,0.942795466810577,0.970862143113449,0.791832387168417,-0.0230722987754491,-0.390697346962267
"2311","충남","아산시",2016,3564,1817,1747,"5",2014,3754,1896,1858,422114,434628,0.971207561408837,0.949387320191795,0.977532875479893,0.844321676134883,-0.0189694802327477,-0.329942420509821
"2312","충남","아산시",2017,3824,1990,1834,"5",2015,4014,2116,1898,445571,459820,0.969011787221086,0.952665670154459,0.983131147337739,0.858224615156731,-0.0144772645842049,-0.263421264749409
"2313","충남","아산시",2018,3957,2034,1923,"5",2016,4095,2093,2002,447106,462028,0.967703256079718,0.966300366300366,0.998550289284925,0.885025027622085,-0.00128303026565333,-0.0680397904587737
"2314","충남","아산시",2019,4141,2111,2030,"5",2017,4333,2226,2107,459384,475293,0.966528015350531,0.955688899146088,0.988785512647027,0.901424516308796,-0.0101090138378051,-0.198735793027663
"2315","충남","아산시",2020,3646,1895,1751,"5",2018,3802,1978,1824,417119,431567,0.966522000060246,0.958968963703314,0.992185344610407,0.874091086716261,-0.00683072062180284,-0.150190515883469
"2316","충남","연기군",2010,736,382,354,"5",2008,726,384,342,470657,486853,0.966733284995676,1.0137741046832,1.04865956351935,0.156377149389046,0.00760924383367151,0.0636378485293169
"2317","충남","연기군",2011,719,371,348,"5",2009,732,371,361,451574,467208,0.966537388058424,0.98224043715847,1.01624670632927,0.159220858596819,0.00258681453111695,-0.0107347613517934
"2318","충남","연기군",2012,783,388,395,"5",2010,713,351,362,407210,420213,0.969056169133273,1.09817671809257,1.13324361690487,0.192284079467597,0.0256206262214858,0.330352108711551
"2319","충남","연기군",2013,0,0,0,"5",2011,724,354,370,420229,433401,0.969607822778443,0,0,0,0,-0.0490405564895554
"2320","충남","예산군",2010,580,282,298,"5",2008,610,299,311,470657,486853,0.966733284995676,0.950819672131147,0.983538776297953,0.123231992725063,-0.00202854939949633,-0.0790795085633187
"2321","충남","예산군",2011,560,293,267,"5",2009,590,311,279,451574,467208,0.966537388058424,0.949152542372881,0.982013271395052,0.124010682634518,-0.00223054649266146,-0.0820707006940765
"2322","충남","예산군",2012,539,281,258,"5",2010,568,296,272,407210,420213,0.969056169133273,0.948943661971831,0.979245261727779,0.132364136440657,-0.00274718300845435,-0.0897211032631794
"2323","충남","예산군",2013,557,271,286,"5",2011,564,273,291,420229,433401,0.969607822778443,0.987588652482269,1.0185444354732,0.132546778066245,0.00245800517303028,-0.0126421825539481
"2324","충남","예산군",2014,614,338,276,"5",2012,628,350,278,464047,479002,0.968778835996509,0.977707006369427,1.00921590154654,0.1323141836926,0.00121939449012208,-0.030983647125217
"2325","충남","예산군",2015,512,256,256,"5",2013,541,272,269,441255,454391,0.971090976713887,0.946395563770795,0.974569413643755,0.116032679516379,-0.00295077907658774,-0.0927359731670546
"2326","충남","예산군",2016,484,264,220,"5",2014,510,267,243,422114,434628,0.971207561408837,0.949019607843137,0.977154261923668,0.114660968363996,-0.00261951445082248,-0.0878305751424531
"2327","충남","예산군",2017,496,259,237,"5",2015,529,270,259,445571,459820,0.969011787221086,0.937618147448015,0.967602417032406,0.111317837112379,-0.00360642886362137,-0.102444897452934
"2328","충남","예산군",2018,497,262,235,"5",2016,501,263,238,447106,462028,0.967703256079718,0.992015968063872,1.02512413989661,0.111159322397821,0.00279278236673549,-0.00768477008985104
"2329","충남","예산군",2019,486,265,221,"5",2017,484,267,217,459384,475293,0.966528015350531,1.00413223140496,1.03890649361135,0.105793845671595,0.00411606758074221,0.0119105629759038
"2330","충남","예산군",2020,441,229,212,"5",2018,428,221,207,417119,431567,0.966522000060246,1.0303738317757,1.06606350575722,0.10572522469607,0.00698457899039171,0.0543877522318811
"2331","충남","천안시",2010,6122,3184,2938,"5",2008,6340,3258,3082,470657,486853,0.966733284995676,0.965615141955836,0.998843380012673,1.30073493010834,-0.00150445601837779,-0.0713186840246089
"2332","충남","천안시",2011,6315,3307,3008,"5",2009,6224,3248,2976,451574,467208,0.966537388058424,1.01462082262211,1.04974813717271,1.39844189435176,0.0695698791882768,0.981156818655971
"2333","충남","천안시",2012,6027,3089,2938,"5",2010,5839,2985,2854,407210,420213,0.969056169133273,1.0321972940572,1.06515734271668,1.4800717074728,0.0964375394890656,1.37901568288178
"2334","충남","천안시",2013,6104,3190,2914,"5",2011,6105,3163,2942,420229,433401,0.969607822778443,0.9998361998362,1.03117587992549,1.45254135245307,0.045284254790886,0.62153298719504
"2335","충남","천안시",2014,6797,3506,3291,"5",2012,6857,3542,3315,464047,479002,0.968778835996509,0.991249817704535,1.02319516165412,1.46472232338535,0.0339744710693167,0.454056636231538
"2336","충남","천안시",2015,6599,3425,3174,"5",2013,6605,3438,3167,441255,454391,0.971090976713887,0.999091597274792,1.02883418879625,1.49550713306365,0.0431217350208981,0.589510189157506
"2337","충남","천안시",2016,6326,3273,3053,"5",2014,6278,3248,3030,422114,434628,0.971207561408837,1.0076457470532,1.03751843281729,1.4986472848567,0.056226897473715,0.783572678804932
"2338","충남","천안시",2017,6857,3517,3340,"5",2015,6593,3371,3222,445571,459820,0.969011787221086,1.04004246928561,1.0733021857951,1.538924211854,0.112806508501896,1.62140892989633
"2339","충남","천안시",2018,7076,3700,3376,"5",2016,6840,3580,3260,447106,462028,0.967703256079718,1.03450292397661,1.06902908249736,1.58262246536615,0.109246976723935,1.56869904542924
"2340","충남","천안시",2019,7491,3751,3740,"5",2017,7281,3630,3651,459384,475293,0.966528015350531,1.02884219200659,1.06447218876885,1.63066192988872,0.105132343761963,1.50776916993472
"2341","충남","천안시",2020,6790,3458,3332,"5",2018,6785,3449,3336,417119,431567,0.966522000060246,1.00073691967576,1.03540004222705,1.62783282468552,0.0576253507324527,0.804281107412611
"2342","충남","청양군",2010,189,103,86,"5",2008,201,100,101,470657,486853,0.966733284995676,0.940298507462687,0.972655562870055,0.0401566321121326,-0.00109806050214055,-0.0653007406418774
"2343","충남","청양군",2011,196,96,100,"5",2009,206,105,101,451574,467208,0.966537388058424,0.951456310679612,0.984396798752807,0.0434037389220814,-0.000677237273281872,-0.0590691503210546
"2344","충남","청양군",2012,159,86,73,"5",2010,169,88,81,407210,420213,0.969056169133273,0.940828402366864,0.970870866245394,0.0390461923823089,-0.00113738176051235,-0.0658830135685331
"2345","충남","청양군",2013,173,88,85,"5",2011,188,99,89,420229,433401,0.969607822778443,0.920212765957447,0.949056664291906,0.0411680298123166,-0.00209723676316967,-0.0800966375649436
"2346","충남","청양군",2014,162,76,86,"5",2012,167,76,91,464047,479002,0.968778835996509,0.970059880239521,1.00132232889016,0.0349102569351811,4.61628413082224e-05,-0.0483569727533197
"2347","충남","청양군",2015,171,99,72,"5",2013,185,108,77,441255,454391,0.971090976713887,0.924324324324324,0.951841121469568,0.0387531019478533,-0.00186630592938413,-0.0766769918564583
"2348","충남","청양군",2016,144,63,81,"5",2014,168,71,97,422114,434628,0.971207561408837,0.857142857142857,0.882553731253372,0.0341140071165609,-0.00400656284783601,-0.108370119475081
"2349","충남","청양군",2017,165,88,77,"5",2015,185,94,91,445571,459820,0.969011787221086,0.891891891891892,0.920413872827742,0.037031135329723,-0.00294716464568444,-0.092682450331128
"2350","충남","청양군",2018,169,89,80,"5",2016,180,98,82,447106,462028,0.967703256079718,0.938888888888889,0.970223963792827,0.0377986428274279,-0.00112549375741151,-0.0657069748901122
"2351","충남","청양군",2019,159,80,79,"5",2017,189,99,90,459384,475293,0.966528015350531,0.841269841269841,0.87040399027103,0.0346115667937934,-0.00448552094694336,-0.115462576473169
"2352","충남","청양군",2020,143,74,69,"5",2018,162,83,79,417119,431567,0.966522000060246,0.882716049382716,0.913291212541147,0.0342827826111973,-0.00297261851093237,-0.0930593735840024
"2353","충남","태안군",2010,442,217,225,"5",2008,468,233,235,470657,486853,0.966733284995676,0.944444444444444,0.976944167644614,0.093911277214617,-0.00216520266374039,-0.081103083072458
"2354","충남","태안군",2011,436,219,217,"5",2009,434,214,220,451574,467208,0.966537388058424,1.00460829493088,1.03938896450651,0.096551174336875,0.00380305077901739,0.00727538046192155
"2355","충남","태안군",2012,414,209,205,"5",2010,428,219,209,407210,420213,0.969056169133273,0.967289719626168,0.998177144356158,0.1016674443162,-0.000185325074666789,-0.0517848677877493
"2356","충남","태안군",2013,429,212,217,"5",2011,438,221,217,420229,433401,0.969607822778443,0.979452054794521,1.01015279764129,0.102087195314935,0.00103647063579899,-0.0336924009246186
"2357","충남","태안군",2014,438,235,203,"5",2012,445,240,205,464047,479002,0.968778835996509,0.984269662921348,1.01599005505617,0.0943869909728971,0.0015092531822431,-0.0266913920965996
"2358","충남","태안군",2015,429,217,212,"5",2013,430,208,222,441255,454391,0.971090976713887,0.997674418604651,1.02737482123531,0.0972226943604039,0.00266145387813111,-0.00962949481584803
"2359","충남","태안군",2016,429,224,205,"5",2014,416,234,182,422114,434628,0.971207561408837,1.03125,1.06182245791421,0.101631312868088,0.00628309756255353,0.0440001486582643
"2360","충남","태안군",2017,349,189,160,"5",2015,358,198,160,445571,459820,0.969011787221086,0.974860335195531,1.00603557980571,0.0783264620004444,0.000472745612302395,-0.042040094585813
"2361","충남","태안군",2018,422,221,201,"5",2016,435,222,213,447106,462028,0.967703256079718,0.970114942528736,1.00249217560638,0.0943847767643467,0.000235223438265856,-0.0455573454864375
"2362","충남","태안군",2019,392,186,206,"5",2017,415,199,216,459384,475293,0.966528015350531,0.944578313253012,0.977290154295674,0.0853316615293524,-0.00193786886702536,-0.0777367026303722
"2363","충남","태안군",2020,356,174,182,"5",2018,375,186,189,417119,431567,0.966522000060246,0.949333333333333,0.982215959154742,0.0853473469201834,-0.00151782070366298,-0.071516589552994
"2364","충남","홍성군",2010,749,398,351,"5",2008,752,387,365,470657,486853,0.966733284995676,0.996010638297872,1.03028483011457,0.159139245777711,0.00481950502293908,0.0223271313958244
"2365","충남","홍성군",2011,733,365,368,"5",2009,730,369,361,451574,467208,0.966537388058424,1.0041095890411,1.03887299285768,0.162321125662682,0.00630990795853542,0.0443971595470199
"2366","충남","홍성군",2012,661,315,346,"5",2010,681,332,349,407210,420213,0.969056169133273,0.970631424375918,1.00162555617808,0.162324107954127,0.000263866956536772,-0.0451331895488115
"2367","충남","홍성군",2013,716,378,338,"5",2011,666,340,326,420229,433401,0.969607822778443,1.07507507507508,1.10877310374251,0.170383291015137,0.0185331193895803,0.22539963474225
"2368","충남","홍성군",2014,773,396,377,"5",2012,724,364,360,464047,479002,0.968778835996509,1.06767955801105,1.10208802911431,0.166577954388241,0.0170056150573892,0.202780205588319
"2369","충남","홍성군",2015,827,412,415,"5",2013,738,375,363,441255,454391,0.971090976713887,1.12059620596206,1.15395594525457,0.187419972578214,0.028854419037865,0.378238419713794
"2370","충남","홍성군",2016,849,429,420,"5",2014,744,377,367,422114,434628,0.971207561408837,1.14112903225806,1.17495896613772,0.20113050029139,0.0351895843897443,0.472050149628638
"2371","충남","홍성군",2017,950,478,472,"5",2015,817,419,398,445571,459820,0.969011787221086,1.16279069767442,1.19997580319332,0.21320956704992,0.042636754419308,0.582328550370948
"2372","충남","홍성군",2018,942,490,452,"5",2016,921,481,440,447106,462028,0.967703256079718,1.0228013029316,1.05693692410945,0.210688293156433,0.0119959433581972,0.128596511508856
"2373","충남","홍성군",2019,943,482,461,"5",2017,958,501,457,459384,475293,0.966528015350531,0.984342379958246,1.01843129668751,0.205274889852498,0.00378348239736719,0.00698561000885913
"2374","충남","홍성군",2020,865,462,403,"5",2018,856,457,399,417119,431567,0.966522000060246,1.01051401869159,1.04551579646258,0.207374873836963,0.0094388325490154,0.0907305719052225
"2375","충북","괴산군",2010,200,112,88,"5",2008,207,115,92,470657,486853,0.966733284995676,0.966183574879227,0.999431373549477,0.0424937905948493,-2.41630933152037e-05,-0.0493983658691197
"2376","충북","괴산군",2011,177,88,89,"5",2009,191,88,103,451574,467208,0.966537388058424,0.926701570680628,0.958785021800535,0.0391962336184103,-0.0016154719140839,-0.0729626179467355
"2377","충북","괴산군",2012,167,79,88,"5",2010,160,72,88,407210,420213,0.969056169133273,1.04375,1.07707894882248,0.0410107806782741,0.00316106786507044,-0.00223116346992237
"2378","충북","괴산군",2013,166,83,83,"5",2011,177,89,88,420229,433401,0.969607822778443,0.937853107344633,0.967249938905385,0.0395022713806044,-0.00129370180109084,-0.0681978155685593
"2379","충북","괴산군",2014,191,90,101,"5",2012,213,101,112,464047,479002,0.968778835996509,0.896713615023474,0.925612308717596,0.0411596239174049,-0.00306176939726778,-0.0943795283717673
"2380","충북","괴산군",2015,189,79,110,"5",2013,181,90,91,441255,454391,0.971090976713887,1.04419889502762,1.07528431430918,0.042832375837101,0.00322460604512924,-0.00129028406806282
"2381","충북","괴산군",2016,182,77,105,"5",2014,207,97,110,422114,434628,0.971207561408837,0.879227053140097,0.905292635762315,0.0431163145500978,-0.00408343250668271,-0.109508412680361
"2382","충북","괴산군",2017,190,104,86,"5",2015,198,112,86,445571,459820,0.969011787221086,0.95959595959596,0.990283061827215,0.042641913409984,-0.000414348836174055,-0.0551762733889035
"2383","충북","괴산군",2018,142,61,81,"5",2016,163,77,86,447106,462028,0.967703256079718,0.871165644171779,0.900240480435062,0.0317598063993773,-0.00316834302787733,-0.0959576808106491
"2384","충북","괴산군",2019,170,96,74,"5",2017,179,90,89,459384,475293,0.966528015350531,0.949720670391061,0.982610597217532,0.0370060777040559,-0.000643513590595129,-0.0585697668265095
"2385","충북","괴산군",2020,143,62,81,"5",2018,144,63,81,417119,431567,0.966522000060246,0.993055555555556,1.02745261410879,0.0342827826111973,0.000941152001600738,-0.0351038883082281
"2386","충북","단양군",2010,203,103,100,"5",2008,237,119,118,470657,486853,0.966733284995676,0.856540084388186,0.886014889196679,0.0431311974537721,-0.00491631432084813,-0.12184180564828
"2387","충북","단양군",2011,205,114,91,"5",2009,219,117,102,451574,467208,0.966537388058424,0.936073059360731,0.968480961963727,0.0453967677501362,-0.00143086244944038,-0.0702289034696976
"2388","충북","단양군",2012,200,106,94,"5",2010,213,106,107,407210,420213,0.969056169133273,0.938967136150235,0.968950166211779,0.0491147073991307,-0.00152500350130011,-0.0716229531022527
"2389","충북","단양군",2013,184,95,89,"5",2011,206,106,100,420229,433401,0.969607822778443,0.893203883495146,0.921201193422347,0.0437856502050073,-0.00345025698138112,-0.100132289395645
"2390","충북","단양군",2014,211,108,103,"5",2012,215,111,104,464047,479002,0.968778835996509,0.981395348837209,1.01302310947753,0.0454695321810075,0.000592154695485483,-0.0402718735467792
"2391","충북","단양군",2015,182,86,96,"5",2013,184,86,98,441255,454391,0.971090976713887,0.989130434782609,1.01857648613909,0.041245991546838,0.000766205590262879,-0.0376945113746221
"2392","충북","단양군",2016,175,100,75,"5",2014,192,109,83,422114,434628,0.971207561408837,0.911458333333333,0.938479445126198,0.0414579947597095,-0.0025505188415725,-0.086808881611068
"2393","충북","단양군",2017,152,88,64,"5",2015,159,92,67,445571,459820,0.969011787221086,0.955974842767296,0.986546144612773,0.0341135307279872,-0.000458958509162068,-0.0558368576612145
"2394","충북","단양군",2018,164,92,72,"5",2016,169,97,72,447106,462028,0.967703256079718,0.970414201183432,1.00280142190975,0.0366803397851964,0.000102757107531164,-0.0475189194867131
"2395","충북","단양군",2019,155,78,77,"5",2017,162,81,81,459384,475293,0.966528015350531,0.95679012345679,0.989924873631098,0.033740835553698,-0.000339943181995862,-0.0540744673986571
"2396","충북","단양군",2020,117,60,57,"5",2018,141,75,66,417119,431567,0.966522000060246,0.829787234042553,0.85852907020309,0.0280495494091614,-0.00396819583529845,-0.107801977111323
"2397","충북","보은군",2010,209,90,119,"5",2008,204,89,115,470657,486853,0.966733284995676,1.02450980392157,1.05976469396743,0.0444060111716175,0.00265391166798588,-0.00974118057964508
"2398","충북","보은군",2011,210,113,97,"5",2009,211,108,103,451574,467208,0.966537388058424,0.995260663507109,1.02971770756472,0.0465040059879444,0.00138199245053756,-0.0285758810922947
"2399","충북","보은군",2012,199,108,91,"5",2010,198,113,85,407210,420213,0.969056169133273,1.0050505050505,1.03714370442471,0.048869133862135,0.00181518066366694,-0.0221611889106089
"2400","충북","보은군",2013,188,103,85,"5",2011,194,106,88,420229,433401,0.969607822778443,0.969072164948454,0.999447552074761,0.0447375121659857,-2.47151457764537e-05,-0.0494065407143711
"2401","충북","보은군",2014,191,115,76,"5",2012,197,112,85,464047,479002,0.968778835996509,0.969543147208122,1.00078894292816,0.0411596239174049,3.24725942154444e-05,-0.0485596992318565
"2402","충북","보은군",2015,180,100,80,"5",2013,195,104,91,441255,454391,0.971090976713887,0.923076923076923,0.950556585543158,0.0407927388924771,-0.00201693229589048,-0.0789074813903356
"2403","충북","보은군",2016,196,101,95,"5",2014,187,91,96,422114,434628,0.971207561408837,1.04812834224599,1.07920117582854,0.0464329541308746,0.0036775445643581,0.00541687252119995
"2404","충북","보은군",2017,185,110,75,"5",2015,181,110,71,445571,459820,0.969011787221086,1.02209944751381,1.0547853607075,0.0415197577939318,0.00227467490722856,-0.015356954533105
"2405","충북","보은군",2018,202,101,101,"5",2016,196,98,98,447106,462028,0.967703256079718,1.03061224489796,1.0650085534207,0.0451794429061565,0.00293705022768222,-0.00554843790990054
"2406","충북","보은군",2019,184,93,91,"5",2017,186,101,85,459384,475293,0.966528015350531,0.989247311827957,1.02350609202899,0.0400536370443899,0.000941504478461156,-0.0350986687974192
"2407","충북","보은군",2020,146,67,79,"5",2018,149,72,77,417119,431567,0.966522000060246,0.979865771812081,1.0138059679459,0.0350020018268168,0.000483236515263224,-0.0418847442988892
"2408","충북","영동군",2010,339,163,176,"5",2008,344,165,179,470657,486853,0.966733284995676,0.98546511627907,1.01937642116406,0.0720269750582696,0.00139562500390243,-0.0283740089479574
"2409","충북","영동군",2011,320,162,158,"5",2009,330,170,160,451574,467208,0.966537388058424,0.96969696969697,1.0032689699101,0.0708632472197248,0.000231649822892995,-0.0456102639221148
"2410","충북","영동군",2012,295,154,141,"5",2010,291,156,135,407210,420213,0.969056169133273,1.01374570446735,1.04611655831473,0.0724441934137177,0.00334087687012712,0.000431465345855949
"2411","충북","영동군",2013,296,150,146,"5",2011,301,152,149,420229,433401,0.969607822778443,0.983388704318937,1.0142128407143,0.070437785112403,0.00100112102007101,-0.0342158613899848
"2412","충북","영동군",2014,343,178,165,"5",2012,355,187,168,464047,479002,0.968778835996509,0.966197183098592,0.997335147298855,0.0739149267207847,-0.000196972392126853,-0.0519573423703538
"2413","충북","영동군",2015,294,159,135,"5",2013,319,172,147,441255,454391,0.971090976713887,0.921630094043887,0.949066684938858,0.066628140191046,-0.00339359205628846,-0.099293189805788
"2414","충북","영동군",2016,272,143,129,"5",2014,294,155,139,422114,434628,0.971207561408837,0.925170068027211,0.952597678178242,0.0644375689979484,-0.00305449038305246,-0.094271740038285
"2415","충북","영동군",2017,298,181,117,"5",2015,342,198,144,445571,459820,0.969011787221086,0.871345029239766,0.899209938135627,0.0668804747167118,-0.00674088718421605,-0.148860253811981
"2416","충북","영동군",2018,279,141,138,"5",2016,311,163,148,447106,462028,0.967703256079718,0.897106109324759,0.927046699169995,0.0624013097565231,-0.00455238152285397,-0.116452654228191
"2417","충북","영동군",2019,266,132,134,"5",2017,301,143,158,459384,475293,0.966528015350531,0.883720930232558,0.914325209613359,0.0579036274663462,-0.00496088114580537,-0.122501755422884
"2418","충북","영동군",2020,224,113,111,"5",2018,250,131,119,417119,431567,0.966522000060246,0.896,0.927035287292116,0.0537017014329244,-0.00391832921697791,-0.107063547493497
"2419","충북","옥천군",2010,408,221,187,"5",2008,418,226,192,470657,486853,0.966733284995676,0.976076555023923,1.0096647856997,0.0866873328134926,0.000837814494520697,-0.0366341199226864
"2420","충북","옥천군",2011,392,191,201,"5",2009,411,208,203,451574,467208,0.966537388058424,0.953771289537713,0.986791924783835,0.0868074778441629,-0.00114655969669124,-0.0660189213187127
"2421","충북","옥천군",2012,354,176,178,"5",2010,364,172,192,407210,420213,0.969056169133273,0.972527472527473,1.00358214880083,0.0869330320964613,0.000311407056677035,-0.0444292112330505
"2422","충북","옥천군",2013,374,198,176,"5",2011,397,205,192,420229,433401,0.969607822778443,0.942065491183879,0.971594359134149,0.0889990933514822,-0.00252807628312854,-0.086476550075204
"2423","충북","옥천군",2014,396,200,196,"5",2012,426,218,208,464047,479002,0.968778835996509,0.929577464788732,0.959535272911434,0.0853361836193317,-0.00345310538093597,-0.100174468766646
"2424","충북","옥천군",2015,357,183,174,"5",2013,371,191,180,441255,454391,0.971090976713887,0.962264150943396,0.990910402853952,0.080905598803413,-0.000735399299982768,-0.059930419133643
"2425","충북","옥천군",2016,350,179,171,"5",2014,373,186,187,422114,434628,0.971207561408837,0.938337801608579,0.966155782650027,0.0829159895194189,-0.00280622677108331,-0.0905954289050919
"2426","충북","옥천군",2017,362,195,167,"5",2015,355,188,167,445571,459820,0.969011787221086,1.01971830985915,1.05232807619759,0.0812440666021801,0.00425134570776099,0.0139137743224722
"2427","충북","옥천군",2018,379,210,169,"5",2016,390,214,176,447106,462028,0.967703256079718,0.971794871794872,1.00422817190027,0.084767370601155,0.000358411014435382,-0.0437331721645759
"2428","충북","옥천군",2019,334,163,171,"5",2017,333,163,170,459384,475293,0.966528015350531,1.003003003003,1.03773815872191,0.0727060585479686,0.00274379277752779,-0.00841021257731956
"2429","충북","옥천군",2020,272,148,124,"5",2018,288,150,138,417119,431567,0.966522000060246,0.944444444444444,0.977157730900668,0.0652092088828368,-0.00148952629705633,-0.071097603294033
"2430","충북","음성군",2010,824,427,397,"5",2008,899,455,444,470657,486853,0.966733284995676,0.916573971078977,0.948114630275791,0.175074417250779,-0.00908380086830709,-0.183554342053977
"2431","충북","음성군",2011,786,443,343,"5",2009,870,478,392,451574,467208,0.966537388058424,0.903448275862069,0.93472667175029,0.174057850983449,-0.0113613352416818,-0.217280287256563
"2432","충북","음성군",2012,720,376,344,"5",2010,764,394,370,407210,420213,0.969056169133273,0.942408376963351,0.972501292475383,0.17681294663687,-0.0048621275061331,-0.121039402152137
"2433","충북","음성군",2013,727,349,378,"5",2011,781,379,402,420229,433401,0.969607822778443,0.930857874519846,0.960035441806196,0.173000911407828,-0.00691390499153927,-0.151422317927048
"2434","충북","음성군",2014,836,436,400,"5",2012,893,473,420,464047,479002,0.968778835996509,0.936170212765957,0.966340487612934,0.180154165418589,-0.00606390136248853,-0.138835383498968
"2435","충북","음성군",2015,797,413,384,"5",2013,822,429,393,441255,454391,0.971090976713887,0.969586374695864,0.998450606530075,0.180621182762802,-0.000279853281102794,-0.0531846504420219
"2436","충북","음성군",2016,785,427,358,"5",2014,817,444,373,422114,434628,0.971207561408837,0.960832313341493,0.989317167123067,0.185968719350697,-0.00198667274916066,-0.0784593951498838
"2437","충북","음성군",2017,823,454,369,"5",2015,834,457,377,445571,459820,0.969011787221086,0.986810551558753,1.01836795441747,0.184706814402194,0.0033926863475353,0.00119866500548338
"2438","충북","음성군",2018,801,428,373,"5",2016,873,476,397,447106,462028,0.967703256079718,0.917525773195876,0.948147861889897,0.179152147365502,-0.0092894218879175,-0.186599197631549
"2439","충북","음성군",2019,756,411,345,"5",2017,874,475,399,459384,475293,0.966528015350531,0.864988558352403,0.894944113998286,0.164568204378037,-0.0172888585186458,-0.305055614629438
"2440","충북","음성군",2020,670,340,330,"5",2018,723,367,356,417119,431567,0.966522000060246,0.926694329183956,0.958792794293552,0.160625624821694,-0.00661893316375423,-0.147054347100138
"2441","충북","제천시",2010,1162,605,557,"5",2008,1142,597,545,470657,486853,0.966733284995676,1.01751313485114,1.05252725921782,0.246888923356075,0.0129683984751329,0.142996719193603
"2442","충북","제천시",2011,1162,618,544,"5",2009,1165,613,552,451574,467208,0.966537388058424,0.997424892703863,1.0319568648115,0.257322166466626,0.00822320968677507,0.0727295131645899
"2443","충북","제천시",2012,1053,536,517,"5",2010,1061,550,511,407210,420213,0.969056169133273,0.992459943449576,1.02415110192966,0.258588934456423,0.00624520771393909,0.0434390721831762
"2444","충북","제천시",2013,1082,562,520,"5",2011,1081,561,520,420229,433401,0.969607822778443,1.0009250693802,1.03229887988323,0.257478660444662,0.00831627232619694,0.0741075935633939
"2445","충북","제천시",2014,1105,568,537,"5",2012,1138,583,555,464047,479002,0.968778835996509,0.971001757469244,1.0022945603167,0.238122431564044,0.000546386281982584,-0.0409496165586315
"2446","충북","제천시",2015,1079,572,507,"5",2013,1116,586,530,441255,454391,0.971090976713887,0.966845878136201,0.995628526389925,0.244529807027682,-0.00106895559829821,-0.0648697524629113
"2447","충북","제천시",2016,993,496,497,"5",2014,1022,512,510,422114,434628,0.971207561408837,0.971624266144814,1.00042905837283,0.235244507407951,0.00010093362556537,-0.0475459217807619
"2448","충북","제천시",2017,1061,511,550,"5",2015,1100,532,568,445571,459820,0.969011787221086,0.964545454545455,0.995390837619798,0.238121421726279,-0.00109754029894102,-0.0652930374235169
"2449","충북","제천시",2018,1057,524,533,"5",2016,1081,546,535,447106,462028,0.967703256079718,0.977798334875116,1.01043199837551,0.236409263127759,0.00246622104890386,-0.012520521084096
"2450","충북","제천시",2019,1078,536,542,"5",2017,1130,581,549,459384,475293,0.966528015350531,0.953982300884956,0.987019812911449,0.234662069205719,-0.00304595756087665,-0.0941453851975024
"2451","충북","제천시",2020,931,477,454,"5",2018,972,482,490,417119,431567,0.966522000060246,0.957818930041152,0.99099547654523,0.223197696580592,-0.0020097888939105,-0.0788017012157076
"2452","충북","증평군",2010,311,165,146,"5",2008,324,162,162,470657,486853,0.966733284995676,0.959876543209877,0.992907307638807,0.0660778443749907,-0.000468669822042591,-0.0559806637042242
"2453","충북","증평군",2011,332,165,167,"5",2009,350,171,179,451574,467208,0.966537388058424,0.948571428571429,0.981412038779912,0.0735206189904645,-0.00136659841467163,-0.0692772755423892
"2454","충북","증평군",2012,319,163,156,"5",2010,342,171,171,407210,420213,0.969056169133273,0.932748538011696,0.962532996251342,0.0783379583016134,-0.0029350885773488,-0.0925036267648574
"2455","충북","증평군",2013,323,172,151,"5",2011,322,172,150,420229,433401,0.969607822778443,1.00310559006211,1.03454774858115,0.0768628533490073,0.00265543853273153,-0.00971857062154926
"2456","충북","증평군",2014,367,192,175,"5",2012,406,214,192,464047,479002,0.968778835996509,0.903940886699507,0.933072496128275,0.0790868166371079,-0.00529308322668248,-0.127421035371772
"2457","충북","증평군",2015,352,183,169,"5",2013,386,198,188,441255,454391,0.971090976713887,0.911917098445596,0.939064537013275,0.0797724671675109,-0.00486097222044558,-0.121022294572007
"2458","충북","증평군",2016,341,193,148,"5",2014,368,200,168,422114,434628,0.971207561408837,0.926630434782609,0.95410133899538,0.0807838640746339,-0.00370787119180495,-0.103947065078388
"2459","충북","증평군",2017,397,214,183,"5",2015,440,231,209,445571,459820,0.969011787221086,0.902272727272727,0.931126678923326,0.0890991559145456,-0.00613655477296311,-0.139911242098114
"2460","충북","증평군",2018,381,192,189,"5",2016,408,214,194,447106,462028,0.967703256079718,0.933823529411765,0.964989549786983,0.0852146918180476,-0.00298340472531334,-0.0932190968704689
"2461","충북","증평군",2019,369,188,181,"5",2017,418,212,206,459384,475293,0.966528015350531,0.882775119617225,0.913346644480935,0.0803249568988036,-0.00696042704720563,-0.152111220943598
"2462","충북","증평군",2020,355,184,171,"5",2018,398,211,187,417119,431567,0.966522000060246,0.891959798994975,0.922855143431165,0.0851076071816436,-0.00656561414894461,-0.146264794067373
"2463","충북","진천군",2010,632,336,296,"5",2008,613,333,280,470657,486853,0.966733284995676,1.03099510603589,1.06647316487143,0.134280378279724,0.00892604172438552,0.083137116695925
"2464","충북","진천군",2011,644,356,288,"5",2009,677,373,304,451574,467208,0.966537388058424,0.951255539143279,0.984189076279974,0.142612285029696,-0.00225483196014307,-0.0824303222019137
"2465","충북","진천군",2012,598,325,273,"5",2010,598,331,267,407210,420213,0.969056169133273,1,1.03193192701554,0.146852975123401,0.00468929848365603,0.0203990206018821
"2466","충북","진천군",2013,564,300,264,"5",2011,545,287,258,420229,433401,0.969607822778443,1.0348623853211,1.06729995469268,0.134212536497957,0.00903249762550223,0.0847135257853011
"2467","충북","진천군",2014,698,355,343,"5",2012,679,343,336,464047,479002,0.968778835996509,1.0279823269514,1.06111146193031,0.150415798399731,0.0091921293376222,0.0870773673318836
"2468","충북","진천군",2015,670,369,301,"5",2013,629,351,278,441255,454391,0.971090976713887,1.06518282988871,1.09689293323806,0.151839639210887,0.0147121880249522,0.168818920381682
"2469","충북","진천군",2016,681,325,356,"5",2014,562,273,289,422114,434628,0.971207561408837,1.21174377224199,1.24766715210107,0.161330825322069,0.0399563460536328,0.542636808846379
"2470","충북","진천군",2017,767,392,375,"5",2015,702,366,336,445571,459820,0.969011787221086,1.09259259259259,1.12753281951906,0.172138671502409,0.0219533301249671,0.276046439985427
"2471","충북","진천군",2018,852,437,415,"5",2016,731,376,355,447106,462028,0.967703256079718,1.16552667578659,1.20442570433036,0.190558838396264,0.0389551247555308,0.527810628820206
"2472","충북","진천군",2019,904,455,449,"5",2017,760,388,372,459384,475293,0.966528015350531,1.18947368421053,1.2306665355987,0.196785260261568,0.0453917742414245,0.623125145425215
"2473","충북","진천군",2020,837,415,422,"5",2018,759,384,375,417119,431567,0.966522000060246,1.10276679841897,1.14096399083542,0.200662161157847,0.0282861390464708,0.369823275655578
"2474","충북","청원군",2010,1453,777,676,"5",2008,1643,855,788,470657,486853,0.966733284995676,0.884357881923311,0.914789938082318,0.30871738867158,-0.0263058278037704,-0.438579751765908
"2475","충북","청원군",2011,1558,793,765,"5",2009,1632,840,792,451574,467208,0.966537388058424,0.954656862745098,0.987708157532125,0.345015434901035,-0.00424087537478897,-0.111839841617006
"2476","충북","청원군",2012,1530,813,717,"5",2010,1528,820,708,407210,420213,0.969056169133273,1.00130890052356,1.03328262325509,0.37572751160335,0.0125051972152682,0.136137590966785
"2477","충북","청원군",2013,1618,825,793,"5",2011,1729,864,865,420229,433401,0.969607822778443,0.935801041064199,0.965133550988306,0.38502816321577,-0.0134245648208288,-0.247832786722711
"2478","충북","청원군",2014,1759,922,837,"5",2012,1869,970,899,464047,479002,0.968778835996509,0.941144997324773,0.971475596240382,0.37905643178385,-0.0108123587078824,-0.209150990630849
"2479","충북","청원군",2015,0,0,0,"5",2013,1791,919,872,441255,454391,0.971090976713887,0,0,0,0,-0.0490405564895554
"2480","충북","청주시",2010,7191,3773,3418,"5",2008,7173,3756,3417,470657,486853,0.966733284995676,1.00250941028858,1.03700723441323,1.52786424083781,0.056542030112275,0.788239192831622
"2481","충북","청주시",2011,6977,3643,3334,"5",2009,6861,3582,3279,451574,467208,0.966537388058424,1.0169071563912,1.05211362638951,1.54504023703756,0.0805176496697408,1.14327244319482
"2482","충북","청주시",2012,6402,3293,3109,"5",2010,6393,3285,3108,407210,420213,0.969056169133273,1.00140778977006,1.0333846702258,1.57216178384617,0.0524861026953048,0.728178634620281
"2483","충북","청주시",2013,6508,3290,3218,"5",2011,6547,3342,3205,420229,433401,0.969607822778443,0.994043073163281,1.02520116877236,1.54867941051189,0.0390285311985855,0.528897638397282
"2484","충북","청주시",2014,7226,3741,3485,"5",2012,7260,3760,3500,464047,479002,0.968778835996509,0.995316804407714,1.02739321651665,1.55716985563962,0.0426558910087426,0.582611926803894
"2485","충북","청주시",2015,8391,4303,4088,"5",2013,6882,3494,3388,441255,454391,0.971090976713887,1.21926765475153,1.25556480699414,1.90162151137098,0.485987534529434,7.14750898861926
"2486","충북","청주시",2016,8134,4263,3871,"5",2014,8397,4409,3988,422114,434628,0.971207561408837,0.968679290222699,0.997396775636229,1.9269675964313,-0.00501632899522789,-0.123322832440683
"2487","충북","청주시",2017,8554,4407,4147,"5",2015,8695,4476,4219,445571,459820,0.969011787221086,0.983783783783784,1.01524439305848,1.91978382794212,0.0292659392604606,0.384332250234757
"2488","충북","청주시",2018,8496,4284,4212,"5",2016,8762,4419,4343,447106,462028,0.967703256079718,0.969641634330062,1.00200307091886,1.90022052935993,0.00380627648178982,0.00732314697478506
"2489","충북","청주시",2019,8854,4511,4343,"5",2017,9048,4605,4443,459384,475293,0.966528015350531,0.978558797524315,1.01244742209508,1.92736359995124,0.0239907082592776,0.306216128802413
"2490","충북","청주시",2020,8056,4118,3938,"5",2018,8193,4185,4008,417119,431567,0.966522000060246,0.983278408397412,1.01733681006343,1.93134333367696,0.0334833325432208,0.446783810314341
"2491","충북","충주시",2010,1918,977,941,"5",2008,1934,987,947,470657,486853,0.966733284995676,0.991726990692865,1.02585377589156,0.407515451804605,0.0105358131633034,0.106974764975712
"2492","충북","충주시",2011,1818,948,870,"5",2009,1852,967,885,451574,467208,0.966537388058424,0.981641468682505,1.0156270008907,0.402591823267061,0.00629130278078202,0.0441216523086962
"2493","충북","충주시",2012,1624,845,779,"5",2010,1666,876,790,407210,420213,0.969056169133273,0.974789915966387,1.00591683641851,0.398811424080941,0.00235970195812165,-0.0140978658920372
"2494","충북","충주시",2013,1676,865,811,"5",2011,1699,872,827,420229,433401,0.969607822778443,0.986462625073573,1.0173831129444,0.398830161649957,0.0069329097455938,0.0536226291500585
"2495","충북","충주시",2014,1837,957,880,"5",2012,1857,972,885,464047,479002,0.968778835996509,0.989229940764674,1.02111018945529,0.3958650740119,0.00835678671112495,0.0747075344213551
"2496","충북","충주시",2015,1701,902,799,"5",2013,1729,922,807,441255,454391,0.971090976713887,0.983805668016194,1.0130932030131,0.385491382533909,0.00504731693131805,0.0257005917608161
"2497","충북","충주시",2016,1594,789,805,"5",2014,1611,801,810,422114,434628,0.971207561408837,0.989447548106766,1.01878072970465,0.377623106554154,0.00709203749442274,0.0559790079603872
"2498","충북","충주시",2017,1738,874,864,"5",2015,1763,880,883,445571,459820,0.969011787221086,0.985819625638117,1.0173453394878,0.390061292139749,0.00676574553321415,0.0511472456245858
"2499","충북","충주시",2018,1735,914,821,"5",2016,1734,919,815,447106,462028,0.967703256079718,1.00057670126874,1.03397058445602,0.388051155654364,0.013182324556414,0.146164556912776
"2500","충북","충주시",2019,1682,828,854,"5",2017,1661,810,851,459384,475293,0.966528015350531,1.01264298615292,1.04771198565379,0.366142486460129,0.017469385061228,0.209647755829898
"2501","충북","충주시",2020,1598,806,792,"5",2018,1598,807,791,417119,431567,0.966522000060246,1,1.03463759742424,0.383104102186666,0.0132698056631152,0.147459985445209
