,prov,distinct,입학년도,총입학자,남자입학,여자입학,인구나이,인구연도,인구총합,인구남자,인구여자,(입학합계)/(인구총합*총합보정),(입학남자)/(인구남자*남자보정),(입학여자)/(인구여자*여자보정),,,
1,강원,강릉시,2009,2051,1074,977,5,2008,2065,1052,1013,1.017543419,1.043555778,0.990460074,,총합보정,0.9760963
2,강원,강릉시,2010,2054,1059,995,5,2009,2017,1036,981,1.043282413,1.044872574,1.04161189,,남자보정,0.9783018
3,강원,강릉시,2011,1935,989,946,5,2010,1767,916,851,1.121893844,1.103641298,1.14159861,,여자보정,0.9737515
4,강원,강릉시,2012,1735,919,816,5,2011,1730,947,783,1.027450059,0.991956569,1.070237716,,,
5,강원,강릉시,2013,1704,923,781,5,2012,1896,1013,883,0.920743375,0.931363858,0.90832692,,,
6,강원,강릉시,2014,1839,999,840,5,2013,1654,840,814,1.139078276,1.215663361,1.05975808,,,
7,강원,강릉시,2015,1627,850,777,5,2014,1666,827,839,1.000506469,1.050607608,0.951066563,,,
8,강원,강릉시,2016,1659,820,839,5,2015,1655,877,778,1.026965214,0.955743569,1.107475734,,,
9,강원,강릉시,2017,1625,869,756,5,2016,1660,882,778,1.002888433,1.007113266,0.997916156,,,
10,강원,강릉시,2018,1662,875,787,5,2017,1662,846,816,1.024489107,1.057218649,0.990458831,,,
11,강원,강릉시,2019,1627,824,803,5,2018,1474,792,682,1.130830243,1.06347958,1.209157923,,,
12,강원,강릉시,2020,1451,770,681,5,2019,1381,702,679,1.076418316,1.121193931,1.029980951,,,
13,강원,고성군,2009,221,117,104,5,2008,213,112,101,1.062967572,1.067812411,1.057459689,,,
14,강원,고성군,2010,196,99,97,5,2009,202,105,97,0.994058738,0.963769151,1.026956044,,,
15,강원,고성군,2011,175,97,78,5,2010,189,99,90,0.948601025,1.001529313,0.890028571,,,
16,강원,고성군,2012,183,102,81,5,2011,188,103,85,0.997242057,1.01225533,0.978628701,,,
17,강원,고성군,2013,181,99,82,5,2012,174,94,80,1.065704186,1.076550647,1.052629945,,,
18,강원,고성군,2014,162,91,71,5,2013,162,90,72,1.024489107,1.033536951,1.012692765,,,
19,강원,고성군,2015,160,94,66,5,2014,143,68,75,1.146281519,1.413012703,0.903721319,,,
20,강원,고성군,2016,144,69,75,5,2015,155,87,68,0.951783429,0.810694009,1.132672107,,,
21,강원,고성군,2017,154,82,72,5,2016,160,92,68,0.986070766,0.911072945,1.087365223,,,
22,강원,고성군,2018,163,90,73,5,2017,161,90,71,1.03721568,1.022179402,1.055884383,,,
23,강원,고성군,2019,155,78,77,5,2018,127,59,68,1.250360722,1.35135582,1.162876697,,,
24,강원,고성군,2020,150,76,74,5,2019,146,72,74,1.052557302,1.078967147,1.026956044,,,
25,강원,동해시,2009,947,505,442,5,2008,983,528,455,0.986969669,0.977652648,0.997614443,,,
26,강원,동해시,2010,980,531,449,5,2009,923,502,421,1.087756582,1.081229607,1.095257158,,,
27,강원,동해시,2011,943,507,436,5,2010,838,441,397,1.152855881,1.175158633,1.127840894,,,
28,강원,동해시,2012,845,436,409,5,2011,837,438,399,1.034281118,1.017511916,1.052694291,,,
29,강원,동해시,2013,845,445,400,5,2012,888,458,430,0.974879838,0.993165576,0.955307948,,,
30,강원,동해시,2014,928,484,444,5,2013,814,432,382,1.167967926,1.145219515,1.193634773,,,
31,강원,동해시,2015,836,452,384,5,2014,864,432,432,0.991288072,1.069502523,0.912849817,,,
32,강원,동해시,2016,869,429,440,5,2015,819,440,379,1.08703423,0.996624917,1.192244484,,,
33,강원,동해시,2017,810,426,384,5,2016,835,436,399,0.993815781,0.998734921,0.988348674,,,
34,강원,동해시,2018,829,436,393,5,2017,875,448,427,0.970630251,0.994799597,0.945184368,,,
35,강원,동해시,2019,861,439,422,5,2018,749,378,371,1.17768374,1.187134279,1.168127899,,,
36,강원,동해시,2020,756,386,370,5,2019,724,384,340,1.069770394,1.027503253,1.117569812,,,
37,강원,삼척시,2009,603,302,301,5,2008,545,284,261,1.133517306,1.086965421,1.184343943,,,
38,강원,삼척시,2010,522,267,255,5,2009,570,276,294,0.93821634,0.988847465,0.890727181,,,
39,강원,삼척시,2011,547,268,279,5,2010,478,243,235,1.17237561,1.127341892,1.219237175,,,
40,강원,삼척시,2012,473,234,239,5,2011,495,273,222,0.978956258,0.876153773,1.105596822,,,
41,강원,삼척시,2013,464,256,208,5,2012,519,272,247,0.915920898,0.962051202,0.86480509,,,
42,강원,삼척시,2014,500,266,234,5,2013,477,235,242,1.073887953,1.157020089,0.993007084,,,
43,강원,삼척시,2015,447,216,231,5,2014,496,265,231,0.923279498,0.833172645,1.026956044,,,
44,강원,삼척시,2016,461,249,212,5,2015,492,248,244,0.959937964,1.026301093,0.892273284,,,
45,강원,삼척시,2017,464,236,228,5,2016,483,244,239,0.984188294,0.988665323,0.979690284,,,
46,강원,삼척시,2018,450,233,217,5,2017,492,264,228,0.93703272,0.90215076,0.977409919,,,
47,강원,삼척시,2019,486,260,226,5,2018,444,225,219,1.121400239,1.181185087,1.059781123,,,
48,강원,삼척시,2020,400,199,201,5,2019,423,224,199,0.968784026,0.90809688,1.03727721,,,
49,강원,속초시,2009,898,482,416,5,2008,833,426,407,1.104431235,1.156550403,1.049665146,,,
50,강원,속초시,2010,847,429,418,5,2009,804,420,384,1.079281435,1.044083247,1.117884444,,,
51,강원,속초시,2011,803,424,379,5,2010,674,340,334,1.220570851,1.274717843,1.165318385,,,
52,강원,속초시,2012,677,339,338,5,2011,656,326,330,1.057285253,1.062941158,1.051851948,,,
53,강원,속초시,2013,680,340,340,5,2012,734,396,338,0.949117974,0.87762878,1.033032707,,,
54,강원,속초시,2014,712,399,313,5,2013,630,315,315,1.157835309,1.294760576,1.020435688,,,
55,강원,속초시,2015,644,312,332,5,2014,632,333,299,1.043941432,0.957717638,1.140299019,,,
56,강원,속초시,2016,597,314,283,5,2015,710,348,362,0.861436616,0.9223113,0.802841327,,,
57,강원,속초시,2017,666,316,350,5,2016,677,356,321,1.007843051,0.907327784,1.119734004,,,
58,강원,속초시,2018,648,342,306,5,2017,673,322,351,0.986432305,1.085668806,0.895295013,,,
59,강원,속초시,2019,663,324,339,5,2018,606,296,310,1.120851944,1.118872048,1.123026125,,,
60,강원,속초시,2020,579,274,305,5,2019,635,315,320,0.934140462,0.889133829,0.978817479,,,
61,강원,양구군,2009,205,117,88,5,2008,217,113,104,0.967835332,1.058362744,0.868962806,,,
62,강원,양구군,2010,210,106,104,5,2009,234,116,118,0.919413302,0.934060488,0.905113801,,,
63,강원,양구군,2011,222,105,117,5,2010,196,108,88,1.160390724,0.99378553,1.36538474,,,
64,강원,양구군,2012,192,100,92,5,2011,207,106,101,0.950250766,0.964320191,0.935445109,,,
65,강원,양구군,2013,199,110,89,5,2012,215,122,93,0.948248058,0.921637166,0.982785891,,,
66,강원,양구군,2014,209,115,94,5,2013,208,109,99,1.029414536,1.078446158,0.975089577,,,
67,강원,양구군,2015,197,106,91,5,2014,173,92,81,1.166614764,1.177728442,1.153740741,,,
68,강원,양구군,2016,166,85,81,5,2015,207,101,106,0.821570975,0.860249992,0.78474943,,,
69,강원,양구군,2017,197,93,104,5,2016,213,117,96,0.947532179,0.812501576,1.112535714,,,
70,강원,양구군,2018,199,110,89,5,2017,217,112,105,0.939508444,1.003926199,0.870467504,,,
71,강원,양구군,2019,195,97,98,5,2018,183,85,98,1.091668721,1.166487083,1.026956044,,,
72,강원,양구군,2020,166,83,83,5,2019,177,94,83,0.960820293,0.902562664,1.026956044,,,
73,강원,양양군,2009,183,92,91,5,2008,223,116,107,0.840724245,0.810694009,0.873392523,,,
74,강원,양양군,2010,207,113,94,5,2009,210,118,92,1.009853549,0.978866716,1.049281175,,,
75,강원,양양군,2011,180,103,77,5,2010,197,95,102,0.936081418,1.108257668,0.775251131,,,
76,강원,양양군,2012,169,85,84,5,2011,173,90,83,1.000801498,0.965391658,1.039329008,,,
77,강원,양양군,2013,168,82,86,5,2012,184,92,92,0.935403098,0.911072945,0.95998065,,,
78,강원,양양군,2014,175,89,86,5,2013,163,93,70,1.099911618,0.978214697,1.261688854,,,
79,강원,양양군,2015,150,87,63,5,2014,162,74,88,0.948601025,1.201751459,0.735207168,,,
80,강원,양양군,2016,151,70,81,5,2015,157,83,74,0.985336657,0.862079014,1.124100534,,,
81,강원,양양군,2017,158,85,73,5,2016,159,82,77,1.01804578,1.05957621,0.973607678,,,
82,강원,양양군,2018,146,74,72,5,2017,156,82,74,0.958816729,0.922454583,0.999200475,,,
83,강원,양양군,2019,154,83,71,5,2018,136,72,64,1.160083254,1.1783457,1.139279361,,,
84,강원,양양군,2020,141,76,65,5,2019,146,79,67,0.989403864,0.983362463,0.99630064,,,
85,강원,영월군,2009,286,136,150,5,2008,281,144,137,1.042718451,0.965391658,1.124404428,,,
86,강원,영월군,2010,283,144,139,5,2009,300,148,152,0.966434725,0.994552932,0.939124277,,,
87,강원,영월군,2011,287,147,140,5,2010,252,138,114,1.166779261,1.088843276,1.261174089,,,
88,강원,영월군,2012,244,132,112,5,2011,254,132,122,0.984154891,1.022179402,0.942779319,,,
89,강원,영월군,2013,253,137,116,5,2012,269,140,129,0.963552952,1.000275558,0.923464349,,,
90,강원,영월군,2014,254,136,118,5,2013,242,125,117,1.07529022,1.11213119,1.035733446,,,
91,강원,영월군,2015,232,120,112,5,2014,211,114,97,1.126452478,1.075978318,1.185763679,,,
92,강원,영월군,2016,205,113,92,5,2015,223,130,93,0.941794919,0.888509788,1.015913506,,,
93,강원,영월군,2017,221,121,100,5,2016,253,126,127,0.894909457,0.981616728,0.808626806,,,
94,강원,영월군,2018,238,115,123,5,2017,209,116,93,1.166643098,1.013367511,1.358232187,,,
95,강원,영월군,2019,198,117,81,5,2018,183,99,84,1.108463624,1.208030203,0.990279042,,,
96,강원,영월군,2020,168,88,80,5,2019,190,107,83,0.905864053,0.84067091,0.989837151,,,
97,강원,원주시,2009,3179,1678,1501,5,2008,3303,1733,1570,0.986028118,0.989738625,0.981822307,,,
98,강원,원주시,2010,3262,1724,1538,5,2009,3188,1641,1547,1.048269595,1.073880128,1.02098151,,,
99,강원,원주시,2011,3221,1671,1550,5,2010,3070,1602,1468,1.074879288,1.066205856,1.084320074,,,
100,강원,원주시,2012,3041,1599,1442,5,2011,3026,1550,1476,1.02956754,1.054493461,1.003299875,,,
101,강원,원주시,2013,3061,1576,1485,5,2012,3429,1765,1664,0.91454102,0.912722231,0.91648421,,,
102,강원,원주시,2014,3415,1764,1651,5,2013,3084,1591,1493,1.134445623,1.13332776,1.13563592,,,
103,강원,원주시,2015,3085,1569,1516,5,2014,3084,1623,1461,1.024821302,0.988169736,1.065616265,,,
104,강원,원주시,2016,3173,1655,1518,5,2015,3256,1631,1625,0.998373445,1.037220669,0.959334938,,,
105,강원,원주시,2017,3285,1649,1636,5,2016,3260,1658,1602,1.032345619,1.016630781,1.048751615,,,
106,강원,원주시,2018,3224,1648,1576,5,2017,3329,1654,1675,0.992175693,1.018471375,0.966258343,,,
107,강원,원주시,2019,3303,1634,1669,5,2018,2914,1480,1434,1.161251723,1.128541313,1.195250793,,,
108,강원,원주시,2020,3008,1537,1471,5,2019,2926,1481,1445,1.053200012,1.060830345,1.045434146,,,
109,강원,인제군,2009,322,163,159,5,2008,337,176,161,0.978888702,0.946677515,1.014198826,,,
110,강원,인제군,2010,305,165,140,5,2009,315,162,153,0.991965644,1.04110865,0.939698341,,,
111,강원,인제군,2011,323,167,156,5,2010,304,166,138,1.088519677,1.02833711,1.160906832,,,
112,강원,인제군,2012,279,146,133,5,2011,306,154,152,0.93409301,0.969079174,0.898586538,,,
113,강원,인제군,2013,291,140,151,5,2012,328,173,155,0.908921739,0.827197204,1.000453952,,,
114,강원,인제군,2014,310,159,151,5,2013,289,144,145,1.098932953,1.128656423,1.069450777,,,
115,강원,인제군,2015,282,138,144,5,2014,282,148,134,1.024489107,0.953113226,1.103594555,,,
116,강원,인제군,2016,264,137,127,5,2015,326,175,151,0.829647621,0.800220446,0.863731242,,,
117,강원,인제군,2017,300,163,137,5,2016,279,158,121,1.101601191,1.054526852,1.162751884,,,
118,강원,인제군,2018,253,152,101,5,2017,312,155,157,0.83075559,1.002395285,0.660653251,,,
119,강원,인제군,2019,274,140,134,5,2018,259,129,130,1.083822453,1.109341987,1.058554691,,,
120,강원,인제군,2020,251,123,128,5,2019,233,124,109,1.103634189,1.01393602,1.20596673,,,
121,강원,정선군,2009,301,156,145,5,2008,258,130,128,1.195237292,1.226615283,1.163348643,,,
122,강원,정선군,2010,251,125,126,5,2009,267,140,127,0.963096502,0.912660181,1.018869776,,,
123,강원,정선군,2011,256,142,114,5,2010,271,136,135,0.967783068,1.067275552,0.867207326,,,
124,강원,정선군,2012,255,124,131,5,2011,235,111,124,1.11167967,1.141894107,1.084929369,,,
125,강원,정선군,2013,227,112,115,5,2012,287,148,139,0.8103102,0.773541169,0.849639892,,,
126,강원,정선군,2014,289,148,141,5,2013,256,120,136,1.156552156,1.260687929,1.064711781,,,
127,강원,정선군,2015,238,114,124,5,2014,271,141,130,0.899735821,0.826442921,0.979558073,,,
128,강원,정선군,2016,267,143,124,5,2015,261,135,126,1.048040581,1.082752996,1.010655154,,,
129,강원,정선군,2017,262,134,128,5,2016,229,112,117,1.172122909,1.222964642,1.123507467,,,
130,강원,정선군,2018,218,108,110,5,2017,266,140,126,0.839618893,0.788538396,0.896548927,,,
131,강원,정선군,2019,251,136,115,5,2018,191,94,97,1.346318146,1.478897859,1.217525207,,,
132,강원,정선군,2020,187,95,92,5,2019,218,106,112,0.878804877,0.916104181,0.843571036,,,
133,강원,철원군,2009,488,245,243,5,2008,447,225,222,1.118457907,1.113039794,1.124100534,,,
134,강원,철원군,2010,416,216,200,5,2009,447,245,202,0.953439527,0.901186738,1.016788162,,,
135,강원,철원군,2011,432,241,191,5,2010,421,204,217,1.051257231,1.207574686,0.903910619,,,
136,강원,철원군,2012,402,200,202,5,2011,470,236,234,0.876265151,0.866253731,0.88651761,,,
137,강원,철원군,2013,441,225,216,5,2012,442,223,219,1.022171259,1.031346931,1.012888153,,,
138,강원,철원군,2014,427,216,211,5,2013,442,239,203,0.989721378,0.923810673,1.067427218,,,
139,강원,철원군,2015,418,221,197,5,2014,393,202,191,1.08966017,1.11832499,1.059216443,,,
140,강원,철원군,2016,361,184,177,5,2015,398,214,184,0.929247658,0.878883224,0.987887064,,,
141,강원,철원군,2017,371,200,171,5,2016,371,203,168,1.024489107,1.007073303,1.045294545,,,
142,강원,철원군,2018,359,200,159,5,2017,385,187,198,0.95530283,1.093240002,0.824676823,,,
143,강원,철원군,2019,336,160,176,5,2018,317,156,161,1.085893817,1.048389131,1.122635178,,,
144,강원,철원군,2020,301,141,160,5,2019,375,192,183,0.822323257,0.750662999,0.897885066,,,
145,강원,춘천시,2009,2659,1413,1246,5,2008,2561,1306,1255,1.063692517,1.105926107,1.019591419,,,
146,강원,춘천시,2010,2590,1314,1276,5,2009,2448,1292,1156,1.083916172,1.039584934,1.133560477,,,
147,강원,춘천시,2011,2406,1264,1142,5,2010,2430,1275,1155,1.014370696,1.0133606,1.015397231,,,
148,강원,춘천시,2012,2418,1265,1153,5,2011,2299,1202,1097,1.077518339,1.075754529,1.079380418,,,
149,강원,춘천시,2013,2271,1199,1072,5,2012,2523,1285,1238,0.922162015,0.953768952,0.889254345,,,
150,강원,춘천시,2014,2517,1289,1228,5,2013,2412,1263,1149,1.069087514,1.043221892,1.097564858,,,
151,강원,춘천시,2015,2436,1277,1159,5,2014,2274,1195,1079,1.09747382,1.092320583,1.103097363,,,
152,강원,춘천시,2016,2297,1190,1107,5,2015,2504,1286,1218,0.939796917,0.94587363,0.933366454,,,
153,강원,춘천시,2017,2485,1289,1196,5,2016,2626,1357,1269,0.969480362,0.970957443,0.96787977,,,
154,강원,춘천시,2018,2570,1337,1233,5,2017,2586,1333,1253,1.018150428,1.025246707,1.010564088,,,
155,강원,춘천시,2019,2544,1308,1236,5,2018,2413,1227,1186,1.08010787,1.089658238,1.070250987,,,
156,강원,춘천시,2020,2377,1212,1165,5,2019,2323,1204,1119,1.048304179,1.028971292,1.069172289,,,
157,강원,태백시,2009,472,235,237,5,2008,461,234,227,1.048934618,1.02654769,1.072196398,,,
158,강원,태백시,2010,437,224,213,5,2009,436,219,217,1.026838853,1.045516832,1.008025979,,,
159,강원,태백시,2011,397,195,202,5,2010,420,224,196,0.968386132,0.889843676,1.058393474,,,
160,강원,태백시,2012,406,221,185,5,2011,423,209,214,0.983315786,1.080869129,0.887789103,,,
161,강원,태백시,2013,415,196,219,5,2012,472,258,214,0.900769025,0.776539391,1.050950344,,,
162,강원,태백시,2014,449,244,205,5,2013,421,218,203,1.09262615,1.144090707,1.037073837,,,
163,강원,태백시,2015,399,204,195,5,2014,402,193,209,1.016843666,1.080438332,0.95816473,,,
164,강원,태백시,2016,399,189,210,5,2015,431,214,217,0.948424951,0.902765921,0.99382843,,,
165,강원,태백시,2017,397,193,204,5,2016,392,193,199,1.037556571,1.022179402,1.05275896,,,
166,강원,태백시,2018,373,181,192,5,2017,392,194,198,0.974832748,0.953682844,0.995836164,,,
167,강원,태백시,2019,360,179,181,5,2018,308,161,147,1.197454801,1.136460329,1.264483292,,,
168,강원,태백시,2020,284,152,132,5,2019,302,156,146,0.963426843,0.995969674,0.928480807,,,
169,강원,평창군,2009,368,189,179,5,2008,342,175,167,1.102374244,1.103953754,1.100749292,,,
170,강원,평창군,2010,336,171,165,5,2009,323,179,144,1.065722415,0.976495407,1.176720467,,,
171,강원,평창군,2011,314,178,136,5,2010,293,165,128,1.097916654,1.102714749,1.091140797,,,
172,강원,평창군,2012,304,175,129,5,2011,298,160,138,1.045116405,1.118008721,0.95998065,,,
173,강원,평창군,2013,286,146,140,5,2012,334,179,155,0.87725714,0.83373292,0.927573201,,,
174,강원,평창군,2014,313,163,150,5,2013,317,165,152,1.0115618,1.009789349,1.013443464,,,
175,강원,평창군,2015,312,156,156,5,2014,275,132,143,1.16232946,1.208030203,1.120315684,,,
176,강원,평창군,2016,258,128,130,5,2015,285,157,128,0.927432245,0.833369194,1.043002232,,,
177,강원,평창군,2017,278,157,121,5,2016,251,130,121,1.134693115,1.234478201,1.026956044,,,
178,강원,평창군,2018,237,116,121,5,2017,266,143,123,0.912796686,0.829180494,1.010257572,,,
179,강원,평창군,2019,261,132,129,5,2018,231,126,105,1.157539641,1.070854612,1.261688854,,,
180,강원,평창군,2020,213,119,94,5,2019,187,85,102,1.166931443,1.431051163,0.946410472,,,
181,강원,홍천군,2009,641,321,320,5,2008,626,338,288,1.049037568,0.970768012,1.141062271,,,
182,강원,홍천군,2010,588,324,264,5,2009,562,269,293,1.071885401,1.231175191,0.92531193,,,
183,강원,홍천군,2011,530,259,271,5,2010,506,250,256,1.073081476,1.058977861,1.08712925,,,
184,강원,홍천군,2012,495,250,245,5,2011,468,252,216,1.083594248,1.014066867,1.164834402,,,
185,강원,홍천군,2013,456,240,216,5,2012,561,282,279,0.832739809,0.869939917,0.795062744,,,
186,강원,홍천군,2014,569,287,282,5,2013,518,248,270,1.125355796,1.182925357,1.072598535,,,
187,강원,홍천군,2015,494,241,253,5,2014,513,279,234,0.986545066,0.882957835,1.110341364,,,
188,강원,홍천군,2016,504,274,230,5,2015,526,270,256,0.981639753,1.037322801,0.922655821,,,
189,강원,홍천군,2017,495,240,255,5,2016,487,232,255,1.041318497,1.057426968,1.026956044,,,
190,강원,홍천군,2018,474,232,242,5,2017,485,239,246,1.001253272,0.992241093,1.010257572,,,
191,강원,홍천군,2019,443,220,223,5,2018,415,207,208,1.093611264,1.086374244,1.101015374,,,
192,강원,홍천군,2020,384,195,189,5,2019,399,191,208,0.985974479,1.043586301,0.933147559,,,
193,강원,화천군,2009,237,110,127,5,2008,240,121,119,1.011682994,0.929254002,1.095995106,,,
194,강원,화천군,2010,200,95,105,5,2009,229,122,107,0.894750312,0.795959371,1.007760604,,,
195,강원,화천군,2011,221,120,101,5,2010,201,116,85,1.126428322,1.057426968,1.220265417,,,
196,강원,화천군,2012,188,112,76,5,2011,222,114,108,0.86758537,1.00424643,0.722672772,,,
197,강원,화천군,2013,190,93,97,5,2012,256,129,127,0.760363009,0.736920034,0.784368002,,,
198,강원,화천군,2014,243,117,126,5,2013,232,125,107,1.073064022,0.956759921,1.209312725,,,
199,강원,화천군,2015,191,99,92,5,2014,234,115,119,0.836228289,0.879963138,0.79394921,,,
200,강원,화천군,2016,208,97,111,5,2015,231,111,120,0.922483698,0.893255874,0.949934341,,,
201,강원,화천군,2017,197,101,96,5,2016,211,105,106,0.956513527,0.983239235,0.930073398,,,
202,강원,화천군,2018,190,100,90,5,2017,228,109,119,0.853740923,0.937779268,0.776689445,,,
203,강원,화천군,2019,191,87,104,5,2018,195,96,99,1.003473946,0.926350083,1.078822511,,,
204,강원,화천군,2020,180,94,86,5,2019,195,104,91,0.945682253,0.923892921,0.970529888,,,
205,강원,횡성군,2009,303,156,147,5,2008,302,160,142,1.027881455,0.996624917,1.063116468,,,
206,강원,횡성군,2010,292,152,140,5,2009,315,175,140,0.949685141,0.887835824,1.026956044,,,
207,강원,횡성군,2011,309,164,145,5,2010,308,154,154,1.027815371,1.088554688,0.966939132,,,
208,강원,횡성군,2012,291,148,143,5,2011,290,146,144,1.028021828,1.03618186,1.019824405,,,
209,강원,횡성군,2013,292,156,136,5,2012,318,156,162,0.940725847,1.022179402,0.862135938,,,
210,강원,횡성군,2014,314,159,155,5,2013,288,156,132,1.116977707,1.041836698,1.205895354,,,
211,강원,횡성군,2015,293,156,137,5,2014,282,140,142,1.064451448,1.138999905,0.99079562,,,
212,강원,횡성군,2016,260,135,125,5,2015,278,135,143,0.95815528,1.022179402,0.897688849,,,
213,강원,횡성군,2017,255,126,129,5,2016,264,138,126,0.989563342,0.933294237,1.051407378,,,
214,강원,횡성군,2018,268,143,125,5,2017,269,125,144,1.020680598,1.169373236,0.891454899,,,
215,강원,횡성군,2019,265,132,133,5,2018,236,117,119,1.150379718,1.153228044,1.147774402,,,
216,강원,횡성군,2020,221,114,107,5,2019,227,116,111,0.9974101,1.004555619,0.989948619,,,
217,경기,가평군,2009,478,254,224,5,2008,443,243,200,1.105430685,1.068450898,1.150190769,,,
218,경기,가평군,2010,463,254,209,5,2009,493,257,236,0.962146971,1.010247347,0.90946531,,,
219,경기,가평군,2011,494,261,233,5,2010,447,227,220,1.132209439,1.175281163,1.08763981,,,
220,경기,가평군,2012,447,236,211,5,2011,421,224,197,1.087759219,1.076939013,1.099937692,,,
221,경기,가평군,2013,440,233,207,5,2012,452,230,222,0.997290282,1.035512177,0.957567122,,,
222,경기,가평군,2014,450,234,216,5,2013,462,245,217,0.997879001,0.976285633,1.022223527,,,
223,경기,가평군,2015,438,224,214,5,2014,407,209,198,1.102521447,1.09554156,1.109942391,,,
224,경기,가평군,2016,418,217,201,5,2015,461,234,227,0.928929386,0.947918506,0.909331123,,,
225,경기,가평군,2017,459,238,221,5,2016,460,224,236,1.022261957,1.086065615,0.961683414,,,
226,경기,가평군,2018,422,196,226,5,2017,472,231,241,0.915962719,0.867303735,0.963037618,,,
227,경기,가평군,2019,436,204,232,5,2018,368,194,174,1.213796877,1.074869062,1.369274725,,,
228,경기,가평군,2020,357,189,168,5,2019,338,174,164,1.082078732,1.110298316,1.052003752,,,
229,경기,고양시,2009,9576,4986,4590,5,2008,10419,5460,4959,0.941597821,0.933440751,0.950540077,,,
230,경기,고양시,2010,9935,5232,4703,5,2009,9837,4988,4849,1.034695464,1.072181763,0.996035115,,,
231,경기,고양시,2011,9446,4811,4635,5,2010,8718,4482,4236,1.110039471,1.097212205,1.123687739,,,
232,경기,고양시,2012,8370,4267,4103,5,2011,9057,4691,4366,0.946778605,0.929788853,0.965094056,,,
233,경기,고양시,2013,8587,4387,4200,5,2012,9692,5035,4657,0.90768551,0.890625827,0.926178953,,,
234,경기,고양시,2014,9425,4870,4555,5,2013,9459,4796,4663,1.020806622,1.037951144,1.003170658,,,
235,경기,고양시,2015,9234,4715,4519,5,2014,9023,4682,4341,1.048446461,1.029383999,1.069065736,,,
236,경기,고양시,2016,8646,4490,4156,5,2015,9625,4955,4670,0.92028393,0.926253384,0.913924908,,,
237,경기,고양시,2017,9165,4721,4444,5,2016,9617,4901,4716,0.976338013,0.984637616,0.967725331,,,
238,경기,고양시,2018,9095,4631,4464,5,2017,9872,5086,4786,0.943854177,0.930733939,0.957862888,,,
239,경기,고양시,2019,9283,4787,4496,5,2018,8768,4477,4291,1.084663821,1.092957963,1.076018265,,,
240,경기,고양시,2020,8550,4305,4245,5,2019,8895,4558,4337,0.984753442,0.965441493,1.00517141,,,
241,경기,과천시,2009,757,390,367,5,2008,744,401,343,1.042390127,0.994139568,1.098813026,,,
242,경기,과천시,2010,711,391,320,5,2009,762,392,370,0.955920939,1.019571802,0.8881782,,,
243,경기,과천시,2011,677,349,328,5,2010,741,376,365,0.936004218,0.948778222,0.92285365,,,
244,경기,과천시,2012,606,312,294,5,2011,666,375,291,0.932192791,0.850453263,1.03754322,,,
245,경기,과천시,2013,590,331,259,5,2012,636,333,303,0.950390839,1.016040187,0.877827113,,,
246,경기,과천시,2014,578,304,274,5,2013,658,341,317,0.899931161,0.911268441,0.887652858,,,
247,경기,과천시,2015,554,278,276,5,2014,585,302,283,0.970199941,0.940946602,1.001554304,,,
248,경기,과천시,2016,496,258,238,5,2015,559,298,261,0.909027902,0.884974113,0.936458002,,,
249,경기,과천시,2017,440,229,211,5,2016,516,245,271,0.873595363,0.955424829,0.799585702,,,
250,경기,과천시,2018,418,205,213,5,2017,501,262,239,0.854763367,0.799796861,0.915236976,,,
251,경기,과천시,2019,466,242,224,5,2018,477,250,227,1.000863572,0.989469661,1.013383938,,,
252,경기,과천시,2020,483,253,230,5,2019,478,240,238,1.035205521,1.077547453,0.992436513,,,
253,경기,광명시,2009,3051,1612,1439,5,2008,3371,1760,1611,0.927237101,0.936223407,0.917312071,,,
254,경기,광명시,2010,3376,1785,1591,5,2009,3270,1658,1612,1.057698846,1.100476618,1.013577584,,,
255,경기,광명시,2011,3560,1794,1766,5,2010,3314,1745,1569,1.100537484,1.050882434,1.155898262,,,
256,경기,광명시,2012,3308,1765,1543,5,2011,3743,1958,1785,0.90542612,0.92142321,0.887727269,,,
257,경기,광명시,2013,3595,1859,1736,5,2012,3993,1978,2015,0.922373739,0.96068327,0.88476213,,,
258,경기,광명시,2014,3800,1877,1923,5,2013,3874,1979,1895,1.00491962,0.969495067,1.042130065,,,
259,경기,광명시,2015,3612,1822,1790,5,2014,3479,1833,1646,1.063654687,1.016045211,1.1167991,,,
260,경기,광명시,2016,3274,1735,1539,5,2015,3516,1798,1718,0.953975352,0.986363328,0.919956549,,,
261,경기,광명시,2017,3272,1651,1621,5,2016,3426,1791,1635,0.978437933,0.942277048,1.018162536,,,
262,경기,광명시,2018,3176,1654,1522,5,2017,3333,1711,1622,0.976230845,0.988126669,0.963641861,,,
263,경기,광명시,2019,3071,1575,1496,5,2018,2808,1449,1359,1.12044375,1.111064568,1.130482886,,,
264,경기,광명시,2020,2623,1355,1268,5,2019,2744,1416,1328,0.979313021,0.978144838,0.980557427,,,
265,경기,광주시,2009,2634,1357,1277,5,2008,2794,1444,1350,0.965821156,0.960593801,0.971424347,,,
266,경기,광주시,2010,2600,1361,1239,5,2009,2824,1431,1393,0.943226515,0.972177615,0.913423215,,,
267,경기,광주시,2011,2694,1385,1309,5,2010,2667,1367,1300,1.034860763,1.03563897,1.03406574,,,
268,경기,광주시,2012,2576,1312,1264,5,2011,2846,1452,1394,0.927295833,0.92362216,0.931185394,,,
269,경기,광주시,2013,2725,1405,1320,5,2012,3301,1603,1698,0.845723362,0.895921435,0.798340387,,,
270,경기,광주시,2014,3122,1535,1587,5,2013,3077,1543,1534,1.039471886,1.016879703,1.062437576,,,
271,경기,광주시,2015,2939,1461,1478,5,2014,3045,1590,1455,0.988825447,0.939247866,1.043189713,,,
272,경기,광주시,2016,2816,1424,1392,5,2015,3402,1770,1632,0.848019202,0.822363542,0.875933096,,,
273,경기,광주시,2017,3151,1628,1523,5,2016,3555,1846,1709,0.908063341,0.901466992,0.915186691,,,
274,경기,광주시,2018,3451,1781,1670,5,2017,3932,2042,1890,0.899163761,0.891528656,0.907416187,,,
275,경기,광주시,2019,3728,1931,1797,5,2018,3627,1863,1764,1.053017754,1.059489225,1.046167807,,,
276,경기,광주시,2020,3312,1680,1632,5,2019,3934,2045,1889,0.862508369,0.839736624,0.887237831,,,
277,경기,구리시,2009,1946,1006,940,5,2008,2186,1109,1077,0.912010889,0.927242992,0.896321895,,,
278,경기,구리시,2010,1999,1015,984,5,2009,2105,1055,1050,0.972899632,0.983423785,0.962404521,,,
279,경기,구리시,2011,1831,938,893,5,2010,1803,1008,795,1.040399088,0.951194722,1.153549367,,,
280,경기,구리시,2012,1653,919,734,5,2011,1931,1043,888,0.876996631,0.900654718,0.848857811,,,
281,경기,구리시,2013,1736,946,790,5,2012,2005,1059,946,0.887038948,0.913108323,0.857605999,,,
282,경기,구리시,2014,1802,954,848,5,2013,1798,875,923,1.026768282,1.1144676,0.943508911,,,
283,경기,구리시,2015,1607,784,823,5,2014,1682,897,785,0.97880737,0.893409868,1.076668566,,,
284,경기,구리시,2016,1524,804,720,5,2015,1686,854,832,0.926050652,0.962332833,0.888711961,,,
285,경기,구리시,2017,1598,839,759,5,2016,1705,853,852,0.960195656,1.005402718,0.914858729,,,
286,경기,구리시,2018,1693,853,840,5,2017,1966,1024,942,0.882227904,0.851483428,0.915756982,,,
287,경기,구리시,2019,1806,929,877,5,2018,1819,979,840,1.017167305,0.969974121,1.072191012,,,
288,경기,구리시,2020,1598,845,753,5,2019,1793,913,880,0.913069489,0.946047749,0.878747615,,,
289,경기,군포시,2009,2938,1511,1427,5,2008,3260,1670,1590,0.923297239,0.92485813,0.921676902,,,
290,경기,군포시,2010,3089,1593,1496,5,2009,2963,1540,1423,1.068054962,1.057358304,1.079638961,,,
291,경기,군포시,2011,2990,1550,1440,5,2010,2911,1488,1423,1.052292144,1.064770211,1.039224668,,,
292,경기,군포시,2012,2753,1400,1353,5,2011,3060,1582,1478,0.921705396,0.904583542,0.940102522,,,
293,경기,군포시,2013,2838,1463,1375,5,2012,3149,1619,1530,0.923309015,0.923686514,0.922918013,,,
294,경기,군포시,2014,2995,1551,1444,5,2013,3061,1602,1459,1.002399502,0.98963811,1.016397894,,,
295,경기,군포시,2015,2892,1507,1385,5,2014,2847,1464,1383,1.040682297,1.052202431,1.028441157,,,
296,경기,군포시,2016,2679,1361,1318,5,2015,2936,1513,1423,0.934811416,0.919488544,0.951179245,,,
297,경기,군포시,2017,2682,1415,1267,5,2016,2896,1483,1413,0.948784457,0.975309409,0.920844521,,,
298,경기,군포시,2018,2625,1346,1279,5,2017,2783,1428,1355,0.966325515,0.963482826,0.969355557,,,
299,경기,군포시,2019,2511,1291,1220,5,2018,2448,1233,1215,1.050854636,1.070262456,1.0311822,,,
300,경기,군포시,2020,2338,1185,1153,5,2019,2339,1202,1137,1.024051104,1.007722622,1.041407492,,,
301,경기,김포시,2009,2447,1271,1176,5,2008,2555,1319,1236,0.981183893,0.984981062,0.977103809,,,
302,경기,김포시,2010,2576,1335,1241,5,2009,2519,1311,1208,1.047671275,1.040892069,1.055010307,,,
303,경기,김포시,2011,2662,1400,1262,5,2010,2342,1231,1111,1.16447054,1.162511099,1.166533328,,,
304,경기,김포시,2012,2601,1357,1244,5,2011,2753,1440,1313,0.967924507,0.963262117,0.972988057,,,
305,경기,김포시,2013,3302,1719,1583,5,2012,3414,1725,1689,0.990879623,1.018623996,0.96250528,,,
306,경기,김포시,2014,3827,1938,1889,5,2013,3862,1963,1899,1.015204509,1.009161325,1.021548166,,,
307,경기,김포시,2015,4265,2158,2107,5,2014,4184,2174,2010,1.044322668,1.014656463,1.076515614,,,
308,경기,김포시,2016,4133,2137,1996,5,2015,4582,2441,2141,0.924097224,0.894878076,0.957405074,,,
309,경기,김포시,2017,4856,2591,2265,5,2016,4898,2463,2435,1.015704187,1.07530119,0.955258907,,,
310,경기,김포시,2018,5362,2712,2650,5,2017,5649,2814,2835,0.972439475,0.985128123,0.959941276,,,
311,경기,김포시,2019,6010,3023,2987,5,2018,5352,2733,2619,1.150444607,1.130643371,1.171255328,,,
312,경기,김포시,2020,5412,2756,2656,5,2019,5729,2940,2789,0.967801545,0.95820627,0.977983239,,,
313,경기,남양주시,2009,5938,3092,2846,5,2008,6390,3315,3075,0.952021333,0.953417409,0.950477041,,,
314,경기,남양주시,2010,6436,3320,3116,5,2009,6511,3334,3177,1.01268805,1.017887107,1.007237971,,,
315,경기,남양주시,2011,6648,3403,3245,5,2010,6444,3348,3096,1.056921723,1.038971477,1.076379962,,,
316,경기,남양주시,2012,6176,3235,2941,5,2011,6929,3593,3336,0.913154095,0.920331302,0.90535903,,,
317,경기,남양주시,2013,6846,3544,3302,5,2012,7784,4001,3783,0.901034485,0.905424594,0.896380877,,,
318,경기,남양주시,2014,7590,3918,3672,5,2013,7513,3929,3584,1.034988996,1.019317612,1.052171482,,,
319,경기,남양주시,2015,7243,3775,3468,5,2014,7361,3780,3581,1.008066106,1.020827313,0.994550003,,,
320,경기,남양주시,2016,7049,3628,3421,5,2015,7610,3931,3679,0.948965009,0.943390199,0.954937925,,,
321,경기,남양주시,2017,7192,3700,3492,5,2016,7674,3949,3725,0.960141473,0.957726966,0.962719599,,,
322,경기,남양주시,2018,7351,3780,3571,5,2017,7739,3902,3837,0.973125653,0.990219923,0.955762323,,,
323,경기,남양주시,2019,7734,3947,3787,5,2018,7185,3717,3468,1.102769486,1.085429675,1.121419417,,,
324,경기,남양주시,2020,7055,3634,3421,5,2019,7283,3758,3525,0.992416676,0.98845129,0.996657199,,,
325,경기,동두천시,2009,900,454,446,5,2008,1036,537,499,0.89000019,0.864188917,0.917880552,,,
326,경기,동두천시,2010,1015,526,489,5,2009,956,488,468,1.087715946,1.101775339,1.073037405,,,
327,경기,동두천시,2011,931,459,472,5,2010,887,454,433,1.075309311,1.033436885,1.119453239,,,
328,경기,동두천시,2012,804,413,391,5,2011,987,516,471,0.834538239,0.818139715,0.852526143,,,
329,경기,동두천시,2013,896,460,436,5,2012,1038,519,519,0.884337418,0.90597789,0.862722226,,,
330,경기,동두천시,2014,983,491,492,5,2013,917,440,477,1.09822551,1.140659288,1.059250259,,,
331,경기,동두천시,2015,866,414,452,5,2014,901,433,468,0.984692083,0.977326265,0.991846435,,,
332,경기,동두천시,2016,863,431,432,5,2015,978,510,468,0.904022597,0.863841809,0.947959425,,,
333,경기,동두천시,2017,923,482,441,5,2016,902,477,425,1.048340849,1.032894071,1.065617918,,,
334,경기,동두천시,2018,835,439,396,5,2017,852,429,423,1.004047423,1.046006428,0.961405658,,,
335,경기,동두천시,2019,803,401,402,5,2018,796,411,385,1.033498434,0.997308857,1.072302155,,,
336,경기,동두천시,2020,733,377,356,5,2019,760,401,359,0.988092784,0.961001583,1.018374238,,,
337,경기,부천시,2009,8209,4289,3920,5,2008,8668,4456,4212,0.970238934,0.983870614,0.95576156,,,
338,경기,부천시,2010,8247,4254,3993,5,2009,8153,4151,4002,1.036300953,1.047543044,1.024646547,,,
339,경기,부천시,2011,7620,3898,3722,5,2010,7465,3819,3646,1.045761152,1.04332425,1.048362698,,,
340,경기,부천시,2012,6986,3558,3428,5,2011,7702,4047,3655,0.929249663,0.898669215,0.96317519,,,
341,경기,부천시,2013,7249,3755,3494,5,2012,8294,4269,4025,0.895408915,0.899106033,0.891474389,,,
342,경기,부천시,2014,7777,3979,3798,5,2013,7549,3812,3737,1.05543142,1.066960084,1.043719308,,,
343,경기,부천시,2015,7048,3609,3439,5,2014,7135,3662,3473,1.011997089,1.007385435,1.016902342,,,
344,경기,부천시,2016,6657,3403,3254,5,2015,7249,3692,3557,0.940822733,0.942165901,0.939475672,,,
345,경기,부천시,2017,6934,3528,3406,5,2016,7321,3691,3630,0.970332942,0.977038453,0.963584652,,,
346,경기,부천시,2018,7070,3575,3495,5,2017,7505,3894,3611,0.965108326,0.938441542,0.993966041,,,
347,경기,부천시,2019,7059,3638,3421,5,2018,6673,3415,3258,1.083750728,1.088927867,1.078335367,,,
348,경기,부천시,2020,6172,3198,2974,5,2019,6721,3432,3289,0.940804459,0.952485352,0.92860057,,,
349,경기,성남시,2009,8221,4231,3990,5,2008,8936,4602,4334,0.942516221,0.93977424,0.945444074,,,
350,경기,성남시,2010,8852,4638,4214,5,2009,8929,4613,4316,1.015654337,1.02771907,1.002685998,,,
351,경기,성남시,2011,8517,4411,4106,5,2010,8135,4143,3992,1.072596648,1.088301555,1.056282945,,,
352,경기,성남시,2012,7665,3948,3717,5,2011,8380,4285,4095,0.937077447,0.94178863,0.932160101,,,
353,경기,성남시,2013,7917,4076,3841,5,2012,9011,4602,4409,0.900108785,0.905346207,0.894655968,,,
354,경기,성남시,2014,8606,4427,4179,5,2013,8458,4326,4132,1.04241585,1.046044432,1.038637296,,,
355,경기,성남시,2015,7921,4067,3854,5,2014,8017,4064,3953,1.012221307,1.022933964,1.001236679,,,
356,경기,성남시,2016,7483,3825,3658,5,2015,8447,4370,4077,0.907570971,0.894699362,0.921414081,,,
357,경기,성남시,2017,8106,4157,3949,5,2016,8466,4409,4057,0.980924723,0.963755903,0.999617801,,,
358,경기,성남시,2018,7902,4071,3831,5,2017,8508,4473,4035,0.951517739,0.930313514,0.97503559,,,
359,경기,성남시,2019,7813,4093,3720,5,2018,7789,3949,3840,1.027645833,1.0594531,0.994863667,,,
360,경기,성남시,2020,7248,3704,3544,5,2019,7562,3782,3780,0.98194883,1.001097966,0.962839211,,,
361,경기,수원시,2009,11217,5832,5385,5,2008,11947,6223,5724,0.961889539,0.957954407,0.966135272,,,
362,경기,수원시,2010,11610,6047,5563,5,2009,11468,5891,5577,1.03717462,1.049247809,1.024378066,,,
363,경기,수원시,2011,10941,5633,5308,5,2010,10219,5254,4965,1.096872035,1.095914841,1.097901849,,,
364,경기,수원시,2012,10298,5241,5057,5,2011,10533,5375,5158,1.001631902,0.996696232,1.006846978,,,
365,경기,수원시,2013,11042,5631,5411,5,2012,11969,6219,5750,0.945142345,0.9255334,0.966410288,,,
366,경기,수원시,2014,12350,6416,5934,5,2013,11734,6019,5715,1.07827173,1.089600107,1.066309215,,,
367,경기,수원시,2015,11849,6089,5760,5,2014,11500,5919,5581,1.055580125,1.051537486,1.059893713,,,
368,경기,수원시,2016,11258,5747,5511,5,2015,11998,6220,5778,0.961301748,0.944447753,0.97950065,,,
369,경기,수원시,2017,11580,5984,5596,5,2016,12004,6219,5785,0.988302554,0.983553874,0.993404671,,,
370,경기,수원시,2018,11749,6072,5677,5,2017,12664,6478,6186,0.950467666,0.958115673,0.942455458,,,
371,경기,수원시,2019,12205,6273,5932,5,2018,11156,5765,5391,1.120821939,1.112251759,1.130013588,,,
372,경기,수원시,2020,10731,5521,5210,5,2019,11089,5696,5393,0.991414249,0.990774663,0.992108472,,,
373,경기,시흥시,2009,4894,2604,2290,5,2008,5105,2656,2449,0.982144896,1.002166854,0.960281478,,,
374,경기,시흥시,2010,4860,2513,2347,5,2009,4802,2478,2324,1.036863195,1.036616964,1.03711955,,,
375,경기,시흥시,2011,4589,2386,2203,5,2010,4401,2234,2167,1.068252787,1.091727867,1.044016689,,,
376,경기,시흥시,2012,4164,2099,2065,5,2011,4482,2256,2226,0.951801125,0.95104369,0.952679349,,,
377,경기,시흥시,2013,4245,2122,2123,5,2012,4570,2266,2304,0.951631567,0.957221841,0.946279375,,,
378,경기,시흥시,2014,4395,2199,2196,5,2013,4290,2261,2029,1.049564016,0.994149715,1.111481258,,,
379,경기,시흥시,2015,4152,2179,1973,5,2014,4079,2105,1974,1.042823921,1.0581135,1.026435803,,,
380,경기,시흥시,2016,4069,2106,1963,5,2015,4133,2096,2037,1.008624771,1.027056212,0.989648853,,,
381,경기,시흥시,2017,4248,2165,2083,5,2016,4102,2130,1972,1.060953127,1.038975777,1.084761379,,,
382,경기,시흥시,2018,4662,2422,2240,5,2017,4454,2300,2154,1.072332335,1.076399353,1.067958003,,,
383,경기,시흥시,2019,5317,2756,2561,5,2018,4430,2279,2151,1.229618191,1.236123928,1.222703128,,,
384,경기,시흥시,2020,4959,2537,2422,5,2019,4897,2518,2379,1.037459972,1.029892432,1.045518091,,,
385,경기,안산시,2009,7976,4140,3836,5,2008,8136,4209,3927,1.004341829,1.005422363,1.003158488,,,
386,경기,안산시,2010,7654,3947,3707,5,2009,7736,4045,3691,1.013629735,0.997414611,1.031407763,,,
387,경기,안산시,2011,7397,3852,3545,5,2010,6896,3522,3374,1.098919073,1.117954304,1.079003905,,,
388,경기,안산시,2012,6600,3390,3210,5,2011,6699,3423,3276,1.009348874,1.012324912,1.006266453,,,
389,경기,안산시,2013,6424,3298,3126,5,2012,7401,3788,3613,0.889247132,0.889954506,0.888531578,,,
390,경기,안산시,2014,7139,3668,3471,5,2013,6710,3452,3258,1.089989231,1.086139643,1.094095896,,,
391,경기,안산시,2015,6508,3354,3154,5,2014,6193,3208,2985,1.076598597,1.068700036,1.085098614,,,
392,경기,안산시,2016,5900,3037,2863,5,2015,6254,3205,3049,0.966499158,0.968598703,0.96430802,,,
393,경기,안산시,2017,6090,3146,2944,5,2016,6093,3080,3013,1.023984681,1.044083247,1.003437966,,,
394,경기,안산시,2018,5745,2909,2836,5,2017,5907,2955,2952,0.996392403,1.006267303,0.986601403,,,
395,경기,안산시,2019,5611,2815,2796,5,2018,5075,2592,2483,1.132691307,1.110121534,1.156411236,,,
396,경기,안산시,2020,5094,2610,2484,5,2019,4809,2433,2376,1.085204307,1.096542639,1.073635864,,,
397,경기,안성시,2009,1853,990,863,5,2008,1832,966,866,1.036232705,1.047575164,1.023398459,,,
398,경기,안성시,2010,1798,937,861,5,2009,1835,942,893,1.003831834,1.016753822,0.990155827,,,
399,경기,안성시,2011,1852,948,904,5,2010,1743,898,845,1.088556412,1.079093623,1.098660667,,,
400,경기,안성시,2012,1696,876,820,5,2011,1860,987,873,0.93415781,0.907223056,0.964609342,,,
401,경기,안성시,2013,1813,966,847,5,2012,2102,1079,1023,0.88363404,0.91513003,0.850275434,,,
402,경기,안성시,2014,2031,1044,987,5,2013,1994,1034,960,1.043499186,1.032065083,1.055839183,,,
403,경기,안성시,2015,1926,990,936,5,2014,1919,979,940,1.02822617,1.033664564,1.022586018,,,
404,경기,안성시,2016,1802,919,883,5,2015,1837,945,892,1.004969718,0.994055948,1.01659438,,,
405,경기,안성시,2017,1809,938,871,5,2016,1951,1002,949,0.949923524,0.956890498,0.942548698,,,
406,경기,안성시,2018,1888,984,904,5,2017,1830,914,916,1.056959254,1.100464477,1.013502471,,,
407,경기,안성시,2019,1787,897,890,5,2018,1664,885,779,1.100217569,1.036039462,1.173287393,,,
408,경기,안성시,2020,1681,886,795,5,2019,1558,781,777,1.105369826,1.15960429,1.050746531,,,
409,경기,안양시,2009,5819,3020,2799,5,2008,6273,3271,3002,0.950343076,0.943742524,0.957511648,,,
410,경기,안양시,2010,6023,3126,2897,5,2009,5782,3018,2764,1.067190919,1.058758387,1.076371801,,,
411,경기,안양시,2011,5482,2893,2589,5,2010,5279,2730,2549,1.06388507,1.083210627,1.043071478,,,
412,경기,안양시,2012,5104,2628,2476,5,2011,5423,2764,2659,0.964225042,0.971884034,0.956277986,,,
413,경기,안양시,2013,5291,2688,2603,5,2012,5615,2958,2657,0.96537344,0.928877023,1.006084525,,,
414,경기,안양시,2014,5378,2845,2533,5,2013,5387,2753,2634,1.022777505,1.056338685,0.987577699,,,
415,경기,안양시,2015,5127,2626,2501,5,2014,4791,2459,2332,1.096338062,1.091599476,1.101379531,,,
416,경기,안양시,2016,4642,2389,2253,5,2015,5197,2723,2474,0.915081477,0.896800071,0.935219065,,,
417,경기,안양시,2017,4978,2583,2395,5,2016,5214,2666,2548,0.978117909,0.990356113,0.965290316,,,
418,경기,안양시,2018,4837,2443,2394,5,2017,5068,2610,2458,0.977792781,0.956775586,1.000216749,,,
419,경기,안양시,2019,4602,2360,2242,5,2018,4396,2257,2139,1.072497469,1.068827377,1.07640741,,,
420,경기,안양시,2020,4147,2145,2002,5,2019,4455,2270,2185,0.953660231,0.96589199,0.940945538,,,
421,경기,양주시,2009,2175,1146,1029,5,2008,2266,1135,1131,0.983346782,1.032085987,0.934339318,,,
422,경기,양주시,2010,2278,1155,1123,5,2009,2278,1203,1075,1.024489107,0.981394189,1.072810825,,,
423,경기,양주시,2011,2334,1242,1092,5,2010,2252,1177,1075,1.061792885,1.078629412,1.043196279,,,
424,경기,양주시,2012,2112,1104,1008,5,2011,2256,1189,1067,0.959096186,0.949105181,0.970170283,,,
425,경기,양주시,2013,2158,1144,1014,5,2012,2515,1290,1225,0.87906461,0.906490881,0.850068105,,,
426,경기,양주시,2014,2361,1220,1141,5,2013,2257,1133,1124,1.071696403,1.100669789,1.042488297,,,
427,경기,양주시,2015,2212,1111,1101,5,2014,2196,1115,1081,1.031953509,1.018512391,1.045956156,,,
428,경기,양주시,2016,2141,1089,1052,5,2015,2196,1100,1096,0.998830227,1.011957608,0.985727881,,,
429,경기,양주시,2017,2136,1074,1062,5,2016,2212,1123,1089,0.989289662,0.97757852,1.001494324,,,
430,경기,양주시,2018,2187,1100,1087,5,2017,2350,1174,1176,0.953428799,0.957749014,0.949235731,,,
431,경기,양주시,2019,2359,1179,1180,5,2018,2062,1056,1006,1.172051312,1.141240071,1.204580648,,,
432,경기,양주시,2020,2065,1035,1030,5,2019,2054,1062,992,1.029975661,0.99619179,1.066295086,,,
433,경기,양평군,2009,628,346,282,5,2008,699,375,324,0.920427982,0.943130862,0.893832112,,,
434,경기,양평군,2010,722,380,342,5,2009,734,400,334,1.007739967,0.971070432,1.051553793,,,
435,경기,양평군,2011,790,429,361,5,2010,656,339,317,1.233759748,1.293554465,1.169498839,,,
436,경기,양평군,2012,681,361,320,5,2011,794,408,386,0.878686501,0.904428344,0.851362523,,,
437,경기,양평군,2013,776,390,386,5,2012,847,426,421,0.938611036,0.935798044,0.941579651,,,
438,경기,양평군,2014,847,422,425,5,2013,812,404,408,1.068648121,1.067722049,1.069745879,,,
439,경기,양평군,2015,816,410,406,5,2014,810,424,386,1.032077916,0.988428196,1.080166202,,,
440,경기,양평군,2016,822,431,391,5,2015,840,426,414,1.002535769,1.034176813,0.96990293,,,
441,경기,양평군,2017,831,421,410,5,2016,889,459,430,0.957649548,0.937554528,0.979190646,,,
442,경기,양평군,2018,873,444,429,5,2017,891,469,422,1.003792358,0.967692227,1.04399086,,,
443,경기,양평군,2019,840,438,402,5,2018,809,403,406,1.063746416,1.110954288,1.01683825,,,
444,경기,양평군,2020,746,373,373,5,2019,801,426,375,0.954143413,0.895006848,1.021478945,,,
445,경기,여주시,2014,1014,511,503,5,2013,927,503,424,1.120638571,1.038436729,1.218299269,,,
446,경기,여주시,2015,884,475,409,5,2014,932,499,433,0.97172572,0.973016465,0.970034693,,,
447,경기,여주시,2016,908,481,427,5,2015,952,474,478,0.977138771,1.037274879,0.91738542,,,
448,경기,여주시,2017,939,463,476,5,2016,1010,520,490,0.952470566,0.910132814,0.997614443,,,
449,경기,여주시,2018,955,494,461,5,2017,930,487,443,1.052029137,1.036871919,1.068683377,,,
450,경기,여주시,2019,868,457,411,5,2018,851,473,378,1.044954812,0.987602509,1.116610937,,,
451,경기,여주시,2020,804,428,376,5,2019,800,409,391,1.029611553,1.069664509,0.987558753,,,
452,경기,연천군,2009,377,201,176,5,2008,374,213,161,1.032706934,0.96459183,1.122635178,,,
453,경기,연천군,2010,333,192,141,5,2009,366,169,197,0.932117139,1.161292575,0.735029453,,,
454,경기,연천군,2011,334,159,175,5,2010,340,190,150,1.006409888,0.855402763,1.198115384,,,
455,경기,연천군,2012,329,186,143,5,2011,297,150,147,1.134871772,1.267502459,0.999011662,,,
456,경기,연천군,2013,281,147,134,5,2012,338,178,160,0.851720234,0.844159394,0.860075687,,,
457,경기,연천군,2014,312,170,142,5,2013,321,166,155,0.995765114,1.046810231,0.940824247,,,
458,경기,연천군,2015,300,157,143,5,2014,305,172,133,1.007694204,0.93303585,1.104170784,,,
459,경기,연천군,2016,271,147,124,5,2015,349,168,181,0.795520195,0.894406977,0.703549997,,,
460,경기,연천군,2017,334,165,169,5,2016,350,189,161,0.97765532,0.892378843,1.077984916,,,
461,경기,연천군,2018,300,166,134,5,2017,356,192,164,0.863333517,0.883759275,0.839098231,,,
462,경기,연천군,2019,286,156,130,5,2018,340,169,171,0.861776132,0.943550217,0.780726817,,,
463,경기,연천군,2020,284,143,141,5,2019,308,148,160,0.944658787,0.987646314,0.905005014,,,
464,경기,오산시,2009,1986,995,991,5,2008,2238,1158,1080,0.909131085,0.8782975,0.942327259,,,
465,경기,오산시,2010,2310,1200,1110,5,2009,2261,1152,1109,1.046691658,1.064770211,1.027882064,,,
466,경기,오산시,2011,2447,1243,1204,5,2010,2388,1202,1186,1.049801024,1.057045755,1.042542223,,,
467,경기,오산시,2012,2479,1264,1215,5,2011,2660,1311,1349,0.954777631,0.985533764,0.924945584,,,
468,경기,오산시,2013,2583,1276,1307,5,2012,3049,1581,1468,0.86790927,0.824984767,0.914326668,,,
469,경기,오산시,2014,2993,1554,1439,5,2013,3080,1642,1438,0.995550616,0.967397559,1.0276702,,,
470,경기,오산시,2015,2971,1600,1371,5,2014,2922,1524,1398,1.04166911,1.073154228,1.007122129,,,
471,경기,오산시,2016,2728,1427,1301,5,2015,2927,1483,1444,0.954836449,0.983580585,0.925256103,,,
472,경기,오산시,2017,2839,1439,1400,5,2016,2988,1520,1468,0.973401799,0.967708,0.979385873,,,
473,경기,오산시,2018,2943,1502,1441,5,2017,3039,1578,1461,0.992126174,0.972948962,1.012897782,,,
474,경기,오산시,2019,2979,1555,1424,5,2018,2736,1407,1329,1.115479916,1.129700761,1.100365242,,,
475,경기,오산시,2020,2677,1378,1299,5,2019,2715,1360,1355,1.010150033,1.035708247,0.98451358,,,
476,경기,용인시,2009,10494,5502,4992,5,2008,11701,6019,5682,0.918809392,0.934379643,0.902246493,,,
477,경기,용인시,2010,11092,5717,5375,5,2009,11422,5856,5566,0.994889965,0.997916606,0.991715547,,,
478,경기,용인시,2011,11162,5763,5399,5,2010,10979,5682,5297,1.041565481,1.036751126,1.046731297,,,
479,경기,용인시,2012,10455,5449,5006,5,2011,11458,5957,5501,0.93480831,0.935010167,0.934546802,,,
480,경기,용인시,2013,11055,5738,5317,5,2012,12790,6556,6234,0.885514236,0.89464085,0.875894335,,,
481,경기,용인시,2014,12253,6241,6012,5,2013,12307,6365,5942,1.019993909,1.002265774,1.039054146,,,
482,경기,용인시,2015,11757,6077,5680,5,2014,11609,5953,5656,1.037550042,1.043471229,1.031313707,,,
483,경기,용인시,2016,10993,5693,5300,5,2015,12031,6155,5876,0.93609914,0.94545367,0.926287786,,,
484,경기,용인시,2017,11437,5882,5555,5,2016,11881,6068,5813,0.986203343,0.990846942,0.981376367,,,
485,경기,용인시,2018,11495,5866,5629,5,2017,12202,6245,5957,0.965128855,0.960144816,0.970410537,,,
486,경기,용인시,2019,11990,6091,5899,5,2018,11157,5692,5465,1.100979152,1.093832526,1.108511199,,,
487,경기,용인시,2020,10958,5579,5379,5,2019,11398,5842,5556,0.984940484,0.976162082,0.994239842,,,
488,경기,의왕시,2009,1291,644,647,5,2008,1494,788,706,0.885284764,0.835385197,0.941133938,,,
489,경기,의왕시,2010,1394,727,667,5,2009,1457,708,749,0.980190677,1.04961077,0.914525609,,,
490,경기,의왕시,2011,1331,657,674,5,2010,1380,712,668,0.98811232,0.943218915,1.0361802,,,
491,경기,의왕시,2012,1198,606,592,5,2011,1514,783,731,0.810659148,0.791112028,0.83167986,,,
492,경기,의왕시,2013,1407,721,686,5,2012,1642,842,800,0.877866123,0.875286638,0.880614808,,,
493,경기,의왕시,2014,1503,767,736,5,2013,1627,845,782,0.946408807,0.927824381,0.966546865,,,
494,경기,의왕시,2015,1397,729,668,5,2014,1585,792,793,0.902972418,0.940869677,0.865077727,,,
495,경기,의왕시,2016,1368,701,667,5,2015,1574,834,740,0.890407306,0.859169977,0.925648218,,,
496,경기,의왕시,2017,1326,708,618,5,2016,1547,796,751,0.878133521,0.909174644,0.845085,,,
497,경기,의왕시,2018,1237,647,590,5,2017,1542,816,726,0.821850211,0.810478031,0.834578603,,,
498,경기,의왕시,2019,1313,686,627,5,2018,1360,658,702,0.989083969,1.065676398,0.917238518,,,
499,경기,의왕시,2020,1257,590,667,5,2019,1391,724,667,0.925796411,0.832991502,1.026956044,,,
500,경기,의정부시,2009,4514,2375,2139,5,2008,4842,2487,2355,0.955089597,0.976146393,0.932763897,,,
501,경기,의정부시,2010,4414,2261,2153,5,2009,4470,2276,2194,1.011654345,1.015442719,1.007764978,,,
502,경기,의정부시,2011,4024,2034,1990,5,2010,4028,2072,1956,1.02347174,1.003432869,1.044807018,,,
503,경기,의정부시,2012,3709,1908,1801,5,2011,4016,2018,1998,0.946172834,0.966461001,0.925699617,,,
504,경기,의정부시,2013,3720,1873,1847,5,2012,4334,2257,2077,0.879349211,0.848268507,0.913234383,,,
505,경기,의정부시,2014,4073,2144,1929,5,2013,3901,1999,1902,1.069660122,1.096324481,1.041534284,,,
506,경기,의정부시,2015,3574,1856,1718,5,2014,3715,1880,1835,0.985605402,1.009130304,0.961477103,,,
507,경기,의정부시,2016,3466,1731,1735,5,2015,3934,2016,1918,0.902612925,0.877674874,0.928972229,,,
508,경기,의정부시,2017,3749,1897,1852,5,2016,3867,1970,1897,0.993227221,0.984301688,1.002594936,,,
509,경기,의정부시,2018,3683,1884,1799,5,2017,4074,2090,1984,0.926164306,0.921428705,0.931196534,,,
510,경기,의정부시,2019,3868,1967,1901,5,2018,3715,1940,1775,1.066682064,1.03640561,1.099855459,,,
511,경기,의정부시,2020,3502,1812,1690,5,2019,3715,1897,1818,0.965749893,0.976378006,0.954651108,,,
512,경기,이천시,2009,2333,1233,1100,5,2008,2302,1209,1093,1.038285442,1.042470805,1.033533072,,,
513,경기,이천시,2010,2251,1164,1087,5,2009,2229,1181,1048,1.034600709,1.007465558,1.06517292,,,
514,경기,이천시,2011,2187,1158,1029,5,2010,2155,1141,1014,1.039701939,1.037409069,1.042147701,,,
515,경기,이천시,2012,2124,1116,1008,5,2011,2242,1182,1060,0.970568628,0.965103395,0.976577068,,,
516,경기,이천시,2013,2165,1142,1023,5,2012,2474,1245,1229,0.896531495,0.937613556,0.854821833,,,
517,경기,이천시,2014,2377,1210,1167,5,2013,2277,1165,1112,1.069482041,1.061662727,1.077749733,,,
518,경기,이천시,2015,2168,1141,1027,5,2014,2091,1100,991,1.062215392,1.060278816,1.064262217,,,
519,경기,이천시,2016,2032,1064,968,5,2015,2238,1180,1058,0.930188501,0.921693969,0.939596834,,,
520,경기,이천시,2017,2274,1203,1071,5,2016,2323,1219,1104,1.002879135,1.008762774,0.996258988,,,
521,경기,이천시,2018,2274,1181,1093,5,2017,2361,1197,1164,0.98673792,1.008516186,0.964315254,,,
522,경기,이천시,2019,2291,1163,1128,5,2018,2082,1045,1037,1.127331674,1.137602531,1.117074655,,,
523,경기,이천시,2020,2035,1016,1019,5,2019,2131,1143,988,0.978336618,0.908603913,1.059178349,,,
524,경기,파주시,2009,3543,1852,1691,5,2008,3877,2019,1858,0.936230309,0.937630635,0.934651599,,,
525,경기,파주시,2010,3766,1961,1805,5,2009,3813,1984,1829,1.011860996,1.01032954,1.013480404,,,
526,경기,파주시,2011,4048,2133,1915,5,2010,3886,1999,1887,1.067198123,1.090699682,1.042194395,,,
527,경기,파주시,2012,4011,2075,1936,5,2011,4313,2196,2117,0.952753492,0.965857131,0.939153,,,
528,경기,파주시,2013,4441,2243,2198,5,2012,5016,2548,2468,0.907048669,0.899822763,0.91460672,,,
529,경기,파주시,2014,4943,2512,2431,5,2013,4874,2515,2359,1.038992544,1.020960103,1.058300188,,,
530,경기,파주시,2015,4757,2456,2301,5,2014,4637,2423,2214,1.051001657,1.036100954,1.067310685,,,
531,경기,파주시,2016,4591,2396,2195,5,2015,5189,2594,2595,0.906423105,0.944156456,0.868658388,,,
532,경기,파주시,2017,4992,2492,2500,5,2016,5022,2583,2439,1.018369101,0.986167662,1.052640471,,,
533,경기,파주시,2018,4847,2483,2364,5,2017,5245,2675,2570,0.946749038,0.948811759,0.944639723,,,
534,경기,파주시,2019,5245,2689,2556,5,2018,4865,2451,2414,1.104510867,1.121436317,1.087365223,,,
535,경기,파주시,2020,4595,2333,2262,5,2019,4943,2551,2392,0.952362421,0.93482734,0.971143215,,,
536,경기,평택시,2009,4718,2460,2258,5,2008,4790,2390,2400,1.009089689,1.052117711,0.966194478,,,
537,경기,평택시,2010,4672,2350,2322,5,2009,4625,2445,2180,1.034900132,0.98246282,1.093849511,,,
538,경기,평택시,2011,4523,2376,2147,5,2010,4168,2083,2085,1.111747657,1.165961719,1.057493825,,,
539,경기,평택시,2012,4190,2142,2048,5,2011,4523,2311,2212,0.949062428,0.94742894,0.950816446,,,
540,경기,평택시,2013,4508,2318,2190,5,2012,4989,2554,2435,0.925715954,0.927725863,0.923627818,,,
541,경기,평택시,2014,4946,2541,2405,5,2013,4734,2419,2315,1.070368214,1.073732063,1.066880901,,,
542,경기,평택시,2015,4718,2401,2317,5,2014,4650,2371,2279,1.039470884,1.035112925,1.044079488,,,
543,경기,평택시,2016,4704,2401,2303,5,2015,4894,2563,2331,0.984715317,0.957570326,1.014620235,,,
544,경기,평택시,2017,4918,2572,2346,5,2016,4952,2546,2406,1.017455055,1.032617998,1.001346167,,,
545,경기,평택시,2018,5043,2593,2450,5,2017,5211,2683,2528,0.991460098,0.987890865,0.9952699,,,
546,경기,평택시,2019,5410,2767,2643,5,2018,4806,2390,2416,1.153243044,1.18341858,1.123445705,,,
547,경기,평택시,2020,5066,2515,2551,5,2019,5002,2574,2428,1.037597325,0.998749494,1.078980588,,,
548,경기,포천시,2009,1530,792,738,5,2008,1684,834,850,0.930800674,0.970702742,0.891639483,,,
549,경기,포천시,2010,1571,773,798,5,2009,1388,700,688,1.159562239,1.128778111,1.191149597,,,
550,경기,포천시,2011,1273,642,631,5,2010,1284,697,587,1.015712332,0.941519622,1.10393401,,,
551,경기,포천시,2012,1263,683,580,5,2011,1404,741,663,0.921602381,0.942170758,0.898392919,,,
552,경기,포천시,2013,1322,689,633,5,2012,1383,753,630,0.979301952,0.93530094,1.031846311,,,
553,경기,포천시,2014,1335,733,602,5,2013,1257,661,596,1.088061224,1.133521183,1.037294527,,,
554,경기,포천시,2015,1240,653,587,5,2014,1243,617,626,1.022016487,1.08182034,0.962976354,,,
555,경기,포천시,2016,1192,603,589,5,2015,1217,632,585,1.003443727,0.975275601,1.033977965,,,
556,경기,포천시,2017,1171,605,566,5,2016,1193,644,549,1.005596601,0.960277233,1.05875614,,,
557,경기,포천시,2018,1110,606,504,5,2017,1231,607,624,0.923787904,1.020495416,0.829464497,,,
558,경기,포천시,2019,1127,553,574,5,2018,988,515,473,1.168622696,1.097602348,1.246242641,,,
559,경기,포천시,2020,922,486,436,5,2019,961,475,486,0.982912546,1.045850925,0.92130213,,,
560,경기,하남시,2009,1294,666,628,5,2008,1412,730,682,0.938873162,0.932563674,0.945642809,,,
561,경기,하남시,2010,1286,666,620,5,2009,1502,755,747,0.877159116,0.901684082,0.852359769,,,
562,경기,하남시,2011,1320,676,644,5,2010,1280,683,597,1.056504392,1.011703186,1.10780518,,,
563,경기,하남시,2012,1109,598,511,5,2011,1350,712,638,0.84159883,0.858515846,0.822530624,,,
564,경기,하남시,2013,1189,624,565,5,2012,1490,779,711,0.817528556,0.818793257,0.816076181,,,
565,경기,하남시,2014,1328,699,629,5,2013,1363,686,677,0.99818161,1.041550149,0.954143798,,,
566,경기,하남시,2015,1390,709,681,5,2014,1364,689,675,1.044017492,1.051850793,1.036084542,,,
567,경기,하남시,2016,1652,836,816,5,2015,1805,940,865,0.937648756,0.909087213,0.968781655,,,
568,경기,하남시,2017,2477,1269,1208,5,2016,2559,1285,1274,0.991660617,1.009451877,0.973754239,,,
569,경기,하남시,2018,2735,1333,1402,5,2017,2947,1555,1392,0.950789857,0.876247681,1.034333602,,,
570,경기,하남시,2019,3089,1646,1443,5,2018,3054,1563,1491,1.036230142,1.076460202,0.993895085,,,
571,경기,하남시,2020,3027,1522,1505,5,2019,3292,1663,1629,0.942019601,0.935512357,0.948783822,,,
572,경기,화성시,2009,6561,3411,3150,5,2008,7068,3633,3435,0.951000712,0.959717573,0.941750084,,,
573,경기,화성시,2010,7266,3772,3494,5,2009,7648,3932,3716,0.973318234,0.980585123,0.965603987,,,
574,경기,화성시,2011,7373,3783,3590,5,2010,7101,3606,3495,1.063731614,1.072352934,1.054870443,,,
575,경기,화성시,2012,6814,3475,3339,5,2011,7713,3940,3773,0.905078281,0.901541478,0.908827519,,,
576,경기,화성시,2013,7351,3762,3589,5,2012,8433,4269,4164,0.893041554,0.90078213,0.885145351,,,
577,경기,화성시,2014,8041,4064,3977,5,2013,8198,4230,3968,1.004869104,0.982065506,1.029285329,,,
578,경기,화성시,2015,8225,4211,4014,5,2014,7854,4064,3790,1.072882978,1.059152919,1.087652127,,,
579,경기,화성시,2016,8751,4483,4268,5,2015,9122,4669,4453,0.982822208,0.981458612,0.984291128,,,
580,경기,화성시,2017,9716,4984,4732,5,2016,9664,4967,4697,1.030001673,1.025677902,1.034608473,,,
581,경기,화성시,2018,10549,5378,5171,5,2017,10571,5369,5202,1.022356976,1.023892871,1.02083616,,,
582,경기,화성시,2019,11743,5921,5822,5,2018,10473,5453,5020,1.148722963,1.109907251,1.191023523,,,
583,경기,화성시,2020,11118,5741,5377,5,2019,11196,5585,5611,1.017351723,1.050730877,0.984128078,,,
584,경남,거제시,2009,2728,1474,1254,5,2008,2785,1383,1402,1.003521108,1.089437772,0.918546989,,,
585,경남,거제시,2010,2755,1388,1367,5,2009,2841,1501,1340,0.993476766,0.945226523,1.047648442,,,
586,경남,거제시,2011,2706,1429,1277,5,2010,2551,1310,1241,1.086737564,1.115033867,1.056746872,,,
587,경남,거제시,2012,2467,1272,1195,5,2011,2691,1374,1317,0.939210192,0.946297089,0.931824201,,,
588,경남,거제시,2013,2643,1349,1294,5,2012,3094,1610,1484,0.875153429,0.856472058,0.895472453,,,
589,경남,거제시,2014,3060,1594,1466,5,2013,3036,1538,1498,1.032587836,1.059397898,1.005018398,,,
590,경남,거제시,2015,3028,1546,1482,5,2014,3080,1622,1458,1.007192538,0.974284436,1.04386067,,,
591,경남,거제시,2016,3054,1595,1459,5,2015,3387,1724,1663,0.923764315,0.945693821,0.900979476,,,
592,경남,거제시,2017,3305,1674,1631,5,2016,3534,1792,1742,0.958103141,0.954870714,0.961518546,,,
593,경남,거제시,2018,3396,1731,1665,5,2017,3586,1892,1694,0.970207755,0.935196906,1.009375332,,,
594,경남,거제시,2019,3412,1791,1621,5,2018,3200,1648,1552,1.092361511,1.110875795,1.072613239,,,
595,경남,거제시,2020,3038,1573,1465,5,2019,3210,1654,1556,0.969594364,0.97212104,0.966896275,,,
596,경남,거창군,2009,520,264,256,5,2008,478,281,197,1.114506979,0.960339367,1.334521559,,,
597,경남,거창군,2010,473,280,193,5,2009,497,265,232,0.975016796,1.080038614,0.854321192,,,
598,경남,거창군,2011,484,249,235,5,2010,437,235,202,1.134674435,1.083075196,1.194726091,,,
599,경남,거창군,2012,453,239,214,5,2011,439,222,217,1.057160742,1.100454402,1.012758495,,,
600,경남,거창군,2013,428,216,212,5,2012,510,264,246,0.859767329,0.836328602,0.88501903,,,
601,경남,거창군,2014,495,246,249,5,2013,476,252,224,1.06538258,0.997841797,1.141571674,,,
602,경남,거창군,2015,483,252,231,5,2014,479,255,224,1.03304434,1.010153762,1.05904842,,,
603,경남,거창군,2016,490,260,230,5,2015,451,240,211,1.113081292,1.107361019,1.119430759,,,
604,경남,거창군,2017,454,240,214,5,2016,518,274,244,0.897911303,0.895339622,0.900690956,,,
605,경남,거창군,2018,519,269,250,5,2017,475,256,219,1.119389151,1.07408695,1.172324251,,,
606,경남,거창군,2019,482,255,227,5,2018,441,225,216,1.119736394,1.158469989,1.079254731,,,
607,경남,거창군,2020,427,219,208,5,2019,448,226,222,0.97646618,0.990518978,0.96219305,,,
608,경남,고성군,2009,336,180,156,5,2008,341,169,172,1.009467273,1.088711789,0.931425249,,,
609,경남,고성군,2010,356,176,180,5,2009,353,172,181,1.033195814,1.045951016,1.021282254,,,
610,경남,고성군,2011,339,165,174,5,2010,342,157,185,1.015502361,1.074264977,0.965893793,,,
611,경남,고성군,2012,333,155,178,5,2011,387,196,191,0.881537139,0.80835616,0.957058512,,,
612,경남,고성군,2013,374,193,181,5,2012,399,232,167,0.960298061,0.85034752,1.113048167,,,
613,경남,고성군,2014,382,210,172,5,2013,412,217,195,0.949890386,0.989205873,0.905827895,,,
614,경남,고성군,2015,397,207,190,5,2014,377,198,179,1.078838662,1.068642102,1.090065074,,,
615,경남,고성군,2016,364,187,177,5,2015,423,228,195,0.881593464,0.83836644,0.932160101,,,
616,경남,고성군,2017,397,214,183,5,2016,389,205,184,1.045558292,1.067055571,1.021374761,,,
617,경남,고성군,2018,368,194,174,5,2017,412,214,198,0.915077649,0.926648617,0.902476523,,,
618,경남,고성군,2019,382,197,185,5,2018,329,151,178,1.189528386,1.333571803,1.067341956,,,
619,경남,고성군,2020,309,142,167,5,2019,325,153,172,0.974052721,0.94868938,0.99710267,,,
620,경남,김해시,2009,6162,3238,2924,5,2008,6322,3331,2991,0.998560879,0.99364062,1.003951679,,,
621,경남,김해시,2010,6399,3400,2999,5,2009,6225,3274,2951,1.053125429,1.061518011,1.043660175,,,
622,경남,김해시,2011,6059,3190,2869,5,2010,5713,3033,2680,1.086535883,1.075091425,1.099379436,,,
623,경남,김해시,2012,5594,2977,2617,5,2011,5909,3057,2852,0.969875117,0.995429532,0.942336594,,,
624,경남,김해시,2013,5830,3015,2815,5,2012,6486,3282,3204,0.920871338,0.939022211,0.902272554,,,
625,경남,김해시,2014,6507,3312,3195,5,2013,6191,3184,3007,1.076780911,1.063272042,1.091162142,,,
626,경남,김해시,2015,6072,3127,2945,5,2014,5834,2995,2839,1.066283486,1.067230381,1.065299595,,,
627,경남,김해시,2016,5671,2930,2741,5,2015,6045,3147,2898,0.96110467,0.951695471,0.971320399,,,
628,경남,김해시,2017,5886,3038,2848,5,2016,5974,2994,2980,1.009397872,1.037201411,0.981466716,,,
629,경남,김해시,2018,5838,2909,2929,5,2017,6095,3028,3067,0.981290797,0.982007887,0.980748044,,,
630,경남,김해시,2019,6171,3071,3100,5,2018,5460,2755,2705,1.157897854,1.139423936,1.176918202,,,
631,경남,김해시,2020,5602,2829,2773,5,2019,5604,2867,2737,1.02412348,1.008631158,1.040463686,,,
632,경남,남해군,2009,296,183,113,5,2008,270,130,140,1.123143614,1.438914082,0.828900235,,,
633,경남,남해군,2010,259,128,131,5,2009,278,149,129,0.954470068,0.878113849,1.042877843,,,
634,경남,남해군,2011,244,129,115,5,2010,233,121,112,1.072855546,1.089761512,1.054463795,,,
635,경남,남해군,2012,218,118,100,5,2011,244,129,115,0.915322235,0.935016818,0.893005256,,,
636,경남,남해군,2013,218,120,98,5,2012,265,130,135,0.842787266,0.943550217,0.745494017,,,
637,경남,남해군,2014,245,121,124,5,2013,242,132,110,1.037189386,0.936997785,1.15765954,,,
638,경남,남해군,2015,237,131,106,5,2014,217,125,92,1.118912067,1.071244014,1.183231964,,,
639,경남,남해군,2016,226,132,94,5,2015,238,126,112,0.972834194,1.070854612,0.861909537,,,
640,경남,남해군,2017,221,114,107,5,2016,215,125,90,1.053079501,0.932227615,1.22093663,,,
641,경남,남해군,2018,197,119,78,5,2017,205,102,103,0.984509045,1.192542636,0.777694868,,,
642,경남,남해군,2019,183,91,92,5,2018,154,74,80,1.217412381,1.2570044,1.18099945,,,
643,경남,남해군,2020,152,71,81,5,2019,195,115,80,0.798576125,0.631084674,1.039792994,,,
644,경남,마산시,2009,3452,1774,1678,5,2008,3493,1906,1587,1.012463899,0.951388384,1.085842622,,,
645,경남,마산시,2010,3481,1875,1606,5,2009,3448,1795,1653,1.034294253,1.067736144,0.997756447,,,
646,경남,밀양시,2009,762,426,336,5,2008,791,410,381,0.986928824,1.06206933,0.905662023,,,
647,경남,밀양시,2010,774,394,380,5,2009,738,393,345,1.074464186,1.024780368,1.13113999,,,
648,경남,밀양시,2011,728,391,337,5,2010,720,379,341,1.03587232,1.054543922,1.014909639,,,
649,경남,밀양시,2012,681,348,333,5,2011,686,350,336,1.017021986,1.016338377,1.017786793,,,
650,경남,밀양시,2013,667,344,323,5,2012,801,415,386,0.853101417,0.847300517,0.859344047,,,
651,경남,밀양시,2014,782,402,380,5,2013,723,354,369,1.108091953,1.160779999,1.05756991,,,
652,경남,밀양시,2015,739,364,375,5,2014,635,341,294,1.192279449,1.091124054,1.309892913,,,
653,경남,밀양시,2016,635,330,305,5,2015,699,364,335,0.93068753,0.926701106,0.934989831,,,
654,경남,밀양시,2017,692,359,333,5,2016,678,337,341,1.04564375,1.088909215,1.002863233,,,
655,경남,밀양시,2018,648,333,315,5,2017,709,377,332,0.936345475,0.902879949,0.974370945,,,
656,경남,밀양시,2019,673,359,314,5,2018,630,303,327,1.094414554,1.211097048,0.986129045,,,
657,경남,밀양시,2020,607,298,309,5,2019,619,309,310,1.004628252,0.985791139,1.023643282,,,
658,경남,사천시,2009,1041,526,515,5,2008,1154,610,544,0.92417085,0.881420271,0.972210225,,,
659,경남,사천시,2010,1083,564,519,5,2009,1082,571,511,1.025435955,1.009648306,1.043033634,,,
660,경남,사천시,2011,1052,555,497,5,2010,1025,511,514,1.05147565,1.11019485,0.992990572,,,
661,경남,사천시,2012,972,497,475,5,2011,1081,564,517,0.921187246,0.900750289,0.94352828,,,
662,경남,사천시,2013,1065,555,510,5,2012,1178,590,588,0.926214685,0.961541641,0.890727181,,,
663,경남,사천시,2014,1172,587,585,5,2013,1191,620,571,1.008145452,0.967773079,1.052135351,,,
664,경남,사천시,2015,1166,602,564,5,2014,1172,583,589,1.019244283,1.055492282,0.983367078,,,
665,경남,사천시,2016,1121,546,575,5,2015,1224,639,585,0.938278014,0.873411508,1.00940124,,,
666,경남,사천시,2017,1167,619,548,5,2016,1110,583,527,1.077098008,1.085298542,1.067878391,,,
667,경남,사천시,2018,1061,554,507,5,2017,1119,579,540,0.971387795,0.978043849,0.964197619,,,
668,경남,사천시,2019,1068,551,517,5,2018,972,522,450,1.125673217,1.078967147,1.179858388,,,
669,경남,사천시,2020,904,481,423,5,2019,949,477,472,0.97590954,1.030751137,0.920344082,,,
670,경남,산청군,2009,204,111,93,5,2008,213,107,106,0.981200835,1.060391716,0.901008604,,,
671,경남,산청군,2010,187,98,89,5,2009,189,104,85,1.013647953,0.963207514,1.075283387,,,
672,경남,산청군,2011,184,99,85,5,2010,199,91,108,0.94726631,1.112041328,0.808252442,,,
673,경남,산청군,2012,181,86,95,5,2011,204,100,104,0.908982983,0.879074286,0.938084848,,,
674,경남,산청군,2013,181,92,89,5,2012,241,122,119,0.769429579,0.770823812,0.768059562,,,
675,경남,산청군,2014,215,110,105,5,2013,189,115,74,1.165424117,0.97773682,1.457167359,,,
676,경남,산청군,2015,175,107,68,5,2014,175,95,80,1.024489107,1.1512968,0.872912637,,,
677,경남,산청군,2016,159,77,82,5,2015,206,114,92,0.790746447,0.690419421,0.915330387,,,
678,경남,산청군,2017,194,108,86,5,2016,169,103,66,1.176040751,1.071799762,1.338154845,,,
679,경남,산청군,2018,149,88,61,5,2017,182,92,90,0.838730093,0.97773682,0.696047985,,,
680,경남,산청군,2019,159,90,69,5,2018,170,90,80,0.958198636,1.022179402,0.885749588,,,
681,경남,산청군,2020,139,77,62,5,2019,130,68,62,1.095415276,1.157467853,1.026956044,,,
682,경남,양산시,2009,2864,1481,1383,5,2008,2884,1519,1365,1.017384467,0.996608094,1.040498321,,,
683,경남,양산시,2010,2902,1539,1363,5,2009,2840,1476,1364,1.046854715,1.065809011,1.026203144,,,
684,경남,양산시,2011,2830,1462,1368,5,2010,2733,1413,1320,1.060850411,1.057626529,1.0642999,,,
685,경남,양산시,2012,2683,1385,1298,5,2011,2790,1455,1335,0.985198665,0.973002386,0.998493592,,,
686,경남,양산시,2013,2741,1394,1347,5,2012,3189,1658,1531,0.880565896,0.859419835,0.903533502,,,
687,경남,양산시,2014,3194,1612,1582,5,2013,3109,1632,1477,1.05249862,1.009652694,1.099962398,,,
688,경남,양산시,2015,3213,1671,1542,5,2014,3026,1564,1462,1.087800232,1.092111113,1.083150629,,,
689,경남,양산시,2016,3092,1584,1508,5,2015,3404,1755,1649,0.930587638,0.922582435,0.939144763,,,
690,경남,양산시,2017,3559,1800,1759,5,2016,3674,1852,1822,0.992421539,0.993478901,0.991446587,,,
691,경남,양산시,2018,3935,1987,1948,5,2017,4013,2074,1939,1.004576286,0.979301096,1.03172273,,,
692,경남,양산시,2019,4026,2088,1938,5,2018,3828,1906,1922,1.077479923,1.1197852,1.035505106,,,
693,경남,양산시,2020,3713,1862,1851,5,2019,3942,2055,1887,0.964974139,0.926179098,1.007363878,,,
694,경남,의령군,2009,156,77,79,5,2008,186,105,81,0.859248929,0.749598228,1.001599104,,,
695,경남,의령군,2010,156,93,63,5,2009,180,92,88,0.88789056,1.033290048,0.735207168,,,
696,경남,의령군,2011,161,85,76,5,2010,150,74,76,1.099618309,1.174124989,1.026956044,,,
697,경남,의령군,2012,130,70,60,5,2011,138,72,66,0.965098435,0.99378553,0.933596403,,,
698,경남,의령군,2013,129,66,63,5,2012,180,87,93,0.734217194,0.775446443,0.695679901,,,
699,경남,의령군,2014,142,69,73,5,2013,169,94,75,0.860813333,0.750323178,0.999570549,,,
700,경남,의령군,2015,131,65,66,5,2014,182,91,91,0.737406995,0.730128144,0.744825263,,,
701,경남,의령군,2016,143,80,63,5,2015,153,77,76,0.957529035,1.062004574,0.85129251,,,
702,경남,의령군,2017,127,66,61,5,2016,147,74,73,0.885102834,0.911673521,0.858141352,,,
703,경남,의령군,2018,120,54,66,5,2017,160,93,67,0.768366831,0.593523524,1.011628342,,,
704,경남,의령군,2019,129,79,50,5,2018,134,78,56,0.986261902,1.035284266,0.916925039,,,
705,경남,의령군,2020,96,52,44,5,2019,126,74,52,0.780563129,0.718288229,0.868962806,,,
706,경남,진주시,2009,3336,1825,1511,5,2008,3256,1747,1509,1.04966083,1.067817635,1.028317152,,,
707,경남,진주시,2010,3296,1769,1527,5,2009,3112,1740,1372,1.085063013,1.039215726,1.14297513,,,
708,경남,진주시,2011,3165,1765,1400,5,2010,2782,1468,1314,1.165531281,1.228982728,1.094169301,,,
709,경남,진주시,2012,2845,1478,1367,5,2011,2969,1546,1423,0.981701418,0.977219377,0.986541751,,,
710,경남,진주시,2013,3054,1594,1460,5,2012,3319,1705,1614,0.942690489,0.955632825,0.928968912,,,
711,경남,진주시,2014,3364,1716,1648,5,2013,3096,1602,1494,1.113172273,1.09491876,1.132813628,,,
712,경남,진주시,2015,3261,1679,1582,5,2014,2881,1520,1361,1.159617834,1.129104748,1.193713785,,,
713,경남,진주시,2016,3086,1650,1436,5,2015,3267,1735,1532,0.967729839,0.972101449,0.962603707,,,
714,경남,진주시,2017,3352,1776,1576,5,2016,3373,1786,1587,1.018110729,1.016456113,1.019837886,,,
715,경남,진주시,2018,3368,1789,1579,5,2017,3373,1736,1637,1.022970446,1.053386492,0.990570307,,,
716,경남,진주시,2019,3444,1791,1653,5,2018,3052,1629,1423,1.156074864,1.123832602,1.192943317,,,
717,경남,진주시,2020,3121,1670,1451,5,2019,3269,1682,1587,0.978106609,1.014886802,0.938949729,,,
718,경남,진해시,2009,2047,1080,967,5,2008,2323,1269,1054,0.902767629,0.869939917,0.942188325,,,
719,경남,진해시,2010,2224,1190,1034,5,2009,2242,1215,1027,1.01626395,1.001146904,1.033955744,,,
720,경남,창녕군,2009,395,200,195,5,2008,377,188,189,1.073403707,1.087424896,1.059557823,,,
721,경남,창녕군,2010,345,168,177,5,2009,353,200,153,1.001271224,0.858630698,1.188047188,,,
722,경남,창녕군,2011,331,192,139,5,2010,317,171,146,1.069734683,1.147710206,0.977718425,,,
723,경남,창녕군,2012,322,171,151,5,2011,357,195,162,0.924048999,0.896372707,0.957224461,,,
724,경남,창녕군,2013,369,197,172,5,2012,422,225,197,0.895821044,0.894974854,0.896631673,,,
725,경남,창녕군,2014,399,220,179,5,2013,392,206,186,1.042783556,1.091647905,0.98830716,,,
726,경남,창녕군,2015,379,201,178,5,2014,372,196,176,1.043767128,1.048255407,1.038625999,,,
727,경남,창녕군,2016,355,192,163,5,2015,396,206,190,0.918418265,0.952710899,0.881020185,,,
728,경남,창녕군,2017,382,203,179,5,2016,413,214,199,0.947590409,0.96963747,0.923744381,,,
729,경남,창녕군,2018,391,200,191,5,2017,424,221,203,0.944752927,0.925049233,0.966249283,,,
730,경남,창녕군,2019,392,186,206,5,2018,396,214,182,1.014140733,0.888436303,1.162378819,,,
731,경남,창녕군,2020,354,193,161,5,2019,366,189,177,0.990899301,1.043812829,0.934123859,,,
732,경남,창원시,2009,4927,2621,2306,5,2008,5184,2774,2410,0.973699427,0.965801086,0.982639268,,,
733,경남,창원시,2010,4988,2665,2323,5,2009,4787,2537,2250,1.067506093,1.073751717,1.060275062,,,
734,경남,통영시,2009,1312,692,620,5,2008,1316,689,627,1.021375159,1.026630111,1.015490825,,,
735,경남,통영시,2010,1290,680,610,5,2009,1266,685,581,1.043910702,1.014718239,1.078215468,,,
736,경남,통영시,2011,1279,684,595,5,2010,1269,661,608,1.032562308,1.057746916,1.004998102,,,
737,경남,통영시,2012,1235,651,584,5,2011,1298,656,642,0.974764289,1.014388401,0.934178083,,,
738,경남,통영시,2013,1254,637,617,5,2012,1525,773,752,0.842432355,0.8423393,0.842595584,,,
739,경남,통영시,2014,1483,754,729,5,2013,1472,728,744,1.032144936,1.058685809,1.006251285,,,
740,경남,통영시,2015,1439,714,725,5,2014,1416,753,663,1.04112982,0.96923784,1.122991149,,,
741,경남,통영시,2016,1411,756,655,5,2015,1571,810,761,0.920149033,0.954034109,0.883910918,,,
742,경남,통영시,2017,1522,789,733,5,2016,1522,771,751,1.024489107,1.046043513,1.002341918,,,
743,경남,통영시,2018,1455,732,723,5,2017,1463,757,706,1.01888698,0.988421826,1.051684447,,,
744,경남,통영시,2019,1427,742,685,5,2018,1180,609,571,1.238937251,1.245413984,1.231987548,,,
745,경남,통영시,2020,1103,569,534,5,2019,1219,623,596,0.926998758,0.933579582,0.920125046,,,
746,경남,하동군,2009,289,150,139,5,2008,344,196,148,0.860689977,0.782280155,0.964506014,,,
747,경남,하동군,2010,304,169,135,5,2009,332,178,154,0.938086412,0.970496174,0.900253675,,,
748,경남,하동군,2011,281,151,130,5,2010,305,158,147,0.943873571,0.976892973,0.90819242,,,
749,경남,하동군,2012,294,158,136,5,2011,303,154,149,0.994058738,1.048729517,0.937355852,,,
750,경남,하동군,2013,261,130,131,5,2012,326,174,152,0.820219807,0.763697255,0.885073959,,,
751,경남,하동군,2014,296,163,133,5,2013,301,151,150,1.007471016,1.103412202,0.910567692,,,
752,경남,하동군,2015,268,138,130,5,2014,249,111,138,1.102662975,1.270817635,0.96742236,,,
753,경남,하동군,2016,217,91,126,5,2015,305,167,138,0.728898808,0.556995962,0.937655518,,,
754,경남,하동군,2017,266,150,116,5,2016,252,136,116,1.081405169,1.127403752,1.026956044,,,
755,경남,하동군,2018,226,131,95,5,2017,259,138,121,0.893955746,0.970329722,0.806287803,,,
756,경남,하동군,2019,214,113,101,5,2018,197,108,89,1.112896797,1.069502523,1.165422027,,,
757,경남,하동군,2020,171,96,75,5,2019,227,128,99,0.771751706,0.766634552,0.777997003,,,
758,경남,함안군,2009,565,309,256,5,2008,657,355,302,0.881029445,0.889727987,0.870532276,,,
759,경남,함안군,2010,599,325,274,5,2009,567,308,259,1.082308598,1.078598395,1.086432263,,,
760,경남,함안군,2011,543,295,248,5,2010,587,320,267,0.947696057,0.942321636,0.953876775,,,
761,경남,함안군,2012,554,306,248,5,2011,604,326,278,0.939680406,0.959469009,0.916133449,,,
762,경남,함안군,2013,547,293,254,5,2012,637,314,323,0.879741824,0.953817086,0.807575341,,,
763,경남,함안군,2014,630,325,305,5,2013,668,351,317,0.966209787,0.94646241,0.988080736,,,
764,경남,함안군,2015,686,360,326,5,2014,652,324,328,1.077913386,1.135754891,1.020694117,,,
765,경남,함안군,2016,646,329,317,5,2015,657,352,305,1.007336322,0.955389271,1.067360872,,,
766,경남,함안군,2017,628,337,291,5,2016,605,286,319,1.063436627,1.204456149,0.936815701,,,
767,경남,함안군,2018,598,290,308,5,2017,609,309,300,1.005984378,0.959326947,1.054341538,,,
768,경남,함안군,2019,592,304,288,5,2018,542,267,275,1.118999173,1.163829731,1.075503057,,,
769,경남,함안군,2020,502,245,257,5,2019,478,233,245,1.075927891,1.074823835,1.077255932,,,
770,경남,함양군,2009,274,143,131,5,2008,262,131,131,1.071412273,1.115814157,1.026956044,,,
771,경남,함양군,2010,267,127,140,5,2009,266,139,127,1.02834057,0.933933698,1.132077529,,,
772,경남,함양군,2011,270,148,122,5,2010,278,141,137,0.995007406,1.072925897,0.914515601,,,
773,경남,함양군,2012,266,136,130,5,2011,297,151,146,0.917555901,0.920638402,0.914412916,,,
774,경남,함양군,2013,283,149,134,5,2012,296,156,140,0.979494653,0.976312378,0.982943642,,,
775,경남,함양군,2014,283,155,128,5,2013,309,155,154,0.93828614,1.022179402,0.853573855,,,
776,경남,함양군,2015,283,143,140,5,2014,265,131,134,1.094077047,1.115814157,1.07293915,,,
777,경남,함양군,2016,241,115,126,5,2015,279,150,129,0.884952957,0.783670875,1.003073345,,,
778,경남,함양군,2017,253,142,111,5,2016,213,104,109,1.216881428,1.39566803,1.045799274,,,
779,경남,함양군,2018,191,93,98,5,2017,239,137,102,0.818733973,0.693888207,0.986683258,,,
780,경남,함양군,2019,222,132,90,5,2018,221,112,109,1.029124805,1.204711438,0.847945357,,,
781,경남,함양군,2020,216,105,111,5,2019,214,113,101,1.034063772,0.949812719,1.12863486,,,
782,경남,합천군,2009,270,149,121,5,2008,342,187,155,0.80880719,0.814463802,0.801688266,,,
783,경남,합천군,2010,258,142,116,5,2009,290,137,153,0.911442033,1.05948522,0.778607197,,,
784,경남,합천군,2011,244,112,132,5,2010,252,124,128,0.991965644,0.923258815,1.05904842,,,
785,경남,합천군,2012,214,105,109,5,2011,243,127,116,0.902224975,0.845108955,0.964984558,,,
786,경남,합천군,2013,205,107,98,5,2012,320,165,155,0.656313334,0.662867855,0.649301241,,,
787,경남,합천군,2014,273,146,127,5,2013,282,154,128,0.991792647,0.969079174,1.01893295,,,
788,경남,합천군,2015,226,120,106,5,2014,264,126,138,0.877024766,0.973504193,0.788821309,,,
789,경남,합천군,2016,210,101,109,5,2015,225,112,113,0.956189834,0.921786782,0.990603617,,,
790,경남,합천군,2017,165,85,80,5,2016,255,129,126,0.662904717,0.673529064,0.652035583,,,
791,경남,합천군,2018,212,109,103,5,2017,230,118,112,0.944311699,0.944216566,0.94443279,,,
792,경남,합천군,2019,177,97,80,5,2018,217,108,109,0.835643189,0.918068537,0.753729206,,,
793,경남,합천군,2020,183,95,88,5,2019,184,91,93,1.018921232,1.067110365,0.971743353,,,
794,경북,경산시,2009,2407,1323,1084,5,2008,2615,1399,1216,0.943000108,0.966649999,0.915477263,,,
795,경북,경산시,2010,2359,1274,1085,5,2009,2513,1292,1221,0.961707045,1.007938513,0.912569457,,,
796,경북,경산시,2011,2320,1193,1127,5,2010,2218,1135,1083,1.071602673,1.074414121,1.068679096,,,
797,경북,경산시,2012,2048,1052,996,5,2011,2200,1171,1029,0.953706224,0.91830293,0.994021593,,,
798,경북,경산시,2013,2128,1139,989,5,2012,2549,1326,1223,0.855281609,0.878025897,0.830465681,,,
799,경북,경산시,2014,2386,1227,1159,5,2013,2302,1185,1117,1.061872724,1.058408546,1.065570327,,,
800,경북,경산시,2015,2156,1132,1024,5,2014,2280,1171,1109,0.968771279,0.988135853,0.948244354,,,
801,경북,경산시,2016,2155,1109,1046,5,2015,2321,1165,1156,0.951216728,0.973044598,0.929235313,,,
802,경북,경산시,2017,2164,1102,1062,5,2016,2454,1281,1173,0.903420712,0.87934559,0.92977606,,,
803,경북,경산시,2018,2342,1220,1122,5,2017,2504,1269,1235,0.958208263,0.982709906,0.932991645,,,
804,경북,경산시,2019,2437,1241,1196,5,2018,2301,1178,1123,1.085041267,1.076846043,1.093712759,,,
805,경북,경산시,2020,2228,1130,1098,5,2019,2359,1178,1181,0.967597173,0.980528629,0.954782164,,,
806,경북,경주시,2009,2379,1249,1130,5,2008,2451,1280,1171,0.994393956,0.997423495,0.990999427,,,
807,경북,경주시,2010,2304,1208,1096,5,2009,2226,1208,1018,1.060387648,1.022179402,1.105642263,,,
808,경북,경주시,2011,2130,1134,996,5,2010,2028,1060,968,1.076016666,1.093539096,1.056661384,,,
809,경북,경주시,2012,1947,1026,921,5,2011,2105,1094,1011,0.947591588,0.958643571,0.935535624,,,
810,경북,경주시,2013,2046,1061,985,5,2012,2280,1176,1104,0.919344173,0.922221382,0.916260601,,,
811,경북,경주시,2014,2153,1109,1044,5,2013,2068,1056,1012,1.066598186,1.073481967,1.059428962,,,
812,경북,경주시,2015,1973,1007,966,5,2014,1916,996,920,1.054967124,1.033468532,1.078303846,,,
813,경북,경주시,2016,1909,990,919,5,2015,1975,1002,973,0.990253016,1.009937733,0.969961567,,,
814,경북,경주시,2017,1946,992,954,5,2016,1963,999,964,1.015616813,1.015016984,1.016302973,,,
815,경북,경주시,2018,1939,993,946,5,2017,2019,1018,1001,0.983895185,0.997076765,0.970529888,,,
816,경북,경주시,2019,1984,1010,974,5,2018,1816,959,857,1.119265633,1.076539308,1.167158911,,,
817,경북,경주시,2020,1768,941,827,5,2019,1789,937,852,1.012463243,1.026543028,0.996822357,,,
818,경북,고령군,2009,233,112,121,5,2008,247,125,122,0.966420899,0.915872744,1.018538371,,,
819,경북,고령군,2010,209,106,103,5,2009,227,131,96,0.943252086,0.827106997,1.101838255,,,
820,경북,고령군,2011,205,117,88,5,2010,209,124,85,1.00488166,0.964475726,1.063201551,,,
821,경북,고령군,2012,193,115,78,5,2011,247,123,124,0.800511732,0.955696189,0.645988479,,,
822,경북,고령군,2013,230,112,118,5,2012,273,152,121,0.863122691,0.753184823,1.001494324,,,
823,경북,고령군,2014,247,128,119,5,2013,239,138,101,1.05878163,0.948108431,1.209977913,,,
824,경북,고령군,2015,230,131,99,5,2014,228,119,109,1.033475854,1.125256317,0.932739893,,,
825,경북,고령군,2016,213,114,99,5,2015,227,117,110,0.961304757,0.995969674,0.924260439,,,
826,경북,고령군,2017,191,99,92,5,2016,186,86,100,1.052029137,1.176694893,0.94479956,,,
827,경북,고령군,2018,160,76,84,5,2017,218,111,107,0.751918611,0.699870582,0.806208483,,,
828,경북,고령군,2019,188,100,88,5,2018,183,92,91,1.052480613,1.111064568,0.99310035,,,
829,경북,고령군,2020,153,76,77,5,2019,184,98,86,0.851884964,0.792710557,0.9194839,,,
830,경북,구미시,2009,4854,2498,2356,5,2008,5141,2750,2391,0.967296271,0.928510599,1.011923228,,,
831,경북,구미시,2010,4998,2687,2311,5,2009,4636,2456,2180,1.104485884,1.118320869,1.088667623,,,
832,경북,구미시,2011,4722,2489,2233,5,2010,4421,2290,2131,1.094240571,1.111006346,1.076111143,,,
833,경북,구미시,2012,4463,2284,2179,5,2011,4515,2344,2171,1.012689897,0.9960144,1.030740313,,,
834,경북,구미시,2013,4506,2346,2160,5,2012,5068,2623,2445,0.910881594,0.914232893,0.907249511,,,
835,경북,구미시,2014,4962,2582,2380,5,2013,4765,2430,2335,1.066844691,1.086118196,1.046747488,,,
836,경북,구미시,2015,4723,2422,2301,5,2014,4439,2312,2127,1.090034254,1.070812505,1.110966552,,,
837,경북,구미시,2016,4405,2311,2094,5,2015,4662,2433,2229,0.968012552,0.970923386,0.964758168,,,
838,경북,구미시,2017,4667,2411,2256,5,2016,4959,2600,2359,0.96416428,0.947874823,0.982116505,,,
839,경북,구미시,2018,4998,2616,2382,5,2017,5235,2693,2542,0.978108225,0.992952587,0.962316796,,,
840,경북,구미시,2019,5161,2660,2501,5,2018,4590,2382,2208,1.151936445,1.141476579,1.163232367,,,
841,경북,구미시,2020,4552,2362,2190,5,2019,4802,2491,2311,0.971152523,0.969244379,0.973186385,,,
842,경북,군위군,2009,111,61,50,5,2008,86,49,37,1.322305708,1.272509052,1.387778438,,,
843,경북,군위군,2010,77,43,34,5,2009,91,43,48,0.866875399,1.022179402,0.727427198,,,
844,경북,군위군,2011,68,36,32,5,2010,90,48,42,0.774058437,0.766634552,0.7824427,,,
845,경북,군위군,2012,77,42,35,5,2011,85,41,44,0.928066603,1.047110607,0.816896853,,,
846,경북,군위군,2013,77,37,40,5,2012,97,51,46,0.81325424,0.741581135,0.893005256,,,
847,경북,군위군,2014,80,43,37,5,2013,104,54,50,0.788068544,0.813957672,0.759947472,,,
848,경북,군위군,2015,93,52,41,5,2014,72,44,28,1.32329843,1.208030203,1.503757064,,,
849,경북,군위군,2016,70,39,31,5,2015,85,42,43,0.843696912,0.949166588,0.74036366,,,
850,경북,군위군,2017,78,38,40,5,2016,99,52,47,0.807173236,0.746977255,0.874005144,,,
851,경북,군위군,2018,79,43,36,5,2017,115,58,57,0.703779474,0.75782266,0.648603817,,,
852,경북,군위군,2019,87,50,37,5,2018,70,40,30,1.273293605,1.277724253,1.266579121,,,
853,경북,군위군,2020,66,44,22,5,2019,77,42,35,0.878133521,1.070854612,0.645515228,,,
854,경북,김천시,2009,1097,604,493,5,2008,1101,587,514,1.020767076,1.051782554,0.984998696,,,
855,경북,김천시,2010,1026,547,479,5,2009,1087,561,526,0.966997078,0.996670469,0.935193812,,,
856,경북,김천시,2011,1002,513,489,5,2010,948,467,481,1.082846082,1.122865168,1.044036394,,,
857,경북,김천시,2012,913,452,461,5,2011,939,527,412,0.996121997,0.87670795,1.14909402,,,
858,경북,김천시,2013,884,503,381,5,2012,1096,570,526,0.826321506,0.90202849,0.743859796,,,
859,경북,김천시,2014,1028,538,490,5,2013,1093,587,506,0.963563406,0.936852672,0.994483125,,,
860,경북,김천시,2015,1077,577,500,5,2014,1019,523,496,1.082801539,1.127719914,1.035237947,,,
861,경북,김천시,2016,1021,528,493,5,2015,1156,573,583,0.904847213,0.941903533,0.868420806,,,
862,경북,김천시,2017,1130,568,562,5,2016,1189,628,561,0.97365239,0.92451895,1.028786625,,,
863,경북,김천시,2018,1131,605,526,5,2017,1296,654,642,0.894056466,0.945594095,0.841400123,,,
864,경북,김천시,2019,1228,630,598,5,2018,1150,610,540,1.093976195,1.055693481,1.13725873,,,
865,경북,김천시,2020,1118,602,516,5,2019,1152,583,569,0.99425245,1.055492282,0.93129933,,,
866,경북,문경시,2009,574,301,273,5,2008,509,277,232,1.155317775,1.110743683,1.208443965,,,
867,경북,문경시,2010,518,283,235,5,2009,481,267,214,1.103295962,1.083433599,1.127732104,,,
868,경북,문경시,2011,485,259,226,5,2010,498,265,233,0.997745416,0.999035718,0.996103287,,,
869,경북,문경시,2012,485,256,229,5,2011,466,255,211,1.066260123,1.026187949,1.114563668,,,
870,경북,문경시,2013,464,257,207,5,2012,518,289,229,0.917689085,0.908996908,0.928296511,,,
871,경북,문경시,2014,507,279,228,5,2013,486,251,235,1.068757155,1.136207383,0.996365864,,,
872,경북,문경시,2015,484,256,228,5,2014,466,250,216,1.064061648,1.046711708,1.084009157,,,
873,경북,문경시,2016,456,249,207,5,2015,497,254,243,0.939973909,1.00205776,0.874814408,,,
874,경북,문경시,2017,464,238,226,5,2016,563,308,255,0.844339158,0.789865902,0.910164964,,,
875,경북,문경시,2018,513,278,235,5,2017,508,270,238,1.034572662,1.052466199,1.01401122,,,
876,경북,문경시,2019,486,256,230,5,2018,446,239,207,1.116371539,1.094886724,1.141062271,,,
877,경북,문경시,2020,415,223,192,5,2019,421,215,206,1.009888313,1.060213985,0.957162915,,,
878,경북,봉화군,2009,177,103,74,5,2008,187,95,92,0.969703594,1.108257668,0.826029861,,,
879,경북,봉화군,2010,192,99,93,5,2009,196,103,93,1.003581166,0.982483115,1.026956044,,,
880,경북,봉화군,2011,186,98,88,5,2010,169,90,79,1.127544225,1.113039794,1.143951036,,,
881,경북,봉화군,2012,140,69,71,5,2011,195,98,97,0.735530641,0.719697742,0.751689475,,,
882,경북,봉화군,2013,171,88,83,5,2012,206,89,117,0.850425424,1.01069424,0.728524373,,,
883,경북,봉화군,2014,186,80,106,5,2013,211,119,92,0.903104142,0.68717943,1.183231964,,,
884,경북,봉화군,2015,175,102,73,5,2014,183,105,78,0.979702698,0.992974276,0.961125528,,,
885,경북,봉화군,2016,157,91,66,5,2015,226,113,113,0.71170261,0.823171023,0.599815034,,,
886,경북,봉화군,2017,177,89,88,5,2016,192,92,100,0.944450896,0.988847465,0.903721319,,,
887,경북,봉화군,2018,160,82,78,5,2017,196,100,96,0.836317639,0.83818711,0.834401786,,,
888,경북,봉화군,2019,141,78,63,5,2018,166,86,80,0.870198579,0.927092946,0.808727885,,,
889,경북,봉화군,2020,132,69,63,5,2019,161,88,73,0.839953802,0.801481577,0.886277134,,,
890,경북,상주시,2009,721,415,306,5,2008,722,370,352,1.023070147,1.146498519,0.892751561,,,
891,경북,상주시,2010,696,359,337,5,2009,658,349,309,1.083654132,1.05146821,1.120013549,,,
892,경북,상주시,2011,634,336,298,5,2010,661,327,334,0.982641595,1.05031278,0.916266171,,,
893,경북,상주시,2012,650,329,321,5,2011,639,348,291,1.04212507,0.966370757,1.132827801,,,
894,경북,상주시,2013,619,331,288,5,2012,710,384,326,0.893181349,0.881097349,0.907249511,,,
895,경북,상주시,2014,703,379,324,5,2013,697,365,332,1.033308239,1.061386283,1.002210115,,,
896,경북,상주시,2015,712,372,340,5,2014,682,357,325,1.069554611,1.065128117,1.074354015,,,
897,경북,상주시,2016,658,339,319,5,2015,667,359,308,1.010665416,0.965233475,1.063633045,,,
898,경북,상주시,2017,637,348,289,5,2016,631,320,311,1.034230684,1.1116201,0.954309636,,,
899,경북,상주시,2018,609,305,304,5,2017,639,348,291,0.976391027,0.895875626,1.072833805,,,
900,경북,상주시,2019,606,320,286,5,2018,589,298,291,1.054058403,1.097642311,1.009310751,,,
901,경북,상주시,2020,564,288,276,5,2019,533,283,250,1.084074778,1.040239109,1.133759472,,,
902,경북,성주군,2009,240,128,112,5,2008,261,144,117,0.942058949,0.908603913,0.983069033,,,
903,경북,성주군,2010,227,131,96,5,2009,229,146,83,1.015541604,0.917160971,1.187804581,,,
904,경북,성주군,2011,214,141,73,5,2010,217,114,103,1.010325664,1.264274524,0.727842633,,,
905,경북,성주군,2012,196,100,96,5,2011,229,126,103,0.876855306,0.811253494,0.957162915,,,
906,경북,성주군,2013,207,118,89,5,2012,237,112,125,0.894806942,1.076939013,0.731192703,,,
907,경북,성주군,2014,203,107,96,5,2013,232,127,105,0.896427969,0.861206268,0.93893124,,,
908,경북,성주군,2015,207,114,93,5,2014,230,127,103,0.922040197,0.917546865,0.927251574,,,
909,경북,성주군,2016,218,126,92,5,2015,227,106,121,0.983870597,1.21504344,0.780826083,,,
910,경북,성주군,2017,178,84,94,5,2016,238,113,125,0.766214543,0.759850175,0.772270945,,,
911,경북,성주군,2018,192,92,100,5,2017,239,116,123,0.823020538,0.810694009,0.834923613,,,
912,경북,성주군,2019,193,94,99,5,2018,201,104,97,0.983713422,0.923892921,1.048130395,,,
913,경북,성주군,2020,162,80,82,5,2019,182,86,96,0.911907887,0.95086456,0.877191621,,,
914,경북,안동시,2009,1404,761,643,5,2008,1390,701,689,1.034807703,1.109669793,0.958392941,,,
915,경북,안동시,2010,1370,700,670,5,2009,1372,718,654,1.022995683,0.996553735,1.052080351,,,
916,경북,안동시,2011,1374,718,656,5,2010,1275,674,601,1.104037673,1.088909215,1.120937046,,,
917,경북,안동시,2012,1267,669,598,5,2011,1269,650,619,1.022874467,1.052058492,0.992115855,,,
918,경북,안동시,2013,1244,635,609,5,2012,1441,748,693,0.884430569,0.867759252,0.902476523,,,
919,경북,안동시,2014,1391,726,665,5,2013,1351,676,675,1.054821871,1.097784388,1.01174188,,,
920,경북,안동시,2015,1318,674,644,5,2014,1305,675,630,1.034694746,1.020665062,1.049777289,,,
921,경북,안동시,2016,1302,665,637,5,2015,1413,748,665,0.944009071,0.908755752,0.983715789,,,
922,경북,안동시,2017,1407,743,664,5,2016,1389,740,649,1.037765424,1.026323373,1.050691546,,,
923,경북,안동시,2018,1473,776,697,5,2017,1412,743,669,1.068748198,1.067579026,1.069937762,,,
924,경북,안동시,2019,1424,759,665,5,2018,1250,660,590,1.167097991,1.175506313,1.157501304,,,
925,경북,안동시,2020,1315,686,629,5,2019,1079,557,522,1.248566428,1.25891395,1.237462359,,,
926,경북,영덕군,2009,259,139,120,5,2008,267,139,128,0.993792805,1.022179402,0.962771291,,,
927,경북,영덕군,2010,245,125,120,5,2009,233,122,111,1.077252495,1.047314961,1.11022275,,,
928,경북,영덕군,2011,212,109,103,5,2010,225,118,107,0.965296403,0.944216566,0.988565164,,,
929,경북,영덕군,2012,200,99,101,5,2011,229,114,115,0.894750312,0.887682112,0.901935308,,,
930,경북,영덕군,2013,205,99,106,5,2012,237,135,102,0.886161464,0.749598228,1.06722883,,,
931,경북,영덕군,2014,216,118,98,5,2013,178,92,86,1.243200265,1.31105619,1.170252236,,,
932,경북,영덕군,2015,168,86,82,5,2014,207,109,98,0.83146942,0.806490171,0.859289751,,,
933,경북,영덕군,2016,191,98,93,5,2015,190,90,100,1.029881155,1.113039794,0.955069121,,,
934,경북,영덕군,2017,203,106,97,5,2016,210,107,103,0.99033947,1.012626324,0.967133362,,,
935,경북,영덕군,2018,186,94,92,5,2017,194,98,96,0.982242134,0.980457794,0.984166209,,,
936,경북,영덕군,2019,174,87,87,5,2018,207,111,96,0.861164757,0.80116764,0.930678915,,,
937,경북,영덕군,2020,169,88,81,5,2019,207,107,100,0.836418643,0.84067091,0.831834396,,,
938,경북,영양군,2009,109,51,58,5,2008,110,56,54,1.01517557,0.930913384,1.103026862,,,
939,경북,영양군,2010,104,52,52,5,2009,83,39,44,1.283697195,1.36290587,1.213675325,,,
940,경북,영양군,2011,75,34,41,5,2010,105,53,52,0.731777934,0.65573773,0.809715342,,,
941,경북,영양군,2012,95,51,44,5,2011,87,49,38,1.118695002,1.063901011,1.189106998,,,
942,경북,영양군,2013,87,45,42,5,2012,116,54,62,0.768366831,0.851816169,0.695679901,,,
943,경북,영양군,2014,107,56,51,5,2013,107,56,51,1.024489107,1.022179402,1.026956044,,,
944,경북,영양군,2015,105,54,51,5,2014,84,48,36,1.280611384,1.149951828,1.454854395,,,
945,경북,영양군,2016,81,45,36,5,2015,95,49,46,0.873511765,0.938736186,0.80370473,,,
946,경북,영양군,2017,93,46,47,5,2016,85,53,32,1.120911612,0.887174576,1.508341689,,,
947,경북,영양군,2018,71,45,26,5,2017,83,45,38,0.8763702,1.022179402,0.702654135,,,
948,경북,영양군,2019,70,42,28,5,2018,89,53,36,0.80577795,0.81002896,0.79874359,,,
949,경북,영양군,2020,77,46,31,5,2019,81,31,50,0.973897053,1.516782339,0.636712747,,,
950,경북,영주시,2009,973,516,457,5,2008,952,472,480,1.047088132,1.117467313,0.977747733,,,
951,경북,영주시,2010,937,471,466,5,2009,869,450,419,1.104656264,1.069881108,1.142151591,,,
952,경북,영주시,2011,874,463,411,5,2010,852,461,391,1.050943051,1.02661402,1.079485765,,,
953,경북,영주시,2012,836,461,375,5,2011,840,448,392,1.019610588,1.051840858,0.982419685,,,
954,경북,영주시,2013,826,440,386,5,2012,854,417,437,0.990899301,1.078558602,0.907105338,,,
955,경북,영주시,2014,840,419,421,5,2013,806,402,404,1.067705769,1.065405894,1.070169541,,,
956,경북,영주시,2015,816,402,414,5,2014,776,389,387,1.077297824,1.056339639,1.09860414,,,
957,경북,영주시,2016,787,396,391,5,2015,781,404,377,1.032359702,1.001938226,1.065092343,,,
958,경북,영주시,2017,830,427,403,5,2016,813,406,407,1.045911389,1.075050751,1.01686311,,,
959,경북,영주시,2018,809,403,406,5,2017,847,440,407,0.978526196,0.936223407,1.02443281,,,
960,경북,영주시,2019,845,445,400,5,2018,692,355,337,1.251001872,1.281323476,1.218938924,,,
961,경북,영주시,2020,666,333,333,5,2019,674,375,299,1.012328999,0.907695309,1.143733654,,,
962,경북,영천시,2009,651,357,294,5,2008,771,420,351,0.86503555,0.868852492,0.860185404,,,
963,경북,영천시,2010,728,393,335,5,2009,714,392,322,1.044577129,1.024787003,1.068417002,,,
964,경북,영천시,2011,648,352,296,5,2010,613,297,316,1.082983592,1.211471884,0.961958826,,,
965,경북,영천시,2012,579,279,300,5,2011,641,329,312,0.925396557,0.866832989,0.987457734,,,
966,경북,영천시,2013,568,292,276,5,2012,684,364,320,0.850745341,0.81999007,0.885749588,,,
967,경북,영천시,2014,644,348,296,5,2013,611,327,284,1.07982158,1.087823951,1.070348553,,,
968,경북,영천시,2015,578,313,265,5,2014,599,334,265,0.988572127,0.957910637,1.026956044,,,
969,경북,영천시,2016,577,325,252,5,2015,636,326,310,0.929450024,1.019043883,0.834815881,,,
970,경북,영천시,2017,615,324,291,5,2016,629,317,312,1.001686488,1.044751187,0.957834002,,,
971,경북,영천시,2018,552,274,278,5,2017,681,344,337,0.830422889,0.81417778,0.847162552,,,
972,경북,영천시,2019,610,291,319,5,2018,598,302,296,1.045047417,0.984947702,1.106753304,,,
973,경북,영천시,2020,542,271,271,5,2019,575,300,275,0.965692341,0.923368727,1.012018501,,,
974,경북,예천군,2009,255,151,104,5,2008,266,147,119,0.982123016,1.049993808,0.897507803,,,
975,경북,예천군,2010,233,124,109,5,2009,253,133,120,0.943501826,0.953009368,0.932818406,,,
976,경북,예천군,2011,232,129,103,5,2010,224,115,109,1.061078004,1.146618634,0.970426353,,,
977,경북,예천군,2012,211,104,107,5,2011,259,141,118,0.8346224,0.753947928,0.931222853,,,
978,경북,예천군,2013,253,139,114,5,2012,285,150,135,0.909458751,0.947219579,0.867207326,,,
979,경북,예천군,2014,248,141,107,5,2013,268,153,115,0.948034696,0.942008469,0.955515623,,,
980,경북,예천군,2015,243,144,99,5,2014,267,146,121,0.932400199,1.008176945,0.840236763,,,
981,경북,예천군,2016,243,138,105,5,2015,259,135,124,0.961200205,1.0448945,0.869599876,,,
982,경북,예천군,2017,208,108,100,5,2016,327,156,171,0.651662796,0.707662663,0.60055909,,,
983,경북,예천군,2018,219,108,111,5,2017,400,215,185,0.560907786,0.513466863,0.616173626,,,
984,경북,예천군,2019,367,210,157,5,2018,481,249,232,0.781678799,0.862079014,0.694965943,,,
985,경북,예천군,2020,394,204,190,5,2019,457,234,223,0.883257567,0.891130761,0.87498497,,,
986,경북,울릉군,2009,47,22,25,5,2008,72,37,35,0.668763723,0.607782347,0.733540031,,,
987,경북,울릉군,2010,58,31,27,5,2009,51,31,20,1.165105259,1.022179402,1.386390659,,,
988,경북,울릉군,2011,48,29,19,5,2010,66,37,29,0.745082987,0.80116764,0.67283327,,,
989,경북,울릉군,2012,57,27,30,5,2011,60,32,28,0.973264652,0.862463871,1.100310047,,,
990,경북,울릉군,2013,51,25,26,5,2012,71,25,46,0.735900626,1.022179402,0.580453416,,,
991,경북,울릉군,2014,54,19,35,5,2013,51,28,23,1.084753173,0.693621737,1.562759197,,,
992,경북,울릉군,2015,57,32,25,5,2014,52,25,27,1.122997675,1.308389635,0.950885226,,,
993,경북,울릉군,2016,41,21,20,5,2015,45,23,22,0.933423409,0.933294237,0.933596403,,,
994,경북,울릉군,2017,40,22,18,5,2016,54,34,20,0.75888082,0.661410201,0.924260439,,,
995,경북,울릉군,2018,50,29,21,5,2017,52,25,27,0.98508568,1.185728107,0.79874359,,,
996,경북,울릉군,2019,50,20,30,5,2018,53,22,31,0.966499158,0.929254002,0.99382843,,,
997,경북,울릉군,2020,50,22,28,5,2019,50,27,23,1.024489107,0.83288692,1.250207358,,,
998,경북,울진군,2009,457,232,225,5,2008,415,194,221,1.128172342,1.22240011,1.045543484,,,
999,경북,울진군,2010,396,186,210,5,2009,420,205,215,0.965946873,0.927440824,1.003073345,,,
1000,경북,울진군,2011,413,205,208,5,2010,393,195,198,1.076625958,1.074598859,1.078822511,,,
1001,경북,울진군,2012,397,191,206,5,2011,372,201,171,1.093339182,0.971324706,1.237151725,,,
1002,경북,울진군,2013,362,196,166,5,2012,419,237,182,0.885119467,0.845346679,0.936674194,,,
1003,경북,울진군,2014,400,220,180,5,2013,409,210,199,1.001945337,1.070854612,0.928904964,,,
1004,경북,울진군,2015,368,189,179,5,2014,388,207,181,0.971680391,0.933294237,1.015608463,,,
1005,경북,울진군,2016,332,169,163,5,2015,367,196,171,0.926785787,0.881368974,0.978911317,,,
1006,경북,울진군,2017,335,181,154,5,2016,367,174,193,0.935160357,1.063301562,0.819436429,,,
1007,경북,울진군,2018,343,166,177,5,2017,375,209,166,0.937066037,0.811874549,1.095007348,,,
1008,경북,울진군,2019,330,185,145,5,2018,341,169,172,0.991441072,1.118953784,0.865747828,,,
1009,경북,울진군,2020,299,148,151,5,2019,334,157,177,0.917132464,0.963583131,0.876103744,,,
1010,경북,의성군,2009,257,135,122,5,2008,249,132,117,1.05740442,1.045410752,1.070843054,,,
1011,경북,의성군,2010,231,123,108,5,2009,248,136,112,0.954262031,0.924471077,0.990279042,,,
1012,경북,의성군,2011,223,123,100,5,2010,238,125,113,0.959920466,1.005824532,0.908810658,,,
1013,경북,의성군,2012,214,115,99,5,2011,227,110,117,0.965817925,1.068642102,0.868962806,,,
1014,경북,의성군,2013,217,110,107,5,2012,243,112,131,0.914872989,1.003926199,0.838811425,,,
1015,경북,의성군,2014,225,105,120,5,2013,245,146,99,0.940857344,0.735129022,1.244795205,,,
1016,경북,의성군,2015,220,135,85,5,2014,211,101,110,1.068187695,1.366279399,0.793556943,,,
1017,경북,의성군,2016,193,95,98,5,2015,212,119,93,0.932671687,0.816025573,1.082168734,,,
1018,경북,의성군,2017,192,104,88,5,2016,214,105,109,0.919167797,1.01244436,0.829102127,,,
1019,경북,의성군,2018,183,88,95,5,2017,200,103,97,0.937407533,0.873318324,1.005781692,,,
1020,경북,의성군,2019,177,90,87,5,2018,193,102,91,0.939557368,0.901923002,0.981815119,,,
1021,경북,의성군,2020,162,83,79,5,2019,190,98,92,0.873511765,0.865723371,0.88184269,,,
1022,경북,청도군,2009,229,121,108,5,2008,205,98,107,1.144429296,1.26207865,1.036553764,,,
1023,경북,청도군,2010,181,90,91,5,2009,225,127,98,0.824144571,0.724379104,0.953602041,,,
1024,경북,청도군,2011,198,110,88,5,2010,180,93,87,1.126938018,1.209029401,1.038760136,,,
1025,경북,청도군,2012,163,80,83,5,2011,202,107,95,0.826691705,0.764246282,0.89723528,,,
1026,경북,청도군,2013,184,98,86,5,2012,232,101,131,0.812525844,0.991817638,0.674184884,,,
1027,경북,청도군,2014,216,102,114,5,2013,181,94,87,1.222594736,1.109173394,1.34566654,,,
1028,경북,청도군,2015,176,92,84,5,2014,186,91,95,0.969409048,1.033412143,0.908045344,,,
1029,경북,청도군,2016,175,82,93,5,2015,197,108,89,0.910079156,0.776099176,1.073111372,,,
1030,경북,청도군,2017,182,97,85,5,2016,199,96,103,0.936969937,1.032827104,0.847487997,,,
1031,경북,청도군,2018,174,83,91,5,2017,188,100,88,0.948197365,0.848408904,1.061965909,,,
1032,경북,청도군,2019,183,98,85,5,2018,152,74,78,1.233430965,1.353697046,1.119118766,,,
1033,경북,청도군,2020,145,74,71,5,2019,169,87,82,0.87899953,0.869439951,0.889193648,,,
1034,경북,청송군,2009,130,70,60,5,2008,164,91,73,0.812095024,0.786291848,0.844073461,,,
1035,경북,청송군,2010,151,85,66,5,2009,146,77,69,1.059574351,1.12837986,0.982305781,,,
1036,경북,청송군,2011,121,61,60,5,2010,135,63,72,0.918245793,0.989729263,0.855796703,,,
1037,경북,청송군,2012,120,62,58,5,2011,128,64,64,0.960458538,0.990236296,0.930678915,,,
1038,경북,청송군,2013,118,58,60,5,2012,127,58,69,0.951887517,1.022179402,0.893005256,,,
1039,경북,청송군,2014,125,63,62,5,2013,130,81,49,0.98508568,0.795028424,1.29941377,,,
1040,경북,청송군,2015,123,74,49,5,2014,113,52,61,1.11515186,1.454639919,0.824931904,,,
1041,경북,청송군,2016,106,49,57,5,2015,107,57,50,1.014914443,0.878715627,1.17072989,,,
1042,경북,청송군,2017,98,50,48,5,2016,120,64,56,0.836666104,0.798577658,0.880248038,,,
1043,경북,청송군,2018,116,64,52,5,2017,136,69,67,0.873828945,0.948108431,0.797040512,,,
1044,경북,청송군,2019,115,59,56,5,2018,129,62,67,0.913304243,0.972719109,0.85835132,,,
1045,경북,청송군,2020,104,45,59,5,2019,107,49,58,0.995765114,0.938736186,1.044662183,,,
1046,경북,칠곡군,2009,1220,670,550,5,2008,1446,731,715,0.864368403,0.936881258,0.789966188,,,
1047,경북,칠곡군,2010,1282,655,627,5,2009,1335,709,626,0.983816506,0.944326528,1.028596549,,,
1048,경북,칠곡군,2011,1207,666,541,5,2010,1303,691,612,0.949008713,0.985197514,0.907815718,,,
1049,경북,칠곡군,2012,1153,616,537,5,2011,1304,671,633,0.905855783,0.938394205,0.871209156,,,
1050,경북,칠곡군,2013,1214,633,581,5,2012,1415,751,664,0.878960973,0.861570655,0.898586538,,,
1051,경북,칠곡군,2014,1316,709,607,5,2013,1328,700,628,1.015231676,1.035321709,0.992615157,,,
1052,경북,칠곡군,2015,1235,635,600,5,2014,1270,645,625,0.996255156,1.00633166,0.985877802,,,
1053,경북,칠곡군,2016,1212,623,589,5,2015,1315,698,617,0.944243953,0.912346372,0.98035188,,,
1054,경북,칠곡군,2017,1223,651,572,5,2016,1326,662,664,0.944909637,1.005194548,0.884666953,,,
1055,경북,칠곡군,2018,1206,591,615,5,2017,1316,686,630,0.938855519,0.880623946,1.002504709,,,
1056,경북,칠곡군,2019,1244,649,595,5,2018,1187,637,550,1.073685299,1.041435529,1.11097972,,,
1057,경북,칠곡군,2020,1123,600,523,5,2019,1075,579,496,1.070233737,1.059253267,1.082858893,,,
1058,경북,포항시,2009,4508,2382,2126,5,2008,4679,2452,2227,0.987047851,0.992998098,0.980381028,,,
1059,경북,포항시,2010,4670,2451,2219,5,2009,4455,2369,2086,1.073931343,1.057560876,1.092433107,,,
1060,경북,포항시,2011,4461,2357,2104,5,2010,4333,2293,2040,1.054753268,1.050709486,1.059174273,,,
1061,경북,포항시,2012,4263,2245,2018,5,2011,4301,2232,2069,1.015437588,1.028132956,1.001641999,,,
1062,경북,포항시,2013,4337,2271,2066,5,2012,4687,2419,2268,0.94798576,0.959640109,0.935489941,,,
1063,경북,포항시,2014,4684,2428,2256,5,2013,4529,2298,2231,1.05955111,1.080005043,1.038463844,,,
1064,경북,포항시,2015,4423,2262,2161,5,2014,4440,2331,2109,1.020566514,0.99192184,1.052276914,,,
1065,경북,포항시,2016,4355,2275,2080,5,2015,4857,2496,2361,0.918602031,0.931673934,0.904730441,,,
1066,경북,포항시,2017,4712,2432,2280,5,2016,4813,2555,2258,1.002990375,0.972970766,1.036961816,,,
1067,경북,포항시,2018,4691,2485,2206,5,2017,5027,2648,2379,0.956013209,0.959258238,0.95227618,,,
1068,경북,포항시,2019,4866,2559,2307,5,2018,4603,2361,2242,1.083024983,1.107902198,1.056729524,,,
1069,경북,포항시,2020,4488,2298,2190,5,2019,4487,2311,2176,1.024717431,1.016429367,1.033563298,,,
1070,광주,광산구,2009,4689,2432,2257,5,2008,5007,2601,2406,0.959422693,0.955763286,0.963358184,,,
1071,광주,광산구,2010,5399,2796,2603,5,2009,4856,2541,2315,1.139047918,1.124759389,1.154715586,,,
1072,광주,광산구,2011,5118,2683,2435,5,2010,4819,2510,2309,1.088054628,1.092632405,1.082996088,,,
1073,광주,광산구,2012,4901,2544,2357,5,2011,5099,2660,2439,0.984707024,0.977603158,0.992429436,,,
1074,광주,광산구,2013,5131,2682,2449,5,2012,5746,2994,2752,0.914837036,0.915659705,0.913886392,,,
1075,광주,광산구,2014,5817,3039,2778,5,2013,5390,2713,2677,1.105649933,1.14500671,1.065701864,,,
1076,광주,광산구,2015,5397,2739,2658,5,2014,5273,2652,2621,1.048581019,1.055712437,1.041453325,,,
1077,광주,광산구,2016,5163,2606,2557,5,2015,5444,2811,2633,0.971608608,0.947634124,0.99731356,,,
1078,광주,광산구,2017,5323,2737,2586,5,2016,5216,2742,2474,1.045505276,1.020315472,1.073447182,,,
1079,광주,광산구,2018,5100,2664,2436,5,2017,5348,2777,2571,0.976981011,0.980585498,0.973031864,,,
1080,광주,광산구,2019,5395,2820,2575,5,2018,4696,2384,2312,1.176984398,1.209121608,1.143776736,,,
1081,광주,광산구,2020,4616,2337,2279,5,2019,4543,2347,2196,1.040951292,1.017824143,1.065770867,,,
1082,광주,남구,2009,1999,1036,963,5,2008,1742,912,830,1.175633597,1.161159935,1.19151647,,,
1083,광주,남구,2010,1931,1029,902,5,2009,1700,886,814,1.163699098,1.187158696,1.137978319,,,
1084,광주,남구,2011,1908,1008,900,5,2010,1635,847,788,1.195550591,1.216477966,1.172919339,,,
1085,광주,남구,2012,1764,923,841,5,2011,1766,902,864,1.023328871,1.045977371,0.999618094,,,
1086,광주,남구,2013,1941,990,951,5,2012,1870,978,892,1.063386822,1.034721481,1.094882509,,,
1087,광주,남구,2014,2074,1054,1020,5,2013,1863,947,916,1.140520885,1.137673801,1.143553673,,,
1088,광주,남구,2015,2076,1076,1000,5,2014,1811,917,894,1.174400545,1.199416616,1.148720407,,,
1089,광주,남구,2016,1985,1030,955,5,2015,2069,1077,992,0.982895543,0.977571759,0.98865224,,,
1090,광주,남구,2017,2240,1143,1097,5,2016,2025,1032,993,1.133262025,1.132123117,1.134512367,,,
1091,광주,남구,2018,2195,1123,1072,5,2017,2122,1116,1006,1.059733078,1.028590922,1.094330894,,,
1092,광주,남구,2019,2317,1205,1112,5,2018,1868,961,907,1.270739434,1.281712986,1.25906849,,,
1093,광주,남구,2020,2173,1101,1072,5,2019,2016,1035,981,1.104273229,1.087361857,1.122219041,,,
1094,광주,동구,2009,803,416,387,5,2008,820,467,353,1.003249699,0.910549532,1.125869657,,,
1095,광주,동구,2010,810,460,350,5,2009,752,387,365,1.103505555,1.214993605,0.984752371,,,
1096,광주,동구,2011,742,361,381,5,2010,572,307,265,1.328970136,1.201976431,1.47649152,,,
1097,광주,동구,2012,619,331,288,5,2011,635,329,306,0.998675209,1.028393259,0.966546865,,,
1098,광주,동구,2013,673,350,323,5,2012,712,352,360,0.968372429,1.016371565,0.921407784,,,
1099,광주,동구,2014,608,303,305,5,2013,649,342,307,0.959767916,0.905615084,1.020265776,,,
1100,광주,동구,2015,530,270,260,5,2014,586,307,279,0.926585711,0.898985142,0.957019969,,,
1101,광주,동구,2016,496,263,233,5,2015,650,337,313,0.781763996,0.797724578,0.764475266,,,
1102,광주,동구,2017,560,300,260,5,2016,675,326,349,0.849946519,0.940655892,0.76506754,,,
1103,광주,동구,2018,578,276,302,5,2017,693,361,332,0.854480092,0.781500042,0.934158811,,,
1104,광주,동구,2019,587,292,295,5,2018,600,306,294,1.002291843,0.975413024,1.030449092,,,
1105,광주,동구,2020,571,295,276,5,2019,738,400,338,0.792660271,0.753857309,0.838579491,,,
1106,광주,북구,2009,4955,2583,2372,5,2008,5264,2775,2489,0.964350974,0.951455638,0.978682096,,,
1107,광주,북구,2010,4979,2630,2349,5,2009,4721,2463,2258,1.080476862,1.091486735,1.068343555,,,
1108,광주,북구,2011,4554,2408,2146,5,2010,4201,2166,2035,1.110574481,1.136384118,1.082971828,,,
1109,광주,북구,2012,3765,1960,1805,5,2011,3905,2042,1863,0.987759664,0.981132041,0.994984251,,,
1110,광주,북구,2013,3856,2003,1853,5,2012,4352,2314,2038,0.907727481,0.884799197,0.933733832,,,
1111,광주,북구,2014,4308,2305,2003,5,2013,3994,2047,1947,1.105032317,1.151012957,1.056493557,,,
1112,광주,북구,2015,3986,2051,1935,5,2014,3952,2099,1853,1.033303032,0.998804171,1.072401481,,,
1113,광주,북구,2016,3883,2076,1807,5,2015,4078,2081,1997,0.97550054,1.019723421,0.929248659,,,
1114,광주,북구,2017,3957,2018,1939,5,2016,3967,2064,1903,1.021906579,0.999398272,1.046383483,,,
1115,광주,북구,2018,3978,2058,1920,5,2017,4137,2152,1985,0.985114254,0.977530302,0.99332776,,,
1116,광주,북구,2019,4081,2110,1971,5,2018,3742,1960,1782,1.117300921,1.100407418,1.135875624,,,
1117,광주,북구,2020,3635,1904,1731,5,2019,3743,1895,1848,0.994928642,1.02703408,0.961937723,,,
1118,광주,서구,2009,3423,1863,1560,5,2008,3580,1902,1678,0.979560395,1.001219888,0.954738634,,,
1119,광주,서구,2010,3339,1788,1551,5,2009,3213,1636,1577,1.064665151,1.117149616,1.010024619,,,
1120,광주,서구,2011,3064,1571,1493,5,2010,2816,1462,1354,1.114714,1.0983884,1.132382107,,,
1121,광주,서구,2012,2893,1482,1411,5,2011,3135,1607,1528,0.945405738,0.942669492,0.948321321,,,
1122,광주,서구,2013,2924,1520,1404,5,2012,3321,1721,1600,0.902019316,0.902796451,0.901153928,,,
1123,광주,서구,2014,3174,1665,1509,5,2013,3043,1564,1479,1.068592976,1.088189709,1.047786795,,,
1124,광주,서구,2015,2852,1455,1397,5,2014,2798,1442,1356,1.044261235,1.031394612,1.058007075,,,
1125,광주,서구,2016,2724,1387,1337,5,2015,2782,1447,1335,1.00313024,0.979794631,1.028494555,,,
1126,광주,서구,2017,2820,1472,1348,5,2016,2807,1443,1364,1.029233802,1.042722162,1.014909639,,,
1127,광주,서구,2018,2794,1445,1349,5,2017,2910,1524,1386,0.983650366,0.969192412,0.999540911,,,
1128,광주,서구,2019,2803,1472,1331,5,2018,2625,1341,1284,1.093959226,1.122034363,1.064547114,,,
1129,광주,서구,2020,2547,1313,1234,5,2019,2447,1247,1200,1.066356255,1.076280317,1.056053132,,,
1130,대구,남구,2009,1079,576,503,5,2008,1276,662,614,0.866319551,0.889388725,0.841301124,,,
1131,대구,남구,2010,1102,568,534,5,2009,1129,584,545,0.999988482,0.994174487,1.006228491,,,
1132,대구,남구,2011,954,497,457,5,2010,1040,539,501,0.939771739,0.942529059,0.936764295,,,
1133,대구,남구,2012,894,476,418,5,2011,1002,548,454,0.914065132,0.887878459,0.945523406,,,
1134,대구,남구,2013,857,475,382,5,2012,1084,563,521,0.809951259,0.862407133,0.75296969,,,
1135,대구,남구,2014,938,495,443,5,2013,992,526,466,0.968720547,0.96193689,0.976269372,,,
1136,대구,남구,2015,832,445,387,5,2014,911,448,463,0.935647571,1.015334451,0.858384425,,,
1137,대구,남구,2016,779,382,397,5,2015,906,498,408,0.880879707,0.784081389,0.999268503,,,
1138,대구,남구,2017,731,386,345,5,2016,907,493,414,0.82569078,0.800327078,0.855796703,,,
1139,대구,남구,2018,732,389,343,5,2017,898,445,453,0.835106934,0.89354559,0.777584819,,,
1140,대구,남구,2019,737,371,366,5,2018,781,398,383,0.966771411,0.952835573,0.981373138,,,
1141,대구,남구,2020,720,353,367,5,2019,759,403,356,0.971847375,0.895358136,1.058687832,,,
1142,대구,달서구,2009,5990,3171,2819,5,2008,5834,3064,2770,1.051883742,1.057875615,1.045122414,,,
1143,대구,달서구,2010,6108,3217,2891,5,2009,5456,2872,2584,1.146917058,1.144969059,1.148966688,,,
1144,대구,달서구,2011,5784,3043,2741,5,2010,5074,2654,2420,1.167844895,1.172001477,1.163176246,,,
1145,대구,달서구,2012,5386,2812,2574,5,2011,5086,2617,2469,1.084919059,1.098344853,1.070629752,,,
1146,대구,달서구,2013,5330,2746,2584,5,2012,5699,2910,2789,0.95815528,0.964572041,0.951471645,,,
1147,대구,달서구,2014,5906,2978,2928,5,2013,5337,2800,2537,1.133714197,1.087160807,1.185229522,,,
1148,대구,달서구,2015,5526,2906,2620,5,2014,5152,2719,2433,1.098860017,1.092480082,1.105887725,,,
1149,대구,달서구,2016,5193,2742,2451,5,2015,5517,2841,2676,0.964323352,0.986559634,0.940608843,,,
1150,대구,달서구,2017,5415,2796,2619,5,2016,5292,2674,2618,1.048300929,1.06881586,1.027348311,,,
1151,대구,달서구,2018,5249,2636,2613,5,2017,5289,2664,2625,1.016741033,1.011435775,1.022261388,,,
1152,대구,달서구,2019,5343,2677,2666,5,2018,4621,2341,2280,1.184558602,1.168891183,1.2008179,,,
1153,대구,달서구,2020,4632,2364,2268,5,2019,4626,2361,2265,1.025817887,1.023478233,1.028316251,,,
1154,대구,달성군,2009,1877,1045,832,5,2008,2065,1082,983,0.931218428,0.987225023,0.869203895,,,
1155,대구,달성군,2010,1945,1021,924,5,2009,1935,992,943,1.029783625,1.052061663,1.006264459,,,
1156,대구,달성군,2011,1797,935,862,5,2010,1947,1027,920,0.945560825,0.930611238,0.962213163,,,
1157,대구,달성군,2012,1772,930,842,5,2011,1883,965,918,0.964097025,0.985105538,0.941935718,,,
1158,대구,달성군,2013,1761,917,844,5,2012,2106,1089,1017,0.856659695,0.860733252,0.85226244,,,
1159,대구,달성군,2014,1921,986,935,5,2013,2048,1065,983,0.960958777,0.946355766,0.976809665,,,
1160,대구,달성군,2015,1896,986,910,5,2014,1844,931,913,1.053379256,1.082565941,1.023581599,,,
1161,대구,달성군,2016,1916,955,961,5,2015,2226,1151,1075,0.881815422,0.848115838,0.918050938,,,
1162,대구,달성군,2017,2687,1377,1310,5,2016,2699,1389,1310,1.019934135,1.013348479,1.026956044,,,
1163,대구,달성군,2018,2910,1510,1400,5,2017,3109,1593,1516,0.958913896,0.96892084,0.948376294,,,
1164,대구,달성군,2019,3044,1569,1475,5,2018,2987,1540,1447,1.044039117,1.041428235,1.046828034,,,
1165,대구,달성군,2020,2880,1481,1399,5,2019,3200,1617,1583,0.922040197,0.936207603,0.907587811,,,
1166,대구,동구,2009,2902,1576,1326,5,2008,3023,1567,1456,0.983482431,1.028050248,0.93526354,,,
1167,대구,동구,2010,2923,1465,1458,5,2009,2923,1552,1371,1.024489107,0.964879397,1.092123933,,,
1168,대구,동구,2011,2814,1469,1345,5,2010,2662,1425,1237,1.082987358,1.053741433,1.116617525,,,
1169,대구,동구,2012,2567,1364,1203,5,2011,2668,1422,1246,0.985705974,0.980487134,0.991515346,,,
1170,대구,동구,2013,2592,1385,1207,5,2012,3082,1533,1549,0.861607971,0.923495416,0.800216879,,,
1171,대구,동구,2014,3072,1524,1548,5,2013,2925,1495,1430,1.075976252,1.042007631,1.111697871,,,
1172,대구,동구,2015,2929,1485,1444,5,2014,2930,1541,1389,1.024139452,0.985033363,1.06762025,,,
1173,대구,동구,2016,2890,1518,1372,5,2015,3231,1705,1526,0.916364445,0.910069403,0.923318278,,,
1174,대구,동구,2017,3072,1578,1494,5,2016,3158,1631,1527,0.996589784,0.988963272,1.004762495,,,
1175,대구,동구,2018,3015,1579,1436,5,2017,3302,1738,1564,0.935443567,0.928665867,0.94290849,,,
1176,대구,동구,2019,3154,1644,1510,5,2018,2925,1491,1434,1.104696973,1.127071051,1.081383282,,,
1177,대구,동구,2020,2723,1361,1362,5,2019,2949,1475,1474,0.945976209,0.943177062,0.948924106,,,
1178,대구,북구,2009,4987,2708,2279,5,2008,5508,2912,2596,0.927583003,0.95057068,0.901553476,,,
1179,대구,북구,2010,5034,2655,2379,5,2009,4983,2617,2366,1.034974547,1.0370219,1.032598659,,,
1180,대구,북구,2011,4559,2390,2169,5,2010,4498,2368,2130,1.038382801,1.031676001,1.045759464,,,
1181,대구,북구,2012,4205,2215,1990,5,2011,4372,2278,2094,0.985356061,0.993910174,0.975951541,,,
1182,대구,북구,2013,4109,2121,1988,5,2012,4823,2500,2323,0.872823086,0.867217005,0.878858638,,,
1183,대구,북구,2014,4452,2303,2149,5,2013,4356,2291,2065,1.04706738,1.027533463,1.068730527,,,
1184,대구,북구,2015,4014,2085,1929,5,2014,3956,2027,1929,1.039509423,1.051427752,1.026956044,,,
1185,대구,북구,2016,3662,1862,1800,5,2015,4162,2185,1977,0.901412569,0.871074621,0.93501309,,,
1186,대구,북구,2017,3816,1988,1828,5,2016,4106,2116,1990,0.952131133,0.960346244,0.943354597,,,
1187,대구,북구,2018,3807,1943,1864,5,2017,4189,2143,2046,0.931064701,0.926782351,0.935604138,,,
1188,대구,북구,2019,3864,1967,1897,5,2018,3771,1905,1866,1.049754949,1.055447183,1.044016943,,,
1189,대구,북구,2020,3458,1754,1704,5,2019,3776,1941,1835,0.938210629,0.923700501,0.953642016,,,
1190,대구,서구,2009,1606,856,750,5,2008,1642,863,779,1.002027714,1.01388826,0.988725331,,,
1191,대구,서구,2010,1514,794,720,5,2009,1453,772,681,1.067499318,1.051308867,1.085768504,,,
1192,대구,서구,2011,1332,693,639,5,2010,1238,634,604,1.102277456,1.117303353,1.086465086,,,
1193,대구,서구,2012,1158,609,549,5,2011,1261,650,611,0.940807602,0.957703471,0.922747738,,,
1194,대구,서구,2013,1136,570,566,5,2012,1362,681,681,0.854493117,0.855568663,0.853534685,,,
1195,대구,서구,2014,1204,600,604,5,2013,1203,614,589,1.025340719,0.99887238,1.053109424,,,
1196,대구,서구,2015,1080,548,532,5,2014,1128,561,567,0.980893826,0.998492536,0.963563695,,,
1197,대구,서구,2016,1028,498,530,5,2015,1148,595,553,0.917399654,0.85553839,0.984243586,,,
1198,대구,서구,2017,991,509,482,5,2016,1153,586,567,0.880545278,0.887865727,0.873003198,,,
1199,대구,서구,2018,1018,531,487,5,2017,1149,585,564,0.907684866,0.927824381,0.886751052,,,
1200,대구,서구,2019,1024,509,515,5,2018,987,499,488,1.062894474,1.042663959,1.083775333,,,
1201,대구,서구,2020,869,424,445,5,2019,861,434,427,1.03400817,0.998626881,1.070246931,,,
1202,대구,수성구,2009,3890,2075,1815,5,2008,4046,2205,1841,0.984988292,0.961914857,1.012452591,,,
1203,대구,수성구,2010,4270,2302,1968,5,2009,3870,2015,1855,1.130379454,1.167770215,1.089514552,,,
1204,대구,수성구,2011,3937,2079,1858,5,2010,3712,1970,1742,1.08658772,1.078736537,1.095341176,,,
1205,대구,수성구,2012,3731,1986,1745,5,2011,3718,1971,1747,1.028071237,1.029958545,1.025780364,,,
1206,대구,수성구,2013,3735,1982,1753,5,2012,4037,2075,1962,0.9478491,0.97636606,0.917560624,,,
1207,대구,수성구,2014,4119,2146,1973,5,2013,3859,2005,1854,1.093514028,1.09406334,1.092871777,,,
1208,대구,수성구,2015,3821,1990,1831,5,2014,3606,1893,1713,1.085572069,1.074557322,1.097697908,,,
1209,대구,수성구,2016,3558,1874,1684,5,2015,3536,1801,1735,1.030863191,1.063611438,0.996768863,,,
1210,대구,수성구,2017,3571,1852,1719,5,2016,3657,1849,1808,1.000396665,1.023837887,0.976403451,,,
1211,대구,수성구,2018,3553,1778,1775,5,2017,3657,1868,1789,0.99535406,0.97293093,1.018919496,,,
1212,대구,수성구,2019,3675,1919,1756,5,2018,3282,1668,1614,1.147165591,1.175996567,1.117307815,,,
1213,대구,수성구,2020,3323,1689,1634,5,2019,3291,1694,1597,1.034450715,1.019162344,1.050749014,,,
1214,대구,중구,2009,754,401,353,5,2008,550,281,269,1.404481431,1.458697296,1.347641202,,,
1215,대구,중구,2010,760,405,355,5,2009,506,256,250,1.538758343,1.617119757,1.458277582,,,
1216,대구,중구,2011,717,359,358,5,2010,454,240,214,1.617970683,1.529010023,1.717991886,,,
1217,대구,중구,2012,626,330,296,5,2011,504,253,251,1.272480518,1.333277481,1.211071669,,,
1218,대구,중구,2013,701,346,355,5,2012,503,275,228,1.427767126,1.286087539,1.598988577,,,
1219,대구,중구,2014,735,391,344,5,2013,495,258,237,1.521211099,1.549116846,1.490602865,,,
1220,대구,중구,2015,725,380,345,5,2014,481,273,208,1.544188364,1.42281382,1.703364592,,,
1221,대구,중구,2016,686,370,316,5,2015,573,280,293,1.226526226,1.350737067,1.107570341,,,
1222,대구,중구,2017,735,385,350,5,2016,586,293,293,1.284982072,1.343136757,1.226739302,,,
1223,대구,중구,2018,797,416,381,5,2017,631,358,273,1.294006052,1.187783886,1.433224369,,,
1224,대구,중구,2019,787,436,351,5,2018,564,277,287,1.429561928,1.60891776,1.255963663,,,
1225,대구,중구,2020,717,361,356,5,2019,582,301,281,1.262128333,1.225936094,1.301054632,,,
1226,대전,대덕구,2009,2186,1140,1046,5,2008,2360,1168,1192,0.948954741,0.997675102,0.901171159,,,
1227,대전,대덕구,2010,2264,1141,1123,5,2009,2157,1154,1003,1.075309847,1.010664383,1.149822171,,,
1228,대전,대덕구,2011,2074,1093,981,5,2010,1825,964,861,1.164268717,1.15896482,1.170085806,,,
1229,대전,대덕구,2012,1747,916,831,5,2011,1768,937,831,1.012320402,0.999270365,1.026956044,,,
1230,대전,대덕구,2013,1763,927,836,5,2012,2029,1043,986,0.890179545,0.90849502,0.870725408,,,
1231,대전,대덕구,2014,1929,997,932,5,2013,1834,894,940,1.077556973,1.139947275,1.018215992,,,
1232,대전,대덕구,2015,1721,849,872,5,2014,1704,905,799,1.034709949,0.958928522,1.120783067,,,
1233,대전,대덕구,2016,1575,834,741,5,2015,1670,894,776,0.966209787,0.953576758,0.98063715,,,
1234,대전,대덕구,2017,1553,831,722,5,2016,1634,838,796,0.97370354,1.013640911,0.931485256,,,
1235,대전,대덕구,2018,1510,792,718,5,2017,1560,799,761,0.991652918,1.013224138,0.968928304,,,
1236,대전,대덕구,2019,1376,716,660,5,2018,1351,702,649,1.043447085,1.042564746,1.044362078,,,
1237,대전,대덕구,2020,1269,661,608,5,2019,1267,690,577,1.026106296,0.979218239,1.082130459,,,
1238,대전,동구,2009,2150,1142,1008,5,2008,2347,1239,1108,0.938496626,0.942154058,0.93427048,,,
1239,대전,동구,2010,2165,1116,1049,5,2009,2379,1232,1147,0.932332458,0.925935238,0.939212633,,,
1240,대전,동구,2011,2111,1076,1035,5,2010,2136,1098,1038,1.012498364,1.001698576,1.023987963,,,
1241,대전,동구,2012,2070,1077,993,5,2011,2310,1210,1100,0.918048681,0.909824146,0.927061229,,,
1242,대전,동구,2013,2170,1115,1055,5,2012,2539,1303,1236,0.875597228,0.874696879,0.876568468,,,
1243,대전,동구,2014,2378,1224,1154,5,2013,2425,1226,1199,1.00463303,1.020511899,0.988413073,,,
1244,대전,동구,2015,2140,1105,1035,5,2014,2220,1176,1044,0.987570581,0.96046619,1.018102974,,,
1245,대전,동구,2016,1971,1035,936,5,2015,2181,1109,1072,0.925845039,0.953972661,0.896670576,,,
1246,대전,동구,2017,1953,999,954,5,2016,2149,1076,1073,0.931050361,0.949030876,0.913062503,,,
1247,대전,동구,2018,1931,960,971,5,2017,1999,1005,994,0.989639053,0.976410175,1.003193479,,,
1248,대전,동구,2019,1869,929,940,5,2018,1832,919,913,1.045180208,1.033302138,1.057326047,,,
1249,대전,동구,2020,1637,803,834,5,2019,1753,913,840,0.956696331,0.899025257,1.019620644,,,
1250,대전,서구,2009,5098,2655,2443,5,2008,5251,2711,2540,0.994638254,1.001064667,0.987737644,,,
1251,대전,서구,2010,5198,2641,2557,5,2009,4999,2578,2421,1.06527193,1.047158961,1.084645437,,,
1252,대전,서구,2011,5017,2593,2424,5,2010,4486,2319,2167,1.145756097,1.142954373,1.148750092,,,
1253,대전,서구,2012,4427,2265,2162,5,2011,4587,2400,2187,0.988753712,0.964681811,1.01521672,,,
1254,대전,서구,2013,4487,2332,2155,5,2012,4916,2485,2431,0.935085969,0.959244413,0.910362104,,,
1255,대전,서구,2014,4873,2428,2445,5,2013,4597,2380,2217,1.085998569,1.042794785,1.132569927,,,
1256,대전,서구,2015,4476,2316,2160,5,2014,4401,2261,2140,1.041948022,1.047044447,1.036553764,,,
1257,대전,서구,2016,4253,2210,2043,5,2015,4603,2353,2250,0.946589653,0.960058002,0.932476088,,,
1258,대전,서구,2017,4454,2299,2155,5,2016,4636,2408,2228,0.984269733,0.975909654,0.993308023,,,
1259,대전,서구,2018,4459,2294,2165,5,2017,4792,2452,2340,0.953296521,0.95631303,0.950153776,,,
1260,대전,서구,2019,4556,2339,2217,5,2018,4325,2224,2101,1.079207485,1.075034902,1.08365614,,,
1261,대전,서구,2020,4192,2171,2021,5,2019,4177,2136,2041,1.028168144,1.038928597,1.01689278,,,
1262,대전,유성구,2009,3563,1859,1704,5,2008,3700,1940,1760,0.986555322,0.979500778,0.99428017,,,
1263,대전,유성구,2010,3738,1989,1749,5,2009,3627,1852,1775,1.055842372,1.097794185,1.011913307,,,
1264,대전,유성구,2011,3743,1921,1822,5,2010,3499,1868,1631,1.095931046,1.05118128,1.14721883,,,
1265,대전,유성구,2012,3627,1932,1695,5,2011,3852,2011,1841,0.964647454,0.98202417,0.945513576,,,
1266,대전,유성구,2013,3957,2087,1870,5,2012,4173,2113,2060,0.971460196,1.00960171,0.932236797,,,
1267,대전,유성구,2014,4268,2193,2075,5,2013,4003,2117,1886,1.092310645,1.058875498,1.129869454,,,
1268,대전,유성구,2015,4122,2124,1998,5,2014,3883,1962,1921,1.087546768,1.106579536,1.068119821,,,
1269,대전,유성구,2016,3830,1930,1900,5,2015,4114,2112,2002,0.95376599,0.934093867,0.974633608,,,
1270,대전,유성구,2017,4067,2108,1959,5,2016,4223,2218,2005,0.986643902,0.971485203,1.003394958,,,
1271,대전,유성구,2018,4099,2141,1958,5,2017,4316,2258,2058,0.972979808,0.969214393,0.977055361,,,
1272,대전,유성구,2019,4129,2141,1988,5,2018,3937,2005,1932,1.074451492,1.091514264,1.056722886,,,
1273,대전,유성구,2020,3737,1874,1863,5,2019,3915,2044,1871,0.977909526,0.937164481,1.022564997,,,
1274,대전,중구,2009,2614,1388,1226,5,2008,2556,1308,1248,1.047736513,1.08469802,1.008852652,,,
1275,대전,중구,2010,2627,1357,1270,5,2009,2426,1253,1173,1.109370521,1.107021108,1.111879093,,,
1276,대전,중구,2011,2421,1246,1175,5,2010,2243,1156,1087,1.105790517,1.101760844,1.11009508,,,
1277,대전,중구,2012,2314,1204,1110,5,2011,2314,1172,1142,1.024489107,1.050088737,0.998179692,,,
1278,대전,중구,2013,2339,1191,1148,5,2012,2549,1321,1228,0.940086317,0.921586426,0.96005337,,,
1279,대전,중구,2014,2546,1329,1217,5,2013,2497,1312,1185,1.044593219,1.035424105,1.05468819,,,
1280,대전,중구,2015,2374,1255,1119,5,2014,2196,1123,1073,1.107530574,1.142328718,1.070982118,,,
1281,대전,중구,2016,2067,1053,1014,5,2015,2195,1104,1091,0.96474669,0.974959158,0.954476103,,,
1282,대전,중구,2017,2166,1086,1080,5,2016,2187,1126,1061,1.014651763,0.985867523,1.045346397,,,
1283,대전,중구,2018,2057,1067,990,5,2017,2145,1097,1048,0.982458785,0.994225544,0.97012069,,,
1284,대전,중구,2019,2024,1038,986,5,2018,1856,945,911,1.117223035,1.122774835,1.11150237,,,
1285,대전,중구,2020,1788,920,868,5,2019,1768,891,877,1.036078351,1.05544899,1.016417156,,,
1286,부산,강서구,2009,336,170,166,5,2008,307,162,145,1.121264951,1.072657397,1.175687609,,,
1287,부산,강서구,2010,437,235,202,5,2009,416,227,189,1.076206106,1.058203346,1.097593232,,,
1288,부산,강서구,2011,430,232,198,5,2010,452,237,215,0.974624593,1.000614436,0.945754868,,,
1289,부산,강서구,2012,467,243,224,5,2011,468,241,227,1.022300028,1.030662219,1.013383938,,,
1290,부산,강서구,2013,474,233,241,5,2012,603,301,302,0.805319796,0.791255152,0.819524525,,,
1291,부산,강서구,2014,692,356,336,5,2013,697,342,355,1.017139831,1.064023004,0.971992199,,,
1292,부산,강서구,2015,898,438,460,5,2014,914,468,446,1.006554944,0.956655082,1.059192332,,,
1293,부산,강서구,2016,1191,623,568,5,2015,1305,667,638,0.934993507,0.954749277,0.914280616,,,
1294,부산,강서구,2017,1561,789,772,5,2016,1615,819,796,0.990233744,0.984736933,0.995992545,,,
1295,부산,강서구,2018,1750,887,863,5,2017,1871,981,890,0.958234066,0.924233568,0.995801198,,,
1296,부산,강서구,2019,1958,1033,925,5,2018,1914,994,920,1.048040581,1.062285033,1.032537327,,,
1297,부산,강서구,2020,1956,1014,942,5,2019,2165,1123,1042,0.925589235,0.922965195,0.928399802,,,
1298,부산,금정구,2009,1785,921,864,5,2008,1865,1004,861,0.980543194,0.937676523,1.030534288,,,
1299,부산,금정구,2010,1820,948,872,5,2009,1650,825,825,1.130042531,1.174577059,1.085461418,,,
1300,부산,금정구,2011,1724,870,854,5,2010,1505,789,716,1.173567589,1.127117972,1.224888913,,,
1301,부산,금정구,2012,1583,825,758,5,2011,1530,834,696,1.059977946,1.011148689,1.11843776,,,
1302,부산,금정구,2013,1625,866,759,5,2012,1777,908,869,0.93685695,0.974897976,0.896961608,,,
1303,부산,금정구,2014,1782,923,859,5,2013,1622,864,758,1.125548452,1.091981005,1.163793195,,,
1304,부산,금정구,2015,1612,854,758,5,2014,1560,812,748,1.058638744,1.075050751,1.040685403,,,
1305,부산,금정구,2016,1534,806,728,5,2015,1637,879,758,0.960028278,0.937288508,0.986311346,,,
1306,부산,금정구,2017,1656,874,782,5,2016,1681,862,819,1.009252803,1.036409278,0.980561204,,,
1307,부산,금정구,2018,1709,859,850,5,2017,1696,877,819,1.032341913,1.001199665,1.065827396,,,
1308,부산,금정구,2019,1702,890,812,5,2018,1534,779,755,1.136688697,1.167830126,1.104487825,,,
1309,부산,금정구,2020,1527,765,762,5,2019,1527,805,722,1.024489107,0.971387879,1.083851116,,,
1310,부산,기장군,2009,742,405,337,5,2008,747,400,347,1.017631751,1.034956645,0.997360769,,,
1311,부산,기장군,2010,927,497,430,5,2009,807,412,395,1.176829495,1.233065929,1.117952149,,,
1312,부산,기장군,2011,970,501,469,5,2010,953,532,421,1.042764359,0.962616317,1.144043669,,,
1313,부산,기장군,2012,1036,556,480,5,2011,1052,532,520,1.008907524,1.068292759,0.947959425,,,
1314,부산,기장군,2013,1207,628,579,5,2012,1319,677,642,0.937496856,0.94819596,0.926179983,,,
1315,부산,기장군,2014,1702,888,814,5,2013,1576,806,770,1.106396231,1.12617284,1.085639246,,,
1316,부산,기장군,2015,1720,880,840,5,2014,1739,891,848,1.013295724,1.009559903,1.017267779,,,
1317,부산,기장군,2016,1799,919,880,5,2015,2045,1026,1019,0.901249831,0.915577847,0.886870774,,,
1318,부산,기장군,2017,1987,990,997,5,2016,2209,1128,1081,0.921530039,0.897125539,0.947155574,,,
1319,부산,기장군,2018,2106,1074,1032,5,2017,2279,1192,1087,0.94671964,0.920990502,0.974994146,,,
1320,부산,기장군,2019,2166,1100,1066,5,2018,2130,1102,1028,1.041804416,1.020324267,1.064917454,,,
1321,부산,기장군,2020,2038,1061,977,5,2019,2182,1154,1028,0.956878461,0.939802726,0.976007835,,,
1322,부산,남구,2009,2199,1095,1104,5,2008,2493,1302,1191,0.903670897,0.859667009,0.951939104,,,
1323,부산,남구,2010,2289,1215,1074,5,2009,2343,1225,1118,1.000877323,1.013835081,0.986539169,,,
1324,부산,남구,2011,2110,1104,1006,5,2010,2174,1156,1018,0.994329354,0.976199014,1.014850472,,,
1325,부산,남구,2012,1950,1045,905,5,2011,2127,1080,1047,0.93923543,0.989053218,0.887674517,,,
1326,부산,남구,2013,1895,968,927,5,2012,2293,1214,1079,0.84666675,0.815049144,0.882287537,,,
1327,부산,남구,2014,2222,1183,1039,5,2013,2197,1108,1089,1.036146926,1.091370246,0.97980471,,,
1328,부산,남구,2015,2073,1041,1032,5,2014,2070,1025,1045,1.025973874,1.038135373,1.014180514,,,
1329,부산,남구,2016,1932,971,961,5,2015,2310,1168,1142,0.856845435,0.849774143,0.864189806,,,
1330,부산,남구,2017,2120,1069,1051,5,2016,2218,1103,1115,0.979223132,0.990670699,0.968009688,,,
1331,부산,남구,2018,2139,1093,1046,5,2017,2117,1080,1037,1.035135664,1.034483414,1.035868874,,,
1332,부산,남구,2019,2214,1116,1098,5,2018,2148,1105,1043,1.055967823,1.032354944,1.081110006,,,
1333,부산,남구,2020,2013,1034,979,5,2019,2082,1059,1023,0.990536298,0.998048633,0.982785891,,,
1334,부산,동구,2009,594,313,281,5,2008,591,321,270,1.02968956,0.996704526,1.068794994,,,
1335,부산,동구,2010,591,314,277,5,2009,589,320,269,1.027967848,1.003013538,1.057497488,,,
1336,부산,동구,2011,517,281,236,5,2010,493,242,251,1.074362816,1.186910794,0.965584169,,,
1337,부산,동구,2012,448,225,223,5,2011,499,244,255,0.919781804,0.942583465,0.898083129,,,
1338,부산,동구,2013,454,216,238,5,2012,584,293,291,0.796435025,0.753552051,0.83991594,,,
1339,부산,동구,2014,507,256,251,5,2013,504,268,236,1.030587257,0.976410175,1.092228674,,,
1340,부산,동구,2015,428,219,209,5,2014,484,242,242,0.905953178,0.92503012,0.886916583,,,
1341,부산,동구,2016,388,192,196,5,2015,456,224,232,0.871714416,0.876153773,0.867600796,,,
1342,부산,동구,2017,403,203,200,5,2016,497,260,237,0.830722556,0.798086226,0.866629573,,,
1343,부산,동구,2018,435,223,212,5,2017,497,254,243,0.896685637,0.897425223,0.89594519,,,
1344,부산,동구,2019,404,206,198,5,2018,412,218,194,1.004596115,0.965912646,1.048130395,,,
1345,부산,동구,2020,422,224,198,5,2019,436,221,215,0.991592668,1.036055141,0.945754868,,,
1346,부산,동래구,2009,1995,1035,960,5,2008,2156,1135,1021,0.947985051,0.932119543,0.965600198,,,
1347,부산,동래구,2010,2088,1101,987,5,2009,2052,1067,985,1.042462601,1.054751192,1.029041234,,,
1348,부산,동래구,2011,2018,1032,986,5,2010,1793,939,854,1.153050206,1.123417618,1.185689297,,,
1349,부산,동래구,2012,1738,904,834,5,2011,1963,991,972,0.907061675,0.932442159,0.881153643,,,
1350,부산,동래구,2013,1857,950,907,5,2012,2097,1108,989,0.907237135,0.876417358,0.941809031,,,
1351,부산,동래구,2014,2140,1139,1001,5,2013,2024,1066,958,1.083204886,1.092178555,1.073051148,,,
1352,부산,동래구,2015,2021,1054,967,5,2014,1877,961,916,1.103086034,1.12109999,1.084133727,,,
1353,부산,동래구,2016,1856,970,886,5,2015,2141,1097,1044,0.888113864,0.903841404,0.871535493,,,
1354,부산,동래구,2017,2214,1167,1047,5,2016,2037,1045,992,1.113509516,1.141515179,1.083894131,,,
1355,부산,동래구,2018,2004,1032,972,5,2017,2300,1212,1088,0.892641814,0.87037058,0.917464407,,,
1356,부산,동래구,2019,2225,1167,1058,5,2018,1930,1002,928,1.181082002,1.190502358,1.170818421,,,
1357,부산,동래구,2020,2036,1080,956,5,2019,2116,1110,1006,0.98575606,0.994552932,0.975914491,,,
1358,부산,부산진구,2009,3048,1568,1480,5,2008,3096,1594,1502,1.008605555,1.005506463,1.011914078,,,
1359,부산,부산진구,2010,3108,1602,1506,5,2009,2901,1514,1387,1.097591226,1.081592736,1.115065466,,,
1360,부산,부산진구,2011,2917,1540,1377,5,2010,2602,1317,1285,1.148514499,1.195259134,1.100481301,,,
1361,부산,부산진구,2012,2661,1350,1311,5,2011,2719,1384,1335,1.002635349,0.997068059,1.008493913,,,
1362,부산,부산진구,2013,2738,1404,1334,5,2012,2963,1490,1473,0.946692938,0.963181128,0.930047089,,,
1363,부산,부산진구,2014,2900,1454,1446,5,2013,2747,1427,1320,1.081550204,1.041519867,1.124983666,,,
1364,부산,부산진구,2015,2724,1421,1303,5,2014,2569,1306,1263,1.086301412,1.112187543,1.059480384,,,
1365,부산,부산진구,2016,2550,1288,1262,5,2015,2776,1439,1337,0.941083294,0.914918047,0.969348188,,,
1366,부산,부산진구,2017,2673,1395,1278,5,2016,2733,1326,1407,1.001997579,1.075369733,0.932800159,,,
1367,부산,부산진구,2018,2659,1292,1367,5,2017,2754,1396,1358,0.989149069,0.946028501,1.033762085,,,
1368,부산,부산진구,2019,2739,1386,1353,5,2018,2341,1179,1162,1.198665385,1.201646015,1.195758629,,,
1369,부산,부산진구,2020,2372,1180,1192,5,2019,2410,1238,1172,1.008335337,0.974290545,1.044480891,,,
1370,부산,북구,2009,2717,1421,1296,5,2008,2814,1492,1322,0.989174451,0.973536817,1.006758724,,,
1371,부산,북구,2010,2638,1369,1269,5,2009,2628,1351,1277,1.028387468,1.035798373,1.02052249,,,
1372,부산,북구,2011,2472,1262,1210,5,2010,2336,1239,1097,1.084134021,1.041154484,1.132740942,,,
1373,부산,북구,2012,2240,1200,1040,5,2011,2224,1188,1036,1.031859533,1.032504447,1.030921125,,,
1374,부산,북구,2013,2273,1219,1054,5,2012,2441,1241,1200,0.953979411,1.004058575,0.902009725,,,
1375,부산,북구,2014,2304,1184,1120,5,2013,2364,1224,1140,0.998486846,0.988774847,1.008939271,,,
1376,부산,북구,2015,2252,1165,1087,5,2014,2194,1102,1092,1.051572229,1.080616156,1.022253864,,,
1377,부산,북구,2016,2203,1096,1107,5,2015,2329,1214,1115,0.969063763,0.922824238,1.019587749,,,
1378,부산,북구,2017,2235,1186,1049,5,2016,2425,1244,1181,0.944219858,0.97452152,0.912173489,,,
1379,부산,북구,2018,2224,1141,1083,5,2017,2475,1303,1172,0.920591424,0.895093398,0.948970474,,,
1380,부산,북구,2019,2275,1195,1080,5,2018,2211,1132,1079,1.054144152,1.079067479,1.02790781,,,
1381,부산,북구,2020,2038,1029,1009,5,2019,2118,1061,1057,0.985792635,0.99135024,0.980320386,,,
1382,부산,사상구,2009,1905,1015,890,5,2008,2078,1085,993,0.939197185,0.956232344,0.920433916,,,
1383,부산,사상구,2010,1826,956,870,5,2009,1964,1005,959,0.95250362,0.9723418,0.931649383,,,
1384,부산,사상구,2011,1732,886,846,5,2010,1680,850,830,1.056199485,1.065471706,1.046752787,,,
1385,부산,사상구,2012,1510,748,762,5,2011,1726,898,828,0.896279578,0.85143674,0.945097229,,,
1386,부산,사상구,2013,1526,784,742,5,2012,1898,1000,898,0.823693561,0.801388651,0.84855388,,,
1387,부산,사상구,2014,1660,877,783,5,2013,1799,904,895,0.945331806,0.991649708,0.898443109,,,
1388,부산,사상구,2015,1562,791,771,5,2014,1591,821,770,1.005815202,0.984828145,1.028289753,,,
1389,부산,사상구,2016,1394,726,668,5,2015,1710,883,827,0.835168313,0.840432895,0.829512258,,,
1390,부산,사상구,2017,1462,746,716,5,2016,1721,886,835,0.870309747,0.860661212,0.880599434,,,
1391,부산,사상구,2018,1434,748,686,5,2017,1800,903,897,0.816176322,0.846722251,0.785386673,,,
1392,부산,사상구,2019,1489,750,739,5,2018,1524,748,776,1.000960814,1.024912502,0.977990356,,,
1393,부산,사상구,2020,1280,628,652,5,2019,1438,729,709,0.911923545,0.880560582,0.944393992,,,
1394,부산,사하구,2009,3102,1634,1468,5,2008,3169,1654,1515,1.002829035,1.009819313,0.995096681,,,
1395,부산,사하구,2010,2915,1522,1393,5,2009,2993,1521,1472,0.997790093,1.022851447,0.971840876,,,
1396,부산,사하구,2011,2765,1411,1354,5,2010,2608,1299,1309,1.086162723,1.110311883,1.06226011,,,
1397,부산,사하구,2012,2478,1230,1248,5,2011,2622,1329,1293,0.968224259,0.946035113,0.991215114,,,
1398,부산,사하구,2013,2520,1280,1240,5,2012,2927,1532,1395,0.88203367,0.854040232,0.912849817,,,
1399,부산,사하구,2014,2714,1420,1294,5,2013,2763,1395,1368,1.006320462,1.04049803,0.971404328,,,
1400,부산,사하구,2015,2545,1285,1260,5,2014,2624,1361,1263,0.993645114,0.965099583,1.024516718,,,
1401,부산,사하구,2016,2413,1253,1160,5,2015,2709,1368,1341,0.912547883,0.936250578,0.888343781,,,
1402,부산,사하구,2017,2498,1250,1248,5,2016,2770,1400,1370,0.923889455,0.912660181,0.935504484,,,
1403,부산,사하구,2018,2577,1310,1267,5,2017,2832,1455,1377,0.932241677,0.920312726,0.944918887,,,
1404,부산,사하구,2019,2572,1290,1282,5,2018,2376,1188,1188,1.109000835,1.10994228,1.108213509,,,
1405,부산,사하구,2020,2145,1094,1051,5,2019,2333,1216,1117,0.941932763,0.919625219,0.966276457,,,
1406,부산,서구,2009,740,392,348,5,2008,885,471,414,0.85663496,0.850731052,0.863238414,,,
1407,부산,서구,2010,761,415,346,5,2009,780,389,391,0.999533603,1.090499876,0.908764172,,,
1408,부산,서구,2011,711,342,369,5,2010,659,335,324,1.105328916,1.043538375,1.169588828,,,
1409,부산,서구,2012,589,303,286,5,2011,678,339,339,0.890006024,0.913629377,0.866399494,,,
1410,부산,서구,2013,626,316,310,5,2012,734,381,353,0.873746841,0.84779184,0.901859415,,,
1411,부산,서구,2014,688,354,334,5,2013,614,302,312,1.147961736,1.198183803,1.099369611,,,
1412,부산,서구,2015,599,283,316,5,2014,613,354,259,1.001091314,0.817166019,1.252965675,,,
1413,부산,서구,2016,572,304,268,5,2015,677,326,351,0.865594933,0.95319797,0.784114586,,,
1414,부산,서구,2017,644,317,327,5,2016,638,346,292,1.034123801,0.936505406,1.15005009,,,
1415,부산,서구,2018,615,323,292,5,2017,625,320,305,1.008097282,1.031762334,0.983184147,,,
1416,부산,서구,2019,655,336,319,5,2018,613,360,253,1.094682488,0.954034109,1.29485762,,,
1417,부산,서구,2020,561,322,239,5,2019,615,316,299,0.934533966,1.041587872,0.820877908,,,
1418,부산,수영구,2009,1237,630,607,5,2008,1314,681,633,0.964454358,0.945628522,0.984774595,,,
1419,부산,수영구,2010,1273,657,616,5,2009,1268,658,610,1.028528891,1.020625938,1.037057251,,,
1420,부산,수영구,2011,1172,616,556,5,2010,1158,631,527,1.036874986,0.997880367,1.083467856,,,
1421,부산,수영구,2012,1058,565,493,5,2011,1040,554,486,1.04222065,1.042475383,1.041747592,,,
1422,부산,수영구,2013,1010,545,465,5,2012,1260,642,618,0.821217459,0.867737966,0.772709645,,,
1423,부산,수영구,2014,1098,550,548,5,2013,1185,582,603,0.949273451,0.965977098,0.933286753,,,
1424,부산,수영구,2015,1102,557,545,5,2014,1096,575,521,1.030097624,0.990180743,1.07426304,,,
1425,부산,수영구,2016,1017,532,485,5,2015,1113,578,535,0.93612347,0.940829484,0.930978843,,,
1426,부산,수영구,2017,992,528,464,5,2016,1185,609,576,0.857631388,0.886224506,0.827270146,,,
1427,부산,수영구,2018,1089,555,534,5,2017,1238,640,598,0.901186299,0.8864212,0.917047705,,,
1428,부산,수영구,2019,1042,535,507,5,2018,1089,562,527,0.980273324,0.973071139,0.98798238,,,
1429,부산,수영구,2020,970,518,452,5,2019,1122,588,534,0.885699139,0.900491378,0.869258674,,,
1430,부산,연제구,2009,1698,905,793,5,2008,1784,874,910,0.975102301,1.058435193,0.894918838,,,
1431,부산,연제구,2010,1765,879,886,5,2009,1557,784,773,1.161350851,1.146040427,1.177080278,,,
1432,부산,연제구,2011,1596,820,776,5,2010,1534,821,713,1.065896099,1.02093436,1.1176969,,,
1433,부산,연제구,2012,1576,844,732,5,2011,1555,809,746,1.038324652,1.066402244,1.00768341,,,
1434,부산,연제구,2013,1552,818,734,5,2012,1726,906,820,0.921209209,0.922894869,0.919250898,,,
1435,부산,연제구,2014,1657,882,775,5,2013,1537,788,749,1.104475245,1.144114509,1.062604718,,,
1436,부산,연제구,2015,1570,806,764,5,2014,1415,742,673,1.136712296,1.11034582,1.165816371,,,
1437,부산,연제구,2016,1472,783,689,5,2015,1648,841,807,0.915077649,0.951684271,0.876793946,,,
1438,부산,연제구,2017,1650,824,826,5,2016,1651,860,791,1.023868581,0.979390497,1.072396577,,,
1439,부산,연제구,2018,1675,885,790,5,2017,1688,844,844,1.016599085,1.071835037,0.961250325,,,
1440,부산,연제구,2019,1654,829,825,5,2018,1536,743,793,1.103193349,1.140493573,1.068396893,,,
1441,부산,연제구,2020,1564,764,800,5,2019,1664,852,812,0.962921252,0.916602187,1.011779354,,,
1442,부산,영도구,2009,983,498,485,5,2008,1074,570,504,0.937684164,0.893062004,0.988241431,,,
1443,부산,영도구,2010,965,522,443,5,2009,916,446,470,1.079292564,1.196362439,0.967960697,,,
1444,부산,영도구,2011,832,416,416,5,2010,773,380,393,1.102684266,1.119017451,1.087057797,,,
1445,부산,영도구,2012,716,357,359,5,2011,822,424,398,0.892377373,0.86065577,0.926324673,,,
1446,부산,영도구,2013,746,377,369,5,2012,852,430,422,0.897029195,0.896189848,0.897978152,,,
1447,부산,영도구,2014,776,404,372,5,2013,817,408,409,0.973076557,1.012158036,0.93405293,,,
1448,부산,영도구,2015,731,371,360,5,2014,686,350,336,1.091693203,1.083510166,1.100310047,,,
1449,부산,영도구,2016,617,316,301,5,2015,806,401,405,0.784255309,0.805507958,0.763243875,,,
1450,부산,영도구,2017,708,359,349,5,2016,743,357,386,0.97622919,1.027905898,0.928517252,,,
1451,부산,영도구,2018,686,321,365,5,2017,725,381,344,0.969378659,0.861206268,1.089648128,,,
1452,부산,영도구,2019,645,348,297,5,2018,633,324,309,1.043910702,1.097896395,0.987074256,,,
1453,부산,영도구,2020,589,302,287,5,2019,599,311,288,1.007385783,0.992598648,1.023390224,,,
1454,부산,중구,2009,389,194,195,5,2008,302,164,138,1.319623387,1.209163439,1.45113354,,,
1455,부산,중구,2010,365,208,157,5,2009,254,121,133,1.472198914,1.75713484,1.21227142,,,
1456,부산,중구,2011,341,161,180,5,2010,227,116,111,1.538990245,1.418714515,1.665334125,,,
1457,부산,중구,2012,316,162,154,5,2011,237,117,120,1.365985477,1.415325326,1.317926923,,,
1458,부산,중구,2013,275,142,133,5,2012,253,120,133,1.113575117,1.209578959,1.026956044,,,
1459,부산,중구,2014,280,135,145,5,2013,224,115,109,1.280611384,1.199949733,1.366134187,,,
1460,부산,중구,2015,250,138,112,5,2014,215,123,92,1.191266404,1.146835427,1.250207358,,,
1461,부산,중구,2016,245,135,110,5,2015,228,112,116,1.100876453,1.232091244,0.973837628,,,
1462,부산,중구,2017,270,129,141,5,2016,225,120,105,1.229386929,1.098842857,1.379055259,,,
1463,부산,중구,2018,229,115,114,5,2017,196,97,99,1.19697962,1.211862178,1.182555444,,,
1464,부산,중구,2019,229,125,104,5,2018,184,92,92,1.275043509,1.38883071,1.160906832,,,
1465,부산,중구,2020,209,114,95,5,2019,168,88,80,1.274513235,1.324186953,1.219510302,,,
1466,부산,해운대구,2009,3918,2064,1854,5,2008,4101,2153,1948,0.978773061,0.979924889,0.97740067,,,
1467,부산,해운대구,2010,3965,2094,1871,5,2009,3824,1957,1867,1.062264464,1.093737184,1.029156271,,,
1468,부산,해운대구,2011,3703,1915,1788,5,2010,3463,1792,1671,1.095490374,1.092340154,1.098861404,,,
1469,부산,해운대구,2012,3386,1774,1612,5,2011,3558,1810,1748,0.974963496,1.001848762,0.947055574,,,
1470,부산,해운대구,2013,3499,1789,1710,5,2012,3939,2008,1931,0.910050111,0.910696689,0.909422493,,,
1471,부산,해운대구,2014,3694,1874,1820,5,2013,3591,1837,1754,1.053874342,1.042767665,1.065598632,,,
1472,부산,해운대구,2015,3424,1774,1650,5,2014,3355,1730,1625,1.045559077,1.048177029,1.042755368,,,
1473,부산,해운대구,2016,3149,1615,1534,5,2015,3591,1876,1715,0.898389362,0.879967876,0.918571762,,,
1474,부산,해운대구,2017,3285,1711,1574,5,2016,3623,1882,1741,0.928911598,0.929303378,0.928448485,,,
1475,부산,해운대구,2018,3294,1710,1584,5,2017,3592,1903,1689,0.939495301,0.918511181,0.963113306,,,
1476,부산,해운대구,2019,3398,1793,1605,5,2018,3259,1723,1536,1.068184715,1.063707294,1.073088835,,,
1477,부산,해운대구,2020,3075,1598,1477,5,2019,3155,1659,1496,0.998511571,0.984594747,1.013913153,,,
1478,서울,강남구,2009,3378,1746,1632,5,2008,3907,2006,1901,0.885775328,0.889693538,0.881637172,,,
1479,서울,강남구,2010,3545,1848,1697,5,2009,4050,2089,1961,0.896744169,0.904254445,0.88870189,,,
1480,서울,강남구,2011,3548,1876,1672,5,2010,3599,1860,1739,1.009971479,1.030972343,0.987389595,,,
1481,서울,강남구,2012,3132,1645,1487,5,2011,3860,1954,1906,0.8312694,0.86053486,0.801198131,,,
1482,서울,강남구,2013,3320,1698,1622,5,2012,4325,2209,2116,0.786428633,0.785722329,0.787203546,,,
1483,서울,강남구,2014,3846,2003,1843,5,2013,4171,2153,2018,0.944661977,0.950963931,0.937898904,,,
1484,서울,강남구,2015,3970,2089,1881,5,2014,4176,2115,2061,0.97395157,1.009613603,0.93726556,,,
1485,서울,강남구,2016,3703,1896,1807,5,2015,4501,2324,2177,0.842853403,0.833929495,0.852415972,,,
1486,서울,강남구,2017,3957,2060,1897,5,2016,4459,2284,2175,0.909150796,0.921930634,0.895694536,,,
1487,서울,강남구,2018,3938,2056,1882,5,2017,4545,2343,2202,0.88766515,0.89697006,0.877716292,,,
1488,서울,강남구,2019,4096,2116,1980,5,2018,4094,2106,1988,1.024989591,1.027033056,1.022823424,,,
1489,서울,강남구,2020,3913,2064,1849,5,2019,3972,2091,1881,1.009271369,1.008980529,1.009485234,,,
1490,서울,강동구,2009,3747,1975,1772,5,2008,3906,2013,1893,0.982785634,1.002883418,0.961313317,,,
1491,서울,강동구,2010,3930,2025,1905,5,2009,3992,2076,1916,1.008577703,0.997068059,1.021060158,,,
1492,서울,강동구,2011,3823,1997,1826,5,2010,3613,1859,1754,1.084035942,1.098059315,1.069111594,,,
1493,서울,강동구,2012,3433,1774,1659,5,2011,3918,2058,1860,0.897670012,0.881120631,0.915978536,,,
1494,서울,강동구,2013,3587,1873,1714,5,2012,4266,2263,2003,0.861425792,0.846019452,0.878783155,,,
1495,서울,강동구,2014,3845,2032,1813,5,2013,4146,2157,1989,0.950111099,0.962943229,0.936084116,,,
1496,서울,강동구,2015,3665,1924,1741,5,2014,3730,1923,1807,1.00663608,1.022710957,0.989446858,,,
1497,서울,강동구,2016,3229,1646,1583,5,2015,3821,2003,1818,0.865761667,0.839993658,0.8942087,,,
1498,서울,강동구,2017,3470,1806,1664,5,2016,3449,1795,1654,1.030726936,1.028443454,1.033164968,,,
1499,서울,강동구,2018,3210,1697,1513,5,2017,3684,1896,1788,0.892673734,0.914893695,0.869006988,,,
1500,서울,강동구,2019,3292,1711,1581,5,2018,3170,1650,1520,1.063917395,1.059969065,1.068169411,,,
1501,서울,강동구,2020,3404,1798,1606,5,2019,3432,1759,1673,1.016130805,1.044842846,0.985828695,,,
1502,서울,강북구,2009,2349,1214,1135,5,2008,2895,1486,1409,0.8312694,0.835077924,0.8272499,,,
1503,서울,강북구,2010,2358,1207,1151,5,2009,2664,1299,1365,0.906811305,0.949784864,0.865953411,,,
1504,서울,강북구,2011,2155,1050,1105,5,2010,2381,1240,1141,0.927246546,0.865555139,0.994554276,,,
1505,서울,강북구,2012,1945,990,955,5,2011,2486,1288,1198,0.801541156,0.785681373,0.818650269,,,
1506,서울,강북구,2013,1972,1012,960,5,2012,2624,1368,1256,0.769928552,0.756173651,0.784934556,,,
1507,서울,강북구,2014,2041,1062,979,5,2013,2382,1195,1187,0.877826309,0.908413829,0.847000815,,,
1508,서울,강북구,2015,1855,928,927,5,2014,2352,1224,1128,0.808004802,0.774985691,0.843961217,,,
1509,서울,강북구,2016,1778,898,880,5,2015,2355,1196,1159,0.7734784,0.767489217,0.779742294,,,
1510,서울,강북구,2017,1791,911,880,5,2016,2239,1119,1120,0.819499773,0.832176439,0.806894034,,,
1511,서울,강북구,2018,1753,897,856,5,2017,2249,1189,1060,0.798545756,0.771147959,0.829315447,,,
1512,서울,강북구,2019,1706,892,814,5,2018,1968,1034,934,0.888098789,0.881802734,0.895013083,,,
1513,서울,강북구,2020,1528,810,718,5,2019,1791,927,864,0.874047658,0.893166468,0.85341949,,,
1514,서울,강서구,2009,5290,2774,2516,5,2008,5612,2868,2744,0.965706945,0.988677009,0.941625877,,,
1515,서울,강서구,2010,5328,2743,2585,5,2009,5343,2770,2573,1.021612945,1.012215921,1.031745578,,,
1516,서울,강서구,2011,4919,2540,2379,5,2010,4672,2379,2293,1.078651952,1.091355898,1.065472494,,,
1517,서울,강서구,2012,4386,2224,2162,5,2011,4717,2471,2246,0.952598945,0.920002829,0.988548071,,,
1518,서울,강서구,2013,4427,2324,2103,5,2012,5052,2575,2477,0.897746096,0.922541721,0.871896875,,,
1519,서울,강서구,2014,4807,2442,2365,5,2013,4752,2399,2353,1.03634662,1.040501084,1.032193389,,,
1520,서울,강서구,2015,4757,2433,2324,5,2014,4627,2381,2246,1.053273111,1.044503354,1.06262059,,,
1521,서울,강서구,2016,4413,2289,2124,5,2015,4803,2513,2290,0.94130136,0.931065918,0.952512942,,,
1522,서울,강서구,2017,4529,2353,2176,5,2016,5163,2625,2538,0.898685099,0.916262146,0.880479256,,,
1523,서울,강서구,2018,4816,2460,2356,5,2017,5399,2771,2628,0.913861741,0.907456272,0.920665312,,,
1524,서울,강서구,2019,4946,2556,2390,5,2018,4812,2449,2363,1.053018106,1.066839752,1.038690201,,,
1525,서울,강서구,2020,4277,2180,2097,5,2019,4593,2269,2324,0.9540039,0.982085102,0.926646654,,,
1526,서울,관악구,2009,3626,1916,1710,5,2008,4326,2186,2140,0.858714171,0.895926686,0.820605063,,,
1527,서울,관악구,2010,3663,1895,1768,5,2009,4031,2077,1954,0.930960953,0.932609517,0.92920076,,,
1528,서울,관악구,2011,3379,1767,1612,5,2010,3724,1891,1833,0.92957806,0.955151245,0.903138648,,,
1529,서울,관악구,2012,3148,1594,1554,5,2011,3680,1930,1750,0.876383617,0.844224853,0.911936967,,,
1530,서울,관악구,2013,3029,1606,1423,5,2012,3811,1916,1895,0.814268566,0.85679547,0.771165409,,,
1531,서울,관악구,2014,3225,1623,1602,5,2013,3510,1801,1709,0.941304094,0.921153343,0.96265862,,,
1532,서울,관악구,2015,3014,1560,1454,5,2014,3224,1663,1561,0.957757497,0.958869433,0.956562516,,,
1533,서울,관악구,2016,2732,1422,1310,5,2015,3225,1633,1592,0.867877284,0.890103558,0.845045488,,,
1534,서울,관악구,2017,2769,1411,1358,5,2016,3257,1658,1599,0.870988744,0.869900565,0.872174051,,,
1535,서울,관악구,2018,2687,1393,1294,5,2017,3133,1601,1532,0.878647377,0.88937908,0.867415875,,,
1536,서울,관악구,2019,2581,1318,1263,5,2018,2717,1393,1324,0.973208092,0.967144618,0.979641604,,,
1537,서울,관악구,2020,2302,1169,1133,5,2019,2667,1370,1297,0.884279687,0.872210016,0.897101926,,,
1538,서울,광진구,2009,3003,1547,1456,5,2008,3149,1640,1509,0.976989771,0.964214351,0.99088668,,,
1539,서울,광진구,2010,2935,1539,1396,5,2009,2993,1541,1452,1.004635994,1.020852758,0.987348924,,,
1540,서울,광진구,2011,2839,1442,1397,5,2010,2581,1286,1295,1.126898325,1.146176282,1.107843701,,,
1541,서울,광진구,2012,2528,1266,1262,5,2011,2721,1361,1360,0.951822295,0.950829628,0.952954799,,,
1542,서울,광진구,2013,2689,1341,1348,5,2012,2879,1468,1411,0.956877808,0.93374835,0.981103293,,,
1543,서울,광진구,2014,2817,1416,1401,5,2013,2658,1403,1255,1.085773445,1.031650772,1.146426627,,,
1544,서울,광진구,2015,2601,1364,1237,5,2014,2423,1244,1179,1.099750792,1.120781917,1.077476358,,,
1545,서울,광진구,2016,2407,1246,1161,5,2015,2562,1342,1220,0.962507916,0.949057776,0.977291776,,,
1546,서울,광진구,2017,2550,1366,1184,5,2016,2472,1204,1268,1.05681522,1.159715169,0.958924255,,,
1547,서울,광진구,2018,2480,1248,1232,5,2017,2609,1342,1267,0.973834031,0.950581143,0.998587092,,,
1548,서울,광진구,2019,2599,1350,1249,5,2018,2287,1180,1107,1.164253253,1.169442536,1.158688436,,,
1549,서울,광진구,2020,2244,1124,1120,5,2019,2235,1175,1060,1.028614567,0.977812467,1.085085631,,,
1550,서울,구로구,2009,3478,1790,1688,5,2008,3894,2012,1882,0.915041889,0.9093942,0.921095538,,,
1551,서울,구로구,2010,3539,1820,1719,5,2009,3866,2014,1852,0.937834183,0.923717235,0.953205961,,,
1552,서울,구로구,2011,3447,1795,1652,5,2010,3563,1938,1625,0.991134985,0.946755432,1.044019313,,,
1553,서울,구로구,2012,3288,1778,1510,5,2011,3774,1945,1829,0.892559667,0.93441387,0.847842333,,,
1554,서울,구로구,2013,3371,1726,1645,5,2012,4088,2065,2023,0.844802539,0.85437368,0.835068063,,,
1555,서울,구로구,2014,3665,1867,1798,5,2013,3880,1994,1886,0.967719737,0.957075699,0.979038689,,,
1556,서울,구로구,2015,3516,1788,1728,5,2014,3772,1909,1863,0.954958564,0.957389613,0.952538939,,,
1557,서울,구로구,2016,3329,1689,1640,5,2015,3918,1977,1941,0.870475814,0.873273146,0.86770114,,,
1558,서울,구로구,2017,3464,1761,1703,5,2016,3758,1922,1836,0.944340146,0.936554593,0.952563259,,,
1559,서울,구로구,2018,3320,1684,1636,5,2017,3691,1824,1867,0.921512825,0.94372265,0.899892923,,,
1560,서울,구로구,2019,3305,1615,1690,5,2018,3325,1696,1629,1.018326767,0.973360693,1.065411734,,,
1561,서울,구로구,2020,3014,1551,1463,5,2019,3109,1582,1527,0.993184358,1.002149338,0.983914009,,,
1562,서울,금천구,2009,1970,1005,965,5,2008,2119,1092,1027,0.95245094,0.940742032,0.964958697,,,
1563,서울,금천구,2010,1994,1025,969,5,2009,2020,1024,996,1.011302614,1.023177624,0.999116874,,,
1564,서울,금천구,2011,1799,926,873,5,2010,1756,899,857,1.049576255,1.052878895,1.046129085,,,
1565,서울,금천구,2012,1645,842,803,5,2011,1777,909,868,0.948387497,0.946837246,0.950052653,,,
1566,서울,금천구,2013,1661,850,811,5,2012,1836,923,913,0.926839002,0.941335311,0.91222492,,,
1567,서울,금천구,2014,1715,860,855,5,2013,1680,845,835,1.04583263,1.040324599,1.051553793,,,
1568,서울,금천구,2015,1550,797,753,5,2014,1589,817,772,0.999344315,0.997156651,1.001681219,,,
1569,서울,금천구,2016,1510,776,734,5,2015,1616,849,767,0.957288708,0.934288829,0.982771494,,,
1570,서울,금천구,2017,1610,828,782,5,2016,1580,807,773,1.043941432,1.048778866,1.038912841,,,
1571,서울,금천구,2018,1561,786,775,5,2017,1790,932,858,0.893423182,0.862052586,0.927611811,,,
1572,서울,금천구,2019,1656,844,812,5,2018,1381,711,670,1.228496714,1.21338877,1.244609414,,,
1573,서울,금천구,2020,1336,676,660,5,2019,1414,724,690,0.967975564,0.954410602,0.982305781,,,
1574,서울,노원구,2009,5899,2997,2902,5,2008,5948,3104,2844,1.016049301,0.986943192,1.047899592,,,
1575,서울,노원구,2010,5881,3089,2792,5,2009,5681,2921,2760,1.060556318,1.08096959,1.038862781,,,
1576,서울,노원구,2011,5545,2878,2667,5,2010,4930,2529,2401,1.152290487,1.163239351,1.1407296,,,
1577,서울,노원구,2012,4907,2527,2380,5,2011,4866,2526,2340,1.03312126,1.022584066,1.044510848,,,
1578,서울,노원구,2013,4883,2532,2351,5,2012,5225,2678,2547,0.957431639,0.966451922,0.94792841,,,
1579,서울,노원구,2014,5183,2664,2519,5,2013,4903,2495,2408,1.082995522,1.091417205,1.074294964,,,
1580,서울,노원구,2015,4895,2507,2388,5,2014,4306,2209,2097,1.164624752,1.160074134,1.169466396,,,
1581,서울,노원구,2016,4329,2220,2109,5,2015,4502,2324,2178,0.98512069,0.976436434,0.994421624,,,
1582,서울,노원구,2017,4470,2271,2199,5,2016,4273,2161,2112,1.07172158,1.074210746,1.069259631,,,
1583,서울,노원구,2018,4236,2146,2090,5,2017,4402,2255,2147,0.985855488,0.972770287,0.999691724,,,
1584,서울,노원구,2019,4318,2217,2101,5,2018,3759,1934,1825,1.17684064,1.171753741,1.182265561,,,
1585,서울,노원구,2020,3821,1979,1842,5,2019,3715,1905,1810,1.053720829,1.061886109,1.045112173,,,
1586,서울,도봉구,2009,3371,1751,1620,5,2008,3298,1651,1647,1.047165792,1.084092146,1.010120699,,,
1587,서울,도봉구,2010,3432,1741,1691,5,2009,3155,1608,1547,1.114436329,1.106725335,1.122548591,,,
1588,서울,도봉구,2011,3209,1631,1578,5,2010,2666,1361,1305,1.233152868,1.224962972,1.241790527,,,
1589,서울,도봉구,2012,2781,1452,1329,5,2011,2723,1429,1294,1.046310763,1.038631555,1.054733062,,,
1590,서울,도봉구,2013,2891,1517,1374,5,2012,2973,1527,1446,0.996232092,1.015485366,0.975821303,,,
1591,서울,도봉구,2014,3151,1619,1532,5,2013,2703,1421,1282,1.194289744,1.164608341,1.227220483,,,
1592,서울,도봉구,2015,2813,1464,1349,5,2014,2535,1279,1256,1.136839392,1.170031779,1.102996579,,,
1593,서울,도봉구,2016,2684,1360,1324,5,2015,2679,1387,1292,1.026401181,1.002281173,1.052391488,,,
1594,서울,도봉구,2017,2737,1411,1326,5,2016,2578,1347,1231,1.087675208,1.070746204,1.106209353,,,
1595,서울,도봉구,2018,2572,1313,1259,5,2017,2587,1357,1230,1.018548892,0.989035781,1.051168829,,,
1596,서울,도봉구,2019,2601,1348,1253,5,2018,2191,1134,1057,1.216200898,1.215077455,1.217384979,,,
1597,서울,도봉구,2020,2214,1137,1077,5,2019,2238,1150,1088,1.013502629,1.010624331,1.016573216,,,
1598,서울,동대문구,2009,2796,1388,1408,5,2008,3092,1596,1496,0.926413824,0.888963039,0.966546865,,,
1599,서울,동대문구,2010,2808,1450,1358,5,2009,2880,1474,1406,0.99887688,1.005536047,0.991896378,,,
1600,서울,동대문구,2011,2664,1371,1293,5,2010,2617,1351,1266,1.042888415,1.037311592,1.04885795,,,
1601,서울,동대문구,2012,2384,1249,1135,5,2011,2665,1341,1324,0.916466053,0.952052255,0.880358844,,,
1602,서울,동대문구,2013,2501,1260,1241,5,2012,2883,1508,1375,0.888743412,0.854075628,0.926874509,,,
1603,서울,동대문구,2014,2693,1430,1263,5,2013,2773,1394,1379,0.994932985,1.048577149,0.940569604,,,
1604,서울,동대문구,2015,2596,1329,1267,5,2014,2573,1306,1267,1.033646997,1.04018103,1.026956044,,,
1605,서울,동대문구,2016,2348,1218,1130,5,2015,2653,1349,1304,0.906709545,0.922916614,0.889923566,,,
1606,서울,동대문구,2017,2396,1217,1179,5,2016,2534,1313,1221,0.968696094,0.947442751,0.991630775,,,
1607,서울,동대문구,2018,2284,1168,1116,5,2017,2587,1304,1283,0.904496761,0.915571735,0.893283667,,,
1608,서울,동대문구,2019,2386,1227,1159,5,2018,2315,1213,1102,1.055909724,1.033977021,1.08007446,,,
1609,서울,동대문구,2020,2136,1117,1019,5,2019,2334,1197,1137,0.93757872,0.953863319,0.920376613,,,
1610,서울,동작구,2009,3311,1731,1580,5,2008,3477,1837,1640,0.975577634,0.963196813,0.989384481,,,
1611,서울,동작구,2010,3219,1675,1544,5,2009,3373,1759,1614,0.97771433,0.973365832,0.982416438,,,
1612,서울,동작구,2011,3075,1588,1487,5,2010,3063,1554,1509,1.028502777,1.044543688,1.011983855,,,
1613,서울,동작구,2012,2821,1432,1389,5,2011,3037,1541,1496,0.951624554,0.94987729,0.953503974,,,
1614,서울,동작구,2013,3028,1552,1476,5,2012,3380,1804,1576,0.917796751,0.879391592,0.961793858,,,
1615,서울,동작구,2014,3176,1718,1458,5,2013,3199,1645,1554,1.01712329,1.067540555,0.963514744,,,
1616,서울,동작구,2015,2904,1475,1429,5,2014,3047,1525,1522,0.976408391,0.988665323,0.964205116,,,
1617,서울,동작구,2016,2807,1412,1395,5,2015,3191,1672,1519,0.901203674,0.86322806,0.943122897,,,
1618,서울,동작구,2017,2950,1561,1389,5,2016,3107,1614,1493,0.972720588,0.988613412,0.955419923,,,
1619,서울,동작구,2018,2801,1419,1382,5,2017,3149,1631,1518,0.911271512,0.889314882,0.934949442,,,
1620,서울,동작구,2019,2805,1427,1378,5,2018,2827,1414,1413,1.01651643,1.031577091,1.00151835,,,
1621,서울,동작구,2020,2545,1287,1258,5,2019,2800,1474,1326,0.931187421,0.892499926,0.974291631,,,
1622,서울,마포구,2009,2926,1480,1446,5,2008,3665,1881,1784,0.817914087,0.804266622,0.832387018,,,
1623,서울,마포구,2010,3122,1603,1519,5,2009,3479,1780,1699,0.919360446,0.92053572,0.918155521,,,
1624,서울,마포구,2011,3052,1548,1504,5,2010,3121,1619,1502,1.001839396,0.977352511,1.028323495,,,
1625,서울,마포구,2012,2774,1427,1347,5,2011,3251,1643,1608,0.874171881,0.887796718,0.860267283,,,
1626,서울,마포구,2013,2813,1439,1374,5,2012,3546,1846,1700,0.812715132,0.796812654,0.83002212,,,
1627,서울,마포구,2014,3100,1583,1517,5,2013,3267,1699,1568,0.972120059,0.952389637,0.993553775,,,
1628,서울,마포구,2015,2917,1505,1412,5,2014,3054,1596,1458,0.978531345,0.963897243,0.99455551,,,
1629,서울,마포구,2016,2638,1363,1275,5,2015,3116,1589,1527,0.867330637,0.876797058,0.857478033,,,
1630,서울,마포구,2017,2676,1366,1310,5,2016,2937,1463,1474,0.933446664,0.954406742,0.912694991,,,
1631,서울,마포구,2018,2458,1223,1235,5,2017,3001,1538,1463,0.839118369,0.812825363,0.866910946,,,
1632,서울,마포구,2019,2572,1312,1260,5,2018,2659,1317,1342,0.990968779,1.018298691,0.964206122,,,
1633,서울,마포구,2020,2211,1092,1119,5,2019,2720,1341,1379,0.83277405,0.832378753,0.833331264,,,
1634,서울,서대문구,2009,2657,1405,1252,5,2008,2833,1445,1388,0.960842767,0.993883779,0.926332109,,,
1635,서울,서대문구,2010,2666,1342,1324,5,2009,2765,1388,1377,0.987807581,0.98830314,0.98742905,,,
1636,서울,서대문구,2011,2435,1235,1200,5,2010,2329,1158,1171,1.071116778,1.090148154,1.052388772,,,
1637,서울,서대문구,2012,2166,1096,1070,5,2011,2358,1190,1168,0.941070147,0.941435819,0.940790211,,,
1638,서울,서대문구,2013,2272,1152,1120,5,2012,2320,1164,1156,1.003292781,1.01164147,0.994974714,,,
1639,서울,서대문구,2014,2204,1102,1102,5,2013,2243,1185,1058,1.006675877,0.950583714,1.069664991,,,
1640,서울,서대문구,2015,2109,1080,1029,5,2014,2136,1074,1062,1.011539105,1.027889902,0.99504498,,,
1641,서울,서대문구,2016,2213,1110,1103,5,2015,2248,1199,1049,1.008538432,0.946304534,1.079821274,,,
1642,서울,서대문구,2017,2288,1220,1068,5,2016,2197,1073,1124,1.066923567,1.162217028,0.975790974,,,
1643,서울,서대문구,2018,2140,1054,1086,5,2017,2312,1179,1133,0.94827279,0.913805844,0.984355043,,,
1644,서울,서대문구,2019,2243,1144,1099,5,2018,2164,1108,1056,1.061889588,1.055391007,1.068773383,,,
1645,서울,서대문구,2020,2179,1104,1075,5,2019,2217,1113,1104,1.006929078,1.013913801,0.999979843,,,
1646,서울,서초구,2009,3120,1600,1520,5,2008,3436,1774,1662,0.930269504,0.921920543,0.93921371,,,
1647,서울,서초구,2010,3468,1819,1649,5,2009,3580,1816,1764,0.992438052,1.023868025,0.960005962,,,
1648,서울,서초구,2011,3431,1763,1668,5,2010,3346,1744,1602,1.050514682,1.033315531,1.069265094,,,
1649,서울,서초구,2012,3225,1683,1542,5,2011,3654,1901,1753,0.904208367,0.90495946,0.903346389,,,
1650,서울,서초구,2013,3547,1804,1743,5,2012,3906,2011,1895,0.930328434,0.916962527,0.944582789,,,
1651,서울,서초구,2014,3840,1982,1858,5,2013,4149,2101,2048,0.948189485,0.964283472,0.931681801,,,
1652,서울,서초구,2015,3926,1998,1928,5,2014,4030,2053,1977,0.998050679,0.994795151,1.00150291,,,
1653,서울,서초구,2016,3662,1865,1797,5,2015,4447,2248,2199,0.843642705,0.848026951,0.839217831,,,
1654,서울,서초구,2017,4031,2064,1967,5,2016,4321,2286,2035,0.955731449,0.922912636,0.992640068,,,
1655,서울,서초구,2018,3861,2018,1843,5,2017,4375,2243,2132,0.904126273,0.919642458,0.887748588,,,
1656,서울,서초구,2019,3854,1984,1870,5,2018,3904,2030,1874,1.011368089,0.999016716,1.024764035,,,
1657,서울,서초구,2020,3479,1831,1648,5,2019,3762,1963,1799,0.947420948,0.953443956,0.940757955,,,
1658,서울,성동구,2009,2624,1321,1303,5,2008,2867,1411,1456,0.937655883,0.956980149,0.91904102,,,
1659,서울,성동구,2010,2581,1270,1311,5,2009,2768,1467,1301,0.955276874,0.88491332,1.034849634,,,
1660,서울,성동구,2011,2472,1282,1190,5,2010,2465,1256,1209,1.027398407,1.043339167,1.01081695,,,
1661,서울,성동구,2012,2192,1127,1065,5,2011,2391,1243,1148,0.939222134,0.926786956,0.95270748,,,
1662,서울,성동구,2013,2223,1155,1068,5,2012,2664,1338,1326,0.854894627,0.882374596,0.827141067,,,
1663,서울,성동구,2014,2396,1186,1210,5,2013,2443,1290,1153,1.004779329,0.93977114,1.077724903,,,
1664,서울,성동구,2015,2147,1107,1040,5,2014,2129,1061,1068,1.033150828,1.066496323,1.000032103,,,
1665,서울,성동구,2016,1995,1006,989,5,2015,2284,1168,1116,0.894858043,0.880404519,0.910089182,,,
1666,서울,성동구,2017,2111,1092,1019,5,2016,2330,1197,1133,0.928195925,0.932514542,0.923625956,,,
1667,서울,성동구,2018,2100,1069,1031,5,2017,2428,1249,1179,0.886090249,0.874867719,0.898042138,,,
1668,서울,성동구,2019,2102,1042,1060,5,2018,2392,1222,1170,0.900282652,0.871612878,0.930404621,,,
1669,서울,성동구,2020,1891,987,904,5,2019,2317,1160,1157,0.836128141,0.869733681,0.802392622,,,
1670,서울,성북구,2009,4146,2139,2007,5,2008,4594,2416,2178,0.924582464,0.904984165,0.946327264,,,
1671,서울,성북구,2010,4427,2315,2112,5,2009,4429,2349,2080,1.02402648,1.007384128,1.042755368,,,
1672,서울,성북구,2011,4336,2285,2051,5,2010,4159,2162,1997,1.06808963,1.080332995,1.054725511,,,
1673,서울,성북구,2012,3986,2079,1907,5,2011,4148,2130,2018,0.98447772,0.997704684,0.970468372,,,
1674,서울,성북구,2013,4035,2069,1966,5,2012,4504,2276,2228,0.917809402,0.929213174,0.906191913,,,
1675,서울,성북구,2014,4256,2171,2085,5,2013,4090,2114,1976,1.066069839,1.049740531,1.083604935,,,
1676,서울,성북구,2015,3876,2005,1871,5,2014,3778,1948,1830,1.051063997,1.052089169,1.049964349,,,
1677,서울,성북구,2016,3592,1841,1751,5,2015,3849,1964,1885,0.956083365,0.958163075,0.953952272,,,
1678,서울,성북구,2017,3718,1878,1840,5,2016,3718,1914,1804,1.024489107,1.002953457,1.047449623,,,
1679,서울,성북구,2018,3604,1859,1745,5,2017,3685,1896,1789,1.001969808,1.002231808,1.001698321,,,
1680,서울,성북구,2019,3539,1827,1712,5,2018,3187,1610,1577,1.137642595,1.159951409,1.114869212,,,
1681,서울,성북구,2020,3137,1558,1579,5,2019,3257,1681,1576,0.986743116,0.947385787,1.028910909,,,
1682,서울,송파구,2009,5683,2996,2687,5,2008,6052,3104,2948,0.962024388,0.986613882,0.936034902,,,
1683,서울,송파구,2010,5705,2999,2706,5,2009,6043,3094,2949,0.967186887,0.990793803,0.94233403,,,
1684,서울,송파구,2011,5636,2906,2730,5,2010,5452,2810,2642,1.059064675,1.057100834,1.061161998,,,
1685,서울,송파구,2012,5046,2619,2427,5,2011,5580,2878,2702,0.926446601,0.930190359,0.922436091,,,
1686,서울,송파구,2013,5184,2699,2485,5,2012,6008,3112,2896,0.883979949,0.886523845,0.881210556,,,
1687,서울,송파구,2014,5697,2942,2755,5,2013,5679,2956,2723,1.027736299,1.017338228,1.039024569,,,
1688,서울,송파구,2015,5204,2715,2489,5,2014,5486,2806,2680,0.971826707,0.989029607,0.953766266,,,
1689,서울,송파구,2016,5075,2599,2476,5,2015,5731,2946,2785,0.907220768,0.901780131,0.913013704,,,
1690,서울,송파구,2017,5300,2705,2595,5,2016,5604,2917,2687,0.968913681,0.947890052,0.99179417,,,
1691,서울,송파구,2018,5216,2717,2499,5,2017,5933,3021,2912,0.900680125,0.919318582,0.881306028,,,
1692,서울,송파구,2019,5620,2853,2767,5,2018,5335,2734,2601,1.079218141,1.066670752,1.092498029,,,
1693,서울,송파구,2020,4926,2515,2411,5,2019,5584,2866,2718,0.903766716,0.896992741,0.910960641,,,
1694,서울,양천구,2009,4225,2225,2000,5,2008,4597,2396,2201,0.941585051,0.949227533,0.933172234,,,
1695,서울,양천구,2010,4252,2217,2035,5,2009,4372,2319,2053,0.996369553,0.977219377,1.017952045,,,
1696,서울,양천구,2011,4106,2175,1931,5,2010,3841,1968,1873,1.095171121,1.129695224,1.058757139,,,
1697,서울,양천구,2012,3749,1976,1773,5,2011,3919,1952,1967,0.980048396,1.034747182,0.925670089,,,
1698,서울,양천구,2013,3764,1877,1887,5,2012,4296,2210,2086,0.897620345,0.868158705,0.928986603,,,
1699,서울,양천구,2014,4100,2111,1989,5,2013,4132,2146,1986,1.016555019,1.005508256,1.028507337,,,
1700,서울,양천구,2015,4071,2096,1975,5,2014,3690,1870,1820,1.13026969,1.145715523,1.114416586,,,
1701,서울,양천구,2016,3616,1854,1762,5,2015,3884,1991,1893,0.953798304,0.951843602,0.955888299,,,
1702,서울,양천구,2017,3815,1936,1879,5,2016,3840,2025,1815,1.017819256,0.977253987,1.063168268,,,
1703,서울,양천구,2018,3736,1965,1771,5,2017,3878,1986,1892,0.986975582,1.011370859,0.961278622,,,
1704,서울,양천구,2019,3731,1899,1832,5,2018,3495,1789,1706,1.093667771,1.085030008,1.102803911,,,
1705,서울,양천구,2020,3575,1850,1725,5,2019,3493,1779,1714,1.048539524,1.062974645,1.033546777,,,
1706,서울,영등포구,2009,3064,1592,1472,5,2008,3801,2016,1785,0.825844416,0.807197226,0.846879158,,,
1707,서울,영등포구,2010,3117,1631,1486,5,2009,3706,1942,1764,0.861665555,0.858483319,0.865111497,,,
1708,서울,영등포구,2011,2983,1555,1428,5,2010,3187,1694,1493,0.958911518,0.938305177,0.982245968,,,
1709,서울,영등포구,2012,2571,1329,1242,5,2011,3228,1693,1535,0.815973202,0.802407812,0.830931209,,,
1710,서울,영등포구,2013,2660,1397,1263,5,2012,3456,1784,1672,0.788524602,0.800439812,0.775744906,,,
1711,서울,영등포구,2014,2848,1498,1350,5,2013,3134,1596,1538,0.930997121,0.959414,0.901424356,,,
1712,서울,영등포구,2015,2589,1324,1265,5,2014,2903,1488,1415,0.9136763,0.909519844,0.918091446,,,
1713,서울,영등포구,2016,2377,1211,1166,5,2015,2954,1478,1476,0.824377322,0.837523177,0.811267444,,,
1714,서울,영등포구,2017,2377,1189,1188,5,2016,2833,1376,1457,0.859587225,0.883264033,0.837353315,,,
1715,서울,영등포구,2018,2457,1187,1270,5,2017,2925,1467,1458,0.86057085,0.827080403,0.894536472,,,
1716,서울,영등포구,2019,2564,1285,1279,5,2018,2580,1338,1242,1.018135687,0.981689486,1.057549742,,,
1717,서울,영등포구,2020,2265,1168,1097,5,2019,2644,1373,1271,0.877635336,0.869559754,0.886365681,,,
1718,서울,용산구,2009,1635,840,795,5,2008,1950,999,951,0.858994713,0.859490188,0.858496377,,,
1719,서울,용산구,2010,1559,795,764,5,2009,1932,999,933,0.826696956,0.813446071,0.840937211,,,
1720,서울,용산구,2011,1522,786,736,5,2010,1785,924,861,0.873541973,0.869516245,0.877862542,,,
1721,서울,용산구,2012,1428,726,702,5,2011,1827,944,883,0.800750107,0.786125261,0.8164475,,,
1722,서울,용산구,2013,1386,727,659,5,2012,2012,995,1017,0.705736532,0.746858719,0.66545136,,,
1723,서울,용산구,2014,1593,777,816,5,2013,1814,910,904,0.899675385,0.872783951,0.926986871,,,
1724,서울,용산구,2015,1414,700,714,5,2014,1634,807,827,0.886552997,0.8866488,0.886634359,,,
1725,서울,용산구,2016,1286,658,628,5,2015,1637,811,826,0.80482162,0.829339145,0.780784982,,,
1726,서울,용산구,2017,1253,632,621,5,2016,1679,880,799,0.764553217,0.734110662,0.798172344,,,
1727,서울,용산구,2018,1248,660,588,5,2017,1698,849,849,0.752981393,0.794627097,0.711248709,,,
1728,서울,용산구,2019,1245,642,603,5,2018,1501,772,729,0.849759453,0.850050746,0.849457468,,,
1729,서울,용산구,2020,1090,553,537,5,2019,1448,755,693,0.771196911,0.748695642,0.795779792,,,
1730,서울,은평구,2009,4303,2215,2088,5,2008,4224,2196,2028,1.04364977,1.031023395,1.057339359,,,
1731,서울,은평구,2010,4307,2236,2071,5,2009,3975,2042,1933,1.1100565,1.119291451,1.100272099,,,
1732,서울,은평구,2011,4155,2143,2012,5,2010,3719,1911,1808,1.144595924,1.146274442,1.142829403,,,
1733,서울,은평구,2012,3852,1988,1864,5,2011,4073,2072,2001,0.968900575,0.980739697,0.95664471,,,
1734,서울,은평구,2013,4137,2127,2010,5,2012,4524,2351,2173,0.93685045,0.924787575,0.949922526,,,
1735,서울,은평구,2014,4359,2270,2089,5,2013,4174,2183,1991,1.069896507,1.06291674,1.077504357,,,
1736,서울,은평구,2015,3960,2062,1898,5,2014,3933,2002,1931,1.031522213,1.05281415,1.009405785,,,
1737,서울,은평구,2016,3737,1924,1813,5,2015,4056,2080,1976,0.94391415,0.945515947,0.942242565,,,
1738,서울,은평구,2017,3803,1941,1862,5,2016,3835,1959,1876,1.015940567,1.012787248,1.019292193,,,
1739,서울,은평구,2018,3569,1837,1732,5,2017,3923,2058,1865,0.932042219,0.912411838,0.953720036,,,
1740,서울,은평구,2019,3686,1930,1756,5,2018,3298,1743,1555,1.145017238,1.131845236,1.159700844,,,
1741,서울,은평구,2020,3150,1650,1500,5,2019,3301,1700,1601,0.977625171,0.992115302,0.962169935,,,
1742,서울,종로구,2009,1132,601,531,5,2008,1183,624,559,0.980322629,0.984502918,0.975516385,,,
1743,서울,종로구,2010,1109,577,532,5,2009,1134,610,524,1.001903369,0.966881172,1.042634762,,,
1744,서울,종로구,2011,1065,557,508,5,2010,1015,515,500,1.074956551,1.105541606,1.043387341,,,
1745,서울,종로구,2012,954,490,464,5,2011,1052,536,516,0.929051909,0.934455051,0.923464349,,,
1746,서울,종로구,2013,988,528,460,5,2012,1067,540,527,0.948636587,0.999464304,0.89639427,,,
1747,서울,종로구,2014,1009,520,489,5,2013,1014,527,487,1.019437386,1.008602067,1.031173522,,,
1748,서울,종로구,2015,976,504,472,5,2014,873,475,398,1.145362393,1.084586145,1.21789762,,,
1749,서울,종로구,2016,876,454,422,5,2015,964,497,467,0.93096728,0.933741345,0.927998823,,,
1750,서울,종로구,2017,926,459,467,5,2016,877,443,434,1.081729662,1.059097846,1.105042563,,,
1751,서울,종로구,2018,862,443,419,5,2017,1046,535,511,0.84427305,0.846402757,0.842063762,,,
1752,서울,종로구,2019,946,478,468,5,2018,865,435,430,1.120423926,1.123222424,1.117710299,,,
1753,서울,종로구,2020,764,381,383,5,2019,877,442,435,0.89248538,0.881109394,0.904193482,,,
1754,서울,중구,2009,1173,598,575,5,2008,980,483,497,1.226250738,1.26555545,1.18812822,,,
1755,서울,중구,2010,1138,570,568,5,2009,937,473,464,1.244256781,1.231801817,1.257135847,,,
1756,서울,중구,2011,1067,541,526,5,2010,794,396,398,1.376737881,1.396462264,1.357233364,,,
1757,서울,중구,2012,976,495,481,5,2011,841,421,420,1.188943364,1.201849891,1.176109184,,,
1758,서울,중구,2013,951,469,482,5,2012,1057,537,520,0.921749424,0.892741415,0.951909256,,,
1759,서울,중구,2014,1089,531,558,5,2013,875,445,430,1.275049872,1.219724186,1.332654587,,,
1760,서울,중구,2015,977,481,496,5,2014,767,393,374,1.304988081,1.251064357,1.3619524,,,
1761,서울,중구,2016,883,443,440,5,2015,838,426,412,1.079503439,1.062970599,1.096749173,,,
1762,서울,중구,2017,868,456,412,5,2016,843,431,412,1.054871347,1.081470551,1.026956044,,,
1763,서울,중구,2018,898,439,459,5,2017,862,438,424,1.067275195,1.024513145,1.111728359,,,
1764,서울,중구,2019,919,459,460,5,2018,788,409,379,1.194803921,1.147140209,1.246437415,,,
1765,서울,중구,2020,907,455,452,5,2019,766,386,380,1.213070001,1.204900591,1.221537189,,,
1766,서울,중랑구,2009,3200,1656,1544,5,2008,3561,1794,1767,0.920630481,0.943550217,0.897351518,,,
1767,서울,중랑구,2010,3259,1645,1614,5,2009,3372,1699,1673,0.990157177,0.989691063,0.990739423,,,
1768,서울,중랑구,2011,3043,1525,1518,5,2010,2964,1549,1415,1.051794991,1.006341891,1.101709735,,,
1769,서울,중랑구,2012,2670,1410,1260,5,2011,3061,1637,1424,0.893624932,0.880435527,0.908683016,,,
1770,서울,중랑구,2013,2747,1452,1295,5,2012,3176,1609,1567,0.886105661,0.922439088,0.848696922,,,
1771,서울,중랑구,2014,2883,1481,1402,5,2013,3015,1539,1476,0.979635853,0.983656722,0.975469088,,,
1772,서울,중랑구,2015,2812,1423,1389,5,2014,2911,1441,1470,0.989647327,1.009411027,0.97036867,,,
1773,서울,중랑구,2016,2563,1281,1282,5,2015,2911,1517,1394,0.902014972,0.863158744,0.944445946,,,
1774,서울,중랑구,2017,2652,1358,1294,5,2016,2981,1532,1449,0.911420702,0.906083308,0.917102223,,,
1775,서울,중랑구,2018,2647,1368,1279,5,2017,3050,1584,1466,0.889122186,0.882791302,0.895959604,,,
1776,서울,중랑구,2019,2717,1416,1301,5,2018,2714,1389,1325,1.025621557,1.04204898,1.008354576,,,
1777,서울,중랑구,2020,2369,1218,1151,5,2019,2453,1235,1218,0.989406725,1.008108917,0.97046503,,,
1778,세종,세종시,2013,1182,609,573,5,2012,1281,635,646,0.945313134,0.980326387,0.910906831,,,
1779,세종,세종시,2014,1504,741,763,5,2013,1455,749,706,1.058990802,1.011261598,1.109868926,,,
1780,세종,세종시,2015,2578,1287,1291,5,2014,1952,981,971,1.353039405,1.341024353,1.365396759,,,
1781,세종,세종시,2016,3248,1649,1599,5,2015,3163,1617,1546,1.05202043,1.042408061,1.06216217,,,
1782,세종,세종시,2017,3839,1968,1871,5,2016,3627,1827,1800,1.084371018,1.101066811,1.067463754,,,
1783,세종,세종시,2018,4442,2310,2132,5,2017,4338,2191,2147,1.049050395,1.077697133,1.019781223,,,
1784,세종,세종시,2019,5004,2576,2428,5,2018,4502,2278,2224,1.138725787,1.15589734,1.121155249,,,
1785,세종,세종시,2020,4879,2489,2390,5,2019,4839,2472,2367,1.032957709,1.029208953,1.036934915,,,
1786,울산,남구,2009,3078,1617,1461,5,2008,3264,1744,1520,0.966108294,0.947743173,0.987093934,,,
1787,울산,남구,2010,3139,1664,1475,5,2009,3061,1641,1420,1.050595004,1.036506109,1.06673251,,,
1788,울산,남구,2011,2933,1576,1357,5,2010,2800,1479,1321,1.07315234,1.08921889,1.054942734,,,
1789,울산,남구,2012,2648,1402,1246,5,2011,2869,1484,1385,0.945572379,0.965697791,0.923889697,,,
1790,울산,남구,2013,2734,1383,1351,5,2012,3140,1649,1491,0.892023318,0.857291761,0.930528246,,,
1791,울산,남구,2014,2968,1563,1405,5,2013,2960,1549,1411,1.027257997,1.031417951,1.022589115,,,
1792,울산,남구,2015,2840,1482,1358,5,2014,2877,1492,1385,1.011313544,1.015328334,1.006935962,,,
1793,울산,남구,2016,2702,1411,1291,5,2015,2833,1495,1338,0.977115979,0.964745911,0.990882102,,,
1794,울산,남구,2017,2649,1410,1239,5,2016,2886,1490,1396,0.940357466,0.967297287,0.911460271,,,
1795,울산,남구,2018,2678,1414,1264,5,2017,2982,1514,1468,0.920047562,0.95466425,0.884245531,,,
1796,울산,남구,2019,2817,1450,1367,5,2018,2644,1344,1300,1.091522623,1.102797718,1.079883778,,,
1797,울산,남구,2020,2519,1270,1249,5,2019,2683,1389,1294,0.96186659,0.934606077,0.991242735,,,
1798,울산,동구,2009,1647,835,812,5,2008,1732,930,802,0.974211062,0.917763227,1.039760982,,,
1799,울산,동구,2010,1672,903,769,5,2009,1678,882,796,1.020825857,1.046517007,0.992122108,,,
1800,울산,동구,2011,1581,825,756,5,2010,1557,844,713,1.040280847,0.999168255,1.088890279,,,
1801,울산,동구,2012,1500,801,699,5,2011,1640,865,775,0.93703272,0.946549944,0.926248096,,,
1802,울산,동구,2013,1650,883,767,5,2012,1924,986,938,0.878589931,0.915400012,0.83973911,,,
1803,울산,동구,2014,1879,950,929,5,2013,1850,986,864,1.040548666,0.98485845,1.104215468,,,
1804,울산,동구,2015,1775,941,834,5,2014,1861,955,906,0.97714571,1.007194573,0.945343643,,,
1805,울산,동구,2016,1772,900,872,5,2015,1944,1018,926,0.933845009,0.903694953,0.967068758,,,
1806,울산,동구,2017,1890,997,893,5,2016,2014,1054,960,0.96141232,0.966900251,0.95528307,,,
1807,울산,동구,2018,1869,975,894,5,2017,2088,1071,1017,0.917035508,0.930555478,0.902751921,,,
1808,울산,동구,2019,1920,981,939,5,2018,1833,934,899,1.073114613,1.073616696,1.072649305,,,
1809,울산,동구,2020,1680,867,813,5,2019,1840,937,903,0.935403098,0.945815946,0.924601621,,,
1810,울산,북구,2009,2016,1099,917,5,2008,2166,1181,985,0.953541108,0.951206743,0.956059586,,,
1811,울산,북구,2010,2132,1161,971,5,2009,2139,1135,1004,1.021136408,1.045594966,0.993201513,,,
1812,울산,북구,2011,2142,1117,1025,5,2010,2129,1086,1043,1.030744795,1.051357636,1.009232929,,,
1813,울산,북구,2012,2068,1054,1014,5,2011,2290,1169,1121,0.925171823,0.921622831,0.928932586,,,
1814,울산,북구,2013,2248,1152,1096,5,2012,2614,1325,1289,0.881044955,0.888717488,0.873191485,,,
1815,울산,북구,2014,2526,1284,1242,5,2013,2405,1234,1171,1.07603305,1.06359672,1.08922238,,,
1816,울산,북구,2015,2349,1211,1138,5,2014,2364,1266,1098,1.017988542,0.977771924,1.064367922,,,
1817,울산,북구,2016,2278,1223,1055,5,2015,2457,1235,1222,0.949851928,1.012247295,0.886610987,,,
1818,울산,북구,2017,2446,1225,1221,5,2016,2499,1288,1211,1.002761247,0.972181497,1.035436275,,,
1819,울산,북구,2018,2599,1328,1271,5,2017,2714,1395,1319,0.981078552,0.973085481,0.989583875,,,
1820,울산,북구,2019,2828,1459,1369,5,2018,2590,1317,1273,1.11863135,1.132391608,1.104401276,,,
1821,울산,북구,2020,2713,1396,1317,5,2019,2832,1456,1376,0.981440307,0.980056625,0.982922318,,,
1822,울산,울주군,2009,2377,1262,1115,5,2008,2398,1241,1157,1.015517351,1.039476556,0.989676741,,,
1823,울산,울주군,2010,2381,1248,1133,5,2009,2290,1212,1078,1.065200247,1.052541167,1.07935176,,,
1824,울산,울주군,2011,2323,1228,1095,5,2010,2172,1159,1013,1.095712798,1.083033914,1.110085753,,,
1825,울산,울주군,2012,2213,1157,1056,5,2011,2093,1128,965,1.083227136,1.048458837,1.123798531,,,
1826,울산,울주군,2013,2145,1160,985,5,2012,2409,1212,1197,0.912216329,0.97832352,0.845072434,,,
1827,울산,울주군,2014,2461,1243,1218,5,2013,2230,1155,1075,1.130613315,1.100059738,1.16356508,,,
1828,울산,울주군,2015,2325,1222,1103,5,2014,2115,1076,1039,1.12621143,1.160876607,1.090214164,,,
1829,울산,울주군,2016,2179,1093,1086,5,2015,2301,1179,1122,0.970170259,0.947618394,0.994005583,,,
1830,울산,울주군,2017,2320,1183,1137,5,2016,2202,1151,1051,1.079389069,1.050597943,1.110988603,,,
1831,울산,울주군,2018,2262,1199,1063,5,2017,2272,1118,1154,1.019979912,1.096237123,0.945974241,,,
1832,울산,울주군,2019,2328,1143,1185,5,2018,2016,991,1025,1.183040993,1.178961712,1.187261377,,,
1833,울산,울주군,2020,2032,1016,1016,5,2019,2006,1051,955,1.03776763,0.988139175,1.092552189,,,
1834,울산,중구,2009,1997,1061,936,5,2008,2159,1156,1003,0.947616835,0.93817677,0.95835579,,,
1835,울산,중구,2010,2069,1134,935,5,2009,1910,988,922,1.109773803,1.173230205,1.041435901,,,
1836,울산,중구,2011,1893,1003,890,5,2010,1720,914,806,1.127533651,1.121713283,1.133983721,,,
1837,울산,중구,2012,1696,894,802,5,2011,1778,940,838,0.977240453,0.972157857,0.9828386,,,
1838,울산,중구,2013,1774,949,825,5,2012,1976,1037,939,0.919758946,0.935437081,0.902277674,,,
1839,울산,중구,2014,2023,1048,975,5,2013,1978,1026,952,1.047796494,1.044097479,1.051766957,,,
1840,울산,중구,2015,2063,1059,1004,5,2014,2002,1059,943,1.055704809,1.022179402,1.093386923,,,
1841,울산,중구,2016,2079,1113,966,5,2015,2254,1192,1062,0.944948028,0.954434291,0.934123859,,,
1842,울산,중구,2017,2179,1146,1033,5,2016,2300,1205,1095,0.970592072,0.972130784,0.968808761,,,
1843,울산,중구,2018,2181,1134,1047,5,2017,2342,1262,1080,0.954060949,0.91850352,0.995576831,,,
1844,울산,중구,2019,2188,1187,1001,5,2018,2110,1100,1010,1.062361217,1.1030245,1.01780495,,,
1845,울산,중구,2020,1911,974,937,5,2019,1944,983,961,1.007098089,1.01282069,1.001308859,,,
1846,인천,강화군,2009,422,229,193,5,2008,436,239,197,0.991592668,0.97941039,1.006104144,,,
1847,인천,강화군,2010,430,230,200,5,2009,402,198,204,1.095846558,1.187380114,1.006819651,,,
1848,인천,강화군,2011,381,188,193,5,2010,403,200,203,0.968561662,0.960848638,0.976367076,,,
1849,인천,강화군,2012,411,203,208,5,2011,387,187,200,1.088023316,1.109638602,1.068034286,,,
1850,인천,강화군,2013,377,183,194,5,2012,433,217,216,0.891991671,0.862022261,0.922358669,,,
1851,인천,강화군,2014,422,217,205,5,2013,364,174,190,1.187731877,1.274786956,1.108031521,,,
1852,인천,강화군,2015,382,186,196,5,2014,386,201,185,1.01387264,0.945897357,1.088018295,,,
1853,인천,강화군,2016,394,210,184,5,2015,394,205,189,1.024489107,1.047110607,0.999787895,,,
1854,인천,강화군,2017,402,213,189,5,2016,389,200,189,1.058726533,1.088621063,1.026956044,,,
1855,인천,강화군,2018,386,204,182,5,2017,395,210,185,1.001146318,0.992974276,1.010302703,,,
1856,인천,강화군,2019,353,183,170,5,2018,328,156,172,1.102575167,1.199095068,1.015014694,,,
1857,인천,강화군,2020,334,166,168,5,2019,338,168,170,1.012364976,1.0100106,1.014874208,,,
1858,인천,계양구,2009,3533,1901,1632,5,2008,3590,1823,1767,1.008222846,1.065914999,0.948495905,,,
1859,인천,계양구,2010,3450,1737,1713,5,2009,3437,1768,1669,1.028364103,1.004256573,1.05402978,,,
1860,인천,계양구,2011,3241,1688,1553,5,2010,3000,1512,1488,1.106789732,1.141163248,1.071816355,,,
1861,인천,계양구,2012,2837,1446,1391,5,2011,3054,1575,1479,0.951694695,0.938458042,0.965852506,,,
1862,인천,계양구,2013,2919,1512,1407,5,2012,3378,1716,1662,0.885282328,0.900661571,0.869390586,,,
1863,인천,계양구,2014,3228,1646,1582,5,2013,3122,1571,1551,1.059273171,1.070978546,1.047481922,,,
1864,인천,계양구,2015,2964,1488,1476,5,2014,2875,1488,1387,1.056203727,1.022179402,1.092853007,,,
1865,인천,계양구,2016,2720,1426,1294,5,2015,3011,1530,1481,0.925476709,0.952697927,0.897286375,,,
1866,인천,계양구,2017,2836,1430,1406,5,2016,2854,1432,1422,1.018027718,1.020751777,1.015400983,,,
1867,인천,계양구,2018,2606,1319,1287,5,2017,2761,1395,1366,0.966975231,0.966490775,0.967564003,,,
1868,인천,계양구,2019,2465,1258,1207,5,2018,2256,1180,1076,1.119399667,1.089747193,1.151985079,,,
1869,인천,계양구,2020,2091,1085,1006,5,2019,2204,1119,1085,0.971963123,0.991121226,0.952182286,,,
1870,인천,남동구,2009,4281,2202,2079,5,2008,4772,2454,2318,0.919077508,0.917212324,0.921070585,,,
1871,인천,남동구,2010,4753,2476,2277,5,2009,4580,2379,2201,1.063187058,1.063857167,1.062416589,,,
1872,인천,남동구,2011,4547,2375,2172,5,2010,4403,2264,2139,1.057994997,1.072295089,1.042799685,,,
1873,인천,남동구,2012,4400,2279,2121,5,2011,4872,2563,2309,0.925236468,0.908914108,0.94334074,,,
1874,인천,남동구,2013,4671,2497,2174,5,2012,5453,2786,2667,0.877569892,0.916145717,0.837121275,,,
1875,인천,남동구,2014,5134,2624,2510,5,2013,5211,2607,2604,1.009350811,1.028844937,0.989884666,,,
1876,인천,남동구,2015,4980,2508,2472,5,2014,5134,2652,2482,0.993758425,0.966676448,1.022818429,,,
1877,인천,남동구,2016,5079,2599,2480,5,2015,5502,2822,2680,0.945725223,0.941404772,0.950317533,,,
1878,인천,남동구,2017,5243,2696,2547,5,2016,5525,2862,2663,0.972198442,0.962891568,0.982221947,,,
1879,인천,남동구,2018,5242,2696,2546,5,2017,5750,2969,2781,0.933977722,0.928189851,0.940176227,,,
1880,인천,남동구,2019,5246,2679,2567,5,2018,5054,2546,2508,1.063409153,1.075576834,1.051114898,,,
1881,인천,남동구,2020,4656,2338,2318,5,2019,4872,2516,2356,0.979068408,0.949863053,1.010392237,,,
1882,인천,동구,2009,756,379,377,5,2008,674,333,341,1.149130215,1.163381362,1.135373691,,,
1883,인천,동구,2010,796,377,419,5,2009,745,390,355,1.094621919,0.988106756,1.212097415,,,
1884,인천,동구,2011,859,429,430,5,2010,685,363,322,1.284724297,1.208030203,1.371400928,,,
1885,인천,동구,2012,742,382,360,5,2011,668,351,317,1.137980416,1.112457355,1.16625923,,,
1886,인천,동구,2013,747,394,353,5,2012,770,383,387,0.993887485,1.051537035,0.936732515,,,
1887,인천,동구,2014,839,415,424,5,2013,661,346,315,1.30037271,1.226024428,1.382315437,,,
1888,인천,동구,2015,754,378,376,5,2014,626,304,322,1.233969308,1.270999388,1.199178486,,,
1889,인천,동구,2016,704,332,372,5,2015,649,335,314,1.111310218,1.013025557,1.216648561,,,
1890,인천,동구,2017,714,361,353,5,2016,633,335,298,1.15558487,1.101512729,1.216494911,,,
1891,인천,동구,2018,663,345,318,5,2017,635,329,306,1.06966343,1.071890255,1.06722883,,,
1892,인천,동구,2019,658,325,333,5,2018,468,240,228,1.440414172,1.384201274,1.499896327,,,
1893,인천,동구,2020,539,286,253,5,2019,463,263,200,1.192655786,1.111571517,1.299099395,,,
1894,인천,미추홀구,2019,3144,1633,1511,5,2018,3233,1679,1554,0.996286345,0.994174487,0.998539628,,,
1895,인천,미추홀구,2020,2815,1453,1362,5,2019,3049,1517,1532,0.94586318,0.979055156,0.91299878,,,
1896,인천,부평구,2009,5409,2781,2628,5,2008,5759,2995,2764,0.962226356,0.94914221,0.976425645,,,
1897,인천,부평구,2010,5382,2831,2551,5,2009,5257,2771,2486,1.048849225,1.044312482,1.053807268,,,
1898,인천,부평구,2011,4839,2526,2313,5,2010,4874,2549,2325,1.017132292,1.012956128,1.021655626,,,
1899,인천,부평구,2012,4485,2343,2142,5,2011,4737,2444,2293,0.969988104,0.979937127,0.959328324,,,
1900,인천,부평구,2013,4448,2329,2119,5,2012,5363,2790,2573,0.849697473,0.853281659,0.845751985,,,
1901,인천,부평구,2014,5006,2590,2416,5,2013,4785,2506,2279,1.071806159,1.056442399,1.088690567,,,
1902,인천,부평구,2015,4537,2358,2179,5,2014,4651,2375,2276,0.999378,1.01486275,0.983188585,,,
1903,인천,부평구,2016,4474,2305,2169,5,2015,4715,2403,2312,0.972123917,0.980492519,0.963437569,,,
1904,인천,부평구,2017,4338,2237,2101,5,2016,4633,2361,2272,0.959256151,0.968494419,0.949663137,,,
1905,인천,부평구,2018,4209,2171,2038,5,2017,4586,2330,2256,0.940269222,0.952425529,0.927720043,,,
1906,인천,부평구,2019,4246,2170,2076,5,2018,3963,2004,1959,1.097648436,1.10685095,1.088290325,,,
1907,인천,부평구,2020,3626,1832,1794,5,2019,3901,1987,1914,0.952268009,0.942442207,0.962570085,,,
1908,인천,서구,2009,4458,2249,2209,5,2008,4835,2489,2346,0.944606503,0.923616503,0.966984612,,,
1909,인천,서구,2010,4697,2443,2254,5,2009,4586,2346,2240,1.049285944,1.064443427,1.033374519,,,
1910,인천,서구,2011,4511,2310,2201,5,2010,4223,2216,2007,1.094357178,1.065538998,1.126223345,,,
1911,인천,서구,2012,4547,2382,2165,5,2011,4876,2527,2349,0.955363407,0.963526449,0.94651334,,,
1912,인천,서구,2013,5127,2642,2485,5,2012,5698,2911,2787,0.921824439,0.927721738,0.915674836,,,
1913,인천,서구,2014,5649,2854,2795,5,2013,5617,2828,2789,1.030325613,1.031577091,1.029165343,,,
1914,인천,서구,2015,5471,2745,2726,5,2014,5396,2820,2576,1.038728671,0.99499378,1.086755503,,,
1915,인천,서구,2016,5111,2657,2454,5,2015,5796,2974,2822,0.903409908,0.913224839,0.8930369,,,
1916,인천,서구,2017,5554,2862,2692,5,2016,5899,3056,2843,0.964572386,0.957289741,0.972411421,,,
1917,인천,서구,2018,5863,3035,2828,5,2017,5984,3119,2865,1.003773335,0.994650364,1.013693435,,,
1918,인천,서구,2019,5921,3095,2826,5,2018,5701,2891,2810,1.064023856,1.094308284,1.03280348,,,
1919,인천,서구,2020,5318,2705,2613,5,2019,5617,2886,2731,0.969954259,0.958071824,0.982583721,,,
1920,인천,연수구,2009,2692,1416,1276,5,2008,2742,1396,1346,1.005807687,1.036823806,0.973548226,,,
1921,인천,연수구,2010,2810,1408,1402,5,2009,2590,1339,1251,1.111511348,1.074853322,1.150913168,,,
1922,인천,연수구,2011,2675,1400,1275,5,2010,2447,1236,1211,1.119946204,1.157808384,1.081229526,,,
1923,인천,연수구,2012,2614,1304,1310,5,2011,2584,1325,1259,1.036383331,1.005978823,1.068556328,,,
1924,인천,연수구,2013,2738,1409,1329,5,2012,2934,1527,1407,0.956050162,0.943189769,0.970024579,,,
1925,인천,연수구,2014,3203,1673,1530,5,2013,2896,1535,1361,1.133093443,1.114075661,1.154476669,,,
1926,인천,연수구,2015,3134,1630,1504,5,2014,3011,1577,1434,1.066339709,1.056532927,1.077086395,,,
1927,인천,연수구,2016,3226,1686,1540,5,2015,3317,1715,1602,0.996382834,1.004894736,0.987211178,,,
1928,인천,연수구,2017,3514,1827,1687,5,2016,3446,1760,1686,1.044705375,1.061091914,1.027565152,,,
1929,인천,연수구,2018,3667,1873,1794,5,2017,3710,1896,1814,1.012614975,1.009779547,1.015633485,,,
1930,인천,연수구,2019,3981,2017,1964,5,2018,3634,1869,1765,1.122314567,1.103122447,1.142743156,,,
1931,인천,연수구,2020,3979,2025,1954,5,2019,3847,1986,1861,1.05964184,1.042252412,1.078276255,,,
1932,인천,옹진군,2009,118,59,59,5,2008,148,76,72,0.816822396,0.79353401,0.841533425,,,
1933,인천,옹진군,2010,119,64,55,5,2009,144,71,73,0.846626415,0.921401151,0.773734006,,,
1934,인천,옹진군,2011,114,53,61,5,2010,115,65,50,1.015580506,0.833469359,1.252886373,,,
1935,인천,옹진군,2012,90,51,39,5,2011,142,67,75,0.649324082,0.778076858,0.534017143,,,
1936,인천,옹진군,2013,122,57,65,5,2012,148,65,83,0.844511291,0.896372707,0.804242685,,,
1937,인천,옹진군,2014,118,50,68,5,2013,149,73,76,0.811340367,0.700122878,0.918855408,,,
1938,인천,옹진군,2015,107,55,52,5,2014,135,70,65,0.812002478,0.803140959,0.821564835,,,
1939,인천,옹진군,2016,114,62,52,5,2015,134,67,67,0.871580285,0.945897357,0.797040512,,,
1940,인천,옹진군,2017,111,57,54,5,2016,136,75,61,0.836163904,0.776856346,0.909108629,,,
1941,인천,옹진군,2018,108,63,45,5,2017,120,57,63,0.922040197,1.129777234,0.733540031,,,
1942,인천,옹진군,2019,102,47,55,5,2018,134,71,63,0.779834992,0.676653971,0.896548927,,,
1943,인천,옹진군,2020,97,52,45,5,2019,100,40,60,0.993754434,1.328833223,0.770217033,,,
1944,인천,중구,2009,896,489,407,5,2008,856,437,419,1.07236243,1.143811734,0.997544415,,,
1945,인천,중구,2010,938,490,448,5,2009,904,450,454,1.063020777,1.113039794,1.013383938,,,
1946,인천,중구,2011,1006,515,491,5,2010,789,418,371,1.306256074,1.259383713,1.359125115,,,
1947,인천,중구,2012,877,477,400,5,2011,846,444,402,1.062029488,1.098152196,1.02184681,,,
1948,인천,중구,2013,1066,572,494,5,2012,1059,555,504,1.03126099,1.053489402,1.006579932,,,
1949,인천,중구,2014,1343,668,675,5,2013,1091,540,551,1.261126371,1.264473779,1.258067749,,,
1950,인천,중구,2015,1244,623,621,5,2014,1064,535,529,1.197804934,1.190313584,1.205557095,,,
1951,인천,중구,2016,1201,612,589,5,2015,1206,626,580,1.02024164,0.99931916,1.042891569,,,
1952,인천,중구,2017,1244,643,601,5,2016,1251,637,614,1.018756554,1.031807466,1.005212675,,,
1953,인천,중구,2018,1345,690,655,5,2017,1226,618,608,1.12392973,1.141268265,1.106342449,,,
1954,인천,중구,2019,1442,746,696,5,2018,1129,562,567,1.308514874,1.356843121,1.260602128,,,
1955,인천,중구,2020,1391,714,677,5,2019,1276,633,643,1.11682159,1.15297961,1.081258541,,,
1956,전남,강진군,2009,251,134,117,5,2008,298,152,146,0.862908611,0.901131841,0.822971624,,,
1957,전남,강진군,2010,257,130,127,5,2009,266,138,128,0.989825942,0.962922625,1.01893295,,,
1958,전남,강진군,2011,231,119,112,5,2010,268,143,125,0.883048447,0.850624817,0.920152615,,,
1959,전남,강진군,2012,227,122,105,5,2011,297,148,149,0.783027028,0.842607345,0.723693856,,,
1960,전남,강진군,2013,223,117,106,5,2012,304,149,155,0.751516681,0.80265094,0.702305424,,,
1961,전남,강진군,2014,249,119,130,5,2013,293,155,138,0.870640914,0.784769993,0.96742236,,,
1962,전남,강진군,2015,239,128,111,5,2014,249,119,130,0.983344967,1.099487088,0.876862468,,,
1963,전남,강진군,2016,194,96,98,5,2015,258,142,116,0.770352275,0.691050863,0.867600796,,,
1964,전남,강진군,2017,219,117,102,5,2016,296,153,143,0.757983495,0.781666602,0.732514101,,,
1965,전남,강진군,2018,223,118,105,5,2017,223,113,110,1.024489107,1.067408579,0.980276224,,,
1966,전남,강진군,2019,192,98,94,5,2018,211,109,102,0.932236534,0.919023683,0.946410472,,,
1967,전남,강진군,2020,181,95,86,5,2019,191,89,102,0.970850934,1.091090373,0.8658649,,,
1968,전남,고흥군,2009,479,246,233,5,2008,442,235,207,1.110249508,1.070026098,1.155945692,,,
1969,전남,고흥군,2010,415,227,188,5,2009,399,215,184,1.065571377,1.079231276,1.049281175,,,
1970,전남,고흥군,2011,371,206,165,5,2010,404,209,195,0.940805591,1.007506971,0.868962806,,,
1971,전남,고흥군,2012,384,203,181,5,2011,360,187,173,1.092788381,1.109638602,1.074445341,,,
1972,전남,고흥군,2013,350,179,171,5,2012,404,210,194,0.887552445,0.871286252,0.905203523,,,
1973,전남,고흥군,2014,388,203,185,5,2013,343,170,173,1.158897299,1.220602463,1.098189989,,,
1974,전남,고흥군,2015,312,157,155,5,2014,356,186,170,0.897866858,0.862807345,0.936342275,,,
1975,전남,고흥군,2016,319,164,155,5,2015,346,185,161,0.944543426,0.906148227,0.98868439,,,
1976,전남,고흥군,2017,326,168,158,5,2016,323,169,154,1.034004486,1.016131003,1.053630227,,,
1977,전남,고흥군,2018,292,157,135,5,2017,332,162,170,0.901056685,0.990630655,0.815523917,,,
1978,전남,고흥군,2019,310,148,162,5,2018,285,151,134,1.114356573,1.001871202,1.241543874,,,
1979,전남,고흥군,2020,260,145,115,5,2019,249,122,127,1.069747662,1.214885355,0.929920827,,,
1980,전남,곡성군,2009,207,97,110,5,2008,243,127,116,0.872712943,0.780719701,0.973837628,,,
1981,전남,곡성군,2010,196,98,98,5,2009,194,108,86,1.035050851,0.927533161,1.170252236,,,
1982,전남,곡성군,2011,188,98,90,5,2010,187,96,91,1.029967659,1.043474806,1.015670813,,,
1983,전남,곡성군,2012,160,85,75,5,2011,198,112,86,0.827869986,0.775761154,0.895601201,,,
1984,전남,곡성군,2013,177,102,75,5,2012,171,86,85,1.060436094,1.212352314,0.906137686,,,
1985,전남,곡성군,2014,154,80,74,5,2013,191,109,82,0.826027867,0.750223415,0.92676521,,,
1986,전남,곡성군,2015,177,105,72,5,2014,167,89,78,1.085835761,1.205941991,0.947959425,,,
1987,전남,곡성군,2016,152,84,68,5,2015,167,81,86,0.932469128,1.060037899,0.812011756,,,
1988,전남,곡성군,2017,155,73,82,5,2016,190,90,100,0.83576743,0.829101071,0.842103956,,,
1989,전남,곡성군,2018,169,83,86,5,2017,143,78,65,1.210759854,1.087703723,1.358741843,,,
1990,전남,곡성군,2019,129,70,59,5,2018,132,71,61,1.001205264,1.007782509,0.993285354,,,
1991,전남,곡성군,2020,113,65,48,5,2019,117,66,51,0.989463839,1.006691836,0.966546865,,,
1992,전남,광양시,2009,1682,862,820,5,2008,1534,820,714,1.123331603,1.074534933,1.179417305,,,
1993,전남,광양시,2010,1497,806,691,5,2009,1523,800,723,1.006999471,1.029845748,0.981502941,,,
1994,전남,광양시,2011,1518,791,727,5,2010,1421,730,691,1.094422565,1.107594393,1.080458819,,,
1995,전남,광양시,2012,1418,726,692,5,2011,1535,777,758,0.946401013,0.955086546,0.937537708,,,
1996,전남,광양시,2013,1462,730,732,5,2012,1681,881,800,0.891019081,0.846981798,0.93966478,,,
1997,전남,광양시,2014,1610,845,765,5,2013,1596,830,766,1.033475854,1.040652524,1.02561537,,,
1998,전남,광양시,2015,1533,785,748,5,2014,1526,772,754,1.029188599,1.039392268,1.01878398,,,
1999,전남,광양시,2016,1459,747,712,5,2015,1700,880,820,0.87925271,0.867690924,0.891698419,,,
2000,전남,광양시,2017,1652,866,786,5,2016,1707,855,852,0.991479792,1.035330248,0.947403111,,,
2001,전남,광양시,2018,1606,802,804,5,2017,1746,885,861,0.942342214,0.926313989,0.958969407,,,
2002,전남,광양시,2019,1648,835,813,5,2018,1554,788,766,1.086459491,1.083146955,1.089967707,,,
2003,전남,광양시,2020,1444,733,711,5,2019,1458,713,745,1.014651763,1.050852036,0.980088251,,,
2004,전남,구례군,2009,187,104,83,5,2008,206,109,97,0.929997394,0.975290439,0.878735584,,,
2005,전남,구례군,2010,180,100,80,5,2009,154,80,74,1.197454801,1.277724253,1.11022275,,,
2006,전남,구례군,2011,151,76,75,5,2010,176,91,85,0.878965086,0.853688292,0.906137686,,,
2007,전남,구례군,2012,171,91,80,5,2011,174,88,86,1.006825502,1.057026427,0.955307948,,,
2008,전남,구례군,2013,162,83,79,5,2012,188,100,88,0.882804444,0.848408904,0.921926448,,,
2009,전남,구례군,2014,184,98,86,5,2013,164,93,71,1.149426803,1.077135284,1.243918588,,,
2010,전남,구례군,2015,170,97,73,5,2014,163,85,78,1.068485572,1.166487083,0.961125528,,,
2011,전남,구례군,2016,170,87,83,5,2015,173,86,87,1.0067234,1.034065209,0.979739674,,,
2012,전남,구례군,2017,155,80,75,5,2016,177,93,84,0.897151478,0.879294109,0.916925039,,,
2013,전남,구례군,2018,158,75,83,5,2017,150,67,83,1.079128526,1.144230674,1.026956044,,,
2014,전남,구례군,2019,136,59,77,5,2018,159,79,80,0.87629257,0.763399807,0.988445192,,,
2015,전남,구례군,2020,139,70,69,5,2019,116,64,52,1.227620568,1.118008721,1.362691674,,,
2016,전남,나주시,2009,709,356,353,5,2008,747,379,368,0.972373196,0.960147407,0.985096422,,,
2017,전남,나주시,2010,670,326,344,5,2009,664,362,302,1.033746539,0.920526202,1.169777745,,,
2018,전남,나주시,2011,576,311,265,5,2010,611,344,267,0.965803152,0.924121494,1.019263489,,,
2019,전남,나주시,2012,551,309,242,5,2011,560,305,255,1.008024104,1.035585034,0.974601422,,,
2020,전남,나주시,2013,552,290,262,5,2012,629,333,296,0.899074702,0.890186266,0.908994877,,,
2021,전남,나주시,2014,597,315,282,5,2013,561,299,262,1.090231724,1.076877966,1.105349635,,,
2022,전남,나주시,2015,630,333,297,5,2014,600,318,282,1.075713563,1.070395412,1.081581365,,,
2023,전남,나주시,2016,728,369,359,5,2015,746,396,350,0.999769531,0.952485352,1.053363485,,,
2024,전남,나주시,2017,914,479,435,5,2016,925,439,486,1.012305994,1.115316478,0.919189052,,,
2025,전남,나주시,2018,1006,475,531,5,2017,1157,609,548,0.890783096,0.797266365,0.995097918,,,
2026,전남,나주시,2019,1145,584,561,5,2018,1074,561,513,1.092216041,1.064086936,1.123045498,,,
2027,전남,나주시,2020,989,520,469,5,2019,1079,555,524,0.939035892,0.957717638,0.919164856,,,
2028,전남,담양군,2009,284,139,145,5,2008,293,146,147,0.993020159,0.973170801,1.012983853,,,
2029,전남,담양군,2010,241,125,116,5,2009,263,146,117,0.938790399,0.875153598,1.018178642,,,
2030,전남,담양군,2011,227,126,101,5,2010,257,128,129,0.904898939,1.006207849,0.804050856,,,
2031,전남,담양군,2012,218,109,109,5,2011,241,129,112,0.926716288,0.863701976,0.999448293,,,
2032,전남,담양군,2013,212,113,99,5,2012,285,142,143,0.762076108,0.813424454,0.710969569,,,
2033,전남,담양군,2014,233,117,116,5,2013,258,152,106,0.925216907,0.786809145,1.123838689,,,
2034,전남,담양군,2015,241,136,105,5,2014,264,136,128,0.935234375,1.022179402,0.84242488,,,
2035,전남,담양군,2016,246,132,114,5,2015,285,132,153,0.884295861,1.022179402,0.765182935,,,
2036,전남,담양군,2017,269,130,139,5,2016,243,131,112,1.134105226,1.014376506,1.274525804,,,
2037,전남,담양군,2018,221,125,96,5,2017,275,138,137,0.823316701,0.92588714,0.719618834,,,
2038,전남,담양군,2019,242,126,116,5,2018,248,126,122,0.999703081,1.022179402,0.976450009,,,
2039,전남,담양군,2020,198,98,100,5,2019,270,146,124,0.751292012,0.686120421,0.828190358,,,
2040,전남,목포시,2009,2901,1516,1385,5,2008,2749,1421,1328,1.081136013,1.090516519,1.071034729,,,
2041,전남,목포시,2010,2887,1481,1406,5,2009,2605,1357,1248,1.135393494,1.115584152,1.156971312,,,
2042,전남,목포시,2011,2736,1421,1315,5,2010,2373,1194,1179,1.181206152,1.216513342,1.14541747,,,
2043,전남,목포시,2012,2501,1261,1240,5,2011,2531,1307,1224,1.012345815,0.986203693,1.040380306,,,
2044,전남,목포시,2013,2638,1350,1288,5,2012,2660,1381,1279,1.016015889,0.999234028,1.034182474,,,
2045,전남,목포시,2014,2741,1424,1317,5,2013,2500,1308,1192,1.123249857,1.112831398,1.134648582,,,
2046,전남,목포시,2015,2631,1358,1273,5,2014,2394,1213,1181,1.125910961,1.144369026,1.106956007,,,
2047,전남,목포시,2016,2538,1292,1246,5,2015,2579,1326,1253,1.008202154,0.995969674,1.021218859,,,
2048,전남,목포시,2017,2756,1430,1326,5,2016,2639,1333,1306,1.069909807,1.096561549,1.042682783,,,
2049,전남,목포시,2018,2756,1360,1396,5,2017,2596,1327,1269,1.087631733,1.047599086,1.129732575,,,
2050,전남,목포시,2019,2762,1389,1373,5,2018,2245,1137,1108,1.260418225,1.248731038,1.272572787,,,
2051,전남,목포시,2020,2389,1210,1179,5,2019,2133,1100,1033,1.147447012,1.124397342,1.172101816,,,
2052,전남,무안군,2009,503,251,252,5,2008,610,308,302,0.844783641,0.833009838,0.856930209,,,
2053,전남,무안군,2010,613,327,286,5,2009,667,344,323,0.941546961,0.971664722,0.909317116,,,
2054,전남,무안군,2011,574,298,276,5,2010,659,332,327,0.892347113,0.917498379,0.866788587,,,
2055,전남,무안군,2012,529,252,277,5,2011,665,331,334,0.814969531,0.778215134,0.851697078,,,
2056,전남,무안군,2013,577,293,284,5,2012,785,407,378,0.753032121,0.73586871,0.77157544,,,
2057,전남,무안군,2014,775,394,381,5,2013,853,437,416,0.930807806,0.92159882,0.940553492,,,
2058,전남,무안군,2015,787,408,379,5,2014,878,453,425,0.918306296,0.920638402,0.915803154,,,
2059,전남,무안군,2016,790,413,377,5,2015,948,481,467,0.853740923,0.877671711,0.829041603,,,
2060,전남,무안군,2017,819,407,412,5,2016,888,436,452,0.944883535,0.954190405,0.936074978,,,
2061,전남,무안군,2018,777,382,395,5,2017,999,509,490,0.796824861,0.767136604,0.827852321,,,
2062,전남,무안군,2019,827,438,389,5,2018,811,415,396,1.044700976,1.078830309,1.00880278,,,
2063,전남,무안군,2020,702,362,340,5,2019,767,394,373,0.937667997,0.939159755,0.936099343,,,
2064,전남,보성군,2009,280,140,140,5,2008,334,180,154,0.858853144,0.795028424,0.933596403,,,
2065,전남,보성군,2010,290,164,126,5,2009,285,148,137,1.042462601,1.132685284,0.944499719,,,
2066,전남,보성군,2011,244,126,118,5,2010,284,140,144,0.880194867,0.919961462,0.841533425,,,
2067,전남,보성군,2012,229,122,107,5,2011,315,165,150,0.744787319,0.755793255,0.732561978,,,
2068,전남,보성군,2013,252,136,116,5,2012,332,175,157,0.777624262,0.794379421,0.758770071,,,
2069,전남,보성군,2014,256,127,129,5,2013,287,135,152,0.913830005,0.961605808,0.871561379,,,
2070,전남,보성군,2015,222,105,117,5,2014,236,118,118,0.96371433,0.909566417,1.018253027,,,
2071,전남,보성군,2016,214,101,113,5,2015,281,135,146,0.780215904,0.764741627,0.794835842,,,
2072,전남,보성군,2017,224,108,116,5,2016,293,151,142,0.783227167,0.731095202,0.838921839,,,
2073,전남,보성군,2018,238,122,116,5,2017,266,151,115,0.916648149,0.825866802,1.035886096,,,
2074,전남,보성군,2019,200,110,90,5,2018,212,109,103,0.966499158,1.031557195,0.897340232,,,
2075,전남,보성군,2020,170,85,85,5,2019,192,97,95,0.907099731,0.895724218,0.918855408,,,
2076,전남,순천시,2009,2994,1626,1368,5,2008,2934,1530,1404,1.045439805,1.086316149,1.000623838,,,
2077,전남,순천시,2010,2966,1552,1414,5,2009,2806,1436,1370,1.082906163,1.104750997,1.059938574,,,
2078,전남,순천시,2011,2832,1440,1392,5,2010,2514,1291,1223,1.154078422,1.140153632,1.168865751,,,
2079,전남,순천시,2012,2519,1275,1244,5,2011,2502,1277,1225,1.031450065,1.020578495,1.042884342,,,
2080,전남,순천시,2013,2593,1314,1279,5,2012,2754,1454,1300,0.964597043,0.923757727,1.010366754,,,
2081,전남,순천시,2014,2872,1524,1348,5,2013,2611,1339,1272,1.126898781,1.163406579,1.088315053,,,
2082,전남,순천시,2015,2710,1400,1310,5,2014,2598,1339,1259,1.06865492,1.068746201,1.068556328,,,
2083,전남,순천시,2016,2712,1397,1315,5,2015,2706,1450,1256,1.026760702,0.984816983,1.075196813,,,
2084,전남,순천시,2017,2761,1474,1287,5,2016,2666,1369,1297,1.060995658,1.100578845,1.01903811,,,
2085,전남,순천시,2018,2747,1408,1339,5,2017,2790,1429,1361,1.00869949,1.007157872,1.010355726,,,
2086,전남,순천시,2019,2857,1467,1390,5,2018,2569,1301,1268,1.139340358,1.152603523,1.125764117,,,
2087,전남,순천시,2020,2627,1330,1297,5,2019,2503,1248,1255,1.075242863,1.089341831,1.061324294,,,
2088,전남,신안군,2009,186,110,76,5,2008,245,121,124,0.777775404,0.929254002,0.629424672,,,
2089,전남,신안군,2010,180,85,95,5,2009,242,121,121,0.762016691,0.718059911,0.806287803,,,
2090,전남,신안군,2011,183,90,93,5,2010,195,94,101,0.961443624,0.978682406,0.945612991,,,
2091,전남,신안군,2012,163,73,90,5,2011,193,92,101,0.865242096,0.811077134,0.915109346,,,
2092,전남,신안군,2013,145,62,83,5,2012,206,118,88,0.721120974,0.537077313,0.968606269,,,
2093,전남,신안군,2014,174,98,76,5,2013,233,117,116,0.765069119,0.856184457,0.67283327,,,
2094,전남,신안군,2015,173,87,86,5,2014,193,98,95,0.918324433,0.90744498,0.929665471,,,
2095,전남,신안군,2016,156,75,81,5,2015,210,114,96,0.761049051,0.672486449,0.866494162,,,
2096,전남,신안군,2017,160,89,71,5,2016,224,102,122,0.731777934,0.891901635,0.597654747,,,
2097,전남,신안군,2018,177,80,97,5,2017,229,111,118,0.791854026,0.736705876,0.84419268,,,
2098,전남,신안군,2019,177,87,90,5,2018,197,108,89,0.920480061,0.823422296,1.038494876,,,
2099,전남,신안군,2020,143,76,67,5,2019,182,88,94,0.804955727,0.882791302,0.731979308,,,
2100,전남,여수시,2009,2937,1516,1421,5,2008,2994,1546,1448,1.004984806,1.002344097,1.007807002,,,
2101,전남,여수시,2010,2940,1518,1422,5,2009,2844,1513,1331,1.059071018,1.025557391,1.097168666,,,
2102,전남,여수시,2011,2771,1469,1302,5,2010,2486,1272,1214,1.141938583,1.180488634,1.101397668,,,
2103,전남,여수시,2012,2413,1240,1173,5,2011,2507,1294,1213,0.986075874,0.979522766,0.993091047,,,
2104,전남,여수시,2013,2482,1276,1206,5,2012,2799,1410,1389,0.908460866,0.925036112,0.89165514,,,
2105,전남,여수시,2014,2677,1339,1338,5,2013,2597,1334,1263,1.056048264,1.026010659,1.087939182,,,
2106,전남,여수시,2015,2485,1292,1193,5,2014,2437,1230,1207,1.044667801,1.073703892,1.015044375,,,
2107,전남,여수시,2016,2367,1182,1185,5,2015,2562,1337,1225,0.94651277,0.903676929,0.993422785,,,
2108,전남,여수시,2017,2477,1287,1190,5,2016,2701,1351,1350,0.939525923,0.973756396,0.905242735,,,
2109,전남,여수시,2018,2614,1311,1303,5,2017,2583,1266,1317,1.036784563,1.058512793,1.016039275,,,
2110,전남,여수시,2019,2486,1209,1277,5,2018,2370,1236,1134,1.074632878,0.999850241,1.156457556,,,
2111,전남,여수시,2020,2306,1202,1104,5,2019,2262,1162,1100,1.044417277,1.057366301,1.030690429,,,
2112,전남,영광군,2009,490,257,233,5,2008,445,237,208,1.128089129,1.108439267,1.150388261,,,
2113,전남,영광군,2010,424,226,198,5,2009,419,213,206,1.036714514,1.084565939,0.987074256,,,
2114,전남,영광군,2011,397,207,190,5,2010,376,206,170,1.081707914,1.027141438,1.147774402,,,
2115,전남,영광군,2012,361,191,170,5,2011,398,200,198,0.929247658,0.976181329,0.881729937,,,
2116,전남,영광군,2013,373,183,190,5,2012,452,221,231,0.84543017,0.846420048,0.84468246,,,
2117,전남,영광군,2014,425,219,206,5,2013,405,207,198,1.075081162,1.081436179,1.068449217,,,
2118,전남,영광군,2015,391,199,192,5,2014,395,192,203,1.014114534,1.05944636,0.971308179,,,
2119,전남,영광군,2016,373,184,189,5,2015,413,210,203,0.925264981,0.895623857,0.956131489,,,
2120,전남,영광군,2017,387,200,187,5,2016,416,210,206,0.953070396,0.973504193,0.932236797,,,
2121,전남,영광군,2018,372,186,186,5,2017,439,227,212,0.868132,0.837556691,0.901008604,,,
2122,전남,영광군,2019,375,193,182,5,2018,343,168,175,1.120068266,1.174289432,1.068034286,,,
2123,전남,영광군,2020,312,152,160,5,2019,339,172,167,0.94289263,0.903321332,0.983909982,,,
2124,전남,영암군,2009,543,272,271,5,2008,662,344,318,0.840328679,0.808234876,0.875173232,,,
2125,전남,영암군,2010,570,300,270,5,2009,531,267,264,1.09973407,1.148516182,1.050295954,,,
2126,전남,영암군,2011,480,246,234,5,2010,491,240,251,1.001537213,1.047733887,0.957401252,,,
2127,전남,영암군,2012,458,227,231,5,2011,503,268,235,0.932835012,0.86580121,1.009475941,,,
2128,전남,영암군,2013,471,252,219,5,2012,588,293,295,0.820636683,0.879144059,0.762384317,,,
2129,전남,영암군,2014,497,239,258,5,2013,503,260,243,1.012268561,0.939618758,1.090348392,,,
2130,전남,영암군,2015,445,243,202,5,2014,503,263,240,0.906357163,0.944447128,0.86435467,,,
2131,전남,영암군,2016,453,235,218,5,2015,539,297,242,0.861027023,0.80879515,0.925109163,,,
2132,전남,영암군,2017,448,244,204,5,2016,503,243,260,0.912467436,1.026385902,0.805765511,,,
2133,전남,영암군,2018,413,196,217,5,2017,455,231,224,0.929920882,0.867303735,0.994863667,,,
2134,전남,영암군,2019,414,212,202,5,2018,454,232,222,0.93422575,0.934060488,0.934437481,,,
2135,전남,영암군,2020,412,204,208,5,2019,371,184,187,1.13770758,1.133285859,1.142282658,,,
2136,전남,완도군,2009,385,196,189,5,2008,374,189,185,1.05462114,1.060037899,1.049160499,,,
2137,전남,완도군,2010,358,180,178,5,2009,397,220,177,0.923846601,0.836328602,1.032758055,,,
2138,전남,완도군,2011,402,220,182,5,2010,364,178,186,1.131441267,1.263367801,1.004870968,,,
2139,전남,완도군,2012,359,177,182,5,2011,367,201,166,1.00215692,0.90012813,1.125939759,,,
2140,전남,완도군,2013,369,200,169,5,2012,398,200,198,0.949840404,1.022179402,0.87654329,,,
2141,전남,완도군,2014,376,186,190,5,2013,328,171,157,1.174414343,1.111844262,1.242813047,,,
2142,전남,완도군,2015,308,170,138,5,2014,336,162,174,0.939115015,1.072657397,0.81448238,,,
2143,전남,완도군,2016,323,150,173,5,2015,411,205,206,0.805133775,0.747936148,0.862443668,,,
2144,전남,완도군,2017,390,198,192,5,2016,383,203,180,1.043213451,0.99700257,1.09541978,,,
2145,전남,완도군,2018,354,186,168,5,2017,413,209,204,0.878133521,0.90969076,0.845728507,,,
2146,전남,완도군,2019,387,191,196,5,2018,357,180,177,1.110580629,1.084645921,1.137194263,,,
2147,전남,완도군,2020,315,162,153,5,2019,373,195,178,0.865185171,0.849195196,0.882720644,,,
2148,전남,장성군,2009,327,181,146,5,2008,390,205,185,0.858994713,0.902509619,0.810462608,,,
2149,전남,장성군,2010,363,195,168,5,2009,332,180,152,1.120149235,1.107361019,1.13505668,,,
2150,전남,장성군,2011,325,172,153,5,2010,321,168,153,1.037255327,1.046517007,1.026956044,,,
2151,전남,장성군,2012,331,177,154,5,2011,344,158,186,0.985772949,1.14509971,0.850275434,,,
2152,전남,장성군,2013,343,175,168,5,2012,341,179,162,1.030497841,0.999337404,1.064991453,,,
2153,전남,장성군,2014,340,184,156,5,2013,346,177,169,1.0067234,1.062604576,0.947959425,,,
2154,전남,장성군,2015,346,181,165,5,2014,321,160,161,1.104277979,1.156340449,1.05247048,,,
2155,전남,장성군,2016,309,154,155,5,2015,347,184,163,0.912297217,0.855519717,0.976553293,,,
2156,전남,장성군,2017,339,187,152,5,2016,379,195,184,0.916363608,0.980243837,0.848354993,,,
2157,전남,장성군,2018,366,191,175,5,2017,333,158,175,1.126015055,1.235672569,1.026956044,,,
2158,전남,장성군,2019,322,157,165,5,2018,305,157,148,1.081591779,1.022179402,1.144917211,,,
2159,전남,장성군,2020,271,138,133,5,2019,314,165,149,0.884192828,0.854913682,0.916678885,,,
2160,전남,장흥군,2009,333,178,155,5,2008,297,143,154,1.148669605,1.272363172,1.03362459,,,
2161,전남,장흥군,2010,300,146,154,5,2009,289,152,137,1.063483502,0.981830215,1.154388546,,,
2162,전남,장흥군,2011,275,149,126,5,2010,264,137,127,1.067176154,1.111713365,1.018869776,,,
2163,전남,장흥군,2012,268,135,133,5,2011,257,159,98,1.068338836,0.867888172,1.393726059,,,
2164,전남,장흥군,2013,246,147,99,5,2012,263,136,127,0.958267378,1.104855677,0.800540538,,,
2165,전남,장흥군,2014,258,133,125,5,2013,257,122,135,1.028475446,1.114343119,0.950885226,,,
2166,전남,장흥군,2015,240,116,124,5,2014,260,141,119,0.945682253,0.84094192,1.070105457,,,
2167,전남,장흥군,2016,243,129,114,5,2015,252,123,129,0.987900211,1.072041812,0.90754255,,,
2168,전남,장흥군,2017,230,110,120,5,2016,240,140,100,0.981802061,0.803140959,1.232347253,,,
2169,전남,장흥군,2018,233,129,104,5,2017,246,130,116,0.970349439,1.014316484,0.920719212,,,
2170,전남,장흥군,2019,245,128,117,5,2018,242,114,128,1.037189386,1.147710206,0.938702009,,,
2171,전남,장흥군,2020,221,100,121,5,2019,232,116,116,0.975914193,0.88118914,1.071221391,,,
2172,전남,진도군,2009,259,135,124,5,2008,254,119,135,1.044656216,1.159615288,0.943278144,,,
2173,전남,진도군,2010,229,102,127,5,2009,211,100,111,1.111886282,1.04262299,1.174985744,,,
2174,전남,진도군,2011,210,104,106,5,2010,199,110,89,1.081119159,0.966424162,1.223116187,,,
2175,전남,진도군,2012,197,110,87,5,2011,219,117,102,0.921572393,0.96102337,0.875933096,,,
2176,전남,진도군,2013,201,111,90,5,2012,272,124,148,0.757067318,0.915015433,0.624500297,,,
2177,전남,진도군,2014,241,113,128,5,2013,208,114,94,1.187028245,1.013212916,1.39840823,,,
2178,전남,진도군,2015,183,99,84,5,2014,217,109,108,0.863970077,0.928401475,0.79874359,,,
2179,전남,진도군,2016,208,108,100,5,2015,215,122,93,0.991133648,0.904880127,1.104253811,,,
2180,전남,진도군,2017,185,102,83,5,2016,225,102,123,0.842357711,1.022179402,0.692986599,,,
2181,전남,진도군,2018,202,89,113,5,2017,230,125,105,0.899768694,0.727791734,1.105200314,,,
2182,전남,진도군,2019,199,105,94,5,2018,194,99,95,1.050893466,1.084129669,1.01614598,,,
2183,전남,진도군,2020,171,93,78,5,2019,173,92,81,1.012645303,1.033290048,0.988920635,,,
2184,전남,함평군,2009,223,123,100,5,2008,252,139,113,0.906591551,0.904518464,0.908810658,,,
2185,전남,함평군,2010,209,106,103,5,2009,244,127,117,0.877533703,0.853157611,0.904072415,,,
2186,전남,함평군,2011,204,110,94,5,2010,191,96,95,1.094218733,1.171247232,1.01614598,,,
2187,전남,함평군,2012,167,84,83,5,2011,188,89,99,0.910051494,0.964753593,0.86098335,,,
2188,전남,함평군,2013,165,77,88,5,2012,220,110,110,0.768366831,0.715525582,0.821564835,,,
2189,전남,함평군,2014,192,97,95,5,2013,207,109,98,0.950250766,0.90964589,0.995518614,,,
2190,전남,함평군,2015,162,87,75,5,2014,203,115,88,0.817572588,0.773300939,0.875246628,,,
2191,전남,함평군,2016,166,94,72,5,2015,224,119,105,0.759219606,0.80743583,0.70419843,,,
2192,전남,함평군,2017,167,87,80,5,2016,210,118,92,0.814712766,0.753640746,0.893005256,,,
2193,전남,함평군,2018,164,89,75,5,2017,219,119,100,0.767197322,0.764487116,0.770217033,,,
2194,전남,함평군,2019,162,87,75,5,2018,181,91,90,0.916946052,0.97724844,0.855796703,,,
2195,전남,함평군,2020,152,78,74,5,2019,157,74,83,0.991862066,1.077432343,0.915599364,,,
2196,전남,해남군,2009,596,302,294,5,2008,607,313,294,1.005923407,0.986256164,1.026956044,,,
2197,전남,해남군,2010,557,290,267,5,2009,581,301,280,0.98216942,0.984824009,0.979275942,,,
2198,전남,해남군,2011,537,278,259,5,2010,515,252,263,1.068253691,1.127642356,1.01133694,,,
2199,전남,해남군,2012,493,233,260,5,2011,525,262,263,0.962044057,0.909037407,1.015241716,,,
2200,전남,해남군,2013,495,255,240,5,2012,547,277,270,0.92709709,0.940995479,0.912849817,,,
2201,전남,해남군,2014,499,239,260,5,2013,543,291,252,0.941473415,0.839521915,1.059557823,,,
2202,전남,해남군,2015,517,274,243,5,2014,474,236,238,1.117427993,1.186767611,1.048530751,,,
2203,전남,해남군,2016,441,221,220,5,2015,538,282,256,0.839776387,0.801069673,0.88254035,,,
2204,전남,해남군,2017,479,264,215,5,2016,475,233,242,1.033116384,1.15817752,0.912378303,,,
2205,전남,해남군,2018,415,205,210,5,2017,519,248,271,0.819196492,0.844946683,0.795796196,,,
2206,전남,해남군,2019,455,211,244,5,2018,431,190,241,1.081537225,1.135157126,1.039739729,,,
2207,전남,해남군,2020,376,173,203,5,2019,425,208,217,0.90637154,0.850178061,0.960700815,,,
2208,전남,화순군,2009,716,354,362,5,2008,715,378,337,1.025921959,0.957279123,1.103139727,,,
2209,전남,화순군,2010,659,347,312,5,2009,687,349,338,0.982734093,1.016321641,0.947959425,,,
2210,전남,화순군,2011,635,328,307,5,2010,593,332,261,1.097049887,1.009863988,1.207952128,,,
2211,전남,화순군,2012,561,296,265,5,2011,562,298,264,1.022666173,1.015319138,1.030846029,,,
2212,전남,화순군,2013,513,269,244,5,2012,653,327,326,0.804843663,0.84087541,0.768641947,,,
2213,전남,화순군,2014,611,298,313,5,2013,523,267,256,1.196869684,1.140859408,1.255614225,,,
2214,전남,화순군,2015,484,242,242,5,2014,532,275,257,0.932054,0.899517874,0.967016975,,,
2215,전남,화순군,2016,491,262,229,5,2015,480,256,224,1.047966983,1.046136732,1.04987917,,,
2216,전남,화순군,2017,450,237,213,5,2016,491,257,234,0.938941137,0.942632367,0.934793322,,,
2217,전남,화순군,2018,470,238,232,5,2017,470,231,239,1.024489107,1.053154536,0.996877833,,,
2218,전남,화순군,2019,450,226,224,5,2018,396,214,182,1.164192167,1.079497873,1.2639459,,,
2219,전남,화순군,2020,378,199,179,5,2019,365,182,183,1.060977761,1.117657698,1.004508917,,,
2220,전북,고창군,2009,391,220,171,5,2008,383,207,176,1.045888358,1.086374244,0.997781156,,,
2221,전북,고창군,2010,366,202,164,5,2009,359,188,171,1.044465218,1.098299145,0.984916908,,,
2222,전북,고창군,2011,343,180,163,5,2010,334,179,155,1.052095101,1.027889902,1.079960227,,,
2223,전북,고창군,2012,321,169,152,5,2011,349,187,162,0.942295139,0.923787802,0.963563695,,,
2224,전북,고창군,2013,335,176,159,5,2012,394,210,184,0.871075764,0.85668369,0.887423973,,,
2225,전북,고창군,2014,394,205,189,5,2013,361,185,176,1.118140466,1.132685284,1.102810752,,,
2226,전북,고창군,2015,351,177,174,5,2014,371,184,187,0.969260584,0.983292142,0.955563378,,,
2227,전북,고창군,2016,346,171,175,5,2015,373,212,161,0.950330378,0.824493763,1.116256569,,,
2228,전북,고창군,2017,348,194,154,5,2016,385,211,174,0.926031713,0.939823716,0.908915119,,,
2229,전북,고창군,2018,362,196,166,5,2017,357,186,171,1.038837694,1.077135284,0.996928089,,,
2230,전북,고창군,2019,324,171,153,5,2018,296,157,139,1.121400239,1.113329158,1.130390466,,,
2231,전북,고창군,2020,273,146,127,5,2019,330,181,149,0.847531898,0.824520402,0.87532495,,,
2232,전북,군산시,2009,2691,1453,1238,5,2008,2679,1397,1282,1.029078084,1.063154382,0.991709503,,,
2233,전북,군산시,2010,2729,1395,1334,5,2009,2649,1358,1291,1.055428756,1.050029651,1.061161396,,,
2234,전북,군산시,2011,2645,1358,1287,5,2010,2513,1266,1247,1.078302304,1.096461002,1.059897697,,,
2235,전북,군산시,2012,2525,1277,1248,5,2011,2570,1332,1238,1.006550582,0.979972295,1.035251327,,,
2236,전북,군산시,2013,2525,1302,1223,5,2012,2849,1458,1391,0.907979992,0.912810413,0.90292397,,,
2237,전북,군산시,2014,2801,1417,1384,5,2013,2653,1401,1252,1.081641157,1.033853114,1.135229365,,,
2238,전북,군산시,2015,2618,1379,1239,5,2014,2657,1355,1302,1.009451443,1.040284425,0.977264622,,,
2239,전북,군산시,2016,2597,1327,1270,5,2015,2779,1403,1376,0.957394103,0.966808316,0.947844604,,,
2240,전북,군산시,2017,2708,1366,1342,5,2016,2846,1464,1382,0.974812545,0.953754825,0.99723228,,,
2241,전북,군산시,2018,2721,1402,1319,5,2017,2780,1457,1323,1.002746353,0.983593358,1.023851112,,,
2242,전북,군산시,2019,2706,1416,1290,5,2018,2589,1313,1276,1.070786993,1.102365601,1.038223587,,,
2243,전북,군산시,2020,2503,1277,1226,5,2019,2488,1282,1206,1.03066569,1.018192743,1.043986824,,,
2244,전북,김제시,2009,662,332,330,5,2008,722,363,359,0.939351508,0.934885844,0.943998592,,,
2245,전북,김제시,2010,640,320,320,5,2009,699,332,367,0.938015778,0.985233159,0.895438512,,,
2246,전북,김제시,2011,632,321,311,5,2010,583,319,264,1.110595396,1.028588051,1.20978534,,,
2247,전북,김제시,2012,552,299,253,5,2011,637,344,293,0.88778334,0.888464073,0.886757267,,,
2248,전북,김제시,2013,645,347,298,5,2012,692,328,364,0.954906755,1.081391014,0.840749728,,,
2249,전북,김제시,2014,669,335,334,5,2013,616,321,295,1.112635086,1.066760435,1.162723114,,,
2250,전북,김제시,2015,606,316,290,5,2014,614,324,290,1.011140715,0.996940405,1.026956044,,,
2251,전북,김제시,2016,591,299,292,5,2015,581,278,303,1.042122311,1.099394393,0.989673811,,,
2252,전북,김제시,2017,602,299,303,5,2016,647,317,330,0.953234069,0.96413767,0.942932368,,,
2253,전북,김제시,2018,658,318,340,5,2017,619,327,292,1.089036886,0.994046024,1.195770736,,,
2254,전북,김제시,2019,607,316,291,5,2018,519,283,236,1.198198243,1.141373467,1.26628902,,,
2255,전북,김제시,2020,490,268,222,5,2019,492,260,232,1.020324518,1.053631076,0.982690697,,,
2256,전북,남원시,2009,845,436,409,5,2008,812,420,392,1.066124748,1.06111957,1.071492403,,,
2257,전북,남원시,2010,783,412,371,5,2009,789,412,377,1.016698316,1.022179402,1.010611916,,,
2258,전북,남원시,2011,780,405,375,5,2010,717,370,347,1.114506979,1.118872048,1.109822814,,,
2259,전북,남원시,2012,729,371,358,5,2011,693,347,346,1.077709321,1.092877689,1.062573016,,,
2260,전북,남원시,2013,697,354,343,5,2012,722,362,360,0.989015108,0.999589802,0.978460897,,,
2261,전북,남원시,2014,729,365,364,5,2013,731,393,338,1.021686128,0.949352371,1.105952663,,,
2262,전북,남원시,2015,729,382,347,5,2014,627,342,285,1.191152407,1.141732549,1.250364025,,,
2263,전북,남원시,2016,616,332,284,5,2015,700,356,344,0.901550415,0.953268431,0.847835804,,,
2264,전북,남원시,2017,686,348,338,5,2016,670,332,338,1.048954519,1.07144106,1.026956044,,,
2265,전북,남원시,2018,638,327,311,5,2017,582,321,261,1.123065379,1.041285559,1.223690918,,,
2266,전북,남원시,2019,572,310,262,5,2018,576,301,275,1.0173746,1.052742906,0.978409031,,,
2267,전북,남원시,2020,531,276,255,5,2019,538,283,255,1.011159323,0.996895813,1.026956044,,,
2268,전북,무주군,2009,166,82,84,5,2008,187,101,86,0.909439528,0.829888228,1.003073345,,,
2269,전북,무주군,2010,161,84,77,5,2009,197,94,103,0.837272824,0.913436913,0.767724421,,,
2270,전북,무주군,2011,177,90,87,5,2010,176,83,93,1.030310068,1.108387304,0.960700815,,,
2271,전북,무주군,2012,183,88,95,5,2011,190,106,84,0.986744772,0.848601768,1.161438383,,,
2272,전북,무주군,2013,170,89,81,5,2012,213,102,111,0.817667363,0.891901635,0.749400356,,,
2273,전북,무주군,2014,210,100,110,5,2013,197,97,100,1.092094988,1.053793198,1.129651648,,,
2274,전북,무주군,2015,167,83,84,5,2014,187,79,108,0.91491808,1.073935321,0.79874359,,,
2275,전북,무주군,2016,178,75,103,5,2015,181,102,79,1.007508625,0.751602502,1.33894269,,,
2276,전북,무주군,2017,164,90,74,5,2016,179,91,88,0.938638065,1.010946662,0.863576673,,,
2277,전북,무주군,2018,165,85,80,5,2017,155,81,74,1.090585179,1.072657397,1.11022275,,,
2278,전북,무주군,2019,155,84,71,5,2018,137,72,65,1.159093516,1.192542636,1.121751986,,,
2279,전북,무주군,2020,123,65,58,5,2019,146,94,52,0.863096988,0.706826182,1.145450972,,,
2280,전북,부안군,2009,418,238,180,5,2008,432,218,214,0.991288072,1.115957329,0.863794803,,,
2281,전북,부안군,2010,399,203,196,5,2009,391,203,188,1.045450521,1.022179402,1.070656301,,,
2282,전북,부안군,2011,395,204,191,5,2010,354,173,181,1.143144625,1.205344497,1.083693947,,,
2283,전북,부안군,2012,330,162,168,5,2011,325,177,148,1.040250478,0.935554029,1.165733888,,,
2284,전북,부안군,2013,313,166,147,5,2012,382,191,191,0.83943741,0.888386287,0.790379782,,,
2285,전북,부안군,2014,353,177,176,5,2013,361,188,173,1.001785748,0.962371033,1.04476453,,,
2286,전북,부안군,2015,335,173,162,5,2014,334,170,164,1.02755644,1.040217862,1.01443219,,,
2287,전북,부안군,2016,317,156,161,5,2015,370,192,178,0.877737965,0.830520764,0.928875972,,,
2288,전북,부안군,2017,341,182,159,5,2016,372,199,173,0.939115015,0.934857544,0.943849774,,,
2289,전북,부안군,2018,328,173,155,5,2017,342,187,155,0.982550957,0.945652602,1.026956044,,,
2290,전북,부안군,2019,306,167,139,5,2018,312,160,152,1.004787394,1.066899751,0.939124277,,,
2291,전북,부안군,2020,279,146,133,5,2019,288,145,143,0.992473823,1.029228915,0.955140936,,,
2292,전북,순창군,2009,219,112,107,5,2008,254,130,124,0.883319349,0.88064687,0.886163683,,,
2293,전북,순창군,2010,211,102,109,5,2009,227,116,111,0.952278421,0.898812923,1.008452331,,,
2294,전북,순창군,2011,201,109,92,5,2010,207,106,101,0.994793771,1.051109008,0.935445109,,,
2295,전북,순창군,2012,188,103,85,5,2011,202,110,92,0.953484912,0.957131622,0.948818084,,,
2296,전북,순창군,2013,177,96,81,5,2012,242,126,116,0.749316413,0.778803354,0.717098617,,,
2297,전북,순창군,2014,208,111,97,5,2013,206,93,113,1.034435604,1.220020577,0.881546339,,,
2298,전북,순창군,2015,187,85,102,5,2014,211,116,95,0.907959541,0.749010769,1.102626489,,,
2299,전북,순창군,2016,181,94,87,5,2015,220,115,105,0.842875129,0.835520555,0.850906436,,,
2300,전북,순창군,2017,192,104,88,5,2016,194,90,104,1.013927364,1.181185087,0.868962806,,,
2301,전북,순창군,2018,160,72,88,5,2017,192,106,86,0.853740923,0.694310537,1.050838743,,,
2302,전북,순창군,2019,153,87,66,5,2018,167,87,80,0.938603793,1.022179402,0.847238736,,,
2303,전북,순창군,2020,133,74,59,5,2019,133,71,62,1.024489107,1.065370081,0.977264622,,,
2304,전북,완주군,2009,792,422,370,5,2008,859,448,411,0.944581342,0.962856491,0.924510307,,,
2305,전북,완주군,2010,854,446,408,5,2009,823,439,384,1.063078612,1.03847839,1.091140797,,,
2306,전북,완주군,2011,843,466,377,5,2010,860,437,423,1.004237579,1.090012818,0.915277609,,,
2307,전북,완주군,2012,876,469,407,5,2011,837,415,422,1.072225159,1.155185879,0.990452867,,,
2308,전북,완주군,2013,871,444,427,5,2012,926,482,444,0.963639322,0.941592644,0.987635655,,,
2309,전북,완주군,2014,916,475,441,5,2013,927,486,441,1.012332279,0.999043654,1.026956044,,,
2310,전북,완주군,2015,904,477,427,5,2014,927,471,456,0.999070284,1.035200796,0.961645243,,,
2311,전북,완주군,2016,848,443,405,5,2015,1019,553,466,0.852567972,0.818852577,0.892526175,,,
2312,전북,완주군,2017,898,504,394,5,2016,996,543,453,0.923685962,0.948763202,0.893202387,,,
2313,전북,완주군,2018,829,451,378,5,2017,1036,538,498,0.819789064,0.856882733,0.779496756,,,
2314,전북,완주군,2019,822,445,377,5,2018,893,436,457,0.943034766,1.043279436,0.847182557,,,
2315,전북,완주군,2020,702,343,359,5,2019,809,389,420,0.888988076,0.901304717,0.877802904,,,
2316,전북,익산시,2009,3131,1651,1480,5,2008,3206,1622,1584,1.000522581,1.040455113,0.959529637,,,
2317,전북,익산시,2010,3100,1563,1537,5,2009,2958,1514,1444,1.073670126,1.055261827,1.093096565,,,
2318,전북,익산시,2011,2858,1466,1392,5,2010,2746,1455,1291,1.066274533,1.029907219,1.107298848,,,
2319,전북,익산시,2012,2678,1414,1264,5,2011,2694,1374,1320,1.01840454,1.051937172,0.983388212,,,
2320,전북,익산시,2013,2643,1329,1314,5,2012,2943,1495,1448,0.920055967,0.908679883,0.931920056,,,
2321,전북,익산시,2014,2933,1492,1441,5,2013,2717,1397,1320,1.105935426,1.091690528,1.121093681,,,
2322,전북,익산시,2015,2674,1393,1281,5,2014,2550,1273,1277,1.074307401,1.11853567,1.030172821,,,
2323,전북,익산시,2016,2534,1282,1252,5,2015,2711,1386,1325,0.957600663,0.945479072,0.970376579,,,
2324,전북,익산시,2017,2651,1344,1307,5,2016,2707,1357,1350,1.003295391,1.012386969,0.994245592,,,
2325,전북,익산시,2018,2610,1309,1301,5,2017,2767,1427,1340,0.96635944,0.937654406,0.997067025,,,
2326,전북,익산시,2019,2591,1322,1269,5,2018,2286,1195,1091,1.161177287,1.130812694,1.194507076,,,
2327,전북,익산시,2020,2153,1149,1004,5,2019,2165,1126,1039,1.018810646,1.043058733,0.992361759,,,
2328,전북,임실군,2009,174,97,77,5,2008,204,112,92,0.873828945,0.885280375,0.859517558,,,
2329,전북,임실군,2010,214,122,92,5,2009,161,89,72,1.361743286,1.401189742,1.312221612,,,
2330,전북,임실군,2011,173,97,76,5,2010,152,79,73,1.166030366,1.255081038,1.069159717,,,
2331,전북,임실군,2012,149,80,69,5,2011,182,98,84,0.838730093,0.834432165,0.843571036,,,
2332,전북,임실군,2013,166,82,84,5,2012,171,82,89,0.994533286,1.022179402,0.969261884,,,
2333,전북,임실군,2014,163,84,79,5,2013,209,111,98,0.799003467,0.773541169,0.827852321,,,
2334,전북,임실군,2015,203,103,100,5,2014,196,104,92,1.061078004,1.012350754,1.116256569,,,
2335,전북,임실군,2016,163,84,79,5,2015,192,92,100,0.869748565,0.933294237,0.811295275,,,
2336,전북,임실군,2017,164,78,86,5,2016,183,96,87,0.918121386,0.830520764,1.015151951,,,
2337,전북,임실군,2018,158,91,67,5,2017,190,97,93,0.851943574,0.95895181,0.739850053,,,
2338,전북,임실군,2019,144,69,75,5,2018,180,84,96,0.819591286,0.839647366,0.802309409,,,
2339,전북,임실군,2020,139,64,75,5,2019,140,77,63,1.017171328,0.849603659,1.222566719,,,
2340,전북,장수군,2009,137,81,56,5,2008,180,88,92,0.779750043,0.940869677,0.625103679,,,
2341,전북,장수군,2010,150,73,77,5,2009,182,92,90,0.844359154,0.811077134,0.878617949,,,
2342,전북,장수군,2011,162,82,80,5,2010,158,78,80,1.05042554,1.074598859,1.026956044,,,
2343,전북,장수군,2012,156,81,75,5,2011,144,73,71,1.1098632,1.134199063,1.084812722,,,
2344,전북,장수군,2013,134,71,63,5,2012,193,88,105,0.711303318,0.824712927,0.616173626,,,
2345,전북,장수군,2014,179,76,103,5,2013,190,96,94,0.96517658,0.80922536,1.125281622,,,
2346,전북,장수군,2015,187,92,95,5,2014,143,74,69,1.339716525,1.270817635,1.413924988,,,
2347,전북,장수군,2016,146,78,68,5,2015,195,107,88,0.767053383,0.745140125,0.793556943,,,
2348,전북,장수군,2017,165,90,75,5,2016,186,92,94,0.908820982,0.999958111,0.819379822,,,
2349,전북,장수군,2018,161,78,83,5,2017,160,81,79,1.030892164,0.984320906,1.078953818,,,
2350,전북,장수군,2019,150,76,74,5,2018,162,91,71,0.948601025,0.853688292,1.070348553,,,
2351,전북,장수군,2020,136,75,61,5,2019,131,64,67,1.063591745,1.197866487,0.934989831,,,
2352,전북,전주시,2009,7040,3699,3341,5,2008,6849,3544,3305,1.053059325,1.06688533,1.038142252,,,
2353,전북,전주시,2010,6857,3544,3313,5,2009,6566,3391,3175,1.069893666,1.068299558,1.071592244,,,
2354,전북,전주시,2011,6546,3346,3200,5,2010,6122,3283,2839,1.095443596,1.041794785,1.157541155,,,
2355,전북,전주시,2012,5995,3233,2762,5,2011,5998,3099,2899,1.023976692,1.066378189,0.978424489,,,
2356,전북,전주시,2013,5965,3098,2867,5,2012,6682,3553,3129,0.914558145,0.891278297,0.940966116,,,
2357,전북,전주시,2014,6669,3510,3159,5,2013,6286,3236,3050,1.086910254,1.108729821,1.063657096,,,
2358,전북,전주시,2015,6339,3241,3098,5,2014,6025,3114,2911,1.077881569,1.063867515,1.092926769,,,
2359,전북,전주시,2016,6041,3100,2941,5,2015,6378,3300,3078,0.970357275,0.960229135,0.981246824,,,
2360,전북,전주시,2017,6505,3346,3159,5,2016,6376,3231,3145,1.045216694,1.058561523,1.031527549,,,
2361,전북,전주시,2018,6532,3266,3266,5,2017,6461,3309,3152,1.035747229,1.008896321,1.06409849,,,
2362,전북,전주시,2019,6708,3435,3273,5,2018,5957,3061,2896,1.153646623,1.147071626,1.160644728,,,
2363,전북,전주시,2020,6166,3157,3009,5,2019,5977,3101,2876,1.056884697,1.040638624,1.074447405,,,
2364,전북,정읍시,2009,1218,640,578,5,2008,1114,595,519,1.120132615,1.099487088,1.143700565,,,
2365,전북,정읍시,2010,1069,554,515,5,2009,998,522,476,1.097373603,1.084841741,1.1110974,,,
2366,전북,정읍시,2011,982,519,463,5,2010,968,491,477,1.039306099,1.080470692,0.996814776,,,
2367,전북,정읍시,2012,935,468,467,5,2011,874,462,412,1.095992352,1.035454459,1.16404969,,,
2368,전북,정읍시,2013,855,453,402,5,2012,993,501,492,0.882112978,0.924246046,0.839098231,,,
2369,전북,정읍시,2014,963,488,475,5,2013,875,459,416,1.12752344,1.086761543,1.17260606,,,
2370,전북,정읍시,2015,866,453,413,5,2014,825,457,368,1.075403112,1.013232537,1.152534908,,,
2371,전북,정읍시,2016,812,458,354,5,2015,852,436,416,0.976391027,1.073757262,0.873900095,,,
2372,전북,정읍시,2017,829,434,395,5,2016,904,467,437,0.939492777,0.94994831,0.928255463,,,
2373,전북,정읍시,2018,873,455,418,5,2017,866,444,422,1.032770197,1.047503667,1.017221863,,,
2374,전북,정읍시,2019,858,446,412,5,2018,734,378,356,1.197563562,1.206063528,1.188499691,,,
2375,전북,정읍시,2020,698,365,333,5,2019,742,368,374,0.963737732,1.013846418,0.914375301,,,
2376,전북,진안군,2009,158,86,72,5,2008,182,97,85,0.889391643,0.90626215,0.869892178,,,
2377,전북,진안군,2010,159,84,75,5,2009,191,95,96,0.852846953,0.903821787,0.802309409,,,
2378,전북,진안군,2011,156,82,74,5,2010,169,92,77,0.945682253,0.911072945,0.986944769,,,
2379,전북,진안군,2012,140,71,69,5,2011,199,105,94,0.720746106,0.691187977,0.753829436,,,
2380,전북,진안군,2013,169,88,81,5,2012,194,97,97,0.892467315,0.927338014,0.857561232,,,
2381,전북,진안군,2014,163,81,82,5,2013,173,88,85,0.965270084,0.940869677,0.990710536,,,
2382,전북,진안군,2015,135,68,67,5,2014,177,93,84,0.781389997,0.747399993,0.819119702,,,
2383,전북,진안군,2016,152,80,72,5,2015,188,99,89,0.828310342,0.826003557,0.830795901,,,
2384,전북,진안군,2017,166,85,81,5,2016,176,97,79,0.966279499,0.895724218,1.052954931,,,
2385,전북,진안군,2018,146,85,61,5,2017,185,86,99,0.808515728,1.010293595,0.632770896,,,
2386,전북,진안군,2019,148,67,81,5,2018,141,62,79,1.075350269,1.104613225,1.052954931,,,
2387,전북,진안군,2020,116,50,66,5,2019,130,56,74,0.914159511,0.912660181,0.915933769,,,
2388,제주,서귀포시,2009,1479,779,700,5,2008,1497,784,713,1.012170601,1.015660401,1.00823174,,,
2389,제주,서귀포시,2010,1382,729,653,5,2009,1421,791,630,0.996371532,0.942059146,1.06444809,,,
2390,제주,서귀포시,2011,1385,763,622,5,2010,1327,734,593,1.069267079,1.062565237,1.077178178,,,
2391,제주,서귀포시,2012,1289,706,583,5,2011,1362,740,622,0.969578898,0.975214403,0.962564909,,,
2392,제주,서귀포시,2013,1314,703,611,5,2012,1483,735,748,0.90774018,0.977676353,0.838863827,,,
2393,제주,서귀포시,2014,1431,720,711,5,2013,1403,709,694,1.044935077,1.038038321,1.052112028,,,
2394,제주,서귀포시,2015,1407,723,684,5,2014,1375,695,680,1.048331763,1.063360731,1.032996962,,,
2395,제주,서귀포시,2016,1412,708,704,5,2015,1502,765,737,0.963101611,0.946017015,0.980972937,,,
2396,제주,서귀포시,2017,1515,769,746,5,2016,1610,865,745,0.964037887,0.908735214,1.028334508,,,
2397,제주,서귀포시,2018,1618,882,736,5,2017,1712,886,826,0.968237953,1.017564597,0.915060107,,,
2398,제주,서귀포시,2019,1624,828,796,5,2018,1535,763,772,1.083889453,1.109258906,1.058882138,,,
2399,제주,서귀포시,2020,1437,706,731,5,2019,1519,761,758,0.969184231,0.948303099,0.990375815,,,
2400,제주,제주시,2009,4834,2651,2183,5,2008,5156,2694,2462,0.960508213,1.005863992,0.910578815,,,
2401,제주,제주시,2010,5083,2663,2420,5,2009,4692,2466,2226,1.1098632,1.103837692,1.116457155,,,
2402,제주,제주시,2011,4633,2438,2195,5,2010,4384,2308,2076,1.082677471,1.079754499,1.085822985,,,
2403,제주,제주시,2012,4458,2348,2110,5,2011,4588,2380,2208,0.995460427,1.008435814,0.981375567,,,
2404,제주,제주시,2013,4623,2403,2220,5,2012,4960,2559,2401,0.954881682,0.959866004,0.949538699,,,
2405,제주,제주시,2014,5147,2655,2492,5,2013,4684,2419,2265,1.125756925,1.121904222,1.129878349,,,
2406,제주,제주시,2015,4796,2467,2329,5,2014,4672,2448,2224,1.051680171,1.030112984,1.075440929,,,
2407,제주,제주시,2016,4774,2502,2272,5,2015,4977,2585,2392,0.982702632,0.989358942,0.97543651,,,
2408,제주,제주시,2017,5048,2629,2419,5,2016,5084,2602,2482,1.017234661,1.032786183,1.000889069,,,
2409,제주,제주시,2018,5182,2667,2515,5,2017,5461,2771,2690,0.972148426,0.983815397,0.960146636,,,
2410,제주,제주시,2019,5533,2821,2712,5,2018,4976,2529,2447,1.139167651,1.140200907,1.138171145,,,
2411,제주,제주시,2020,4989,2567,2422,5,2019,5011,2567,2444,1.019991251,1.022179402,1.017711759,,,
2412,충남,계룡시,2009,591,342,249,5,2008,572,283,289,1.05851934,1.235283942,0.884816799,,,
2413,충남,계룡시,2010,579,301,278,5,2009,573,298,275,1.035216742,1.032469799,1.038159201,,,
2414,충남,계룡시,2011,550,290,260,5,2010,516,269,247,1.091994204,1.101977794,1.081006362,,,
2415,충남,계룡시,2012,487,242,245,5,2011,584,306,278,0.854325677,0.808390246,0.90505119,,,
2416,충남,계룡시,2013,532,275,257,5,2012,544,273,271,1.001890083,1.029667896,0.973902964,,,
2417,충남,계룡시,2014,484,243,241,5,2013,483,243,240,1.026610203,1.022179402,1.031235027,,,
2418,충남,계룡시,2015,441,229,212,5,2014,485,278,207,0.931545766,0.84201109,1.051761745,,,
2419,충남,계룡시,2016,455,260,195,5,2015,496,248,248,0.939803516,1.071639696,0.807485599,,,
2420,충남,계룡시,2017,480,249,231,5,2016,511,273,238,0.962338105,0.932317477,0.996751454,,,
2421,충남,계룡시,2018,508,273,235,5,2017,523,269,254,0.995106055,1.037379096,0.950136497,,,
2422,충남,계룡시,2019,475,230,245,5,2018,487,244,243,0.999245023,0.963529764,1.035408357,,,
2423,충남,계룡시,2020,419,194,225,5,2019,457,231,226,0.939301829,0.858453697,1.022411991,,,
2424,충남,공주시,2009,1056,572,484,5,2008,1030,529,501,1.050349997,1.105267709,0.992109232,,,
2425,충남,공주시,2010,981,496,485,5,2009,938,509,429,1.07145396,0.996072659,1.161010912,,,
2426,충남,공주시,2011,925,503,422,5,2010,859,431,428,1.103204219,1.19293791,1.012559464,,,
2427,충남,공주시,2012,832,413,419,5,2011,941,473,468,0.905818212,0.892516053,0.919432868,,,
2428,충남,공주시,2013,887,436,451,5,2012,912,491,421,0.996405524,0.907678655,1.100135809,,,
2429,충남,공주시,2014,871,466,405,5,2013,860,421,439,1.037593038,1.131438483,0.947419585,,,
2430,충남,공주시,2015,797,395,402,5,2014,781,398,383,1.045477361,1.014474532,1.077901644,,,
2431,충남,공주시,2016,731,380,351,5,2015,769,409,360,0.973864158,0.949702134,1.001282143,,,
2432,충남,공주시,2017,749,390,359,5,2016,774,382,392,0.991398374,1.043586301,0.940503112,,,
2433,충남,공주시,2018,735,364,371,5,2017,745,393,352,1.010737576,0.946751406,1.08238833,,,
2434,충남,공주시,2019,734,389,345,5,2018,696,376,320,1.080423858,1.057520711,1.107186985,,,
2435,충남,공주시,2020,670,353,317,5,2019,618,337,281,1.110692074,1.070710175,1.158523366,,,
2436,충남,금산군,2009,405,208,197,5,2008,438,216,222,0.947301572,0.984320906,0.911307841,,,
2437,충남,금산군,2010,412,206,206,5,2009,384,197,187,1.099191438,1.068877954,1.131299171,,,
2438,충남,금산군,2011,370,191,179,5,2010,374,183,191,1.013532005,1.066864841,0.962435245,,,
2439,충남,금산군,2012,371,183,188,5,2011,403,216,187,0.943140096,0.866013105,1.032447787,,,
2440,충남,금산군,2013,377,201,176,5,2012,459,230,229,0.84146491,0.893295912,0.789276261,,,
2441,충남,금산군,2014,454,221,233,5,2013,395,201,194,1.177514063,1.123888796,1.23340597,,,
2442,충남,금산군,2015,378,200,178,5,2014,385,196,189,1.005862033,1.043040206,0.967186115,,,
2443,충남,금산군,2016,377,190,187,5,2015,427,232,195,0.904525512,0.837129683,0.984824514,,,
2444,충남,금산군,2017,400,218,182,5,2016,387,192,195,1.05890347,1.16059953,0.958492308,,,
2445,충남,금산군,2018,370,187,183,5,2017,323,175,148,1.173563374,1.092271704,1.26981727,,,
2446,충남,금산군,2019,322,179,143,5,2018,322,179,143,1.024489107,1.022179402,1.026956044,,,
2447,충남,금산군,2020,298,167,131,5,2019,264,133,131,1.156430886,1.283488422,1.026956044,,,
2448,충남,논산시,2009,1040,539,501,5,2008,1017,526,491,1.047658478,1.047442391,1.047871646,,,
2449,충남,논산시,2010,1068,545,523,5,2009,1017,501,516,1.075864667,1.111951645,1.040887618,,,
2450,충남,논산시,2011,985,489,496,5,2010,914,466,448,1.104071959,1.072630317,1.136987049,,,
2451,충남,논산시,2012,939,483,456,5,2011,980,516,464,0.981627828,0.956807464,1.009249905,,,
2452,충남,논산시,2013,999,518,481,5,2012,1047,550,497,0.977521125,0.962707146,0.993895085,,,
2453,충남,논산시,2014,1065,564,501,5,2013,983,487,496,1.10995005,1.18379709,1.037308423,,,
2454,충남,논산시,2015,1009,512,497,5,2014,896,446,450,1.153693649,1.173443619,1.134215897,,,
2455,충남,논산시,2016,919,467,452,5,2015,892,465,427,1.055499428,1.026575873,1.087082276,,,
2456,충남,논산시,2017,918,495,423,5,2016,907,474,433,1.036914003,1.067465831,1.003238814,,,
2457,충남,논산시,2018,909,465,444,5,2017,930,473,457,1.001355482,1.004890956,0.997742852,,,
2458,충남,논산시,2019,905,466,439,5,2018,811,414,397,1.143233837,1.150569086,1.135601268,,,
2459,충남,논산시,2020,794,409,385,5,2019,821,413,408,0.990797017,1.01227936,0.969063914,,,
2460,충남,당진시,2013,1533,818,715,5,2012,1741,902,839,0.902091787,0.926987529,0.875177081,,,
2461,충남,당진시,2014,1773,923,850,5,2013,1769,945,824,1.026805646,0.998382633,1.059359997,,,
2462,충남,당진시,2015,1734,925,809,5,2014,1738,867,871,1.02213125,1.090560493,0.953854695,,,
2463,충남,당진시,2016,1691,845,846,5,2015,1918,1011,907,0.903238311,0.854343813,0.957888438,,,
2464,충남,당진시,2017,1862,989,873,5,2016,1926,978,948,0.990445856,1.033676308,0.945709521,,,
2465,충남,당진시,2018,1865,967,898,5,2017,1907,990,917,1.001925635,0.9984318,1.005677783,,,
2466,충남,당진시,2019,1871,975,896,5,2018,1775,897,878,1.079898096,1.111064568,1.048009812,,,
2467,충남,당진시,2020,1703,850,853,5,2019,1758,879,879,0.9924374,0.988455622,0.996579642,,,
2468,충남,보령시,2009,900,468,432,5,2008,916,455,461,1.006594101,1.051384528,0.962353603,,,
2469,충남,보령시,2010,900,435,465,5,2009,920,474,446,1.002217605,0.938076034,1.070705292,,,
2470,충남,보령시,2011,888,471,417,5,2010,807,449,358,1.127318869,1.072263916,1.19620299,,,
2471,충남,보령시,2012,779,426,353,5,2011,854,451,403,0.934516411,0.965517573,0.899542143,,,
2472,충남,보령시,2013,813,434,379,5,2012,872,450,422,0.95517161,0.985835246,0.922313603,,,
2473,충남,보령시,2014,828,422,406,5,2013,869,436,433,0.976153028,0.989357128,0.962919524,,,
2474,충남,보령시,2015,836,424,412,5,2014,801,393,408,1.069254549,1.10280933,1.03702424,,,
2475,충남,보령시,2016,768,388,380,5,2015,836,437,399,0.941157458,0.907564321,0.978053375,,,
2476,충남,보령시,2017,797,412,385,5,2016,835,416,419,0.977865651,1.012350754,0.943623095,,,
2477,충남,보령시,2018,811,401,410,5,2017,786,409,377,1.057074639,1.002185673,1.116848748,,,
2478,충남,보령시,2019,726,374,352,5,2018,686,359,327,1.084226082,1.064888848,1.105469503,,,
2479,충남,보령시,2020,644,341,303,5,2019,724,337,387,0.911285891,1.034312095,0.804050856,,,
2480,충남,부여군,2009,528,261,267,5,2008,555,288,267,0.974649097,0.926350083,1.026956044,,,
2481,충남,부여군,2010,536,279,257,5,2009,470,258,212,1.168353535,1.105380051,1.244941997,,,
2482,충남,부여군,2011,451,248,203,5,2010,475,232,243,0.972725447,1.092674533,0.857909781,,,
2483,충남,부여군,2012,451,220,231,5,2011,460,241,219,1.004444755,0.933109828,1.083227608,,,
2484,충남,부여군,2013,455,243,212,5,2012,453,235,218,1.029012238,1.056976999,0.998691199,,,
2485,충남,부여군,2014,442,230,212,5,2013,432,227,205,1.048204133,1.035688381,1.062022836,,,
2486,충남,부여군,2015,408,210,198,5,2014,404,204,200,1.034632564,1.052243502,1.016686483,,,
2487,충남,부여군,2016,377,200,177,5,2015,415,231,184,0.930680466,0.885003811,0.987887064,,,
2488,충남,부여군,2017,380,212,168,5,2016,380,212,168,1.024489107,1.022179402,1.026956044,,,
2489,충남,부여군,2018,359,198,161,5,2017,398,214,184,0.924099471,0.945754774,0.898586538,,,
2490,충남,부여군,2019,370,190,180,5,2018,339,183,156,1.118173952,1.061279161,1.184949281,,,
2491,충남,부여군,2020,314,176,138,5,2019,355,196,159,0.90616783,0.917875382,0.89132034,,,
2492,충남,서산시,2009,1769,965,804,5,2008,1706,907,799,1.062321941,1.087544789,1.033382552,,,
2493,충남,서산시,2010,1714,911,803,5,2009,1727,912,815,1.016777261,1.021058592,1.011835219,,,
2494,충남,서산시,2011,1711,912,799,5,2010,1557,803,754,1.125819437,1.160931027,1.088246524,,,
2495,충남,서산시,2012,1492,762,730,5,2011,1608,816,792,0.950583177,0.954535177,0.94656302,,,
2496,충남,서산시,2013,1599,831,768,5,2012,1892,974,918,0.865834082,0.872105835,0.859152769,,,
2497,충남,서산시,2014,1873,967,906,5,2013,1742,916,826,1.101531629,1.079091138,1.126419099,,,
2498,충남,서산시,2015,1724,901,823,5,2014,1672,891,781,1.056351209,1.033651674,1.082182873,,,
2499,충남,서산시,2016,1641,884,757,5,2015,1779,918,861,0.945017777,0.984320906,0.90291025,,,
2500,충남,서산시,2017,1716,889,827,5,2016,1747,916,831,1.00630985,0.99204966,1.022012814,,,
2501,충남,서산시,2018,1716,904,812,5,2017,1837,966,871,0.957007789,0.956573685,0.957391857,,,
2502,충남,서산시,2019,1834,948,886,5,2018,1685,838,847,1.115081913,1.156355696,1.074242095,,,
2503,충남,서산시,2020,1655,816,839,5,2019,1732,910,822,0.978943114,0.91659164,1.048194794,,,
2504,충남,서천군,2009,419,227,192,5,2008,403,213,190,1.065163613,1.089364903,1.037766107,,,
2505,충남,서천군,2010,405,215,190,5,2009,356,170,186,1.165500249,1.292756303,1.04904112,,,
2506,충남,서천군,2011,339,164,175,5,2010,381,196,185,0.9115533,0.855292969,0.971444906,,,
2507,충남,서천군,2012,360,180,180,5,2011,325,171,154,1.134818704,1.075978318,1.200338233,,,
2508,충남,서천군,2013,310,160,150,5,2012,345,170,175,0.92055543,0.962051202,0.880248038,,,
2509,충남,서천군,2014,328,166,162,5,2013,325,154,171,1.03394593,1.101829745,0.972905726,,,
2510,충남,서천군,2015,315,154,161,5,2014,305,160,145,1.058078914,0.983847675,1.140275331,,,
2511,충남,서천군,2016,293,149,144,5,2015,339,166,173,0.885472886,0.917498379,0.854807343,,,
2512,충남,서천군,2017,316,154,162,5,2016,328,168,160,0.987007799,0.936997785,1.039792994,,,
2513,충남,서천군,2018,306,156,150,5,2017,298,153,145,1.051992171,1.042222136,1.062368321,,,
2514,충남,서천군,2019,266,133,133,5,2018,286,138,148,0.952846512,0.985143917,0.922872661,,,
2515,충남,서천군,2020,261,127,134,5,2019,275,140,135,0.972333298,0.927262743,1.019348962,,,
2516,충남,아산시,2009,2806,1476,1330,5,2008,3033,1583,1450,0.94781287,0.953087048,0.941966578,,,
2517,충남,아산시,2010,3124,1649,1475,5,2009,3380,1706,1674,0.946894666,0.988026867,0.90487465,,,
2518,충남,아산시,2011,3259,1634,1625,5,2010,3091,1598,1493,1.080171466,1.045207224,1.11775189,,,
2519,충남,아산시,2012,2953,1548,1405,5,2011,3401,1765,1636,0.889537293,0.896506354,0.881951859,,,
2520,충남,아산시,2013,3235,1662,1573,5,2012,3822,1996,1826,0.867143449,0.85113335,0.884666953,,,
2521,충남,아산시,2014,3701,1934,1767,5,2013,3706,1878,1828,1.023106904,1.052659725,0.992686723,,,
2522,충남,아산시,2015,3494,1782,1712,5,2014,3754,1896,1858,0.953533549,0.960719248,0.946258744,,,
2523,충남,아산시,2016,3564,1817,1747,5,2015,4014,2116,1898,0.909636068,0.877741008,0.945254061,,,
2524,충남,아산시,2017,3824,1990,1834,5,2016,4095,2093,2002,0.956690195,0.971876259,0.940777914,,,
2525,충남,아산시,2018,3957,2034,1923,5,2017,4333,2226,2107,0.935588137,0.934012985,0.937274073,,,
2526,충남,아산시,2019,4141,2111,2030,5,2018,3802,1978,1824,1.115836242,1.090910373,1.142939018,,,
2527,충남,아산시,2020,3646,1895,1751,5,2019,3621,1847,1774,1.031562354,1.048743891,1.013641507,,,
2528,충남,연기군,2009,733,377,356,5,2008,726,384,342,1.034367102,1.003545924,1.06899518,,,
2529,충남,연기군,2010,736,382,354,5,2009,732,371,361,1.030087409,1.052486608,1.007042769,,,
2530,충남,연기군,2011,719,371,348,5,2010,713,351,362,1.033110334,1.080423243,0.987239512,,,
2531,충남,연기군,2012,783,388,395,5,2011,724,354,370,1.107976479,1.120354825,1.096344966,,,
2532,충남,예산군,2009,635,334,301,5,2008,610,299,311,1.066476366,1.14183251,0.993934949,,,
2533,충남,예산군,2010,580,282,298,5,2009,590,311,279,1.007124885,0.926863638,1.096892118,,,
2534,충남,예산군,2011,560,293,267,5,2010,568,296,272,1.010059683,1.011819476,1.008078175,,,
2535,충남,예산군,2012,539,281,258,5,2011,564,273,291,0.979077356,1.052133377,0.910497111,,,
2536,충남,예산군,2013,557,271,286,5,2012,628,350,278,0.90866311,0.791458909,1.056508736,,,
2537,충남,예산군,2014,614,338,276,5,2013,541,272,269,1.162728858,1.270208228,1.053679807,,,
2538,충남,예산군,2015,512,256,256,5,2014,510,267,243,1.028506712,0.980067142,1.081896079,,,
2539,충남,예산군,2016,484,264,220,5,2015,529,270,259,0.93733975,0.999464304,0.872317875,,,
2540,충남,예산군,2017,496,259,237,5,2016,501,263,238,1.014264665,1.006632947,1.022641102,,,
2541,충남,예산군,2018,497,262,235,5,2017,484,267,217,1.052006377,1.003037466,1.112141338,,,
2542,충남,예산군,2019,486,265,221,5,2018,428,221,207,1.163321743,1.225690233,1.096412008,,,
2543,충남,예산군,2020,441,229,212,5,2019,405,194,211,1.115554806,1.206593212,1.031823134,,,
2544,충남,천안시,2009,6119,3227,2892,5,2008,6340,3258,3082,0.988777421,1.012453324,0.96364597,,,
2545,충남,천안시,2010,6122,3184,2938,5,2009,6224,3248,2976,1.007699601,1.002037936,1.01384303,,,
2546,충남,천안시,2011,6315,3307,3008,5,2010,5839,2985,2854,1.108006288,1.132444651,1.08236993,,,
2547,충남,천안시,2012,6027,3089,2938,5,2011,6105,3163,2942,1.011399812,0.998264993,1.025559775,,,
2548,충남,천안시,2013,6104,3190,2914,5,2012,6857,3542,3315,0.911985053,0.920596356,0.902729988,,,
2549,충남,천안시,2014,6797,3506,3291,5,2013,6605,3438,3167,1.054269866,1.042397029,1.067165248,,,
2550,충남,천안시,2015,6599,3425,3174,5,2014,6278,3248,3030,1.076872192,1.077883144,1.075761876,,,
2551,충남,천안시,2016,6326,3273,3053,5,2015,6593,3371,3222,0.982999862,0.992463122,0.973090255,,,
2552,충남,천안시,2017,6857,3517,3340,5,2016,6840,3580,3260,1.027035352,1.004191329,1.052157419,,,
2553,충남,천안시,2018,7076,3700,3376,5,2017,7281,3630,3651,0.995644132,1.041890851,0.949603836,,,
2554,충남,천안시,2019,7491,3751,3740,5,2018,6785,3449,3336,1.131090332,1.111683079,1.151323622,,,
2555,충남,천안시,2020,6790,3458,3332,5,2019,6696,3408,3288,1.038871123,1.037176166,1.040698765,,,
2556,충남,청양군,2009,194,94,100,5,2008,201,100,101,0.988810382,0.960848638,1.016788162,,,
2557,충남,청양군,2010,189,103,86,5,2009,206,105,101,0.93994389,1.002709318,0.874437819,,,
2558,충남,청양군,2011,196,96,100,5,2010,169,88,81,1.188164882,1.115104802,1.267846968,,,
2559,충남,청양군,2012,159,86,73,5,2011,188,99,89,0.866456213,0.887953824,0.842334733,,,
2560,충남,청양군,2013,173,88,85,5,2012,167,76,91,1.061297099,1.18357615,0.959244656,,,
2561,충남,청양군,2014,162,76,86,5,2013,185,108,77,0.897120191,0.719311431,1.146989867,,,
2562,충남,청양군,2015,171,99,72,5,2014,168,71,97,1.042783556,1.425292406,0.762276651,,,
2563,충남,청양군,2016,144,63,81,5,2015,185,94,91,0.79744017,0.685077684,0.914103731,,,
2564,충남,청양군,2017,165,88,77,5,2016,180,98,82,0.939115015,0.917875382,0.964336773,,,
2565,충남,청양군,2018,169,89,80,5,2017,189,99,90,0.916077562,0.918928958,0.912849817,,,
2566,충남,청양군,2019,159,80,79,5,2018,162,83,79,1.005517087,0.985233159,1.026956044,,,
2567,충남,청양군,2020,143,74,69,5,2019,134,61,73,1.093298077,1.240020914,0.97068448,,,
2568,충남,태안군,2009,457,240,217,5,2008,468,233,235,1.000409235,1.052888655,0.948295581,,,
2569,충남,태안군,2010,442,217,225,5,2009,434,214,220,1.043373699,1.03650902,1.050295954,,,
2570,충남,태안군,2011,436,219,217,5,2010,428,219,209,1.043638437,1.022179402,1.066265366,,,
2571,충남,태안군,2012,414,209,205,5,2011,438,221,217,0.968352718,0.966676448,0.970165848,,,
2572,충남,태안군,2013,429,212,217,5,2012,445,240,205,0.987653544,0.902925139,1.087070544,,,
2573,충남,태안군,2014,438,235,203,5,2013,430,208,222,1.04354937,1.154866152,0.939063409,,,
2574,충남,태안군,2015,429,217,212,5,2014,416,234,182,1.056504392,0.947918506,1.196234513,,,
2575,충남,태안군,2016,429,224,205,5,2015,358,198,160,1.227669908,1.15640498,1.315787431,,,
2576,충남,태안군,2017,349,189,160,5,2016,435,222,213,0.821946433,0.870233815,0.77142238,,,
2577,충남,태안군,2018,422,221,201,5,2017,415,199,216,1.041769647,1.13518416,0.955639652,,,
2578,충남,태안군,2019,392,186,206,5,2018,375,186,189,1.070932614,1.022179402,1.119327751,,,
2579,충남,태안군,2020,356,174,182,5,2019,339,163,176,1.075864667,1.091160834,1.061965909,,,
2580,충남,홍성군,2009,736,370,366,5,2008,752,387,365,1.002691467,0.977277465,1.029769622,,,
2581,충남,홍성군,2010,749,398,351,5,2009,730,369,361,1.051153892,1.102513285,0.998508508,,,
2582,충남,홍성군,2011,733,365,368,5,2010,681,332,349,1.102717351,1.123781572,1.082864826,,,
2583,충남,홍성군,2012,661,315,346,5,2011,666,340,326,1.016797748,0.947019152,1.089959482,,,
2584,충남,홍성군,2013,716,378,338,5,2012,724,364,360,1.013168786,1.061493995,0.964197619,,,
2585,충남,홍성군,2014,773,396,377,5,2013,738,375,363,1.073075989,1.079421449,1.066563164,,,
2586,충남,홍성군,2015,827,412,415,5,2014,744,377,367,1.138780231,1.117076694,1.161271821,,,
2587,충남,홍성군,2016,849,429,420,5,2015,817,419,398,1.064615976,1.046575092,1.083722458,,,
2588,충남,홍성군,2017,950,478,472,5,2016,921,481,440,1.056747722,1.015804063,1.101643756,,,
2589,충남,홍성군,2018,942,490,452,5,2017,958,501,457,1.007378642,0.999736342,1.015720201,,,
2590,충남,홍성군,2019,943,482,461,5,2018,856,457,399,1.128613584,1.078097313,1.186533173,,,
2591,충남,홍성군,2020,865,462,403,5,2019,836,445,391,1.060027605,1.061228952,1.058473876,,,
2592,충북,괴산군,2009,218,111,107,5,2008,207,115,92,1.078930558,0.986625336,1.194394529,,,
2593,충북,괴산군,2010,200,112,88,5,2009,191,88,103,1.072763463,1.300955603,0.877399338,,,
2594,충북,괴산군,2011,177,88,89,5,2010,160,72,88,1.133341075,1.249330381,1.038625999,,,
2595,충북,괴산군,2012,167,79,88,5,2011,177,89,88,0.966608367,0.907327784,1.026956044,,,
2596,충북,괴산군,2013,166,83,83,5,2012,213,101,112,0.798428131,0.840008816,0.761047782,,,
2597,충북,괴산군,2014,191,90,101,5,2013,181,90,91,1.081090716,1.022179402,1.139808356,,,
2598,충북,괴산군,2015,189,79,110,5,2014,207,97,110,0.935403098,0.832496627,1.026956044,,,
2599,충북,괴산군,2016,182,77,105,5,2015,198,112,86,0.941702109,0.702748339,1.253841681,,,
2600,충북,괴산군,2017,190,104,86,5,2016,163,77,86,1.194189757,1.380605946,1.026956044,,,
2601,충북,괴산군,2018,142,61,81,5,2017,179,90,89,0.812723203,0.692810484,0.934645388,,,
2602,충북,괴산군,2019,170,96,74,5,2018,144,63,81,1.209466307,1.557606708,0.938206756,,,
2603,충북,괴산군,2020,143,62,81,5,2019,170,87,83,0.861776132,0.728449689,1.002210115,,,
2604,충북,단양군,2009,209,101,108,5,2008,237,119,118,0.90345242,0.86756403,0.939925871,,,
2605,충북,단양군,2010,203,103,100,5,2009,219,117,102,0.949640588,0.899867337,1.006819651,,,
2606,충북,단양군,2011,205,114,91,5,2010,213,106,107,0.986010643,1.099325018,0.873392523,,,
2607,충북,단양군,2012,200,106,94,5,2011,206,106,100,0.994649619,1.022179402,0.965338681,,,
2608,충북,단양군,2013,184,95,89,5,2012,215,111,104,0.876772073,0.874838227,0.878837384,,,
2609,충북,단양군,2014,211,108,103,5,2013,184,86,98,1.174821748,1.283667156,1.07935176,,,
2610,충북,단양군,2015,182,86,96,5,2014,192,109,83,0.9711303,0.806490171,1.187804581,,,
2611,충북,단양군,2016,175,100,75,5,2015,159,92,67,1.127582351,1.111064568,1.149577661,,,
2612,충북,단양군,2017,152,88,64,5,2016,169,97,72,0.92143399,0.927338014,0.912849817,,,
2613,충북,단양군,2018,164,92,72,5,2017,162,81,81,1.037137121,1.160993889,0.912849817,,,
2614,충북,단양군,2019,155,78,77,5,2018,141,75,66,1.12621143,1.063066578,1.198115384,,,
2615,충북,단양군,2020,117,60,57,5,2019,131,72,59,0.915001722,0.851816169,0.992143975,,,
2616,충북,보은군,2009,244,116,128,5,2008,204,89,115,1.225369325,1.332278771,1.143046727,,,
2617,충북,보은군,2010,209,90,119,5,2009,211,108,103,1.01477831,0.851816169,1.186483196,,,
2618,충북,보은군,2011,210,113,97,5,2010,198,113,85,1.086579356,1.022179402,1.171938074,,,
2619,충북,보은군,2012,199,108,91,5,2011,194,106,88,1.050893466,1.041465806,1.061965909,,,
2620,충북,보은군,2013,188,103,85,5,2012,197,112,85,0.977685037,0.940039986,1.026956044,,,
2621,충북,보은군,2014,191,115,76,5,2013,195,104,91,1.003473946,1.130294531,0.857677575,,,
2622,충북,보은군,2015,180,100,80,5,2014,187,91,96,0.986139248,1.123274068,0.855796703,,,
2623,충북,보은군,2016,196,101,95,5,2015,181,110,71,1.10939152,0.938546542,1.374096115,,,
2624,충북,보은군,2017,185,110,75,5,2016,196,98,98,0.96699227,1.147344227,0.785935748,,,
2625,충북,보은군,2018,202,101,101,5,2017,186,101,85,1.112617203,1.022179402,1.220265417,,,
2626,충북,보은군,2019,184,93,91,5,2018,149,72,77,1.265140911,1.320315061,1.213675325,,,
2627,충북,보은군,2020,146,67,79,5,2019,152,78,74,0.984048748,0.878025897,1.096344966,,,
2628,충북,영동군,2009,360,195,165,5,2008,344,165,179,1.072139764,1.208030203,0.946635459,,,
2629,충북,영동군,2010,339,163,176,5,2009,330,170,160,1.052429719,0.980089662,1.129651648,,,
2630,충북,영동군,2011,320,162,158,5,2010,291,156,135,1.12658596,1.061493995,1.201918925,,,
2631,충북,영동군,2012,295,154,141,5,2011,301,152,149,1.004067398,1.035629131,0.971817464,,,
2632,충북,영동군,2013,296,150,146,5,2012,355,187,168,0.854221904,0.819930002,0.892473705,,,
2633,충북,영동군,2014,343,178,165,5,2013,319,172,147,1.101566658,1.057836823,1.152705763,,,
2634,충북,영동군,2015,294,159,135,5,2014,294,155,139,1.024489107,1.048558226,0.997403352,,,
2635,충북,영동군,2016,272,143,129,5,2015,342,198,144,0.814798354,0.738240679,0.919981456,,,
2636,충북,영동군,2017,298,181,117,5,2016,311,163,148,0.981664804,1.135058109,0.811850386,,,
2637,충북,영동군,2018,279,141,138,5,2017,301,143,158,0.949609505,1.007883187,0.896961608,,,
2638,충북,영동군,2019,266,132,134,5,2018,250,131,119,1.09005641,1.029982298,1.156404285,,,
2639,충북,영동군,2020,224,113,111,5,2019,258,121,137,0.889478915,0.954597293,0.832059276,,,
2640,충북,옥천군,2009,410,208,202,5,2008,418,226,192,1.00488166,0.940766883,1.080443338,,,
2641,충북,옥천군,2010,408,221,187,5,2009,411,208,203,1.017011085,1.086065615,0.946013696,,,
2642,충북,옥천군,2011,392,191,201,5,2010,364,172,192,1.103295962,1.135094569,1.075094608,,,
2643,충북,옥천군,2012,354,176,178,5,2011,397,205,192,0.913524292,0.877578414,0.952073832,,,
2644,충북,옥천군,2013,374,198,176,5,2012,426,218,208,0.899434099,0.928401475,0.868962806,,,
2645,충북,옥천군,2014,396,200,196,5,2013,371,191,180,1.093524762,1.070344924,1.118241026,,,
2646,충북,옥천군,2015,357,183,174,5,2014,373,186,187,0.980543194,1.005692638,0.955563378,,,
2647,충북,옥천군,2016,350,179,171,5,2015,355,188,167,1.010059683,0.973245282,1.051553793,,,
2648,충북,옥천군,2017,362,195,167,5,2016,390,214,176,0.950936043,0.931425156,0.974441246,,,
2649,충북,옥천군,2018,379,210,169,5,2017,333,163,170,1.166010125,1.316918248,1.020915126,,,
2650,충북,옥천군,2019,334,163,171,5,2018,288,150,138,1.188122784,1.110768284,1.272532489,,,
2651,충북,옥천군,2020,272,148,124,5,2019,309,145,164,0.901815654,1.043327942,0.77647896,,,
2652,충북,음성군,2009,892,445,447,5,2008,899,455,444,1.016511995,0.999713921,1.033894936,,,
2653,충북,음성군,2010,824,427,397,5,2009,870,478,392,0.970320718,0.91311842,1.040054973,,,
2654,충북,음성군,2011,786,443,343,5,2010,764,394,370,1.053990103,1.149303237,0.952016008,,,
2655,충북,음성군,2012,720,376,344,5,2011,781,379,402,0.944471392,1.014088272,0.878788256,,,
2656,충북,음성군,2013,727,349,378,5,2012,893,473,420,0.834046563,0.754208481,0.924260439,,,
2657,충북,음성군,2014,836,436,400,5,2013,822,429,393,1.041937827,1.03885832,1.045247882,,,
2658,충북,음성군,2015,797,413,384,5,2014,817,444,373,0.999409815,0.950811021,1.057241611,,,
2659,충북,음성군,2016,785,427,358,5,2015,834,457,377,0.964297301,0.95507791,0.975199638,,,
2660,충북,음성군,2017,823,454,369,5,2016,873,476,397,0.965812755,0.974935816,0.954525895,,,
2661,충북,음성군,2018,801,428,373,5,2017,874,475,399,0.938919651,0.92103744,0.960036602,,,
2662,충북,음성군,2019,756,411,345,5,2018,723,367,356,1.071250021,1.144729521,0.995224256,,,
2663,충북,음성군,2020,670,340,330,5,2019,674,351,323,1.018409053,0.99014529,1.049212057,,,
2664,충북,제천시,2009,1186,623,563,5,2008,1142,597,545,1.063961542,1.066696428,1.060873858,,,
2665,충북,제천시,2010,1162,605,557,5,2009,1165,613,552,1.021850938,1.008839377,1.036258182,,,
2666,충북,제천시,2011,1162,618,544,5,2010,1061,550,511,1.122013518,1.148557947,1.093276101,,,
2667,충북,제천시,2012,1053,536,517,5,2011,1081,561,520,0.997952849,0.976627735,1.021031297,,,
2668,충북,제천시,2013,1082,562,520,5,2012,1138,583,555,0.974074881,0.985359904,0.96219305,,,
2669,충북,제천시,2014,1105,568,537,5,2013,1116,586,530,1.014391096,0.9907814,1.040519614,,,
2670,충북,제천시,2015,1079,572,507,5,2014,1022,512,510,1.081627932,1.141966051,1.020915126,,,
2671,충북,제천시,2016,993,496,497,5,2015,1100,532,568,0.924834258,0.953009368,0.898586538,,,
2672,충북,제천시,2017,1061,511,550,5,2016,1081,546,535,1.005534637,0.956655082,1.055749204,,,
2673,충북,제천시,2018,1057,524,533,5,2017,1130,581,549,0.958305298,0.921896741,0.997026542,,,
2674,충북,제천시,2019,1078,536,542,5,2018,972,482,490,1.136213228,1.136697427,1.135939134,,,
2675,충북,제천시,2020,931,477,454,5,2019,1004,500,504,0.949999362,0.97515915,0.925075484,,,
2676,충북,증평군,2009,345,167,178,5,2008,324,162,162,1.090891179,1.053728149,1.128383801,,,
2677,충북,증평군,2010,311,165,146,5,2009,350,171,179,0.91033175,0.986313458,0.837628952,,,
2678,충북,증평군,2011,332,165,167,5,2010,342,171,171,0.994533286,0.986313458,1.00293368,,,
2679,충북,증평군,2012,319,163,156,5,2011,322,172,150,1.014944178,0.968693271,1.068034286,,,
2680,충북,증평군,2013,323,172,151,5,2012,406,214,192,0.815049216,0.821564753,0.807658139,,,
2681,충북,증평군,2014,367,192,175,5,2013,386,198,188,0.974060887,0.991204269,0.955943126,,,
2682,충북,증평군,2015,352,183,169,5,2014,368,200,168,0.979946103,0.935294153,1.033068877,,,
2683,충북,증평군,2016,341,193,148,5,2015,440,231,209,0.793979058,0.854028678,0.727222462,,,
2684,충북,증평군,2017,397,214,183,5,2016,408,214,194,0.996868078,1.022179402,0.968726577,,,
2685,충북,증평군,2018,381,192,189,5,2017,418,212,206,0.933804665,0.925747383,0.942207244,,,
2686,충북,증평군,2019,369,188,181,5,2018,398,211,187,0.949840404,0.910757003,0.994005583,,,
2687,충북,증평군,2020,355,184,171,5,2019,377,170,207,0.964704597,1.106358882,0.848354993,,,
2688,충북,진천군,2009,637,327,310,5,2008,613,333,280,1.064599611,1.003761755,1.136987049,,,
2689,충북,진천군,2010,632,336,296,5,2009,677,373,304,0.956391604,0.92078359,0.999930885,,,
2690,충북,진천군,2011,644,356,288,5,2010,598,331,267,1.103295962,1.099383285,1.107727867,,,
2691,충북,진천군,2012,598,325,273,5,2011,545,287,258,1.124118323,1.157520229,1.086662791,,,
2692,충북,진천군,2013,564,300,264,5,2012,679,343,336,0.850974752,0.894034463,0.806894034,,,
2693,충북,진천군,2014,698,355,343,5,2013,629,351,278,1.136873445,1.03382817,1.267071666,,,
2694,충북,진천군,2015,670,369,301,5,2014,562,273,289,1.221366018,1.381627104,1.069597817,,,
2695,충북,진천군,2016,681,325,356,5,2015,702,366,336,0.993841997,0.907672966,1.08808438,,,
2696,충북,진천군,2017,767,392,375,5,2016,731,376,355,1.074942743,1.065676398,1.084812722,,,
2697,충북,진천군,2018,852,437,415,5,2017,760,388,372,1.14850621,1.151269069,1.145663328,,,
2698,충북,진천군,2019,904,455,449,5,2018,759,384,375,1.22020837,1.211176115,1.229608703,,,
2699,충북,진천군,2020,837,415,422,5,2019,802,432,370,1.069198732,0.98195475,1.171285001,,,
2700,충북,청원군,2009,1495,795,700,5,2008,1643,855,788,0.932204027,0.950447514,0.912270597,,,
2701,충북,청원군,2010,1453,777,676,5,2009,1632,840,792,0.912121736,0.945515947,0.87654329,,,
2702,충북,청원군,2011,1558,793,765,5,2010,1528,820,708,1.044603422,0.988522276,1.109634708,,,
2703,충북,청원군,2012,1530,813,717,5,2011,1729,864,865,0.906575092,0.961842424,0.851245646,,,
2704,충북,청원군,2013,1618,825,793,5,2012,1869,970,899,0.886903893,0.869379389,0.905868902,,,
2705,충북,청원군,2014,1759,922,837,5,2013,1791,919,872,1.006184444,1.025516223,0.985736478,,,
2706,충북,청주시,2009,7078,3735,3343,5,2008,7173,3756,3417,1.010920661,1.016464342,1.004715849,,,
2707,충북,청주시,2010,7191,3773,3418,5,2009,6861,3582,3279,1.073764928,1.076684222,1.07048971,,,
2708,충북,청주시,2011,6977,3643,3334,5,2010,6393,3285,3108,1.118076099,1.133576731,1.101631741,,,
2709,충북,청주시,2012,6402,3293,3109,5,2011,6547,3342,3205,1.001799185,1.007192331,0.996195426,,,
2710,충북,청주시,2013,6508,3290,3218,5,2012,7260,3760,3500,0.918371227,0.894406977,0.944212728,,,
2711,충북,청주시,2014,7226,3741,3485,5,2013,6882,3494,3388,1.075698676,1.094439938,1.056358268,,,
2712,충북,청주시,2015,8391,4303,4088,5,2014,8397,4409,3988,1.023757068,0.997604438,1.052707198,,,
2713,충북,청주시,2016,8134,4263,3871,5,2015,8695,4476,4219,0.958389235,0.973536817,0.942248601,,,
2714,충북,청주시,2017,8554,4407,4147,5,2016,8762,4419,4343,1.000168891,1.019403627,0.980609421,,,
2715,충북,청주시,2018,8496,4284,4212,5,2017,9048,4605,4443,0.961987119,0.950926506,0.973562651,,,
2716,충북,청주시,2019,8854,4511,4343,5,2018,8193,4185,4008,1.107143483,1.101804369,1.112791941,,,
2717,충북,청주시,2020,8056,4118,3938,5,2019,7957,3998,3959,1.037235673,1.052860125,1.021508689,,,
2718,충북,충주시,2009,1850,967,883,5,2008,1934,987,947,0.979992166,1.001466547,0.957552467,,,
2719,충북,충주시,2010,1918,977,941,5,2009,1852,967,885,1.060998978,1.032750027,1.091938573,,,
2720,충북,충주시,2011,1818,948,870,5,2010,1666,876,790,1.117959902,1.106194148,1.130951593,,,
2721,충북,충주시,2012,1624,845,779,5,2011,1699,872,827,0.979264456,0.990529352,0.967350373,,,
2722,충북,충주시,2013,1676,865,811,5,2012,1857,972,885,0.924633142,0.909655538,0.941086273,,,
2723,충북,충주시,2014,1837,957,880,5,2013,1729,922,807,1.088482643,1.060982308,1.119852935,,,
2724,충북,충주시,2015,1701,902,799,5,2014,1611,801,810,1.081723136,1.15106844,1.013009727,,,
2725,충북,충주시,2016,1594,789,805,5,2015,1763,880,883,0.926282267,0.91647676,0.936239655,,,
2726,충북,충주시,2017,1738,874,864,5,2016,1734,919,815,1.026852404,0.972127092,1.088699413,,,
2727,충북,충주시,2018,1735,914,821,5,2017,1661,810,851,1.070131608,1.15342219,0.990753128,,,
2728,충북,충주시,2019,1682,828,854,5,2018,1598,807,791,1.078342102,1.048778866,1.108749003,,,
2729,충북,충주시,2020,1598,806,792,5,2019,1577,770,807,1.038131638,1.069969608,1.007867642,,,
