"","prov","distinct","adm.year","adm.total","adm.male","adm.female","pop.age","pop.year","pop.total","pop.male","pop.female","adm.per.pop.total","adm.per.pop.male","adm.per.pop.female"
"1","강원","강릉시",2010,2054,1059,995,"4",2008,2018,1050,968,1.04024057274701,1.02895540075347,1.05248369348194
"2","강원","강릉시",2011,1935,989,946,"4",2009,1763,912,851,1.12171665532044,1.10634695085612,1.13822790529006
"3","강원","강릉시",2012,1735,919,816,"4",2010,1729,957,772,1.02555509641051,0.979700802058943,1.08228218772237
"4","강원","강릉시",2013,1704,923,781,"4",2011,1903,1016,887,0.915135311581799,0.9268253056295,0.901560895958818
"5","강원","강릉시",2014,1839,999,840,"4",2012,1639,844,795,1.14671973553666,1.20757171392617,1.08188178735695
"6","강원","강릉시",2015,1627,850,777,"4",2013,1662,819,843,1.00048606667283,1.05882677252421,0.943758979095635
"7","강원","강릉시",2016,1659,820,839,"4",2014,1652,868,784,1.02633905270704,0.963793553661984,1.09575522591112
"8","강원","강릉시",2017,1625,869,756,"4",2015,1650,873,777,1.00652353078417,1.01553623219457,0.996250217315188
"9","강원","강릉시",2018,1662,875,787,"4",2016,1627,823,804,1.04399394013311,1.08467119699831,1.00227370363464
"10","강원","강릉시",2019,1627,824,803,"4",2017,1447,778,669,1.14914156379422,1.08053168062695,1.22901470713551
"11","강원","강릉시",2020,1451,770,681,"4",2018,1373,693,680,1.08006871476359,1.13356748587886,1.02542960480763
"12","강원","고성군",2010,196,99,97,"4",2008,219,111,108,0.914674281294274,0.909917684610872,0.919635295767543
"13","강원","고성군",2011,175,97,78,"4",2009,194,98,96,0.921914891400249,1.00980042364515,0.831938115501051
"14","강원","고성군",2012,183,102,81,"4",2010,195,104,91,0.95911567690818,1.00059130003538,0.911404731774609
"15","강원","고성군",2013,181,99,82,"4",2011,169,97,72,1.09457715964931,1.04124601022481,1.16613547813823
"16","강원","고성군",2014,162,91,71,"4",2012,157,89,68,1.05455654984266,1.04313682127504,1.06909694480678
"17","강원","고성군",2015,160,94,66,"4",2013,146,70,76,1.12000932403381,1.36999727579074,0.889197014138775
"18","강원","고성군",2016,144,69,75,"4",2014,153,83,70,0.961890360640798,0.848126998470813,1.09706125121018
"19","강원","고성군",2017,154,82,72,"4",2015,161,91,70,0.977573355651245,0.9193107742622,1.05317880116177
"20","강원","고성군",2018,163,90,73,"4",2016,169,94,75,0.985724182446616,0.976797514427532,0.996619198877156
"21","강원","고성군",2019,155,78,77,"4",2017,144,68,76,1.10007860255577,1.17024172806906,1.03739651649524
"22","강원","고성군",2020,150,76,74,"4",2018,143,75,68,1.0720368966932,1.03381354712152,1.11427005515073
"23","강원","동해시",2010,980,531,449,"4",2008,920,496,424,1.08866123697525,1.09220141431756,1.08429670206088
"24","강원","동해시",2011,943,507,436,"4",2009,848,464,384,1.1365023858662,1.11475612889337,1.16258018704634
"25","강원","동해시",2012,845,436,409,"4",2010,827,435,392,1.0442529497132,1.02255604933073,1.06832869463086
"26","강원","동해시",2013,845,445,400,"4",2011,877,455,422,0.984717433766039,0.997788523284583,0.970543918922116
"27","강원","동해시",2014,928,484,444,"4",2012,786,423,363,1.20664617759774,1.16733332588377,1.2524027066157
"28","강원","동해시",2015,836,452,384,"4",2013,843,425,418,1.01352207928729,1.08502412530711,0.940638163717051
"29","강원","동해시",2016,869,429,440,"4",2014,843,449,394,1.05352952978548,0.974767051888262,1.1434682415321
"30","강원","동해시",2017,810,426,384,"4",2015,827,431,396,1.00099986895585,1.00837534590709,0.99289583947911
"31","강원","동해시",2018,829,436,393,"4",2016,868,440,428,0.976088771062123,1.0109360942247,0.940191745196012
"32","강원","동해시",2019,861,439,422,"4",2017,759,394,365,1.15935352509053,1.13673226819985,1.18382426888579
"33","강원","동해시",2020,756,386,370,"4",2018,734,393,341,1.052640915783,1.00203904476926,1.11100240103005
"34","강원","삼척시",2010,522,267,255,"4",2008,573,271,302,0.931044400122866,1.00515227622395,0.864571449629212
"35","강원","삼척시",2011,547,268,279,"4",2009,491,247,244,1.13857159669027,1.10694930199993,1.17079815498004
"36","강원","삼척시",2012,473,234,239,"4",2010,488,268,220,0.990594312232666,0.890781016888391,1.11235362016644
"37","강원","삼척시",2013,464,256,208,"4",2011,537,285,252,0.883076252878796,0.916399820163124,0.845143482413766
"38","강원","삼척시",2014,500,266,234,"4",2012,478,231,247,1.06904655667453,1.174788121729,0.970033106333209
"39","강원","삼척시",2015,447,216,231,"4",2013,485,264,221,0.941933614756369,0.834717875965345,1.07025522968739
"40","강원","삼척시",2016,461,249,212,"4",2014,486,246,240,0.969436054056318,1.03265233164818,0.904466053775501
"41","강원","삼척시",2017,464,236,228,"4",2015,473,243,230,1.00256225749665,0.990821950620044,1.01502014894576
"42","강원","삼척시",2018,450,233,217,"4",2016,511,269,242,0.900007492527165,0.883676958322669,0.918146578836506
"43","강원","삼척시",2019,486,260,226,"4",2017,439,218,221,1.13142627557151,1.21676509952135,1.04708953207511
"44","강원","삼척시",2020,400,199,201,"4",2018,426,223,203,0.959632402047744,0.910412272291052,1.01383591491147
"45","강원","속초시",2010,847,429,418,"4",2008,805,423,382,1.07533069121637,1.03468181157879,1.12041927435985
"46","강원","속초시",2011,803,424,379,"4",2009,680,340,340,1.2068718118665,1.27226280179816,1.1413739213571
"47","강원","속초시",2012,677,339,338,"4",2010,688,342,346,1.00566825586982,1.0112615202972,1.00024929493768
"48","강원","속초시",2013,680,340,340,"4",2011,712,383,329,0.976075541521034,0.905670106211312,1.05815836996159
"49","강원","속초시",2014,712,399,313,"4",2012,630,320,310,1.15503183781708,1.27207526305969,1.03383277479634
"50","강원","속초시",2015,644,312,332,"4",2013,614,325,289,1.0719437773102,0.979402307799339,1.17627236346595
"51","강원","속초시",2016,597,314,283,"4",2014,708,348,360,0.861778360711816,0.920534975601629,0.804917903202726
"52","강원","속초시",2017,666,316,350,"4",2015,673,355,318,1.01137840482681,0.90813124784211,1.12696019516349
"53","강원","속초시",2018,648,342,306,"4",2016,671,314,357,0.986976919971966,1.11118494316406,0.877649000968142
"54","강원","속초시",2019,663,324,339,"4",2017,612,301,311,1.10717588386258,1.098167039476,1.11610990316045
"55","강원","속초시",2020,579,274,305,"4",2018,630,309,321,0.939274486090017,0.904652886788764,0.972887132433532
"56","강원","양구군",2010,210,106,104,"4",2008,235,115,120,0.913284198799906,0.940368157850814,0.887400656534454
"57","강원","양구군",2011,222,105,117,"4",2009,209,118,91,1.08557841538827,0.907814639114853,1.31647350145221
"58","강원","양구군",2012,192,100,92,"4",2010,212,108,104,0.925592611182654,0.94463957156572,0.905778776640197
"59","강원","양구군",2013,199,110,89,"4",2011,211,115,96,0.963884801554448,0.975853748713109,0.949262721533251
"60","강원","양구군",2014,209,115,94,"4",2012,211,106,105,1.01232122374311,1.10683240366474,0.916655623233392
"61","강원","양구군",2015,197,106,91,"4",2013,177,88,89,1.13748969554591,1.22889020628231,1.04693335883278
"62","강원","양구군",2016,166,85,81,"4",2014,215,106,109,0.789085638874515,0.818093515752199,0.760897528362288
"63","강원","양구군",2017,197,93,104,"4",2015,218,120,98,0.923558147301041,0.790663321400508,1.0866130488177
"64","강원","양구군",2018,199,110,89,"4",2016,229,114,115,0.888120930689907,0.984413869315856,0.792428011019061
"65","강원","양구군",2019,195,97,98,"4",2017,179,84,95,1.1133612239959,1.17810049425268,1.05625827134061
"66","강원","양구군",2020,166,83,83,"4",2018,186,94,92,0.912115120204412,0.900824374416502,0.923757372395816
"67","강원","양양군",2010,207,113,94,"4",2008,206,117,89,1.02696971453124,0.985331737725474,1.08144764538771
"68","강원","양양군",2011,180,103,77,"4",2009,189,97,92,0.973341436362712,1.08331655609248,0.856979731017805
"69","강원","양양군",2012,169,85,84,"4",2010,170,85,85,1.01599669342684,1.02021073729098,1.01187767170445
"70","강원","양양군",2013,168,82,86,"4",2011,197,97,100,0.87156055519991,0.862446190287218,0.880574497638036
"71","강원","양양군",2014,175,89,86,"4",2012,166,93,73,1.07741860802198,0.976330705579538,1.2062664351206
"72","강원","양양군",2015,150,87,63,"4",2013,167,80,87,0.917971713934893,1.10947917680394,0.741462087024809
"73","강원","양양군",2016,151,70,81,"4",2014,158,76,82,0.976729650223468,0.939667784346953,1.0114369584328
"74","강원","양양군",2017,158,85,73,"4",2015,160,84,76,1.00923340182859,1.03235610321111,0.983505788365615
"75","강원","양양군",2018,146,74,72,"4",2016,155,79,76,0.962666078673572,0.955640437462435,0.970033106333209
"76","강원","양양군",2019,154,83,71,"4",2017,145,80,65,1.08544351903345,1.05846863993939,1.11843988072094
"77","강원","양양군",2020,141,76,65,"4",2018,133,70,63,1.08348270416165,1.10765737191592,1.05642935301721
"78","강원","영월군",2010,283,144,139,"4",2008,297,144,153,0.973833022946733,1.02021073729098,0.930231457453161
"79","강원","영월군",2011,287,147,140,"4",2009,255,142,113,1.15026055626629,1.05613365057587,1.26857820198935
"80","강원","영월군",2012,244,132,112,"4",2010,256,134,122,0.97410185935987,1.00498371136126,0.939995651310141
"81","강원","영월군",2013,253,137,116,"4",2011,268,132,136,0.964806539439382,1.05885508340048,0.873346799983004
"82","강원","영월군",2014,254,136,118,"4",2012,239,121,118,1.08615130158132,1.14668314274027,1.02392383446283
"83","강원","영월군",2015,232,120,112,"4",2013,216,113,103,1.09771284212017,1.08340963252139,1.11339290737706
"84","강원","영월군",2016,205,113,92,"4",2014,223,125,98,0.939514547879254,0.922270506511044,0.961234620107965
"85","강원","영월군",2017,221,121,100,"4",2015,251,128,123,0.899856096844491,0.964417962595377,0.832458402002302
"86","강원","영월군",2018,238,115,123,"4",2016,202,111,91,1.20414863835169,1.05697508818435,1.38398496306515
"87","강원","영월군",2019,198,117,81,"4",2017,177,92,85,1.14326375491417,1.29744191590266,0.975739183429287
"88","강원","영월군",2020,168,88,80,"4",2018,188,104,84,0.913284198799906,0.863255239246212,0.975165556631268
"89","강원","원주시",2010,3262,1724,1538,"4",2008,3127,1613,1514,1.06613103731561,1.09041742782991,1.0401551237806
"90","강원","원주시",2011,3221,1671,1550,"4",2009,2983,1571,1412,1.1035499178178,1.08515094972198,1.12399571063555
"91","강원","원주시",2012,3041,1599,1442,"4",2010,3014,1543,1471,1.03116385978034,1.05723718012202,1.00373770856248
"92","강원","원주시",2013,3061,1576,1485,"4",2011,3389,1739,1650,0.923094731053873,0.924584313956631,0.921531451016549
"93","강원","원주시",2014,3415,1764,1651,"4",2012,3063,1566,1497,1.13945773928749,1.14920289947719,1.12925734849575
"94","강원","원주시",2015,3085,1569,1516,"4",2013,3010,1587,1423,1.04747383645778,1.00863934896632,1.09084225793792
"95","강원","원주시",2016,3173,1655,1518,"4",2014,3108,1561,1547,1.04338255999287,1.0816455927076,1.00472939929837
"96","강원","원주시",2017,3285,1649,1636,"4",2015,3200,1645,1555,1.0491556091794,1.02269149288317,1.0772600599236
"97","강원","원주시",2018,3224,1648,1576,"4",2016,3302,1648,1654,0.997866574916733,1.02021073729098,0.975637220745721
"98","강원","원주시",2019,3303,1634,1669,"4",2017,2860,1444,1416,1.18031262325921,1.15444899219769,1.20687067776728
"99","강원","원주시",2020,3008,1537,1471,"4",2018,2846,1443,1403,1.08018327217428,1.08666937159822,1.07355093406616
"100","강원","인제군",2010,305,165,140,"4",2008,334,180,154,0.933271242500475,0.935193175850063,0.930839849511665
"101","강원","인제군",2011,323,167,156,"4",2009,326,184,142,1.01260352190924,0.925952136563007,1.12487407166339
"102","강원","인제군",2012,279,146,133,"4",2010,323,166,157,0.882787534930206,0.89729378099086,0.867400445755138
"103","강원","인제군",2013,291,140,151,"4",2011,337,178,159,0.88250586314726,0.802412939442342,0.972405654112501
"104","강원","인제군",2014,310,159,151,"4",2012,286,146,140,1.1077714599163,1.11105141937853,1.10437499288491
"105","강원","인제군",2015,282,138,144,"4",2013,301,160,141,0.957496343212621,0.879931760913468,1.04570944796204
"106","강원","인제군",2016,264,137,127,"4",2014,335,185,150,0.805403719879832,0.755507410858724,0.866922179845198
"107","강원","인제군",2017,300,163,137,"4",2015,292,161,131,1.05000874128169,1.03288416259894,1.07082110932372
"108","강원","인제군",2018,253,152,101,"4",2016,326,163,163,0.79315384223851,0.951362159927783,0.634455872888012
"109","강원","인제군",2019,274,140,134,"4",2017,280,144,136,1.00010832586269,0.991871550144006,1.00886613101485
"110","강원","인제군",2020,251,123,128,"4",2018,243,137,106,1.05565487882055,0.915955625451024,1.23643632840795
"111","강원","정선군",2010,251,125,126,"4",2008,279,144,135,0.919441346069508,0.885599598342863,0.955662245498643
"112","강원","정선군",2011,256,142,114,"4",2009,275,138,137,0.951397011251989,1.04978206300956,0.852024212618707
"113","강원","정선군",2012,255,124,131,"4",2010,237,113,124,1.09962940753635,1.11952328693877,1.08172598640831
"114","강원","정선군",2013,227,112,115,"4",2011,286,148,138,0.811174585164519,0.77205136876074,0.85326986205236
"115","강원","정선군",2014,289,148,141,"4",2012,252,123,129,1.17206531295343,1.22757064324443,1.11917256325007
"116","강원","정선군",2015,238,114,124,"4",2013,280,146,134,0.86870723195372,0.796602904460079,0.947511608010382
"117","강원","정선군",2016,267,143,124,"4",2014,259,131,128,1.05357633854937,1.11366515597412,0.991926214635868
"118","강원","정선군",2017,262,134,128,"4",2015,237,115,122,1.12981531284127,1.18876729388688,1.07428074435445
"119","강원","정선군",2018,218,108,110,"4",2016,269,140,129,0.828244813321282,0.787019711624469,0.873113347216368
"120","강원","정선군",2019,251,136,115,"4",2017,196,98,98,1.30879660996629,1.41580265583238,1.20154327513496
"121","강원","정선군",2020,187,95,92,"4",2018,221,109,112,0.864776429999179,0.889174495804063,0.841080292594469
"122","강원","철원군",2010,416,216,200,"4",2008,432,235,197,0.984156341211186,0.937725613850431,1.039516583211
"123","강원","철원군",2011,432,241,191,"4",2009,429,216,213,1.02915542082547,1.13829068373669,0.918166443109863
"124","강원","철원군",2012,402,200,202,"4",2010,476,237,239,0.863124832539287,0.860937331047239,0.865408429127582
"125","강원","철원군",2013,441,225,216,"4",2011,448,227,221,1.00603962524052,1.01122209643379,1.00075813685055
"126","강원","철원군",2014,427,216,211,"4",2012,453,243,210,0.963350183207995,0.906853988703091,1.02879966224599
"127","강원","철원군",2015,418,221,197,"4",2013,404,204,200,1.05742464460296,1.10522829873189,1.00856497694589
"128","강원","철원군",2016,361,184,177,"4",2014,427,222,205,0.864039979984276,0.845580070547477,0.884070822926445
"129","강원","철원군",2017,371,200,171,"4",2015,371,206,165,1.02200850818085,0.990495861447551,1.0611574284433
"130","강원","철원군",2018,359,200,159,"4",2016,400,202,198,0.917252636092311,1.01010964088216,0.822241867068638
"131","강원","철원군",2019,336,160,176,"4",2017,323,163,160,1.06314197755036,1.00143385255556,1.12631621790912
"132","강원","철원군",2020,301,141,160,"4",2018,368,190,178,0.835936306963139,0.757103757673831,0.920380974798051
"133","강원","춘천시",2010,2590,1314,1276,"4",2008,2405,1271,1134,1.10062454727168,1.05472612808839,1.15214004653842
"134","강원","춘천시",2011,2406,1264,1142,"4",2009,2367,1237,1130,1.03884768512172,1.04247887787857,1.03479736190845
"135","강원","춘천시",2012,2418,1265,1153,"4",2010,2264,1183,1081,1.09152675476205,1.09092695069576,1.09212227672123
"136","강원","춘천시",2013,2271,1199,1072,"4",2011,2528,1301,1227,0.918109700189361,0.940224960808518,0.894577302806973
"137","강원","춘천시",2014,2517,1289,1228,"4",2012,2415,1265,1150,1.06517408492389,1.03956651412496,1.09337258149596
"138","강원","춘천시",2015,2436,1277,1159,"4",2013,2254,1178,1076,1.10453093430725,1.10595000977978,1.10290680682381
"139","강원","춘천시",2016,2297,1190,1107,"4",2014,2478,1273,1205,0.947358169205572,0.953692676650639,0.940650360788676
"140","강원","춘천시",2017,2485,1289,1196,"4",2015,2594,1336,1258,0.97906366338836,0.984320090095861,0.973460179664187
"141","강원","춘천시",2018,2570,1337,1233,"4",2016,2568,1337,1231,1.02280446496292,1.02021073729098,1.02558739877553
"142","강원","춘천시",2019,2544,1308,1236,"4",2017,2383,1205,1178,1.09105734150738,1.1074154725117,1.0743377414228
"143","강원","춘천시",2020,2377,1212,1165,"4",2018,2267,1167,1100,1.071598687228,1.05955048294487,1.08442842468109
"144","강원","태백시",2010,437,224,213,"4",2008,434,225,209,1.02907308312219,1.01567646734746,1.0435204628736
"145","강원","태백시",2011,397,195,202,"4",2009,418,222,196,0.9706635831287,0.896131053025859,1.05526844164027
"146","강원","태백시",2012,406,221,185,"4",2010,442,220,222,0.938767996202317,1.02484805882412,0.85326986205236
"147","강원","태백시",2013,415,196,219,"4",2011,485,265,220,0.874502125556808,0.75457096041144,1.01926963521527
"148","강원","태백시",2014,449,244,205,"4",2012,444,227,217,1.0335176130027,1.09661418457709,0.967301318271339
"149","강원","태백시",2015,399,204,195,"4",2013,413,193,220,0.987364151971327,1.07835746325057,0.907568853273874
"150","강원","태백시",2016,399,189,210,"4",2014,432,217,215,0.943938413805922,0.888570642156658,1.00011165226602
"151","강원","태백시",2017,397,193,204,"4",2015,393,189,204,1.03241063040152,1.04180249892677,1.02392383446283
"152","강원","태백시",2018,373,181,192,"4",2016,394,196,198,0.967535973480853,0.94213338494728,0.99289583947911
"153","강원","태백시",2019,360,179,181,"4",2017,312,164,148,1.17924058636252,1.11352269497003,1.2522311759309
"154","강원","태백시",2020,284,152,132,"4",2018,310,160,150,0.936291665559228,0.969200200426429,0.901052974327292
"155","강원","평창군",2010,336,171,165,"4",2008,326,181,145,1.05335846241952,0.963845503186504,1.16515470818184
"156","강원","평창군",2011,314,178,136,"4",2009,279,151,128,1.15021746082002,1.2026325247536,1.08791907411676
"157","강원","평창군",2012,304,175,129,"4",2010,297,159,138,1.0460962507979,1.12287345299321,0.957146193084821
"158","강원","평창군",2013,286,146,140,"4",2011,332,177,155,0.880404919697959,0.841529760703293,0.924834431127719
"159","강원","평창군",2014,313,163,150,"4",2012,327,167,160,0.978252792234267,0.995774551966643,0.959928594808905
"160","강원","평창군",2015,312,156,156,"4",2013,274,136,138,1.16374691442491,1.17024172806906,1.15747911721885
"161","강원","평창군",2016,258,128,130,"4",2014,286,157,129,0.921951731156149,0.831764167982453,1.03186122852844
"162","강원","평창군",2017,278,157,121,"4",2015,244,125,119,1.1644195298126,1.28138468603747,1.04113263840338
"163","강원","평창군",2018,237,116,121,"4",2016,261,133,128,0.928030714325137,0.88980786109589,0.967927999765646
"164","강원","평창군",2019,261,132,129,"4",2017,229,125,104,1.16482192417118,1.07734253857927,1.27005937159332
"165","강원","평창군",2020,213,119,94,"4",2018,191,86,105,1.13972676566765,1.41168695043752,0.916655623233392
"166","강원","홍천군",2010,588,324,264,"4",2008,583,281,302,1.03077358972614,1.17632839459885,0.895085736086714
"167","강원","홍천군",2011,530,259,271,"4",2009,517,262,255,1.04770698130725,1.00852893495559,1.08817003584089
"168","강원","홍천군",2012,495,250,245,"4",2010,478,251,227,1.05835609110778,1.01614615268026,1.10511603279028
"169","강원","홍천군",2013,456,240,216,"4",2011,573,286,287,0.813326142636067,0.856120898425995,0.770618634996417
"170","강원","홍천군",2014,569,287,282,"4",2012,518,241,277,1.12263096748051,1.21493975768677,1.04240621414628
"171","강원","홍천군",2015,494,241,253,"4",2013,516,284,232,0.978434502018098,0.865742210165935,1.11660659534093
"172","강원","홍천군",2016,504,274,230,"4",2014,528,278,250,0.975553575990809,1.00553144610693,0.942009927705805
"173","강원","홍천군",2017,495,240,255,"4",2015,497,234,263,1.01789579788636,1.04636998696511,0.992777862311871
"174","강원","홍천군",2018,474,232,242,"4",2016,485,240,245,0.998828933768498,0.986203712714612,1.01138599159186
"175","강원","홍천군",2019,443,220,223,"4",2017,419,213,206,1.08054837499789,1.05373878969021,1.10842240332627
"176","강원","홍천군",2020,384,195,189,"4",2018,402,195,207,0.976246933187675,1.02021073729098,0.934886979292151
"177","강원","화천군",2010,200,95,105,"4",2008,236,123,113,0.866108905238006,0.787967642623113,0.951433651492012
"178","강원","화천군",2011,221,120,101,"4",2009,221,120,101,1.02200850818085,1.02021073729098,1.02392383446283
"179","강원","화천군",2012,188,112,76,"4",2010,217,112,105,0.885426725981564,1.02021073729098,0.741125823039764
"180","강원","화천군",2013,190,93,97,"4",2011,252,130,122,0.770561970453813,0.729843065908161,0.814103376581104
"181","강원","화천군",2014,243,117,126,"4",2012,234,126,108,1.06131652772626,0.947338541770194,1.1945778068733
"182","강원","화천군",2015,191,99,92,"4",2013,231,121,110,0.845037337933082,0.834717875965346,0.856372661550732
"183","강원","화천군",2016,208,97,111,"4",2014,255,121,134,0.833638312555358,0.817854888572106,0.848175713622197
"184","강원","화천군",2017,197,101,96,"4",2015,223,114,109,0.902850565522991,0.903870916371831,0.901804478059008
"185","강원","화천군",2018,190,100,90,"4",2016,231,111,120,0.840613058676888,0.919108772334214,0.767942875847124
"186","강원","화천군",2019,191,87,104,"4",2017,219,111,108,0.891340753710237,0.799624631930766,0.986000729482727
"187","강원","화천군",2020,180,94,86,"4",2018,208,117,91,0.884430439771887,0.819656489789333,0.96766428311872
"188","강원","횡성군",2010,292,152,140,"4",2008,305,164,141,0.978447489799369,0.945561171147736,1.01666196329643
"189","강원","횡성군",2011,309,164,145,"4",2009,293,138,155,1.07781784651154,1.21242435446174,0.957864232239423
"190","강원","횡성군",2012,291,148,143,"4",2010,276,132,144,1.07755244884285,1.1438726448414,1.01681325227906
"191","강원","횡성군",2013,292,156,136,"4",2011,325,158,167,0.918235336580946,1.00729667732527,0.83385414064039
"192","강원","횡성군",2014,314,159,155,"4",2012,280,152,128,1.14610954131709,1.06719412650833,1.23990776829484
"193","강원","횡성군",2015,293,156,137,"4",2013,288,142,146,1.03975171144788,1.12079489448868,0.960805241927452
"194","강원","횡성군",2016,260,135,125,"4",2014,274,137,137,0.969789095354089,1.00531714988527,0.93423707523981
"195","강원","횡성군",2017,255,126,129,"4",2015,259,139,120,1.00622459299659,0.924795344594699,1.10071812204754
"196","강원","횡성군",2018,268,143,125,"4",2016,263,125,138,1.04143832772801,1.16712108346088,0.927467241361261
"197","강원","횡성군",2019,265,132,133,"4",2017,230,114,116,1.17753154203445,1.18129664317903,1.17398163778928
"198","강원","횡성군",2020,221,114,107,"4",2018,230,117,113,0.982016870904206,0.99405148761685,0.969556197234717
"199","경기","가평군",2010,463,254,209,"4",2008,480,249,231,0.985812373516109,1.04069689667433,0.926407278799705
"200","경기","가평군",2011,494,261,233,"4",2009,441,221,220,1.14483492753138,1.20486426440247,1.08442842468109
"201","경기","가평군",2012,447,236,211,"4",2010,428,229,199,1.06737804475897,1.05139621834354,1.08566798528471
"202","경기","가평군",2013,440,233,207,"4",2011,439,229,210,1.0243365457849,1.03803101217816,1.00929635111336
"203","경기","가평군",2014,450,234,216,"4",2012,465,253,212,0.989040491787917,0.943594120656478,1.04324315209421
"204","경기","가평군",2015,438,224,214,"4",2013,424,220,204,1.05575407213021,1.03876002342354,1.07411617928944
"205","경기","가평군",2016,418,217,201,"4",2014,442,222,220,0.966514833528494,0.997233017982623,0.935494048759224
"206","경기","가평군",2017,459,238,221,"4",2015,449,215,234,1.04477039032296,1.12934956035001,0.967039176992675
"207","경기","가평군",2018,422,196,226,"4",2016,463,220,243,0.931506674843019,0.908915020495598,0.952291302833745
"208","경기","가평군",2019,436,204,232,"4",2017,366,197,169,1.21747461630287,1.0564618802404,1.40562325204365
"209","경기","가평군",2020,357,189,168,"4",2018,353,183,170,1.03358934113474,1.05366026966117,1.01187767170445
"210","경기","고양시",2010,9935,5232,4703,"4",2008,9909,5040,4869,1.02469013308878,1.0590759082354,0.989014950396118
"211","경기","고양시",2011,9446,4811,4635,"4",2009,8670,4430,4240,1.11348239541826,1.10795346661555,1.11931296526774
"212","경기","고양시",2012,8370,4267,4103,"4",2010,8869,4572,4297,0.964506845582782,0.95215205949707,0.977695948987898
"213","경기","고양시",2013,8587,4387,4200,"4",2011,9599,5008,4591,0.914260554198243,0.893702976137284,0.936719691732497
"214","경기","고양시",2014,9425,4870,4555,"4",2012,9142,4632,4510,1.05364583128467,1.07263089175455,1.0341403693965
"215","경기","고양시",2015,9234,4715,4519,"4",2013,8768,4473,4295,1.07632602241582,1.0754065786557,1.07732521721479
"216","경기","고양시",2016,8646,4490,4156,"4",2014,9363,4841,4522,0.943745120338738,0.946239663382873,0.941049857591227
"217","경기","고양시",2017,9165,4721,4444,"4",2015,9564,4869,4695,0.979371390367782,0.989200018638469,0.969183710405288
"218","경기","고양시",2018,9095,4631,4464,"4",2016,9910,5105,4805,0.937958363461635,0.925484020449465,0.951258272017082
"219","경기","고양시",2019,9283,4787,4496,"4",2017,8710,4465,4245,1.08924282220928,1.09378472551219,1.08446679852648
"220","경기","고양시",2020,8550,4305,4245,"4",2018,8622,4425,4197,1.01347399036723,0.992544005432239,1.03563418567899
"221","경기","과천시",2010,711,391,320,"4",2008,707,370,337,1.02779073453548,1.07811458994803,0.972271890291116
"222","경기","과천시",2011,677,349,328,"4",2009,729,373,356,0.9491080384615,0.954567150977349,0.943390499168002
"223","경기","과천시",2012,606,312,294,"4",2010,659,370,289,0.939813590223966,0.860285810904825,1.04163877969575
"224","경기","과천시",2013,590,331,259,"4",2011,631,338,293,0.955602250121553,0.999082112554182,0.905106734217998
"225","경기","과천시",2014,578,304,274,"4",2012,656,337,319,0.900489203854466,0.920308795657143,0.879483168159298
"226","경기","과천시",2015,554,278,276,"4",2013,586,302,284,0.966199169850153,0.939134387307589,0.995080909548386
"227","경기","과천시",2016,496,258,238,"4",2014,569,305,264,0.89088966618225,0.862997935151057,0.923082850765735
"228","경기","과천시",2017,440,229,211,"4",2015,551,278,273,0.816122946641693,0.840389420286453,0.791384355573837
"229","경기","과천시",2018,418,205,213,"4",2016,529,270,259,0.807560598146681,0.774604448683891,0.842068636064028
"230","경기","과천시",2019,466,242,224,"4",2017,440,225,215,1.0823999200279,1.09729332633074,1.06678576241709
"231","경기","과천시",2020,483,253,230,"4",2018,462,243,219,1.06846344037089,1.06219471824945,1.07535379875092
"232","경기","광명시",2010,3376,1785,1591,"4",2008,3285,1644,1641,1.05031985498281,1.10771056329951,0.992725667660186
"233","경기","광명시",2011,3560,1794,1766,"4",2009,2995,1573,1422,1.21480810989109,1.16354613013351,1.27162411509238
"234","경기","광명시",2012,3308,1765,1543,"4",2010,3617,1880,1737,0.934698408919614,0.957804229424774,0.909565041206764
"235","경기","광명시",2013,3595,1859,1736,"4",2011,4078,2027,2051,0.900961399438486,0.935654543968391,0.866665907668199
"236","경기","광명시",2014,3800,1877,1923,"4",2012,3990,2017,1973,0.973341436362712,0.949397894841431,0.997975435211366
"237","경기","광명시",2015,3612,1822,1790,"4",2013,3621,1903,1718,1.01946830476366,0.976786107905497,1.06683565988852
"238","경기","광명시",2016,3274,1735,1539,"4",2014,3646,1864,1782,0.917733366918292,0.949606024248845,0.884297857036082
"239","경기","광명시",2017,3272,1651,1621,"4",2015,3630,1883,1747,0.921215382580643,0.894512972526503,0.950074719899399
"240","경기","광명시",2018,3176,1654,1522,"4",2016,3486,1797,1689,0.931124217436136,0.939025353076949,0.922683289551468
"241","경기","광명시",2019,3071,1575,1496,"4",2017,2932,1503,1429,1.07045979830265,1.06908310793965,1.07193146001147
"242","경기","광명시",2020,2623,1355,1268,"4",2018,2851,1479,1372,0.940276505422084,0.934675827606001,0.946308616690139
"243","경기","광주시",2010,2600,1361,1239,"4",2008,2875,1473,1402,0.924251172615723,0.942638705670754,0.904879907916868
"244","경기","광주시",2011,2694,1385,1309,"4",2009,2586,1304,1282,1.06469099808167,1.08358272327301,1.04548853300456
"245","경기","광주시",2012,2576,1312,1264,"4",2010,2749,1411,1338,0.957691494024686,0.948629686269144,0.967294265142765
"246","경기","광주시",2013,2725,1405,1320,"4",2011,3215,1572,1643,0.866243603357017,0.911829571179277,0.822629008819804
"247","경기","광주시",2014,3122,1535,1587,"4",2012,3055,1530,1525,1.04442244273015,1.02354475930827,1.06555221330657
"248","경기","광주시",2015,2939,1461,1478,"4",2013,3046,1597,1449,0.986107355726694,0.933329923094627,1.04441644398624
"249","경기","광주시",2016,2816,1424,1392,"4",2014,3402,1787,1615,0.845965890369567,0.8129715108575,0.882539924193351
"250","경기","광주시",2017,3151,1628,1523,"4",2015,3527,1824,1703,0.91305608428632,0.910582829117167,0.915699354014617
"251","경기","광주시",2018,3451,1781,1670,"4",2016,3814,1969,1845,0.924738165110672,0.922801078270813,0.926803687562563
"252","경기","광주시",2019,3728,1931,1797,"4",2017,3541,1808,1733,1.07598071688738,1.08961666687438,1.06173752482961
"253","경기","광주시",2020,3312,1680,1632,"4",2018,3945,2039,1906,0.85802083120278,0.840585600122042,0.876728068123474
"254","경기","구리시",2010,1999,1015,984,"4",2008,2130,1073,1057,0.95915258584672,0.965064210950925,0.953208186481955
"255","경기","구리시",2011,1831,938,893,"4",2009,1838,1017,821,1.01811620156645,0.940961328986172,1.11371983456189
"256","경기","구리시",2012,1653,919,734,"4",2010,1939,1042,897,0.871263570924673,0.899782790374672,0.837859637118973
"257","경기","구리시",2013,1736,946,790,"4",2011,2073,1098,975,0.855864336807502,0.878979378394595,0.829640850487833
"258","경기","구리시",2014,1802,954,848,"4",2012,1829,878,951,1.00692144983154,1.10852055054168,0.913025669426374
"259","경기","구리시",2015,1607,784,823,"4",2013,1713,906,807,0.958766884207018,0.882831366485791,1.04422467876445
"260","경기","구리시",2016,1524,804,720,"4",2014,1681,856,825,0.926556196589894,0.958235318670498,0.893606255531199
"261","경기","구리시",2017,1598,839,759,"4",2015,1612,804,808,1.01313250376737,1.06462289625265,0.961829443511497
"262","경기","구리시",2018,1693,853,840,"4",2016,1852,966,886,0.934265877078928,0.900869315640998,0.970763003328193
"263","경기","구리시",2019,1806,929,877,"4",2017,1752,935,817,1.0535087704193,1.01366393042066,1.09912019929486
"264","경기","구리시",2020,1598,845,753,"4",2018,1881,948,933,0.868245399294521,0.909365055918646,0.826382258682221
"265","경기","군포시",2010,3089,1593,1496,"4",2008,3081,1600,1481,1.02466221414172,1.01574731531533,1.03429443373153
"266","경기","군포시",2011,2990,1550,1440,"4",2009,2845,1458,1387,1.07409681527618,1.08458617476064,1.06304997954324
"267","경기","군포시",2012,2753,1400,1353,"4",2010,3122,1624,1498,0.901213780596372,0.879492014906015,0.924812381861289
"268","경기","군포시",2013,2838,1463,1375,"4",2011,3245,1670,1575,0.893824390205623,0.893753478237545,0.89390176024533
"269","경기","군포시",2014,2995,1551,1444,"4",2012,3119,1615,1504,0.98137719846157,0.979781333460252,0.983075809151815
"270","경기","군포시",2015,2892,1507,1385,"4",2013,2882,1473,1409,1.02555468621062,1.04375938974712,1.00648297425906
"271","경기","군포시",2016,2679,1361,1318,"4",2014,3050,1585,1465,0.897692063415243,0.87602953530159,0.921181988957005
"272","경기","군포시",2017,2682,1415,1267,"4",2015,3006,1545,1461,0.91185190250866,0.93436776263219,0.887961326669684
"273","경기","군포시",2018,2625,1346,1279,"4",2016,2904,1488,1416,0.92381967423372,0.922851916931221,0.924857757258448
"274","경기","군포시",2019,2511,1291,1220,"4",2017,2603,1310,1293,0.985886809082638,1.00541378766615,0.966115296244899
"275","경기","군포시",2020,2338,1185,1153,"4",2018,2430,1250,1180,0.983315181945194,0.967159778951847,1.00049506875902
"276","경기","김포시",2010,2576,1335,1241,"4",2008,2461,1279,1182,1.06976591510519,1.06487985479551,1.07503339980404
"277","경기","김포시",2011,2662,1400,1262,"4",2009,2192,1156,1036,1.24114354415028,1.23554933581952,1.2472894585831
"278","경기","김포시",2012,2601,1357,1244,"4",2010,2456,1285,1171,1.08234695837882,1.07737429611195,1.08775512388707
"279","경기","김포시",2013,3302,1719,1583,"4",2011,2931,1483,1448,1.15137225998402,1.18256389575401,1.11938634665377
"280","경기","김포시",2014,3827,1938,1889,"4",2012,3522,1794,1728,1.11051293606136,1.10210056235781,1.11932414542841
"281","경기","김포시",2015,4265,2158,2107,"4",2013,3679,1928,1751,1.18479649018519,1.14191637503835,1.23210023941358
"282","경기","김포시",2016,4133,2137,1996,"4",2014,4485,2377,2108,0.941797361050489,0.917202501300303,0.969521809102378
"283","경기","김포시",2017,4856,2591,2265,"4",2015,4703,2386,2317,1.05525692445805,1.107865054619,1.00094410231261
"284","경기","김포시",2018,5362,2712,2650,"4",2016,5090,2528,2562,1.07662271529778,1.0944665820938,1.05909373978396
"285","경기","김포시",2019,6010,3023,2987,"4",2017,4921,2525,2396,1.24817539812373,1.2214245777547,1.27648601566798
"286","경기","김포시",2020,5412,2756,2656,"4",2018,5572,2854,2718,0.992661530200062,0.985178974062346,1.00056722013734
"287","경기","남양주시",2010,6436,3320,3116,"4",2008,6300,3242,3058,1.04407091407174,1.04475621462247,1.04334423420084
"288","경기","남양주시",2011,6648,3403,3245,"4",2009,5995,3107,2888,1.13332986862156,1.11740493691703,1.15049613671464
"289","경기","남양주시",2012,6176,3235,2941,"4",2010,6875,3555,3320,0.918098115858169,0.928377421979272,0.907036143721442
"290","경기","남양주시",2013,6846,3544,3302,"4",2011,7610,3912,3698,0.919404763075701,0.924239993087737,0.914277042021707
"291","경기","남양주시",2014,7590,3918,3672,"4",2012,7389,3889,3500,1.0498097952487,1.02781837714221,1.07424237718501
"292","경기","남양주시",2015,7243,3775,3468,"4",2013,7197,3667,3530,1.02854072874168,1.0502578492701,1.00593990309266
"293","경기","남양주시",2016,7049,3628,3421,"4",2014,7544,3889,3655,0.95494936030843,0.951741978629897,0.958370297591614
"294","경기","남양주시",2017,7192,3700,3492,"4",2015,7698,3947,3751,0.954830500238589,0.956366791987995,0.95322368167001
"295","경기","남양주시",2018,7351,3780,3571,"4",2016,7752,3927,3825,0.969141452997602,0.982021030547465,0.955929938004385
"296","경기","남양주시",2019,7734,3947,3787,"4",2017,6848,3555,3293,1.15423682860261,1.13270654854782,1.17752795660818
"297","경기","남양주시",2020,7055,3634,3421,"4",2018,6943,3590,3353,1.03849489056832,1.03271471290123,1.04468936406124
"298","경기","동두천시",2010,1015,526,489,"4",2008,939,481,458,1.10472698168643,1.11565664826415,1.09322872282167
"299","경기","동두천시",2011,931,459,472,"4",2009,876,440,436,1.08617570903695,1.06426529185582,1.10846800428086
"300","경기","동두천시",2012,804,413,391,"4",2010,953,493,460,0.862219140165164,0.854659299191022,0.870335259293407
"301","경기","동두천시",2013,896,460,436,"4",2011,1040,524,516,0.880499637817346,0.895604845713454,0.865175953150765
"302","경기","동두천시",2014,983,491,492,"4",2012,929,449,480,1.08141481543786,1.11564247663668,1.0495219303244
"303","경기","동두천시",2015,866,414,452,"4",2013,908,435,473,0.974734986877328,0.970959184456241,0.978464213905285
"304","경기","동두천시",2016,863,431,432,"4",2014,980,510,470,0.89999320669395,0.862178093671395,0.941138503165837
"305","경기","동두천시",2017,923,482,441,"4",2015,924,483,441,1.0209024383668,1.01809849973965,1.02392383446283
"306","경기","동두천시",2018,835,439,396,"4",2016,878,442,436,0.97195569969363,1.0132862300243,0.929985867998352
"307","경기","동두천시",2019,803,401,402,"4",2017,807,412,395,1.01694279066818,0.99297210110117,1.04206932013686
"308","경기","동두천시",2020,733,377,356,"4",2018,775,407,368,0.966622240640724,0.945010928645451,0.990535013773827
"309","경기","부천시",2010,8247,4254,3993,"4",2008,8283,4273,4010,1.01756660231407,1.0156743450587,1.01958301022695
"310","경기","부천시",2011,7620,3898,3722,"4",2009,7626,3920,3706,1.02120441022004,1.01448506478577,1.0283444446494
"311","경기","부천시",2012,6986,3558,3428,"4",2010,7835,4113,3722,0.911263744499221,0.882545539334135,0.943044305356955
"312","경기","부천시",2013,7249,3755,3494,"4",2011,8476,4360,4116,0.87406083952371,0.878644797827436,0.869190932364707
"313","경기","부천시",2014,7777,3979,3798,"4",2012,7711,3888,3823,1.03075608457041,1.04408912646111,1.01722802074021
"314","경기","부천시",2015,7048,3609,3439,"4",2013,7356,3785,3571,0.979216417299975,0.972771611858161,0.986075067689073
"315","경기","부천시",2016,6657,3403,3254,"4",2014,7433,3772,3661,0.915311534906485,0.920407512990774,0.910092367479392
"316","경기","부천시",2017,6934,3528,3406,"4",2015,7349,3741,3608,0.964295413760511,0.962123357701836,0.966597721779492
"317","경기","부천시",2018,7070,3575,3495,"4",2016,7499,3893,3606,0.963541825955273,0.936874745906819,0.992405380323793
"318","경기","부천시",2019,7059,3638,3421,"4",2017,6769,3485,3284,1.06579377444949,1.06500047697692,1.06663929284329
"319","경기","부천시",2020,6172,3198,2974,"4",2018,6960,3562,3398,0.906298349496004,0.915955625451024,0.896159353646987
"320","경기","성남시",2010,8852,4638,4214,"4",2008,8708,4508,4200,1.03890897041994,1.04963118889875,1.02733691391104
"321","경기","성남시",2011,8517,4411,4106,"4",2009,8093,4127,3966,1.07555251009221,1.09041666154362,1.06006839745446
"322","경기","성남시",2012,7665,3948,3717,"4",2010,8385,4300,4085,0.93425106919573,0.936695811819716,0.931682960268873
"323","경기","성남시",2013,7917,4076,3841,"4",2011,9120,4664,4456,0.887197517463571,0.891590687220846,0.882605800756674
"324","경기","성남시",2014,8606,4427,4179,"4",2012,8400,4297,4103,1.04707205016719,1.05107585152133,1.04289000834028
"325","경기","성남시",2015,7921,4067,3854,"4",2013,8090,4109,3981,1.00065876307793,1.00978268886892,0.991259095207173
"326","경기","성남시",2016,7483,3825,3658,"4",2014,8626,4456,4170,0.886585864446705,0.875741936745509,0.898204649032384
"327","경기","성남시",2017,8106,4157,3949,"4",2015,8364,4373,3991,0.990483138129358,0.969818439267916,1.01314838944969
"328","경기","성남시",2018,7902,4071,3831,"4",2016,8519,4466,4053,0.947988171339953,0.929977140956465,0.967839183278339
"329","경기","성남시",2019,7813,4093,3720,"4",2017,7999,4063,3936,0.998243839782093,1.02774367406645,0.967732892327677
"330","경기","성남시",2020,7248,3704,3544,"4",2018,7646,3855,3791,0.968809530119642,0.980249175337427,0.957210780621545
"331","경기","수원시",2010,11610,6047,5563,"4",2008,11484,5928,5556,1.03322176767499,1.04069067618059,1.02521387529099
"332","경기","수원시",2011,10941,5633,5308,"4",2009,10383,5323,5060,1.07693297582651,1.07962560269774,1.07410824374085
"333","경기","수원시",2012,10298,5241,5057,"4",2010,10493,5379,5114,1.00301568829185,0.994036897962821,1.01251130834543
"334","경기","수원시",2013,11042,5631,5411,"4",2011,11642,6033,5609,0.969336707381285,0.952230509147273,0.987778903240931
"335","경기","수원시",2014,12350,6416,5934,"4",2012,11444,5874,5570,1.10291900349821,1.11434662758919,1.09083734895915
"336","경기","수원시",2015,11849,6089,5760,"4",2013,11187,5755,5432,1.08248670898676,1.07942018755252,1.08575134140389
"337","경기","수원시",2016,11258,5747,5511,"4",2014,12069,6238,5831,0.953332652672134,0.939908802053743,0.967731821595724
"338","경기","수원시",2017,11580,5984,5596,"4",2015,12098,6262,5836,0.978249175461581,0.9749187243611,0.981815931743319
"339","경기","수원시",2018,11749,6072,5677,"4",2016,12698,6478,6220,0.945627497449738,0.956270391607104,0.934536271422106
"340","경기","수원시",2019,12205,6273,5932,"4",2017,11370,5865,5505,1.09706366247557,1.09118191901557,1.10334535622771
"341","경기","수원시",2020,10731,5521,5210,"4",2018,11271,5828,5443,0.973043501134653,0.966469368665664,0.980092444892771
"342","경기","시흥시",2010,4860,2513,2347,"4",2008,4859,2482,2377,1.02221884127576,1.03295309541186,1.01100094214736
"343","경기","시흥시",2011,4589,2386,2203,"4",2009,4418,2235,2183,1.06156565053008,1.08913772670079,1.03330472163152
"344","경기","시흥시",2012,4164,2099,2065,"4",2010,4557,2276,2281,0.933869525579339,0.940870974329421,0.926963050489149
"345","경기","시흥시",2013,4245,2122,2123,"4",2011,4702,2335,2367,0.922676758236431,0.927146545837882,0.918373595506799
"346","경기","시흥시",2014,4395,2199,2196,"4",2012,4370,2277,2093,1.02785523877685,0.985262806896294,1.07431282392756
"347","경기","시흥시",2015,4152,2179,1973,"4",2013,4152,2150,2002,1.02200850818085,1.03397171932886,1.00909177092666
"348","경기","시흥시",2016,4069,2106,1963,"4",2014,4105,2086,2019,1.01304570518584,1.02999224004545,0.995523767731817
"349","경기","시흥시",2017,4248,2165,2083,"4",2015,4110,2112,1998,1.05632412232415,1.04581261658853,1.06748415775079
"350","경기","시흥시",2018,4662,2422,2240,"4",2016,4147,2170,1977,1.14892781893878,1.13868682291187,1.16013626160685
"351","경기","시흥시",2019,5317,2756,2561,"4",2017,3965,2038,1927,1.37049665523268,1.37963728752401,1.36080380906036
"352","경기","시흥시",2020,4959,2537,2422,"4",2018,4527,2344,2183,1.11953615906093,1.10421273059181,1.13602543612871
"353","경기","안산시",2010,7654,3947,3707,"4",2008,7961,4148,3813,0.982596799600076,0.970774296067379,0.995459127813721
"354","경기","안산시",2011,7397,3852,3545,"4",2009,7008,3586,3422,1.07873814711954,1.09588727273978,1.06072764265656
"355","경기","안산시",2012,6600,3390,3210,"4",2010,6813,3513,3300,0.990056678995097,0.984490293030576,0.995998638977482
"356","경기","안산시",2013,6424,3298,3126,"4",2011,7561,3887,3674,0.868322001924846,0.865617445738525,0.871199212447145
"357","경기","안산시",2014,7139,3668,3471,"4",2012,6823,3501,3322,1.06934174701789,1.06887545969246,1.06984937670695
"358","경기","안산시",2015,6508,3354,3154,"4",2013,6359,3306,3053,1.04595555452759,1.03502323438413,1.05779750209491
"359","경기","안산시",2016,5900,3037,2863,"4",2014,6488,3347,3141,0.929385049054716,0.92571855666349,0.933299566401493
"360","경기","안산시",2017,6090,3146,2944,"4",2015,6313,3183,3130,0.985907146336347,1.00835154870167,0.963077242382932
"361","경기","안산시",2018,5745,2909,2836,"4",2016,6147,3051,3096,0.955171446152427,0.972727969445904,0.937935398752129
"362","경기","안산시",2019,5611,2815,2796,"4",2017,5376,2744,2632,1.0666833592639,1.04660831832147,1.08772455971052
"363","경기","안산시",2020,5094,2610,2484,"4",2018,4934,2489,2445,1.05515025145384,1.06980716124124,1.04025636188371
"364","경기","안성시",2010,1798,937,861,"4",2008,1863,946,917,0.986350669731167,1.01050471547743,0.961394134648308
"365","경기","안성시",2011,1852,948,904,"4",2009,1696,875,821,1.11601400775409,1.10532546165925,1.12743866791035
"366","경기","안성시",2012,1696,876,820,"4",2010,1859,990,869,0.932397218867519,0.902731925118077,0.966188198227298
"367","경기","안성시",2013,1813,966,847,"4",2011,2104,1077,1027,0.880656570975226,0.915063669659317,0.844462987137311
"368","경기","안성시",2014,2031,1044,987,"4",2012,2024,1058,966,1.02554312258661,1.00671078424554,1.0461830482555
"369","경기","안성시",2015,1926,990,936,"4",2013,1939,984,955,1.01515646557829,1.02643153446958,1.00355257492902
"370","경기","안성시",2016,1802,919,883,"4",2014,1889,967,922,0.974938767465266,0.969569459741891,0.980612522592929
"371","경기","안성시",2017,1809,938,871,"4",2015,1933,993,940,0.956447693377731,0.963703596756231,0.94876346789056
"372","경기","안성시",2018,1888,984,904,"4",2016,1887,946,941,1.02255011311364,1.06119171828152,0.983663279866525
"373","경기","안성시",2019,1787,897,890,"4",2017,1690,895,795,1.08066816811785,1.02249053782124,1.14627951279487
"374","경기","안성시",2020,1681,886,795,"4",2018,1579,782,797,1.0880280571577,1.15589093764681,1.02135438945791
"375","경기","안양시",2010,6023,3126,2897,"4",2008,5832,3041,2791,1.0554796373068,1.04872698611365,1.0628116619272
"376","경기","안양시",2011,5482,2893,2589,"4",2009,5291,2730,2561,1.05890203021119,1.08112441867502,1.03511862843587
"377","경기","안양시",2012,5104,2628,2476,"4",2010,5504,2809,2695,0.947734634039798,0.954472701175041,0.940718149955463
"378","경기","안양시",2013,5291,2688,2603,"4",2011,5686,2980,2706,0.951010731056079,0.920243779140318,0.984949645641815
"379","경기","안양시",2014,5378,2845,2533,"4",2012,5422,2766,2656,1.0137148205453,1.04934907722084,0.976505674960223
"380","경기","안양시",2015,5127,2626,2501,"4",2013,4934,2563,2371,1.06198573600389,1.04528809837148,1.08006474482984
"381","경기","안양시",2016,4642,2389,2253,"4",2014,5338,2802,2536,0.888752996436024,0.86983706330769,0.909661040632792
"382","경기","안양시",2017,4978,2583,2395,"4",2015,5218,2680,2538,0.975001600943706,0.983285199411416,0.96623230241863
"383","경기","안양시",2018,4837,2443,2394,"4",2016,5241,2704,2537,0.943227466909132,0.921736254142699,0.966209562358699
"384","경기","안양시",2019,4602,2360,2242,"4",2017,4579,2330,2249,1.02714198616472,1.03334649785696,1.02073687721906
"385","경기","안양시",2020,4147,2145,2002,"4",2018,4606,2332,2274,0.920162675515843,0.938401385715758,0.901449215740805
"386","경기","양주시",2010,2278,1155,1123,"4",2008,2214,1176,1038,1.05155166288888,1.00199268841078,1.10777116194775
"387","경기","양주시",2011,2334,1242,1092,"4",2009,2102,1120,982,1.13480868605809,1.13134083546017,1.1386199869994
"388","경기","양주시",2012,2112,1104,1008,"4",2010,2280,1197,1083,0.946702618104364,0.940946243917493,0.953014981660697
"389","경기","양주시",2013,2158,1144,1014,"4",2011,2559,1290,1269,0.86185789787193,0.904745025938666,0.818170818081412
"390","경기","양주시",2014,2361,1220,1141,"4",2012,2285,1161,1124,1.05600091370459,1.07205607191645,1.03941022697695
"391","경기","양주시",2015,2212,1111,1101,"4",2013,2188,1105,1083,1.03321883916638,1.02575034310432,1.04094195913534
"392","경기","양주시",2016,2141,1089,1052,"4",2014,2200,1107,1093,0.994600098188725,1.0036219448147,0.985514980654071
"393","경기","양주시",2017,2136,1074,1062,"4",2015,2233,1140,1093,0.977613154265244,0.961145905132026,0.994882993778159
"394","경기","양주시",2018,2187,1100,1087,"4",2016,2285,1127,1158,0.978176195794973,0.995769131339907,0.961144393835145
"395","경기","양주시",2019,2359,1179,1180,"4",2017,1988,1016,972,1.21273544808784,1.18388627880518,1.24303510768122
"396","경기","양주시",2020,2065,1035,1030,"4",2018,1994,1022,972,1.05839898164165,1.0331879775892,1.08502217026411
"397","경기","양평군",2010,722,380,342,"4",2008,699,385,314,1.05563682819252,1.00696124719629,1.11522914454232
"398","경기","양평군",2011,790,429,361,"4",2009,618,319,299,1.30645100560335,1.37200754325338,1.23624248910061
"399","경기","양평군",2012,681,361,320,"4",2010,746,386,360,0.932959509478763,0.954134912336899,0.910154519522517
"400","경기","양평군",2013,776,390,386,"4",2011,782,393,389,1.01416701067562,1.01242286906738,1.01602724962122
"401","경기","양평군",2014,847,422,425,"4",2012,784,387,397,1.10413419187395,1.11247785823461,1.09614012505467
"402","경기","양평군",2015,816,410,406,"4",2013,782,406,376,1.06644366071045,1.03026207460419,1.10561988508487
"403","경기","양평군",2016,822,431,391,"4",2014,798,397,401,1.05274560617125,1.1075839490489,0.998389574251789
"404","경기","양평군",2017,831,421,410,"4",2015,859,442,417,0.988695076016629,0.971739186424212,1.00673566457976
"405","경기","양평군",2018,873,444,429,"4",2016,869,470,399,1.02671280511148,0.963773547568498,1.10091058893372
"406","경기","양평군",2019,840,438,402,"4",2017,800,394,406,1.07310893358989,1.13414290084632,1.01383591491147
"407","경기","양평군",2020,746,373,373,"4",2018,796,420,376,0.95781199384788,0.906044297641749,1.01575422940063
"408","경기","여주시",2015,884,475,409,"4",2013,918,487,431,0.984156341211186,0.995072074359783,0.971658580731551
"409","경기","여주시",2016,908,481,427,"4",2014,962,478,484,0.964640047222671,1.02661373355013,0.903337763048821
"410","경기","여주시",2017,939,463,476,"4",2015,1004,520,484,0.955842618706988,0.908379944934082,1.00699947356262
"411","경기","여주시",2018,955,494,461,"4",2016,918,478,440,1.06320057223607,1.0543600506731,1.07279292656219
"412","경기","여주시",2019,868,457,411,"4",2017,879,494,385,1.00921886814673,0.943798192190237,1.09307193756941
"413","경기","여주시",2020,804,428,376,"4",2018,821,421,400,1.00084633444263,1.03717386118893,0.962488404395062
"414","경기","연천군",2010,333,192,141,"4",2008,381,183,198,0.893251530772237,1.07038503584627,0.729157882117471
"415","경기","연천군",2011,334,159,175,"4",2009,364,199,165,0.937777037726382,0.815143252408369,1.08597982443028
"416","경기","연천군",2012,329,186,143,"4",2010,322,159,163,1.04422608444565,1.1934540700385,0.898289008148374
"417","경기","연천군",2013,281,147,134,"4",2011,329,172,157,0.872900883886985,0.871924292917289,0.873922253617958
"418","경기","연천군",2014,312,170,142,"4",2012,329,170,159,0.969199557910105,1.02021073729098,0.914447701218378
"419","경기","연천군",2015,300,157,143,"4",2013,322,184,138,0.952181839920044,0.870505900840671,1.06102252411728
"420","경기","연천군",2016,271,147,124,"4",2014,352,174,178,0.786830413968778,0.861902174607895,0.71329525546849
"421","경기","연천군",2017,334,165,169,"4",2015,343,182,161,0.995191958403507,0.924916327763799,1.07480203741751
"422","경기","연천군",2018,300,166,134,"4",2016,378,197,181,0.811117863635593,0.859669961372093,0.758043059768063
"423","경기","연천군",2019,286,156,130,"4",2017,366,188,178,0.79861867032711,0.846557845837194,0.747809542023417
"424","경기","연천군",2020,284,143,141,"4",2018,330,148,182,0.879546716131396,0.985744158328445,0.793259673951974
"425","경기","오산시",2010,2310,1200,1110,"4",2008,2186,1110,1076,1.0799815434116,1.10293052680106,1.05627830506853
"426","경기","오산시",2011,2447,1243,1204,"4",2009,2157,1096,1061,1.15941345364791,1.15704557158092,1.16192676408412
"427","경기","오산시",2012,2479,1264,1215,"4",2010,2556,1240,1316,0.991220301948482,1.03995675156113,0.945340014340684
"428","경기","오산시",2013,2583,1276,1307,"4",2011,3037,1565,1472,0.869228836559476,0.831813994110727,0.909149763344376
"429","경기","오산시",2014,2993,1554,1439,"4",2012,3018,1627,1391,1.01354256626417,0.974436069914063,1.05925693586773
"430","경기","오산시",2015,2971,1600,1371,"4",2013,2953,1538,1415,1.02823815706241,1.06133756805303,0.992084506748087
"431","경기","오산시",2016,2728,1427,1301,"4",2014,3081,1561,1520,0.904913732657368,0.932633390207704,0.87639796620799
"432","경기","오산시",2017,2839,1439,1400,"4",2015,3037,1555,1482,0.955377726284302,0.944104984541297,0.967269479249639
"433","경기","오산시",2018,2943,1502,1441,"4",2016,3014,1559,1455,0.997933324345134,0.98290989570946,1.01407164636491
"434","경기","오산시",2019,2979,1555,1424,"4",2017,2715,1392,1323,1.12138613107578,1.13967506931571,1.10209186717693
"435","경기","오산시",2020,2677,1378,1299,"4",2018,2739,1383,1356,0.998874325082194,1.0165223398315,0.980882788323908
"436","경기","용인시",2010,11092,5717,5375,"4",2008,11143,5713,5430,1.0173309138241,1.02092504552643,1.01355259857048
"437","경기","용인시",2011,11162,5763,5399,"4",2009,10583,5484,5099,1.07792298670647,1.07211423760173,1.08416646053439
"438","경기","용인시",2012,10455,5449,5006,"4",2010,11285,5869,5416,0.946840846524658,0.947201960725599,0.94641113650682
"439","경기","용인시",2013,11055,5738,5317,"4",2011,12579,6447,6132,0.898187777878946,0.908014457976676,0.88783480558364
"440","경기","용인시",2014,12253,6241,6012,"4",2012,11919,6161,5758,1.0506477263814,1.03345807684353,1.06909171462149
"441","경기","용인시",2015,11757,6077,5680,"4",2013,11427,5854,5573,1.05152306210573,1.05907424846554,1.04358287811751
"442","경기","용인시",2016,10993,5693,5300,"4",2014,12006,6139,5867,0.935777072333171,0.946092153021263,0.924969545364413
"443","경기","용인시",2017,11437,5882,5555,"4",2015,11775,5987,5788,0.992671873296336,1.00231828240279,0.982705062273848
"444","경기","용인시",2018,11495,5866,5629,"4",2016,12150,6212,5938,0.966912576258341,0.963386378774771,0.970641169449525
"445","경기","용인시",2019,11990,6091,5899,"4",2017,10738,5509,5229,1.14116986525315,1.12799121452883,1.15512080694134
"446","경기","용인시",2020,10958,5579,5379,"4",2018,11093,5672,5421,1.00957083139329,1.00348302245176,1.01599083297834
"447","경기","의왕시",2010,1394,727,667,"4",2008,1384,668,716,1.02939296271973,1.11031917067446,0.953850834618309
"448","경기","의왕시",2011,1331,657,674,"4",2009,1323,680,643,1.02818845380855,0.985703609412018,1.07328874716633
"449","경기","의왕시",2012,1198,606,592,"4",2010,1513,777,736,0.8092307949773,0.795685594335048,0.8235909103288
"450","경기","의왕시",2013,1407,721,686,"4",2011,1616,828,788,0.889830427605478,0.888371910128979,0.89138547010343
"451","경기","의왕시",2014,1503,767,736,"4",2012,1608,837,771,0.955272877982471,0.934888453407622,0.977442207736244
"452","경기","의왕시",2015,1397,729,668,"4",2013,1633,812,821,0.874308564561325,0.915928112666407,0.833107334252341
"453","경기","의왕시",2016,1368,701,667,"4",2014,1645,870,775,0.849913458475015,0.822031869932156,0.88123509366027
"454","경기","의왕시",2017,1326,708,618,"4",2015,1618,832,786,0.837566923268111,0.868160098560111,0.805069885111998
"455","경기","의왕시",2018,1237,647,590,"4",2016,1550,834,716,0.815628725561102,0.791458449672977,0.843736120576915
"456","경기","의왕시",2019,1313,686,627,"4",2017,1390,669,721,0.965393648375146,1.0461353748604,0.890430297098746
"457","경기","의왕시",2020,1257,590,667,"4",2018,1295,667,628,0.992019069330753,0.902435284860085,1.08751146112533
"458","경기","의정부시",2010,4414,2261,2153,"4",2008,4524,2306,2218,0.997158610767078,1.0003020281938,0.9939170494132
"459","경기","의정부시",2011,4024,2034,1990,"4",2009,4194,2165,2029,0.98058231686212,0.958479741177759,1.00424269619568
"460","경기","의정부시",2012,3709,1908,1801,"4",2010,4070,2059,2011,0.93135861347488,0.945391979966579,0.916999913410025
"461","경기","의정부시",2013,3720,1873,1847,"4",2011,4391,2295,2096,0.865832760289855,0.83261643178475,0.902284027792391
"462","경기","의정부시",2014,4073,2144,1929,"4",2012,3895,1995,1900,1.06871390341992,1.09640692769517,1.03955214562042
"463","경기","의정부시",2015,3574,1856,1718,"4",2013,3798,1918,1880,0.961732071679397,0.987232079464054,0.935692099791035
"464","경기","의정부시",2016,3466,1731,1735,"4",2014,3935,2012,1923,0.90019859958191,0.877726036903918,0.923821036293819
"465","경기","의정부시",2017,3749,1897,1852,"4",2015,3842,1954,1888,0.997269624458615,0.990450239836737,1.00439986304299
"466","경기","의정부시",2018,3683,1884,1799,"4",2016,4007,2046,1961,0.939370435645136,0.939431588004009,0.939336551860599
"467","경기","의정부시",2019,3868,1967,1901,"4",2017,3666,1907,1759,1.07832212483457,1.0523096592823,1.10658283644903
"468","경기","의정부시",2020,3502,1812,1690,"4",2018,3654,1866,1788,0.979494744293741,0.990686953896705,0.967802729441938
"469","경기","이천시",2010,2251,1164,1087,"4",2008,2246,1185,1061,1.02428368295418,1.00213105333899,1.04901527621216
"470","경기","이천시",2011,2187,1158,1029,"4",2009,2108,1123,985,1.06030958604911,1.05200715385837,1.06966256412412
"471","경기","이천시",2012,2124,1116,1008,"4",2010,2233,1182,1051,0.972120945533417,0.963244655513309,0.982031612881574
"472","경기","이천시",2013,2165,1142,1023,"4",2011,2497,1255,1242,0.886122715343026,0.928351125088683,0.843376878144506
"473","경기","이천시",2014,2377,1210,1167,"4",2012,2287,1168,1119,1.06222747002443,1.0568963973648,1.06784550028429
"474","경기","이천시",2015,2168,1141,1027,"4",2013,2153,1129,1024,1.02912886471717,1.03105442980426,1.02692361132161
"475","경기","이천시",2016,2032,1064,968,"4",2014,2304,1222,1082,0.901354725965053,0.888301329359738,0.916042765027746
"476","경기","이천시",2017,2274,1203,1071,"4",2015,2251,1178,1073,1.03245106512805,1.04186206872754,1.0220153091423
"477","경기","이천시",2018,2274,1181,1093,"4",2016,2368,1195,1173,0.981438913683804,1.00825847760723,0.954091006877984
"478","경기","이천시",2019,2291,1163,1128,"4",2017,2106,1042,1064,1.11178608368581,1.13868050620864,1.08551323803954
"479","경기","이천시",2020,2035,1016,1019,"4",2018,2162,1165,997,0.961973780827023,0.889728849002261,1.04651794114105
"480","경기","파주시",2010,3766,1961,1805,"4",2008,3678,1905,1773,1.04646113154135,1.05020118416147,1.04240412927547
"481","경기","파주시",2011,4048,2133,1915,"4",2009,3485,1796,1689,1.18711346947376,1.21164226204992,1.16093199703749
"482","경기","파주시",2012,4011,2075,1936,"4",2010,4069,2089,1980,1.00744067985092,1.01337351837184,1.00116997147477
"483","경기","파주시",2013,4441,2243,2198,"4",2011,4833,2462,2371,0.939114377163489,0.929460878856078,0.949213238359049
"484","경기","파주시",2014,4943,2512,2431,"4",2012,4836,2506,2330,1.04462118609138,1.02265338071626,1.0683085156992
"485","경기","파주시",2015,4757,2456,2301,"4",2013,4551,2406,2145,1.06826949536724,1.04141212418397,1.09839102242377
"486","경기","파주시",2016,4591,2396,2195,"4",2014,5101,2538,2563,0.919827692816756,0.963130388711262,0.876907068531376
"487","경기","파주시",2017,4992,2492,2500,"4",2015,5016,2585,2431,1.01711851531874,0.983506830688246,1.05298625510369
"488","경기","파주시",2018,4847,2483,2364,"4",2016,5222,2672,2550,0.948616476283525,0.948047627505052,0.949237625360837
"489","경기","파주시",2019,5245,2689,2556,"4",2017,4707,2357,2350,1.13882188770099,1.16391458318856,1.11368056207957
"490","경기","파주시",2020,4595,2333,2262,"4",2018,4998,2572,2426,0.939601659682072,0.925408884175681,0.954705570302937
"491","경기","평택시",2010,4672,2350,2322,"4",2008,4681,2457,2224,1.02004352707133,0.975781535463491,1.06904278040589
"492","경기","평택시",2011,4523,2376,2147,"4",2009,4268,2134,2134,1.08307040358528,1.13590473842707,1.03016142108327
"493","경기","평택시",2012,4190,2142,2048,"4",2010,4450,2289,2161,0.96229565152309,0.954692616547521,0.970382236455289
"494","경기","평택시",2013,4508,2318,2190,"4",2011,4907,2496,2411,0.93890653247998,0.94745532413481,0.930067688707425
"495","경기","평택시",2014,4946,2541,2405,"4",2012,4632,2366,2266,1.09128974124837,1.09567011135096,1.08673293110464
"496","경기","평택시",2015,4718,2401,2317,"4",2013,4566,2333,2233,1.05603069242165,1.04994684107828,1.06244134547711
"497","경기","평택시",2016,4704,2401,2303,"4",2014,4818,2517,2301,0.997826488684663,0.973192681857623,1.02481381606602
"498","경기","평택시",2017,4918,2572,2346,"4",2015,4872,2503,2369,1.03165801379996,1.04833480475925,1.01398282636125
"499","경기","평택시",2018,5043,2593,2450,"4",2016,5130,2660,2470,1.00467620014737,0.994513699923122,1.01563295321212
"500","경기","평택시",2019,5410,2767,2643,"4",2017,4679,2340,2339,1.18167686028177,1.20637739747185,1.1570032896474
"501","경기","평택시",2020,5066,2515,2551,"4",2018,4837,2460,2377,1.07039386033578,1.04302032694586,1.09887660989259
"502","경기","포천시",2010,1571,773,798,"4",2008,1427,715,712,1.12514041089847,1.10296909080549,1.14760002795132
"503","경기","포천시",2011,1273,642,631,"4",2009,1358,734,624,0.958038903471442,0.892336911908457,1.03541015952892
"504","경기","포천시",2012,1263,683,580,"4",2010,1414,746,668,0.912868985737207,0.93405353025434,0.889035664653357
"505","경기","포천시",2013,1322,689,633,"4",2011,1404,758,646,0.962318552574843,0.927341949859477,1.00331855606033
"506","경기","포천시",2014,1335,733,602,"4",2012,1282,666,616,1.06426002996992,1.12284455020163,1.00065283822504
"507","경기","포천시",2015,1240,653,587,"4",2013,1253,617,636,1.01140506795231,1.079736809483,0.945036620801387
"508","경기","포천시",2016,1192,603,589,"4",2014,1256,652,604,0.969931641521951,0.943538457954693,0.998495262414914
"509","경기","포천시",2017,1171,605,566,"4",2015,1184,643,541,1.01078713097954,0.959918345351542,1.07124009298699
"510","경기","포천시",2018,1110,606,504,"4",2016,1262,636,626,0.898913981046546,0.972087589305554,0.824373183017999
"511","경기","포천시",2019,1127,553,574,"4",2017,1034,535,499,1.11392996974837,1.05453558452694,1.17782020236807
"512","경기","포천시",2020,922,486,436,"4",2018,997,502,495,0.945127226221405,0.98769406040521,0.901880387526858
"513","경기","하남시",2010,1286,666,620,"4",2008,1470,730,740,0.894083633687462,0.930767604158618,0.857882131576967
"514","경기","하남시",2011,1320,676,644,"4",2009,1328,715,613,1.01585183042072,0.964562878893288,1.07570464827743
"515","경기","하남시",2012,1109,598,511,"4",2010,1405,740,665,0.806695683681537,0.82444056878379,0.786804630692492
"516","경기","하남시",2013,1189,624,565,"4",2011,1543,808,735,0.787536044217127,0.787885519888082,0.787097913566667
"517","경기","하남시",2014,1328,699,629,"4",2012,1389,700,689,0.977125485143388,1.01875329338056,0.934757753087259
"518","경기","하남시",2015,1390,709,681,"4",2013,1251,631,620,1.13556500908983,1.14632236567243,1.12466472785353
"519","경기","하남시",2016,1652,836,816,"4",2014,1435,750,685,1.17655613624722,1.13719490183368,1.2197399254331
"520","경기","하남시",2017,2477,1269,1208,"4",2015,1846,908,938,1.37135161146477,1.42582315597164,1.31865670792228
"521","경기","하남시",2018,2735,1333,1402,"4",2016,2668,1413,1255,1.04767363938329,0.962449336736641,1.14385754256326
"522","경기","하남시",2019,3089,1646,1443,"4",2017,2749,1406,1343,1.14841188860336,1.19435766257536,1.10016537090831
"523","경기","하남시",2020,3027,1522,1505,"4",2018,3073,1561,1512,1.00670997535419,0.994721807915995,1.01918344634032
"524","경기","화성시",2010,7266,3772,3494,"4",2008,7062,3652,3410,1.05153126882498,1.05373354355465,1.04914659167541
"525","경기","화성시",2011,7373,3783,3590,"4",2009,7115,3645,3470,1.05906798746555,1.05883599977278,1.05933330424253
"526","경기","화성시",2012,6814,3475,3339,"4",2010,7805,4003,3802,0.8922441991985,0.885643845137684,0.899232425899894
"527","경기","화성시",2013,7351,3762,3589,"4",2011,8533,4313,4220,0.880438830849339,0.889875444861734,0.870820531252868
"528","경기","화성시",2014,8041,4064,3977,"4",2012,8376,4311,4065,0.981133048505515,0.961757466098477,1.00175770963313
"529","경기","화성시",2015,8225,4211,4014,"4",2013,7877,4090,3787,1.06716008376126,1.05039301093699,1.08529978123417
"530","경기","화성시",2016,8751,4483,4268,"4",2014,8201,4191,4010,1.0905495006817,1.09129199123728,1.08980222580732
"531","경기","화성시",2017,9716,4984,4732,"4",2015,9097,4664,4433,1.09155047438552,1.09020804345159,1.09298614587821
"532","경기","화성시",2018,10549,5378,5171,"4",2016,9939,5075,4864,1.08473365054832,1.08112184140904,1.08855060608703
"533","경기","화성시",2019,11743,5921,5822,"4",2017,9585,5003,4582,1.25210703302741,1.2074091096342,1.30102238416469
"534","경기","화성시",2020,11118,5741,5377,"4",2018,10480,5251,5229,1.08422620171323,1.11541227247905,1.0529046582342
"535","경남","거제시",2010,2755,1388,1367,"4",2008,2777,1458,1319,1.01391193375522,0.971229426172755,1.06118565709681
"536","경남","거제시",2011,2706,1429,1277,"4",2009,2603,1333,1270,1.06244910608428,1.0936842787613,1.02956750914097
"537","경남","거제시",2012,2467,1272,1195,"4",2010,2760,1416,1344,0.913512677421069,0.916460492820709,0.910408468886223
"538","경남","거제시",2013,2643,1349,1294,"4",2011,3134,1641,1493,0.861891667875552,0.83867415271513,0.887446377625522
"539","경남","거제시",2014,3060,1594,1466,"4",2012,3048,1537,1511,1.02603216372487,1.0580454881209,0.993429742768042
"540","경남","거제시",2015,3028,1546,1482,"4",2013,3077,1633,1444,1.00573342956503,0.965857807625139,1.05086919852764
"541","경남","거제시",2016,3054,1595,1459,"4",2014,3360,1709,1651,0.928932733328663,0.952156890567062,0.90484850059435
"542","경남","거제시",2017,3305,1674,1631,"4",2015,3570,1810,1760,0.946145131523165,0.943554018908893,0.948874871595954
"543","경남","거제시",2018,3396,1731,1665,"4",2016,3671,1936,1735,0.945448350253925,0.912182224303039,0.982612786386522
"544","경남","거제시",2019,3412,1791,1621,"4",2017,3285,1703,1582,1.06151994822315,1.07292861449685,1.04916595174731
"545","경남","거제시",2020,3038,1573,1465,"4",2018,3275,1671,1604,0.948049419191882,0.960377911285882,0.935192280229457
"546","경남","거창군",2010,473,280,193,"4",2008,488,254,234,0.990594312232666,1.1246417576436,0.84451837628772
"547","경남","거창군",2011,484,249,235,"4",2009,437,232,205,1.13192704338565,1.09496755855799,1.17376634682325
"548","경남","거창군",2012,453,239,214,"4",2010,424,217,207,1.09191003350454,1.1236422406108,1.05854927814032
"549","경남","거창군",2013,428,216,212,"4",2011,506,265,241,0.864465694666804,0.831567997188118,0.90071308259801
"550","경남","거창군",2014,495,246,249,"4",2012,468,247,221,1.08097053749897,1.01608032944769,1.15365174109161
"551","경남","거창군",2015,483,252,231,"4",2013,458,248,210,1.07779499880207,1.03666574918277,1.12631621790912
"552","경남","거창군",2016,490,260,230,"4",2014,437,231,206,1.14595919681605,1.14828914153963,1.1432159316818
"553","경남","거창군",2017,454,240,214,"4",2015,500,264,236,0.92798372542821,0.927464306628162,0.928473307521381
"554","경남","거창군",2018,519,269,250,"4",2016,465,246,219,1.1406933671954,1.11559629402957,1.16886282472926
"555","경남","거창군",2019,482,255,227,"4",2017,437,222,215,1.12724965890885,1.17186368472612,1.08107307173518
"556","경남","거창군",2020,427,219,208,"4",2018,449,226,223,0.9719323674682,0.98861128967577,0.955050033938426
"557","경남","고성군",2010,356,176,180,"4",2008,343,171,172,1.06074352452589,1.05004146060358,1.07154819885645
"558","경남","고성군",2011,339,165,174,"4",2009,346,150,196,1.00133203547199,1.12223181102008,0.908993608145575
"559","경남","고성군",2012,333,155,178,"4",2010,371,188,183,0.917328391439952,0.841131192979264,0.995947773411935
"560","경남","고성군",2013,374,193,181,"4",2011,398,227,171,0.960379854421198,0.867403842718761,1.08380242127352
"561","경남","고성군",2014,382,210,172,"4",2012,420,217,203,0.92954107172639,0.987300713507398,0.867561081416784
"562","경남","고성군",2015,397,207,190,"4",2013,382,204,178,1.06213973232407,1.03521383636879,1.09295240757269
"563","경남","고성군",2016,364,187,177,"4",2014,424,227,197,0.877384662683558,0.840437920147193,0.919972176141732
"564","경남","고성군",2017,397,214,183,"4",2015,400,214,186,1.01434344436949,1.02021073729098,1.00740893390698
"565","경남","고성군",2018,368,194,174,"4",2016,427,218,209,0.880794217823306,0.907893958873623,0.852453335868578
"566","경남","고성군",2019,382,197,185,"4",2017,338,156,182,1.15505103587303,1.28834304645079,1.04080169986607
"567","경남","고성군",2020,309,142,167,"4",2018,332,151,181,0.951206713939403,0.959403474803436,0.944725305830348
"568","경남","김해시",2010,6399,3400,2999,"4",2008,6091,3191,2900,1.07368780887362,1.08703118357547,1.05887847570829
"569","경남","김해시",2011,6059,3190,2869,"4",2009,5638,2967,2671,1.09832379408793,1.0968898725845,1.09982683679291
"570","경남","김해시",2012,5594,2977,2617,"4",2010,5965,3077,2888,0.958443519658619,0.987054717229523,0.927842338915939
"571","경남","김해시",2013,5830,3015,2815,"4",2011,6474,3279,3195,0.92034439337262,0.938071171983013,0.902142595935171
"572","경남","김해시",2014,6507,3312,3195,"4",2012,6062,3117,2945,1.0970322274386,1.08403527812246,1.11084436370416
"573","경남","김해시",2015,6072,3127,2945,"4",2013,5801,2981,2820,1.06975274291917,1.07017744901338,1.06931052925285
"574","경남","김해시",2016,5671,2930,2741,"4",2014,6075,3165,2910,0.954042839488656,0.944460492973954,0.964458842014647
"575","경남","김해시",2017,5886,3038,2848,"4",2015,6030,3027,3003,0.997602334851155,1.02391814333994,0.971073952897151
"576","경남","김해시",2018,5838,2909,2929,"4",2016,6069,3020,3049,0.983108530360815,0.982712925423661,0.983625093847699
"577","경남","김해시",2019,6171,3071,3100,"4",2017,5472,2769,2703,1.15256113011404,1.13147965844008,1.17431146386784
"578","경남","김해시",2020,5602,2829,2773,"4",2018,5441,2765,2676,1.05224989208401,1.04382501837113,1.06103916030098
"579","경남","남해군",2010,259,128,131,"4",2008,282,149,133,0.938653204322126,0.876422646800303,1.00852648356865
"580","경남","남해군",2011,244,129,115,"4",2009,227,116,111,1.09854659029131,1.13454469922876,1.06082199065969
"581","경남","남해군",2012,218,118,100,"4",2010,232,125,107,0.960335580963038,0.963078936002683,0.956938163049376
"582","경남","남해군",2013,218,120,98,"4",2011,278,138,140,0.801431132314477,0.887139771557372,0.716746684123982
"583","경남","남해군",2014,245,121,124,"4",2012,243,130,113,1.03042010084077,0.949580763170833,1.12359783604771
"584","경남","남해군",2015,237,131,106,"4",2013,227,129,98,1.06703090942229,1.03602795802417,1.10750945360265
"585","경남","남해군",2016,226,132,94,"4",2014,233,121,112,0.99130438990932,1.11295716795379,0.859364646781305
"586","경남","남해군",2017,221,114,107,"4",2015,206,120,86,1.09642660343673,0.969200200426429,1.27395174752934
"587","경남","남해군",2018,197,119,78,"4",2016,196,100,96,1.02722283730422,1.21405077737626,0.831938115501051
"588","경남","남해군",2019,183,91,92,"4",2017,152,71,81,1.23044445392826,1.30759404357013,1.16297521938988
"589","경남","남해군",2020,152,71,81,"4",2018,188,107,81,0.826304751295153,0.676962264931396,1.02392383446283
"590","경남","마산시",2010,3481,1875,1606,"4",2008,3493,1833,1660,1.01849745690739,1.0435870880636,0.990615468763439
"591","경남","마산시",2011,0,0,0,"4",2009,3120,1619,1501,0,0,0
"592","경남","밀양시",2010,774,394,380,"4",2008,751,398,353,1.05330836928359,1.00995736304685,1.10224095494582
"593","경남","밀양시",2011,728,391,337,"4",2009,725,372,353,1.02623750890435,1.07231827494831,0.977513688991429
"594","경남","밀양시",2012,681,348,333,"4",2010,684,348,336,1.01752601472391,1.02021073729098,1.01478165736941
"595","경남","밀양시",2013,667,344,323,"4",2011,802,409,393,0.849974657053149,0.858074556547913,0.841545543337137
"596","경남","밀양시",2014,782,402,380,"4",2012,723,356,367,1.10540892586089,1.15203572019936,1.06019361606506
"597","경남","밀양시",2015,739,364,375,"4",2013,628,338,290,1.2026501394039,1.09868848631336,1.32403944111573
"598","경남","밀양시",2016,635,330,305,"4",2014,684,362,322,0.948794448384266,0.93002636272382,0.96986574382349
"599","경남","밀양시",2017,692,359,333,"4",2015,676,338,338,1.04619805867033,1.08359661150136,1.00877703217788
"600","경남","밀양시",2018,648,333,315,"4",2016,702,369,333,0.943392469090013,0.920677982433321,0.968576600167544
"601","경남","밀양시",2019,673,359,314,"4",2017,631,302,329,1.09003443107086,1.21276706850153,0.977240376964526
"602","경남","밀양시",2020,607,298,309,"4",2018,613,313,300,1.01200516226064,0.971318848922401,1.05464154949672
"603","경남","사천시",2010,1083,564,519,"4",2008,1113,581,532,0.994461109038506,0.990359476475235,0.998903139259793
"604","경남","사천시",2011,1052,555,497,"4",2009,1054,531,523,1.02006921309891,1.06632195705554,0.973021311143456
"605","경남","사천시",2012,972,497,475,"4",2010,1071,562,509,0.927537133475055,0.902214833511772,0.955528136286533
"606","경남","사천시",2013,1065,555,510,"4",2011,1156,568,588,0.941556281325781,0.996860843655797,0.88809720336062
"607","경남","사천시",2014,1172,587,585,"4",2012,1185,630,555,1.01079660049616,0.950577306015562,1.07927106875812
"608","경남","사천시",2015,1166,602,564,"4",2013,1210,607,603,0.984844562428817,1.01180702446321,0.957699904870708
"609","경남","사천시",2016,1121,546,575,"4",2014,1258,643,615,0.910708694491836,0.866306473656102,0.957327162302648
"610","경남","사천시",2017,1167,619,548,"4",2015,1147,598,549,1.03982905758243,1.05603753575772,1.02205876372611
"611","경남","사천시",2018,1061,554,507,"4",2016,1133,593,540,0.957061806866619,0.953114246980104,0.961350711245659
"612","경남","사천시",2019,1068,551,517,"4",2017,991,528,463,1.10141784736342,1.06465173531691,1.14334475684079
"613","경남","사천시",2020,904,481,423,"4",2018,973,490,483,0.949533084681897,1.00147217272849,0.896728327076145
"614","경남","산청군",2010,187,98,89,"4",2008,198,108,90,0.965230257726356,0.925746780134406,1.0125469029688
"615","경남","산청군",2011,184,99,85,"4",2009,202,89,113,0.930938443095425,1.13484115721131,0.770208194064962
"616","경남","산청군",2012,181,86,95,"4",2010,202,100,102,0.915760098914522,0.877381234070241,0.953654551705579
"617","경남","산청군",2013,181,92,89,"4",2011,245,124,121,0.755034857064218,0.756930547022338,0.753134060059438
"618","경남","산청군",2014,215,110,105,"4",2012,176,105,71,1.24847630260729,1.0687922009715,1.51425355800841
"619","경남","산청군",2015,175,107,68,"4",2013,181,99,82,0.988129773103029,1.10265200899126,0.849107570042348
"620","경남","산청군",2016,159,77,82,"4",2014,209,112,97,0.777508865075382,0.701394881887547,0.865585097174765
"621","경남","산청군",2017,194,108,86,"4",2015,179,106,73,1.10765167925745,1.03945999648515,1.2062664351206
"622","경남","산청군",2018,149,88,61,"4",2016,179,91,88,0.850722166027633,0.986577416281385,0.709765385252645
"623","경남","산청군",2019,159,90,69,"4",2017,179,94,85,0.907817613412038,0.976797514427532,0.831185230328652
"624","경남","산청군",2020,139,77,62,"4",2018,143,78,65,0.993420857602362,1.00713111245391,0.976665811333778
"625","경남","양산시",2010,2902,1539,1363,"4",2008,2798,1456,1342,1.05999595809179,1.07836835487007,1.03994648761016
"626","경남","양산시",2011,2830,1462,1368,"4",2009,2679,1383,1296,1.0796133177125,1.07848741715069,1.08080849193299
"627","경남","양산시",2012,2683,1385,1298,"4",2010,2805,1466,1339,0.977557514242144,0.96384165835471,0.992571424296308
"628","경남","양산시",2013,2741,1394,1347,"4",2011,3179,1652,1527,0.881197018220731,0.860880004711636,0.903225543563481
"629","경남","양산시",2014,3194,1612,1582,"4",2012,3000,1589,1411,1.08809839170988,1.03497779012779,1.14801382432332
"630","경남","양산시",2015,3213,1671,1542,"4",2013,2880,1472,1408,1.14017824193926,1.15813324865029,1.12137113120858
"631","경남","양산시",2016,3092,1584,1508,"4",2014,3339,1717,1622,0.946406201645756,0.941184512445491,0.951958780745962
"632","경남","양산시",2017,3559,1800,1759,"4",2015,3514,1780,1734,1.03509626653831,1.03167377928301,1.0386862888236
"633","경남","양산시",2018,3935,1987,1948,"4",2016,3723,1929,1794,1.08020507109633,1.05088581389174,1.1118191914903
"634","경남","양산시",2019,4026,2088,1938,"4",2017,3754,1852,1902,1.09605920456476,1.15021599323086,1.04330409631386
"635","경남","양산시",2020,3713,1862,1851,"4",2018,4007,2095,1912,0.947022109028072,0.906745772236659,0.991256808363338
"636","경남","의령군",2010,156,93,63,"4",2008,185,94,91,0.861801769060606,1.00935743157512,0.708870346935807
"637","경남","의령군",2011,161,85,76,"4",2009,156,79,77,1.05476519113536,1.09769509708523,1.01062612232695
"638","경남","의령군",2012,130,70,60,"4",2010,140,73,67,0.949007900453644,0.978284268635184,0.916946717429402
"639","경남","의령군",2013,129,66,63,"4",2011,180,88,92,0.732439430862941,0.765158052968233,0.701165234469113
"640","경남","의령군",2014,142,69,73,"4",2012,184,97,87,0.788723957400437,0.725716916217294,0.859154481790652
"641","경남","의령군",2015,131,65,66,"4",2013,193,95,98,0.693694894153839,0.69803892551488,0.68958135790354
"642","경남","의령군",2016,143,80,63,"4",2014,167,84,83,0.875133033951265,0.971629273610455,0.777195199652511
"643","경남","의령군",2017,127,66,61,"4",2015,156,73,83,0.832019747044664,0.922382310427459,0.752522336171479
"644","경남","의령군",2018,120,54,66,"4",2016,171,97,74,0.717198953109367,0.567952369213534,0.913229365872255
"645","경남","의령군",2019,129,79,50,"4",2017,131,75,56,1.00640532484984,1.07462197661316,0.914217709341814
"646","경남","의령군",2020,96,52,44,"4",2018,134,81,53,0.732185199890756,0.654950102952233,0.850049975780464
"647","경남","진주시",2010,3296,1769,1527,"4",2008,3033,1685,1348,1.11062975369735,1.07106990757729,1.15988998162073
"648","경남","진주시",2011,3165,1765,1400,"4",2009,2703,1426,1277,1.19669142744816,1.26274330386997,1.12254766503365
"649","경남","진주시",2012,2845,1478,1367,"4",2010,2973,1553,1420,0.978006796426004,0.970941062276925,0.985706958951191
"650","경남","진주시",2013,3054,1594,1460,"4",2011,3263,1668,1595,0.956547344157005,0.974949589473512,0.937259434680711
"651","경남","진주시",2014,3364,1716,1648,"4",2012,3036,1568,1468,1.13242312961804,1.11650613851487,1.14947307847054
"652","경남","진주시",2015,3261,1679,1582,"4",2013,2745,1466,1279,1.21412376873506,1.16844053745672,1.26649531362017
"653","경남","진주시",2016,3086,1650,1436,"4",2014,3150,1675,1475,1.00124389087178,1.00498371136126,0.996850594093984
"654","경남","진주시",2017,3352,1776,1576,"4",2015,3317,1769,1548,1.03279243877667,1.02424774981842,1.04244442061591
"655","경남","진주시",2018,3368,1789,1579,"4",2016,3336,1703,1633,1.03181194710824,1.07173048092399,0.9900647486937
"656","경남","진주시",2019,3444,1791,1653,"4",2017,2994,1601,1393,1.1756170013944,1.14128509087329,1.21503668224484
"657","경남","진주시",2020,3121,1670,1451,"4",2018,3174,1649,1525,1.00494283365861,1.03320311175011,0.974238350036439
"658","경남","진해시",2010,2224,1190,1034,"4",2008,2257,1221,1036,1.00706553929739,0.994308580979741,1.02194714752371
"659","경남","진해시",2011,0,0,0,"4",2009,2055,1047,1008,0,0,0
"660","경남","창녕군",2010,345,168,177,"4",2008,358,201,157,0.984896467380984,0.852713452064101,1.15435999171924
"661","경남","창녕군",2011,331,192,139,"4",2009,326,176,150,1.03768348530019,1.11295716795379,0.948836086602224
"662","경남","창녕군",2012,322,171,151,"4",2010,346,184,162,0.95111774460761,0.948130630851941,0.954398141999306
"663","경남","창녕군",2013,369,197,172,"4",2011,404,213,191,0.933468167125576,0.943575188949872,0.922067536793754
"664","경남","창녕군",2014,399,220,179,"4",2012,378,199,179,1.07878675863534,1.12787116685435,1.02392383446283
"665","경남","창녕군",2015,379,201,178,"4",2013,380,201,179,1.01931901210669,1.02021073729098,1.01820358957756
"666","경남","창녕군",2016,355,192,163,"4",2014,406,208,198,0.893628129074386,0.941732988268595,0.842927197057786
"667","경남","창녕군",2017,382,203,179,"4",2015,414,216,198,0.943012681461555,0.958809165139206,0.925668517014378
"668","경남","창녕군",2018,391,200,191,"4",2016,407,212,195,0.981831269530003,0.96246295970847,1.0029202686277
"669","경남","창녕군",2019,392,186,206,"4",2017,402,223,179,0.996585410962418,0.850938103749425,1.17837044636505
"670","경남","창녕군",2020,354,193,161,"4",2018,371,194,177,0.975177929638868,1.01495191905752,0.931365747731729
"671","경남","창원시",2010,4988,2665,2323,"4",2008,4825,2550,2275,1.0565343914624,1.06622024112959,1.04552750217897
"672","경남","창원시",2011,10242,5418,4824,"4",2009,4464,2374,2090,2.34485016594719,2.32834952596568,2.36335338633909
"673","경남","통영시",2010,1290,680,610,"4",2008,1271,685,586,1.03728636943611,1.01276394358812,1.06585928160807
"674","경남","통영시",2011,1279,684,595,"4",2009,1243,640,603,1.0516081109922,1.09035022547973,1.01033943864906
"675","경남","통영시",2012,1235,651,584,"4",2010,1275,648,627,0.989945496159488,1.02493393514881,0.953702582657566
"676","경남","통영시",2013,1254,637,617,"4",2011,1554,799,755,0.824709568377595,0.813359498941618,0.836769544190155
"677","경남","통영시",2014,1483,754,729,"4",2012,1470,723,747,1.03104667866136,1.06395421288713,0.9992509709818
"678","경남","통영시",2015,1439,714,725,"4",2013,1422,755,667,1.03422661270903,0.964808564802329,1.11296068963351
"679","경남","통영시",2016,1411,756,655,"4",2014,1591,820,771,0.906382152761267,0.940584533404853,0.869870443026141
"680","경남","통영시",2017,1522,789,733,"4",2015,1531,777,754,1.01600062015104,1.03596688767385,0.995406061884955
"681","경남","통영시",2018,1455,732,723,"4",2016,1515,781,734,0.981532923698438,0.956202637256076,1.00857892686189
"682","경남","통영시",2019,1427,742,685,"4",2017,1206,620,586,1.20929199102327,1.22096188237082,1.19690755393693
"683","경남","통영시",2020,1103,569,534,"4",2018,1249,645,604,0.902542341491973,0.899999859718708,0.905257164905881
"684","경남","하동군",2010,304,169,135,"4",2008,352,187,165,0.882643711610732,0.922008634236231,0.837755864560499
"685","경남","하동군",2011,281,151,130,"4",2009,320,169,151,0.897451221246307,0.911549238644601,0.881523830994491
"686","경남","하동군",2012,294,158,136,"4",2010,285,143,142,1.05428246107077,1.12722584959423,0.980659447091163
"687","경남","하동군",2013,261,130,131,"4",2011,360,188,172,0.740956168431114,0.705464871530995,0.779848966945529
"688","경남","하동군",2014,296,163,133,"4",2012,305,150,155,0.991850880070593,1.10862900118953,0.878592709571333
"689","경남","하동군",2015,268,138,130,"4",2013,256,112,144,1.06991515700182,1.25704537273353,0.924375683890057
"690","경남","하동군",2016,217,91,126,"4",2014,295,157,138,0.751782529746589,0.591332338175025,0.934886979292151
"691","경남","하동군",2017,266,150,116,"4",2015,267,143,124,1.0181807609592,1.07015112303249,0.957864232239423
"692","경남","하동군",2018,226,131,95,"4",2016,263,137,126,0.878227843531831,0.975529975073855,0.772006065666421
"693","경남","하동군",2019,214,113,101,"4",2017,201,108,93,1.08810856094876,1.06744271586926,1.11200330409404
"694","경남","하동군",2020,171,96,75,"4",2018,229,128,101,0.763159191698362,0.765158052968233,0.760339481036756
"695","경남","함안군",2010,599,325,274,"4",2008,578,313,265,1.05914030519088,1.05932424798584,1.05869860619931
"696","경남","함안군",2011,543,295,248,"4",2009,587,320,267,0.945401396835094,0.94050677344012,0.951060340624653
"697","경남","함안군",2012,554,306,248,"4",2010,627,336,291,0.903018681869521,0.929120492889998,0.872622374387568
"698","경남","함안군",2013,547,293,254,"4",2011,656,324,332,0.852193070083725,0.92259798156252,0.783363415522769
"699","경남","함안군",2014,630,325,305,"4",2012,672,358,314,0.958132976419544,0.926168965417787,0.994575699080139
"700","경남","함안군",2015,686,360,326,"4",2013,628,322,306,1.1163978290001,1.14060827771662,1.09084696089831
"701","경남","함안군",2016,646,329,317,"4",2014,620,322,298,1.06486692949166,1.04238923157991,1.08920756887489
"702","경남","함안군",2017,628,337,291,"4",2015,624,299,325,1.02855984477175,1.14986962698013,0.916805648703643
"703","경남","함안군",2018,598,290,308,"4",2016,623,311,312,0.980996930806014,0.951321909371008,1.01079660581587
"704","경남","함안군",2019,592,304,288,"4",2017,552,273,279,1.09606709573018,1.13605884299069,1.05695363557454
"705","경남","함안군",2020,502,245,257,"4",2018,498,246,252,1.03021741186101,1.01606353917191,1.04423978355932
"706","경남","함양군",2010,267,127,140,"4",2008,268,145,123,1.01819504359808,0.893563887144512,1.16544176280322
"707","경남","함양군",2011,270,148,122,"4",2009,267,135,132,1.0334917498458,1.11845325273381,0.946353847003527
"708","경남","함양군",2012,266,136,130,"4",2010,289,144,145,0.94067219092078,0.963532362997035,0.918000679173574
"709","경남","함양군",2013,283,149,134,"4",2011,300,155,145,0.964094692717266,0.980718708750682,0.946246853917376
"710","경남","함양군",2014,283,155,128,"4",2012,300,149,151,0.964094692717266,1.06129304885974,0.867961925902268
"711","경남","함양군",2015,283,143,140,"4",2013,270,130,140,1.07121632524141,1.12223181102008,1.02392383446283
"712","경남","함양군",2016,241,115,126,"4",2014,277,149,128,0.889184297731351,0.787410971734647,1.00792502454935
"713","경남","함양군",2017,253,142,111,"4",2015,214,103,111,1.20826239518577,1.40650412325552,1.02392383446283
"714","경남","함양군",2018,191,93,98,"4",2016,238,134,104,0.820183298582109,0.708056705731798,0.964851305551515
"715","경남","함양군",2019,222,132,90,"4",2017,221,111,110,1.02663298106854,1.21322357948116,0.837755864560499
"716","경남","함양군",2020,216,105,111,"4",2018,228,119,109,0.968218586697645,0.90018594466851,1.04271142775573
"717","경남","합천군",2010,258,142,116,"4",2008,324,158,166,0.813821589847712,0.916898257565309,0.715513040949931
"718","경남","합천군",2011,244,112,132,"4",2009,277,136,141,0.900252981935476,0.840173548357276,0.958566993965205
"719","경남","합천군",2012,214,105,109,"4",2010,253,135,118,0.864465694666804,0.793497240115205,0.945827948783463
"720","경남","합천군",2013,205,107,98,"4",2011,311,159,152,0.673671203141716,0.686556911258708,0.660161419587879
"721","경남","합천군",2014,273,146,127,"4",2012,286,160,126,0.975553575990809,0.930942297778017,1.03205021410143
"722","경남","합천군",2015,226,120,106,"4",2013,258,120,138,0.895247762980122,1.02021073729098,0.786492220674349
"723","경남","합천군",2016,210,101,109,"4",2014,230,117,113,0.933138203121643,0.880694739028964,0.987678742977422
"724","경남","합천군",2017,165,85,80,"4",2015,262,131,131,0.643631312403969,0.661968799005596,0.625296998145241
"725","경남","합천군",2018,212,109,103,"4",2016,240,121,119,0.902774182226415,0.919032812931542,0.886253402938418
"726","경남","합천군",2019,177,97,80,"4",2017,227,117,110,0.796896501973612,0.84581573946346,0.744671879609332
"727","경남","합천군",2020,183,95,88,"4",2018,187,94,93,1.00014736362083,1.03106404300684,0.968874165943325
"728","경북","경산시",2010,2359,1274,1085,"4",2008,2622,1359,1263,0.919495831730976,0.956400647026274,0.879617862543288
"729","경북","경산시",2011,2320,1193,1127,"4",2009,2246,1158,1088,1.05568109482616,1.05104612226955,1.06062698661729
"730","경북","경산시",2012,2048,1052,996,"4",2010,2237,1177,1060,0.935660896179873,0.91186210333909,0.962102018042434
"731","경북","경산시",2013,2128,1139,989,"4",2011,2574,1328,1246,0.844923894875231,0.875015082661464,0.812729271495779
"732","경북","경산시",2014,2386,1227,1159,"4",2012,2335,1220,1115,1.04433074968715,1.02606440545576,1.06432979743715
"733","경북","경산시",2015,2156,1132,1024,"4",2013,2306,1191,1115,0.95552920365911,0.969671330489829,0.94035695649322
"734","경북","경산시",2016,2155,1109,1046,"4",2014,2369,1176,1193,0.929686929138761,0.962086486101781,0.897757192663975
"735","경북","경산시",2017,2164,1102,1062,"4",2015,2441,1265,1176,0.906032942115262,0.888752752960204,0.924665911734292
"736","경북","경산시",2018,2342,1220,1122,"4",2016,2540,1272,1268,0.94234012840927,0.978504009036944,0.906027241535723
"737","경북","경산시",2019,2437,1241,1196,"4",2017,2322,1194,1128,1.07262477796586,1.06036978641382,1.08564973937726
"738","경북","경산시",2020,2228,1130,1098,"4",2018,2380,1188,1192,0.956737376565936,0.970402468972058,0.943178162953179
"739","경북","경주시",2010,2304,1208,1096,"4",2008,2280,1248,1032,1.03276649247749,0.987511675198318,1.08742298698766
"740","경북","경주시",2011,2130,1134,996,"4",2009,2070,1079,991,1.05163194320058,1.07221406495641,1.02908994866295
"741","경북","경주시",2012,1947,1026,921,"4",2010,2136,1102,1034,0.93157798006934,0.949851376098497,0.912025001489621
"742","경북","경주시",2013,2046,1061,985,"4",2011,2302,1194,1108,0.908353348278894,0.906569172751865,0.910257199409647
"743","경북","경주시",2014,2153,1109,1044,"4",2012,2099,1083,1016,1.04830124731461,1.04470333116869,1.05214220785354
"744","경북","경주시",2015,1973,1007,966,"4",2013,1936,1011,925,1.04154069557893,1.01617429520476,1.06930856658497
"745","경북","경주시",2016,1909,990,919,"4",2014,1995,1014,981,0.977952001061272,0.996063737591783,0.959211013120635
"746","경북","경주시",2017,1946,992,954,"4",2015,1965,1011,954,1.01212649207121,1.00103763738145,1.02392383446283
"747","경북","경주시",2018,1939,993,946,"4",2016,2028,1024,1004,0.977157049981589,0.98932545129877,0.964772855977927
"748","경북","경주시",2019,1984,1010,974,"4",2017,1808,944,864,1.12149606207456,1.09153903036429,1.15428450783194
"749","경북","경주시",2020,1768,941,827,"4",2018,1766,926,840,1.02316593570993,1.03673682914774,1.00807739416757
"750","경북","고령군",2010,209,106,103,"4",2008,241,135,106,0.88630613365061,0.801054356687731,0.994944858015771
"751","경북","고령군",2011,205,117,88,"4",2009,218,126,92,0.961063046683824,0.947338541770194,0.979405406877491
"752","경북","고령군",2012,193,115,78,"4",2010,253,125,128,0.779634948928473,0.9385938783077,0.623953586625788
"753","경북","고령군",2013,230,112,118,"4",2011,276,153,123,0.851673756817373,0.746820931873134,0.982300914362717
"754","경북","고령군",2014,247,128,119,"4",2012,246,139,107,1.02616301431166,0.939474635778742,1.13875641402876
"755","경북","고령군",2015,230,131,99,"4",2013,234,124,110,1.00453827727177,1.07780327891224,0.921531451016549
"756","경북","고령군",2016,213,114,99,"4",2014,236,119,117,0.922405984078477,0.977344739925811,0.866397090699319
"757","경북","고령군",2017,191,99,92,"4",2015,214,101,113,0.912166472254868,1.00000854447333,0.83363710416443
"758","경북","고령군",2018,160,76,84,"4",2016,235,123,112,0.695835580038024,0.63037411409849,0.767942875847124
"759","경북","고령군",2019,188,100,88,"4",2017,203,100,103,0.946490638118223,1.02021073729098,0.874808712939119
"760","경북","고령군",2020,153,76,77,"4",2018,204,105,99,0.766506381135636,0.738438247943946,0.796385204582203
"761","경북","구미시",2010,4998,2687,2311,"4",2008,4706,2482,2224,1.0854225507624,1.10447471841292,1.06397840892248
"762","경북","구미시",2011,4722,2489,2233,"4",2009,4450,2319,2131,1.08447734283819,1.09499979522089,1.0729337974451
"763","경북","구미시",2012,4463,2284,2179,"4",2010,4516,2329,2187,1.01001416563577,1.00049863631284,1.02017834261295
"764","경북","구미시",2013,4506,2346,2160,"4",2011,5086,2632,2454,0.905460152941978,0.909351971764679,0.901253252827921
"765","경북","구미시",2014,4962,2582,2380,"4",2012,4845,2474,2371,1.04668858980255,1.06474701846617,1.02781051287286
"766","경북","구미시",2015,4723,2422,2301,"4",2013,4516,2347,2169,1.06885433661163,1.05281227342086,1.08623731816458
"767","경북","구미시",2016,4405,2311,2094,"4",2014,4744,2472,2272,0.948977124480741,0.953764973252205,0.943704449544529
"768","경북","구미시",2017,4667,2411,2256,"4",2015,4977,2619,2358,0.958351156857548,0.939185982286578,0.979631963760877
"769","경북","구미시",2018,4998,2616,2382,"4",2016,5214,2680,2534,0.979669835805116,0.995847495803432,0.962504567360089
"770","경북","구미시",2019,5161,2660,2501,"4",2017,4626,2405,2221,1.1402044770258,1.12838276972724,1.15300923457521
"771","경북","구미시",2020,4552,2362,2190,"4",2018,4812,2503,2309,0.966787765843561,0.962739816812341,0.971153398645995
"772","경북","군위군",2010,77,43,34,"4",2008,97,49,48,0.811285104432219,0.895286973541062,0.725279382744506
"773","경북","군위군",2011,68,36,32,"4",2009,101,57,44,0.688084936200967,0.644343623552197,0.744671879609332
"774","경북","군위군",2012,77,42,35,"4",2010,92,47,45,0.85537668619484,0.911677680132363,0.796385204582203
"775","경북","군위군",2013,77,37,40,"4",2011,104,57,47,0.756679376249281,0.662242057539758,0.871424539968368
"776","경북","군위군",2014,80,43,37,"4",2012,101,54,47,0.809511689648196,0.812390031546519,0.80606769947074
"777","경북","군위군",2015,93,52,41,"4",2013,76,47,29,1.25061567448446,1.12874379444959,1.44761645561987
"778","경북","군위군",2016,70,39,31,"4",2014,85,40,45,0.841654065560698,0.994705468858703,0.705369752629951
"779","경북","군위군",2017,78,38,40,"4",2015,96,49,47,0.830381912896938,0.791183837082799,0.871424539968368
"780","경북","군위군",2018,79,43,36,"4",2016,111,56,55,0.727375424741324,0.783376101848429,0.670204691648399
"781","경북","군위군",2019,87,50,37,"4",2017,74,44,30,1.20155054340181,1.1593303832852,1.26283939583749
"782","경북","군위군",2020,66,44,22,"4",2018,79,43,36,0.853829892910581,1.04393656839077,0.625731232171731
"783","경북","김천시",2010,1026,547,479,"4",2008,1127,587,540,0.930417683579015,0.950690414477283,0.908258364273512
"784","경북","김천시",2011,1002,513,489,"4",2009,972,480,492,1.05355198065556,1.09035022547973,1.01768039644781
"785","경북","김천시",2012,913,452,461,"4",2010,963,535,428,0.96894472270936,0.86193505281406,1.10287123291441
"786","경북","김천시",2013,884,503,381,"4",2011,1104,565,539,0.818347392420171,0.908258408597101,0.723775474824377
"787","경북","김천시",2014,1028,538,490,"4",2012,1101,593,508,0.954245909545787,0.925587481724361,0.987643068674779
"788","경북","김천시",2015,1077,577,500,"4",2013,1010,515,495,1.08980511218888,1.14303222411047,1.03426649945741
"789","경북","김천시",2016,1021,528,493,"4",2014,1102,548,554,0.946888100592237,0.982976768776709,0.91118131839382
"790","경북","김천시",2017,1130,568,562,"4",2015,1157,608,549,0.998158698569021,0.953091609837624,1.04816975404028
"791","경북","김천시",2018,1131,605,526,"4",2016,1303,655,648,0.887100247699569,0.942332055055025,0.831148050813965
"792","경북","김천시",2019,1228,630,598,"4",2017,1184,628,556,1.05998855409297,1.02345981607216,1.10127059893664
"793","경북","김천시",2020,1118,602,516,"4",2018,1158,587,571,0.986705969038158,1.04628085834611,0.9252971954165
"794","경북","문경시",2010,518,283,235,"4",2008,452,245,207,1.17123983902141,1.17844750470754,1.16242560917278
"795","경북","문경시",2011,485,259,226,"4",2009,494,265,229,1.00338891997512,0.997111626257975,1.01050998510306
"796","경북","문경시",2012,485,256,229,"4",2010,447,252,195,1.10889066323873,1.03640455851782,1.20245414406148
"797","경북","문경시",2013,464,257,207,"4",2011,536,296,240,0.884723783201331,0.885791079337099,0.883134307224193
"798","경북","문경시",2014,507,279,228,"4",2012,478,248,230,1.08401320846797,1.14773707945235,1.01502014894576
"799","경북","문경시",2015,484,256,228,"4",2013,455,242,213,1.08714751199897,1.07923119316732,1.09603114674895
"800","경북","문경시",2016,456,249,207,"4",2014,497,263,234,0.937697947143796,0.965902941389557,0.905778776640197
"801","경북","문경시",2017,464,238,226,"4",2015,564,305,259,0.840801325879279,0.796098870410665,0.893462496481081
"802","경북","문경시",2018,513,278,235,"4",2016,535,286,249,0.979981990087429,0.991673374010111,0.966353819673757
"803","경북","문경시",2019,486,256,230,"4",2017,471,254,217,1.05455654984266,1.02824389270272,1.08526489367028
"804","경북","문경시",2020,415,223,192,"4",2018,418,211,207,1.01467351888768,1.07823220102317,0.949726455153931
"805","경북","봉화군",2010,192,99,93,"4",2008,198,106,92,0.991038553387488,0.952838330111385,1.03505344135917
"806","경북","봉화군",2011,186,98,88,"4",2009,164,87,77,1.15910721049779,1.14920289947719,1.17019866795752
"807","경북","봉화군",2012,140,69,71,"4",2010,190,98,92,0.753058900764835,0.718311641562015,0.790202089639794
"808","경북","봉화군",2013,171,88,83,"4",2011,214,91,123,0.816651658406191,0.986577416281385,0.690940473661911
"809","경북","봉화군",2014,186,80,106,"4",2012,217,121,96,0.876007292726441,0.674519495729572,1.13058256721938
"810","경북","봉화군",2015,175,102,73,"4",2013,194,108,86,0.921914891400249,0.963532362997035,0.869144650183567
"811","경북","봉화군",2016,157,91,66,"4",2014,234,123,111,0.685706563181167,0.754790057670561,0.60881957724817
"812","경북","봉화군",2017,177,89,88,"4",2015,218,103,115,0.829795898844083,0.881541316688321,0.783524325501993
"813","경북","봉화군",2018,160,82,78,"4",2016,208,106,102,0.786160390908344,0.789219626960945,0.783000579295107
"814","경북","봉화군",2019,141,78,63,"4",2017,175,89,86,0.823446855162854,0.89411727537861,0.750083739199516
"815","경북","봉화군",2020,132,69,63,"4",2018,186,95,91,0.725296360644472,0.740995167085026,0.708870346935807
"816","경북","상주시",2010,696,359,337,"4",2008,658,347,311,1.0810302761305,1.05549180025205,1.10952518396776
"817","경북","상주시",2011,634,336,298,"4",2009,669,334,335,0.968540200577963,1.02631978362206,0.910833739313206
"818","경북","상주시",2012,650,329,321,"4",2010,642,351,291,1.034743816694,0.956265904754221,1.12948299265488
"819","경북","상주시",2013,619,331,288,"4",2011,705,387,318,0.897337966757368,0.872583343781172,0.927327246305961
"820","경북","상주시",2014,703,379,324,"4",2012,691,363,328,1.03975684696257,1.06517870367295,1.0114369584328
"821","경북","상주시",2015,712,372,340,"4",2013,668,344,324,1.08932643386941,1.10325114614024,1.0744879744363
"822","경북","상주시",2016,658,339,319,"4",2014,661,357,304,1.01737004293948,0.968771540452777,1.07444639208435
"823","경북","상주시",2017,637,348,289,"4",2015,617,316,301,1.05513682287066,1.12352321701665,0.983102950696872
"824","경북","상주시",2018,609,305,304,"4",2016,638,348,290,0.975553575990809,0.894150215154449,1.07335464026449
"825","경북","상주시",2019,606,320,286,"4",2017,593,301,292,1.04441341645463,1.08460942170469,1.00288430361771
"826","경북","상주시",2020,564,288,276,"4",2018,547,288,259,1.05377111263985,1.02021073729098,1.09113119039282
"827","경북","성주군",2010,227,131,96,"4",2008,235,142,93,0.987216729178946,0.941180328064212,1.05695363557454
"828","경북","성주군",2011,214,141,73,"4",2009,230,119,111,0.950912264133484,1.20882112569771,0.673391350592673
"829","경북","성주군",2012,196,100,96,"4",2010,226,121,105,0.886343661962151,0.843149369661965,0.936158934366018
"830","경북","성주군",2013,207,118,89,"4",2011,234,112,122,0.904084449544596,1.07486488393157,0.746960830058951
"831","경북","성주군",2014,203,107,96,"4",2012,223,121,102,0.930348552290189,0.902169825538303,0.963693020670901
"832","경북","성주군",2015,207,114,93,"4",2013,230,125,105,0.919807657362763,0.930432192409372,0.90690396766708
"833","경북","성주군",2016,218,126,92,"4",2014,229,111,118,0.972916396434169,1.15807705314111,0.798313498055767
"834","경북","성주군",2017,178,84,94,"4",2015,241,117,124,0.754844458324443,0.732458990875574,0.77620032612505
"835","경북","성주군",2018,192,92,100,"4",2016,256,125,131,0.766506381135636,0.75087510264616,0.781621247681551
"836","경북","성주군",2019,193,94,99,"4",2017,210,106,104,0.939274486090017,0.904715182125961,0.974696727036734
"837","경북","성주군",2020,162,80,82,"4",2018,202,102,100,0.819630585768798,0.800165284149787,0.839617544259522
"838","경북","안동시",2010,1370,700,670,"4",2008,1355,707,648,1.03332225550388,1.01010964088216,1.05868668069459
"839","경북","안동시",2011,1374,718,656,"4",2009,1282,680,602,1.09535077241847,1.07722251378665,1.11577082293624
"840","경북","안동시",2012,1267,669,598,"4",2010,1278,653,625,1.01321187782874,1.04520824387085,0.979690324814038
"841","경북","안동시",2013,1244,635,609,"4",2011,1445,760,685,0.879846771056729,0.852412918657593,0.910320606113671
"842","경북","안동시",2014,1391,726,665,"4",2012,1361,685,676,1.04453624899306,1.08127444565438,1.00726235194938
"843","경북","안동시",2015,1318,674,644,"4",2013,1314,669,645,1.02511964519205,1.02783563069375,1.02233635564971
"844","경북","안동시",2016,1302,665,637,"4",2014,1377,728,649,0.966343556754875,0.931923269640797,1.00499149854056
"845","경북","안동시",2017,1407,743,664,"4",2015,1407,738,669,1.02200850818085,1.02712273415609,1.01627118996012
"846","경북","안동시",2018,1473,776,697,"4",2016,1466,771,695,1.02688849423628,1.02682688993229,1.02687037787136
"847","경북","안동시",2019,1424,759,665,"4",2017,1296,679,617,1.12294762009994,1.14041229691289,1.10358079403206
"848","경북","안동시",2020,1315,686,629,"4",2018,1067,545,522,1.25955125422476,1.28415516657176,1.23380860512858
"849","경북","영덕군",2010,245,125,120,"4",2008,243,128,115,1.03042010084077,0.996299548135721,1.06844226204817
"850","경북","영덕군",2011,212,109,103,"4",2009,230,124,106,0.942025233627564,0.896798148102553,0.994944858015771
"851","경북","영덕군",2012,200,99,101,"4",2010,227,108,119,0.90044802482894,0.935193175850063,0.869044598997866
"852","경북","영덕군",2013,205,99,106,"4",2011,237,128,109,0.884015798215501,0.789069242123491,0.995742444523488
"853","경북","영덕군",2014,216,118,98,"4",2012,172,86,86,1.28345254515734,1.39982403488762,1.16679692764369
"854","경북","영덕군",2015,168,86,82,"4",2013,211,112,99,0.813731892769585,0.783376101848429,0.848098529555073
"855","경북","영덕군",2016,191,98,93,"4",2014,198,99,99,0.985876894255262,1.00990557832844,0.961867844495388
"856","경북","영덕군",2017,203,106,97,"4",2015,211,106,105,0.983259370429915,1.02021073729098,0.94591058993233
"857","경북","영덕군",2018,186,94,92,"4",2016,194,101,93,0.979863827431122,0.949503062429227,1.01291390075893
"858","경북","영덕군",2019,174,87,87,"4",2017,201,106,95,0.884723783201331,0.837342774946369,0.937698669455436
"859","경북","영덕군",2020,169,88,81,"4",2018,214,108,106,0.807100177021323,0.831282822977834,0.782432364070655
"860","경북","영양군",2010,104,52,52,"4",2008,76,39,37,1.39853795856326,1.36028098305464,1.43902809167749
"861","경북","영양군",2011,75,34,41,"4",2009,101,52,49,0.758917209045184,0.667060866690255,0.856752596183186
"862","경북","영양군",2012,95,51,44,"4",2010,82,47,35,1.18403424728269,1.10703718301787,1.28721853475327
"863","경북","영양군",2013,87,45,42,"4",2011,115,56,59,0.773171654015076,0.819812199608821,0.72889493300744
"864","경북","영양군",2014,107,56,51,"4",2012,105,51,54,1.0414753369081,1.1202313978097,0.967039176992675
"865","경북","영양군",2015,105,54,51,"4",2013,79,43,36,1.35836573872138,1.28119487938867,1.45055876548901
"866","경북","영양군",2016,81,45,36,"4",2014,95,50,45,0.87139672802788,0.91818966356188,0.819139067570266
"867","경북","영양군",2017,93,46,47,"4",2015,88,56,32,1.0800771734184,0.838030248489018,1.50388813186728
"868","경북","영양군",2018,71,45,26,"4",2016,91,51,40,0.797391253635606,0.90018594466851,0.665550492400841
"869","경북","영양군",2019,70,42,28,"4",2017,95,54,41,0.753058900764835,0.793497240115205,0.699265057681934
"870","경북","영양군",2020,77,46,31,"4",2018,93,37,56,0.846179087418551,1.26837010582122,0.566814979791925
"871","경북","영주시",2010,937,471,466,"4",2008,868,456,412,1.10325112000628,1.05377030101765,1.15812744383417
"872","경북","영주시",2011,874,463,411,"4",2009,850,460,390,1.05086521900007,1.02686428557766,1.07905819478006
"873","경북","영주시",2012,836,461,375,"4",2010,837,435,402,1.02078747053666,1.08118885032446,0.955152830655627
"874","경북","영주시",2013,826,440,386,"4",2011,868,427,441,0.972556483591452,1.05127101734902,0.896223582999213
"875","경북","영주시",2014,840,419,421,"4",2012,785,394,391,1.09361419983683,1.08494492112924,1.10248576549579
"876","경북","영주시",2015,816,402,414,"4",2013,769,381,388,1.08447196706836,1.07644282517316,1.09253728728766
"877","경북","영주시",2016,787,396,391,"4",2014,787,401,386,1.02200850818085,1.00748990515518,1.03718709656727
"878","경북","영주시",2017,830,427,403,"4",2015,772,389,383,1.0987915308162,1.11987142628084,1.07739244200658
"879","경북","영주시",2018,809,403,406,"4",2016,836,437,399,0.98900105636161,0.940835073520055,1.04188741050604
"880","경북","영주시",2019,845,445,400,"4",2017,705,365,340,1.2249605523586,1.24381857012188,1.20461627583863
"881","경북","영주시",2020,666,333,333,"4",2018,677,381,296,1.0054027569401,0.891680250703138,1.15191431377069
"882","경북","영천시",2010,728,393,335,"4",2008,750,407,343,0.992029591940876,0.985117493256399,1.00004222899431
"883","경북","영천시",2011,648,352,296,"4",2009,634,305,329,1.04457651940251,1.1774235394309,0.92122022796656
"884","경북","영천시",2012,579,279,300,"4",2010,642,329,313,0.921717953639736,0.865163512778671,0.981396646449999
"885","경북","영천시",2013,568,292,276,"4",2011,722,379,343,0.804017773748922,0.786019882028933,0.82391538866397
"886","경북","영천시",2014,644,348,296,"4",2012,622,333,289,1.05815671908113,1.06616617590769,1.04872475778892
"887","경북","영천시",2015,578,313,265,"4",2013,614,343,271,0.962086185225619,0.930979477469609,1.00125393406882
"888","경북","영천시",2016,577,325,252,"4",2014,642,333,309,0.918534126511447,0.995701170028732,0.835044680532795
"889","경북","영천시",2017,615,324,291,"4",2015,635,319,316,0.989819263828695,1.03620150119836,0.942917201989507
"890","경북","영천시",2018,552,274,278,"4",2016,671,338,333,0.840758117013156,0.82703473969742,0.854807285227229
"891","경북","영천시",2019,610,291,319,"4",2017,599,307,292,1.0407766110022,0.967040145119461,1.1186017232659
"892","경북","영천시",2020,542,271,271,"4",2018,583,304,279,0.950134839509467,0.909464176992944,0.994564011252428
"893","경북","예천군",2010,233,124,109,"4",2008,269,146,123,0.885234135338801,0.866480352219735,0.90737965818251
"894","경북","예천군",2011,232,129,103,"4",2009,227,118,109,1.04451970880157,1.11531512805539,0.967561054584144
"895","경북","예천군",2012,211,104,107,"4",2010,260,145,115,0.829399212408303,0.731737356401805,0.952694350326287
"896","경북","예천군",2013,253,139,114,"4",2011,287,148,139,0.900934329511339,0.958170895158418,0.839764871429948
"897","경북","예천군",2014,248,141,107,"4",2012,274,159,115,0.925029598645439,0.904715182125961,0.952694350326287
"898","경북","예천군",2015,243,144,99,"4",2013,275,150,125,0.903083881774349,0.979402307799339,0.810947676894563
"899","경북","예천군",2016,243,138,105,"4",2014,263,139,124,0.94428922999219,1.01287109169896,0.867032279182237
"900","경북","예천군",2017,208,108,100,"4",2015,295,150,145,0.720602609158021,0.734551730849504,0.706154368595057
"901","경북","예천군",2018,219,108,111,"4",2016,325,169,156,0.688676502435709,0.651968991878258,0.728561189906246
"902","경북","예천군",2019,367,210,157,"4",2017,393,201,192,0.954394713746491,1.06589181508013,0.837271052138878
"903","경북","예천군",2020,394,204,190,"4",2018,422,221,201,0.954197517116715,0.941732988268595,0.967888201731035
"904","경북","울릉군",2010,58,31,27,"4",2008,61,35,26,0.971745794663757,0.903615224457723,1.06330552040371
"905","경북","울릉군",2011,48,29,19,"4",2009,64,37,27,0.766506381135636,0.799624631930766,0.720538994621993
"906","경북","울릉군",2012,57,27,30,"4",2010,63,34,29,0.924674364544576,0.810167350201659,1.05923155289258
"907","경북","울릉군",2013,51,25,26,"4",2011,64,24,40,0.814413029956613,1.06271951801144,0.665550492400841
"908","경북","울릉군",2014,54,19,35,"4",2012,58,31,27,0.951525162789065,0.625290451888019,1.32730867430367
"909","경북","울릉군",2015,57,32,25,"4",2013,52,24,28,1.12027855704439,1.36028098305464,0.914217709341814
"910","경북","울릉군",2016,41,21,20,"4",2014,40,21,19,1.04755872088537,1.02021073729098,1.07781456259245
"911","경북","울릉군",2017,40,22,18,"4",2015,56,34,22,0.730006077272034,0.660136359423574,0.837755864560499
"912","경북","울릉군",2018,50,29,21,"4",2016,51,25,26,1.0019691256675,1.18344445525753,0.827015404758441
"913","경북","울릉군",2019,50,20,30,"4",2017,50,20,30,1.02200850818085,1.02021073729098,1.02392383446283
"914","경북","울릉군",2020,50,22,28,"4",2018,49,27,22,1.04286582467433,0.831282822977834,1.30317578931633
"915","경북","울진군",2010,396,186,210,"4",2008,423,205,218,0.956773922552283,0.925654620176204,0.98634864787704
"916","경북","울진군",2011,413,205,208,"4",2009,409,202,207,1.03200370141489,1.03536238190421,1.02887032641676
"917","경북","울진군",2012,397,191,206,"4",2010,379,214,165,1.07054717083851,0.910561919731667,1.27835339332935
"918","경북","울진군",2013,362,196,166,"4",2011,427,241,186,0.866433442532709,0.829714956469011,0.913824497423818
"919","경북","울진군",2014,400,220,180,"4",2012,406,206,200,1.00690493416832,1.08954544759231,0.921531451016549
"920","경북","울진군",2015,368,189,179,"4",2013,394,202,192,0.954566322361807,0.954553610633638,0.954595658171078
"921","경북","울진군",2016,332,169,163,"4",2014,369,184,185,0.919530690287375,0.937041383707474,0.902159919013198
"922","경북","울진군",2017,335,181,154,"4",2015,397,195,202,0.862400126550589,0.94696483820342,0.78061520053107
"923","경북","울진군",2018,343,166,177,"4",2016,391,218,173,0.896544548097265,0.776857717386708,1.04759837398798
"924","경북","울진군",2019,330,185,145,"4",2017,363,189,174,0.92909864380077,0.99861897565519,0.85326986205236
"925","경북","울진군",2020,299,148,151,"4",2018,340,159,181,0.898766305723745,0.94963012024569,0.854212701678937
"926","경북","의성군",2010,231,123,108,"4",2008,257,139,118,0.918614651322085,0.902776407818635,0.937150628152422
"927","경북","의성군",2011,223,123,100,"4",2009,237,125,112,0.961636697571008,1.00388736549432,0.914217709341814
"928","경북","의성군",2012,214,115,99,"4",2010,222,107,115,0.985179372750907,1.09648817559311,0.881464866189742
"929","경북","의성군",2013,217,110,107,"4",2011,243,111,132,0.912657803601827,1.01101964956764,0.829998865814568
"930","경북","의성군",2014,225,105,120,"4",2012,251,153,98,0.916143085022672,0.700144623631063,1.25378428709735
"931","경북","의성군",2015,220,135,85,"4",2013,216,104,112,1.04093459166568,1.32431201475271,0.777085052940542
"932","경북","의성군",2016,193,95,98,"4",2014,216,114,102,0.913183528143072,0.850175614409148,0.983769958601544
"933","경북","의성군",2017,192,104,88,"4",2015,220,107,113,0.89193469804874,0.991606697927679,0.79739201267902
"934","경북","의성군",2018,183,88,95,"4",2016,209,109,100,0.894868693766005,0.823656375060606,0.97272764273969
"935","경북","의성군",2019,177,90,87,"4",2017,207,110,97,0.873891333082174,0.834717875965346,0.918364676270787
"936","경북","의성군",2020,162,83,79,"4",2018,202,108,94,0.819630585768798,0.784050844399548,0.860531733218763
"937","경북","청도군",2010,181,90,91,"4",2008,224,122,102,0.825819374913988,0.75261447832941,0.913500675844291
"938","경북","청도군",2011,198,110,88,"4",2009,183,98,85,1.105779697376,1.14513450104089,1.06006232273799
"939","경북","청도군",2012,163,80,83,"4",2010,200,104,96,0.832936934167391,0.784777490223829,0.885267481879323
"940","경북","청도군",2013,184,98,86,"4",2011,246,107,139,0.764429128070227,0.934398619201082,0.633506832833119
"941","경북","청도군",2014,216,102,114,"4",2012,182,97,85,1.2129331745443,1.07279891962556,1.37326255445603
"942","경북","청도군",2015,176,92,84,"4",2013,182,91,91,0.988315919999061,1.03142184429418,0.945160462581076
"943","경북","청도군",2016,175,82,93,"4",2014,195,103,92,0.917187122726402,0.812206606386992,1.03505344135917
"944","경북","청도군",2017,182,97,85,"4",2015,205,96,109,0.907344138970313,1.03083793247109,0.79847271494808
"945","경북","청도군",2018,174,83,91,"4",2016,195,103,92,0.911946053453679,0.822111565001468,1.0127942275665
"946","경북","청도군",2019,183,98,85,"4",2017,158,77,81,1.18371871517149,1.29845002927943,1.0744879744363
"947","경북","청도군",2020,145,74,71,"4",2018,166,87,79,0.89271827521821,0.867765454707269,0.920235344896976
"948","경북","청송군",2010,151,85,66,"4",2008,144,78,66,1.07168947732853,1.11176811115042,1.02392383446283
"949","경북","청송군",2011,121,61,60,"4",2009,142,67,75,0.870866404858328,0.928848581712681,0.819139067570266
"950","경북","청송군",2012,120,62,58,"4",2010,130,66,64,0.943392469090013,0.958379783515767,0.927930974981941
"951","경북","청송군",2013,118,58,60,"4",2011,132,59,73,0.913613666404091,1.00291902987927,0.841581233805067
"952","경북","청송군",2014,125,63,62,"4",2012,140,85,55,0.912507596590042,0.756156193521548,1.15424141339446
"953","경북","청송군",2015,123,74,49,"4",2013,112,54,58,1.12238434380575,1.39806656591727,0.865039101528944
"954","경북","청송군",2016,106,49,57,"4",2014,101,53,48,1.07260298878386,0.9432137005143,1.21590955342461
"955","경북","청송군",2017,98,50,48,"4",2015,121,67,54,0.827742428113414,0.761351296485804,0.910154519522517
"956","경북","청송군",2018,116,64,52,"4",2016,130,67,63,0.911946053453679,0.974529659501829,0.845143482413766
"957","경북","청송군",2019,115,59,56,"4",2017,127,62,65,0.925440775124389,0.970845701615608,0.882149765075671
"958","경북","청송군",2020,104,45,59,"4",2018,113,49,64,0.940609600449629,0.936928228124367,0.943929784895423
"959","경북","칠곡군",2010,1282,655,627,"4",2008,1384,746,638,0.946687071884282,0.895761438238057,1.00626997524796
"960","경북","칠곡군",2011,1207,666,541,"4",2009,1348,710,638,0.91510702475837,0.956986409909565,0.868248894113467
"961","경북","칠곡군",2012,1153,616,537,"4",2010,1353,698,655,0.87093555796934,0.9003578999588,0.839461220009986
"962","경북","칠곡군",2013,1214,633,581,"4",2011,1472,771,701,0.842879299545889,0.837604924390647,0.84864443341356
"963","경북","칠곡군",2014,1316,709,607,"4",2012,1340,697,643,1.00370387818358,1.03777534108939,0.966596839065224
"964","경북","칠곡군",2015,1235,635,600,"4",2013,1275,656,619,0.989945496159488,0.987551552103309,0.992494831466396
"965","경북","칠곡군",2016,1212,623,589,"4",2014,1322,705,617,0.936969978755815,0.901547928130893,0.977457274714113
"966","경북","칠곡군",2017,1223,651,572,"4",2015,1387,676,711,0.901165396903516,0.982481050260986,0.823747444884304
"967","경북","칠곡군",2018,1206,591,615,"4",2016,1377,724,653,0.895092418929631,0.832796333893602,0.964338680236817
"968","경북","칠곡군",2019,1244,649,595,"4",2017,1228,661,567,1.03532457994868,1.00168951361852,1.07448797443631
"969","경북","칠곡군",2020,1123,600,523,"4",2018,1102,596,506,1.04148416940752,1.02705778921911,1.05832443759696
"970","경북","포항시",2010,4670,2451,2219,"4",2008,4395,2336,2059,1.08595670835144,1.07043515286823,1.10349052388199
"971","경북","포항시",2011,4461,2357,2104,"4",2009,4260,2248,2012,1.07023003638375,1.06967825079841,1.07074341337465
"972","경북","포항시",2012,4263,2245,2018,"4",2010,4272,2239,2033,1.01985540036867,1.02294466512651,1.01636905949139
"973","경북","포항시",2013,4337,2271,2066,"4",2011,4631,2385,2246,0.95712608507457,0.971445947332415,0.941864043633219
"974","경북","포항시",2014,4684,2428,2256,"4",2012,4508,2299,2209,1.06190946147273,1.07745614186276,1.04570944796204
"975","경북","포항시",2015,4423,2262,2161,"4",2013,4435,2331,2104,1.01924320894789,0.990011449057139,1.05166321590978
"976","경북","포항시",2016,4355,2275,2080,"4",2014,4845,2490,2355,0.918647482585674,0.93212025194256,0.904357356977788
"977","경북","포항시",2017,4712,2432,2280,"4",2015,4797,2535,2262,1.00389912248242,0.97875838780736,1.03207176948508
"978","경북","포항시",2018,4691,2485,2206,"4",2016,5070,2673,2397,0.945609844551549,0.9484562971074,0.942334576063833
"979","경북","포항시",2019,4866,2559,2307,"4",2017,4588,2363,2225,1.08393491735135,1.1048325335284,1.06165945442955
"980","경북","포항시",2020,4488,2298,2190,"4",2018,4468,2324,2144,1.02658330007065,1.00879701992025,1.04589234956791
"981","광주","광산구",2010,5399,2796,2603,"4",2008,4443,2290,2153,1.24191400757785,1.24563721461379,1.23793485420657
"982","광주","광산구",2011,5118,2683,2435,"4",2009,4553,2372,2181,1.14883363603549,1.1539736122056,1.14317035163549
"983","광주","광산구",2012,4901,2544,2357,"4",2010,4967,2622,2345,1.00842836694068,0.989861218790331,1.029163529991
"984","광주","광산구",2013,5131,2682,2449,"4",2011,5626,2946,2680,0.932087745374321,0.928786557167143,0.935667712910252
"985","광주","광산구",2014,5817,3039,2778,"4",2012,5297,2672,2625,1.12233783124183,1.16033698751021,1.08360396652867
"986","광주","광산구",2015,5397,2739,2658,"4",2013,5186,2608,2578,1.06359042010259,1.07145598521472,1.0556980418938
"987","광주","광산구",2016,5163,2606,2557,"4",2014,5470,2818,2652,0.964648981304884,0.943459610142047,0.987244813243387
"988","광주","광산구",2017,5323,2737,2586,"4",2015,5269,2762,2507,1.03248268913392,1.01097638956025,1.05618948381368
"989","광주","광산구",2018,5100,2664,2436,"4",2016,5367,2794,2573,0.971165155901308,0.972742091676151,0.969404765157971
"990","광주","광산구",2019,5395,2820,2575,"4",2017,4692,2357,2335,1.17513552890786,1.2206170043108,1.12916654121704
"991","광주","광산구",2020,4616,2337,2279,"4",2018,4524,2333,2191,1.04279205874509,1.0219599198667,1.06504902726645
"992","광주","남구",2010,1931,1029,902,"4",2008,1634,857,777,1.20777137655888,1.2249671513097,1.18864774605595
"993","광주","남구",2011,1908,1008,900,"4",2009,1574,818,756,1.23887689555849,1.25717900145392,1.21895694578909
"994","광주","남구",2012,1764,923,841,"4",2010,1716,874,842,1.05059615875933,1.07740790677297,1.02270777290171
"995","광주","남구",2013,1941,990,951,"4",2011,1855,968,887,1.06939003470567,1.04339734495668,1.09780334450299
"996","광주","남구",2014,2074,1054,1020,"4",2012,1804,923,881,1.17496987027,1.16500771083932,1.18547367894675
"997","광주","남구",2015,2076,1076,1000,"4",2013,1719,869,850,1.23425809364947,1.26322986573658,1.20461627583863
"998","광주","남구",2016,1985,1030,955,"4",2014,1971,1007,964,1.02926782787366,1.04351247210497,1.01436437957677
"999","광주","남구",2017,2240,1143,1097,"4",2015,1985,993,992,1.15329927371541,1.17432112056756,1.13230286936061
"1000","광주","남구",2018,2195,1123,1072,"4",2016,2059,1076,983,1.08951368404903,1.06477384570425,1.11662904429721
"1001","광주","남구",2019,2317,1205,1112,"4",2017,1839,942,897,1.28765291650627,1.30504664377455,1.26934593525381
"1002","광주","남구",2020,2173,1101,1072,"4",2018,1876,970,906,1.18380836262099,1.15799177500759,1.21153018823858
"1003","광주","동구",2010,810,460,350,"4",2008,766,405,361,1.08071395773693,1.15875787445395,0.992723939229892
"1004","광주","동구",2011,742,361,381,"4",2009,615,325,290,1.23305741962632,1.13321869588321,1.34522407217358
"1005","광주","동구",2012,619,331,288,"4",2010,604,314,290,1.04738951417872,1.07544507657106,1.01686229077688
"1006","광주","동구",2013,673,350,323,"4",2011,705,352,353,0.975619469511646,1.01441408537455,0.936904811703951
"1007","광주","동구",2014,608,303,305,"4",2012,662,354,308,0.938642255247666,0.87323122429143,1.01395055036092
"1008","광주","동구",2015,530,270,260,"4",2013,596,309,287,0.908833069355451,0.891446275302796,0.92759650508828
"1009","광주","동구",2016,496,263,233,"4",2014,649,340,309,0.781072758178275,0.789163011492727,0.772084962556116
"1010","광주","동구",2017,560,300,260,"4",2015,709,351,358,0.807228158788822,0.871974989137588,0.743631835084738
"1011","광주","동구",2018,578,276,302,"4",2016,716,374,342,0.825029214704651,0.75288279008639,0.904166660841448
"1012","광주","동구",2019,587,292,295,"4",2017,619,311,308,0.969174465754697,0.957882750125291,0.980706270021219
"1013","광주","동구",2020,571,295,276,"4",2018,694,366,328,0.840874435405279,0.822301004100652,0.861594446072383
"1014","광주","북구",2010,4979,2630,2349,"4",2008,4853,2524,2329,1.04854324381464,1.0630563546257,1.0327166539945
"1015","광주","북구",2011,4554,2408,2146,"4",2009,4277,2210,2067,1.08819891191386,1.11161423321116,1.06305783684433
"1016","광주","북구",2012,3765,1960,1805,"4",2010,4323,2235,2088,0.890090685473257,0.894681451941976,0.885144885634776
"1017","광주","북구",2013,3856,2003,1853,"4",2011,4407,2322,2085,0.894228456443238,0.88005258690518,0.909990822666488
"1018","광주","북구",2014,4308,2305,2003,"4",2012,3999,2048,1951,1.10097840791275,1.14823522922642,1.05121447484831
"1019","광주","북구",2015,3986,2051,1935,"4",2013,3906,2090,1816,1.04294058208112,1.00117331204966,1.0910201650251
"1020","광주","북구",2016,3883,2076,1807,"4",2014,4049,2071,1978,0.980108431036362,1.02267382453697,0.935404635426864
"1021","광주","북구",2017,3957,2018,1939,"4",2015,4052,2113,1939,0.998047301794574,0.974342294298719,1.02392383446283
"1022","광주","북구",2018,3978,2058,1920,"4",2016,4123,2140,1983,0.986065933917878,0.981118550161137,0.991393727770367
"1023","광주","북구",2019,4081,2110,1971,"4",2017,3683,1942,1741,1.13245091552703,1.10846789685065,1.15919234791858
"1024","광주","북구",2020,3635,1904,1731,"4",2018,3846,1943,1903,0.965938878636864,0.999733012764808,0.931377907228146
"1025","광주","서구",2010,3339,1788,1551,"4",2008,3257,1641,1616,1.04773914916053,1.11160073021101,0.982738779240008
"1026","광주","서구",2011,3064,1571,1493,"4",2009,2814,1466,1348,1.11280528396095,1.0932817655417,1.13406400953487
"1027","광주","서구",2012,2893,1482,1411,"4",2010,2791,1444,1347,1.05935887286535,1.04705838827232,1.072573519248
"1028","광주","서구",2013,2924,1520,1404,"4",2011,3319,1743,1576,0.900377486568484,0.889684636077043,0.91217580176765
"1029","광주","서구",2014,3174,1665,1509,"4",2012,3075,1577,1498,1.05491219673691,1.0771406959984,1.03144263431536
"1030","광주","서구",2015,2852,1455,1397,"4",2013,2854,1460,1394,1.02129231441198,1.016716864903,1.02612740082107
"1031","광주","서구",2016,2724,1387,1337,"4",2014,2855,1497,1358,0.975114247385159,0.945245352453297,1.00808996073403
"1032","광주","서구",2017,2820,1472,1348,"4",2015,2725,1394,1331,1.05763816259449,1.07729569963581,1.03700174970391
"1033","광주","서구",2018,2794,1445,1349,"4",2016,2894,1509,1385,0.986693770510466,0.976941362084469,0.997309207718672
"1034","광주","서구",2019,2803,1472,1331,"4",2017,2615,1335,1280,1.09548368964853,1.12490652081822,1.06472079974221
"1035","광주","서구",2020,2547,1313,1234,"4",2018,2469,1248,1221,1.05429553274063,1.07334671319155,1.03482556243009
"1036","대구","남구",2010,1102,568,534,"4",2008,1194,621,573,0.943260783932407,0.933139611564051,0.954232683426095
"1037","대구","남구",2011,954,497,457,"4",2009,1118,567,551,0.872089549914605,0.894258794415548,0.849243543284055
"1038","대구","남구",2012,894,476,418,"4",2010,994,542,452,0.919190750818589,0.895978433488017,0.946903015056336
"1039","대구","남구",2013,857,475,382,"4",2011,1103,560,543,0.79407188713598,0.865357321809312,0.720329474704976
"1040","대구","남구",2014,938,495,443,"4",2012,1006,540,466,0.95292642214079,0.935193175850063,0.973386821173894
"1041","대구","남구",2015,832,445,387,"4",2013,934,460,474,0.91039730064932,0.986942995857576,0.835988447124717
"1042","대구","남구",2016,779,382,397,"4",2014,931,499,432,0.855149976232954,0.781003009308925,0.940967042318853
"1043","대구","남구",2017,731,386,345,"4",2015,953,512,441,0.783933073956138,0.769143251160776,0.801028850089971
"1044","대구","남구",2018,732,389,343,"4",2016,922,449,473,0.811399379596942,0.883879681082829,0.742507135773259
"1045","대구","남구",2019,737,371,366,"4",2017,831,422,409,0.906402250937767,0.896915126860078,0.916274140375053
"1046","대구","남구",2020,720,353,367,"4",2018,759,391,368,0.9694942370095,0.92105982164633,1.02114143273875
"1047","대구","달서구",2010,6108,3217,2891,"4",2008,5333,2805,2528,1.17052840201924,1.17005987232266,1.17095087240192
"1048","대구","달서구",2011,5784,3043,2741,"4",2009,4911,2587,2324,1.20368503590267,1.20003914711111,1.20764855002695
"1049","대구","달서구",2012,5386,2812,2574,"4",2010,5055,2613,2442,1.08892934224768,1.09790761318876,1.07927106875812
"1050","대구","달서구",2013,5330,2746,2584,"4",2011,5679,2912,2767,0.959201505300919,0.96205311971189,0.956204983105153
"1051","대구","달서구",2014,5906,2978,2928,"4",2012,5237,2734,2503,1.1525648747978,1.11126100060444,1.19778225621541
"1052","대구","달서구",2015,5526,2906,2620,"4",2013,5188,2731,2457,1.08859271707929,1.0855849148911,1.09185203349313
"1053","대구","달서구",2016,5193,2742,2451,"4",2014,5563,2848,2715,0.954033827607971,0.982239410692367,0.92435996989628
"1054","대구","달서구",2017,5415,2796,2619,"4",2015,5397,2737,2660,1.0254170968685,1.04220285767832,1.0081415497963
"1055","대구","달서구",2018,5249,2636,2613,"4",2016,5403,2756,2647,0.992878522939343,0.975789369919818,1.01077180938851
"1056","대구","달서구",2019,5343,2677,2666,"4",2017,4622,2320,2302,1.18143475967336,1.1772000619517,1.18583012279666
"1057","대구","달서구",2020,4632,2364,2268,"4",2018,4571,2334,2237,1.03564721284045,1.03332398584228,1.03811321258905
"1058","대구","달성군",2010,1945,1021,924,"4",2008,1921,981,940,1.03477696429555,1.06180954411222,1.00649534366346
"1059","대구","달성군",2011,1797,935,862,"4",2009,1988,1044,944,0.923817549899891,0.91369448215236,0.934981297994662
"1060","대구","달성군",2012,1772,930,842,"4",2010,1914,985,929,0.9461855154109,0.963244655513309,0.92803430421712
"1061","대구","달성군",2013,1761,917,844,"4",2011,2084,1070,1014,0.863606997555889,0.874330136538156,0.852260075233363
"1062","대구","달성군",2014,1921,986,935,"4",2012,2085,1089,996,0.941620308976215,0.923716976096331,0.961213639781875
"1063","대구","달성군",2015,1896,986,910,"4",2013,1860,946,914,1.04178931801661,1.06334861201787,1.01944276735359
"1064","대구","달성군",2016,1916,955,961,"4",2014,2127,1090,1037,0.920624495380585,0.893854361571453,0.948882164820426
"1065","대구","달성군",2017,2687,1377,1310,"4",2015,2266,1189,1077,1.21188740577314,1.18152244343959,1.24544124711821
"1066","대구","달성군",2018,2910,1510,1400,"4",2016,2800,1415,1385,1.06215884243081,1.08870545110203,1.0350132622729
"1067","대구","달성군",2019,3044,1569,1475,"4",2017,2965,1538,1427,1.0492390890059,1.04077415267201,1.05836556120019
"1068","대구","달성군",2020,2880,1481,1399,"4",2018,3208,1622,1586,0.91751387268106,0.931524107230541,0.90319637100473
"1069","대구","동구",2010,2923,1465,1458,"4",2008,2903,1553,1350,1.02904955887448,0.96240098527449,1.10583774121986
"1070","대구","동구",2011,2814,1469,1345,"4",2009,2645,1412,1233,1.08730886276783,1.06139488178502,1.11693232550893
"1071","대구","동구",2012,2567,1364,1203,"4",2010,2660,1430,1230,0.986276631767006,0.973124087877548,1.00144745760877
"1072","대구","동구",2013,2592,1385,1207,"4",2011,3081,1544,1537,0.859800731322544,0.915150175613992,0.804083323485126
"1073","대구","동구",2014,3072,1524,1548,"4",2012,2966,1523,1443,1.05853342452177,1.02088060645532,1.09842972678341
"1074","대구","동구",2015,2929,1485,1444,"4",2013,2865,1510,1355,1.04483871569344,1.00331983104444,1.0911778722984
"1075","대구","동구",2016,2890,1518,1372,"4",2014,3245,1702,1543,0.910201722231941,0.909917684610872,0.910449449697346
"1076","대구","동구",2017,3072,1578,1494,"4",2015,3185,1646,1539,0.985748865661401,0.978063513636186,0.993984541057486
"1077","대구","동구",2018,3015,1579,1436,"4",2016,3397,1765,1632,0.907081440142848,0.912698444296008,0.900952589637639
"1078","대구","동구",2019,3154,1644,1510,"4",2017,2952,1499,1453,1.09194269471626,1.11889689933714,1.06409152790012
"1079","대구","동구",2020,2723,1361,1362,"4",2018,3055,1541,1514,0.910942444444009,0.901042708275808,0.921125668783604
"1080","대구","북구",2010,5034,2655,2379,"4",2008,5165,2705,2460,0.996087285611304,1.00135286784013,0.990209269181739
"1081","대구","북구",2011,4559,2390,2169,"4",2009,4601,2441,2160,1.01267915427005,0.998895396200507,1.02819018377309
"1082","대구","북구",2012,4205,2215,1990,"4",2010,4444,2322,2122,0.96704450425303,0.973198442333986,0.960230174637623
"1083","대구","북구",2013,4109,2121,1988,"4",2011,4877,2540,2337,0.861068886634222,0.851916131415025,0.871014370095041
"1084","대구","북구",2014,4452,2303,2149,"4",2012,4434,2331,2103,1.02615739251717,1.00795595365986,1.04632064681913
"1085","대구","북구",2015,4014,2085,1929,"4",2013,4032,2074,1958,1.0174459701979,1.02562169105674,1.00875846612809
"1086","대구","북구",2016,3662,1862,1800,"4",2014,4160,2201,1959,0.899662297345736,0.863076961760927,0.940818224621285
"1087","대구","북구",2017,3816,1988,1828,"4",2015,4230,2176,2054,0.921982143550381,0.932067530208853,0.9112623025307
"1088","대구","북구",2018,3807,1943,1864,"4",2016,4224,2188,2036,0.921114202330608,0.905973246140937,0.93742339265163
"1089","대구","북구",2019,3864,1967,1897,"4",2017,3815,1947,1868,1.03513522296482,1.03069055996474,1.0398198682955
"1090","대구","북구",2020,3458,1754,1704,"4",2018,3790,1952,1838,0.932481641501153,0.916726246520684,0.949274327488937
"1091","대구","서구",2010,1514,794,720,"4",2008,1481,782,699,1.04478114880878,1.03586614502434,1.05468549472566
"1092","대구","서구",2011,1332,693,639,"4",2009,1253,644,609,1.08644479880039,1.09783546730225,1.07436343221962
"1093","대구","서구",2012,1158,609,549,"4",2010,1256,641,615,0.942265806109412,0.969279780047123,0.914039325398528
"1094","대구","서구",2013,1136,570,566,"4",2011,1379,693,686,0.841915638356376,0.839134372663575,0.844811793448925
"1095","대구","서구",2014,1204,600,604,"4",2012,1290,649,641,0.953874607635458,0.943184040638809,0.964820586607723
"1096","대구","서구",2015,1080,548,532,"4",2013,1180,592,588,0.935397617657047,0.944384263573405,0.926407278799705
"1097","대구","서구",2016,1028,498,530,"4",2014,1213,628,585,0.866137466125236,0.809020616514183,0.927657491051796
"1098","대구","서구",2017,991,509,482,"4",2015,1246,620,626,0.812849463569197,0.837560105292109,0.788388639314832
"1099","대구","서구",2018,1018,531,487,"4",2016,1228,632,596,0.847235066228097,0.857170730223907,0.836662596280871
"1100","대구","서구",2019,1024,509,515,"4",2017,1052,530,522,0.994806760814817,0.979787292983222,1.01019305507348
"1101","대구","서구",2020,869,424,445,"4",2018,937,477,460,0.947839267459078,0.906853988703091,0.990535013773827
"1102","대구","수성구",2010,4270,2302,1968,"4",2008,3578,1839,1739,1.21966918108782,1.27706640415651,1.15875911801199
"1103","대구","수성구",2011,3937,2079,1858,"4",2009,3457,1817,1640,1.16391307396818,1.16731872472644,1.16003078319021
"1104","대구","수성구",2012,3731,1986,1745,"4",2010,3512,1842,1670,1.0857385375919,1.09996662554825,1.06990843780697
"1105","대구","수성구",2013,3735,1982,1753,"4",2011,3827,1964,1863,0.997439712060482,1.02956093753092,0.963466710581505
"1106","대구","수성구",2014,4119,2146,1973,"4",2012,3582,1859,1723,1.17522418905553,1.17771503078345,1.17249084468669
"1107","대구","수성구",2015,3821,1990,1831,"4",2013,3456,1790,1666,1.12994632805527,1.13420076380394,1.12533285768394
"1108","대구","수성구",2016,3558,1874,1684,"4",2014,3354,1727,1627,1.08417002746197,1.10704975198801,1.0597957819517
"1109","대구","수성구",2017,3571,1852,1719,"4",2015,3500,1755,1745,1.04274068077537,1.07659845325521,1.00866766271725
"1110","대구","수성구",2018,3553,1778,1775,"4",2016,3544,1821,1723,1.0246039022479,0.996120093851378,1.05482577258939
"1111","대구","수성구",2019,3675,1919,1756,"4",2017,3108,1576,1532,1.20845600629492,1.24224898785621,1.17363593558533
"1112","대구","수성구",2020,3323,1689,1634,"4",2018,3106,1592,1514,1.09341090556502,1.08237181864602,1.1050802810517
"1113","대구","중구",2010,760,405,355,"4",2008,509,256,253,1.52598519885549,1.61400526797987,1.43673107207235
"1114","대구","중구",2011,717,359,358,"4",2009,492,254,238,1.4893904478977,1.44195139640733,1.54018795267939
"1115","대구","중구",2012,626,330,296,"4",2010,512,257,255,1.24956509008049,1.30999822298063,1.18855472549411
"1116","대구","중구",2013,701,346,355,"4",2011,524,291,233,1.36722893937934,1.2130340725178,1.56005562761504
"1117","대구","중구",2014,735,391,344,"4",2012,488,256,232,1.53929560146091,1.55821249328427,1.51823189247937
"1118","대구","중구",2015,725,380,345,"4",2013,448,255,193,1.65392001881945,1.52031403988459,1.83033017041283
"1119","대구","중구",2016,686,370,316,"4",2014,578,295,283,1.21297203566101,1.27958634846665,1.14332131339313
"1120","대구","중구",2017,735,385,350,"4",2015,606,304,302,1.2395647747738,1.29204320347706,1.18666669556951
"1121","대구","중구",2018,797,416,381,"4",2016,637,353,284,1.27871394194684,1.20228800768568,1.37364429905049
"1122","대구","중구",2019,787,436,351,"4",2017,570,283,287,1.41108894024268,1.57177343271684,1.25225528186918
"1123","대구","중구",2020,717,361,356,"4",2018,594,310,284,1.23363653260213,1.18805185858724,1.28351015869285
"1124","대전","대덕구",2010,2264,1141,1123,"4",2008,2232,1186,1046,1.03666095991104,0.981501223650089,1.09929872476268
"1125","대전","대덕구",2011,2074,1093,981,"4",2009,1886,1001,885,1.12388422373652,1.11397635949954,1.13499353854016
"1126","대전","대덕구",2012,1747,916,831,"4",2010,1822,957,865,0.979939003178892,0.976502649277467,0.983677117270073
"1127","대전","대덕구",2013,1763,927,836,"4",2011,2018,1041,977,0.892864717503882,0.908487371247585,0.876151817411389
"1128","대전","대덕구",2014,1929,997,932,"4",2012,1822,878,944,1.0820276686503,1.15848531330194,1.01090785351627
"1129","대전","대덕구",2015,1721,849,872,"4",2013,1733,910,823,1.01493170373874,0.951822984571473,1.08488649289379
"1130","대전","대덕구",2016,1575,834,741,"4",2014,1776,955,821,0.906342004721191,0.890948434450969,0.924150501019438
"1131","대전","대덕구",2017,1553,831,722,"4",2015,1689,881,808,0.939715342335616,0.962310014402727,0.914941842180897
"1132","대전","대덕구",2018,1510,792,718,"4",2016,1629,835,794,0.947349814213063,0.967672938843658,0.925916011516767
"1133","대전","대덕구",2019,1376,716,660,"4",2017,1429,729,700,0.984103364070571,1.00201767887564,0.965413901064956
"1134","대전","대덕구",2020,1269,661,608,"4",2018,1332,712,620,0.973670267929051,0.947133844591765,1.00410595379581
"1135","대전","동구",2010,2165,1116,1049,"4",2008,2365,1240,1125,0.935580727362171,0.91818966356188,0.954752090979121
"1136","대전","동구",2011,2111,1076,1035,"4",2009,2147,1103,1044,1.00487189602691,0.995237310358198,1.01509690485539
"1137","대전","동구",2012,2070,1077,993,"4",2010,2309,1214,1095,0.916222439122717,0.905079871550563,0.928544627964924
"1138","대전","동구",2013,2170,1115,1055,"4",2011,2570,1310,1260,0.862941036090443,0.86834730693087,0.857333051871657
"1139","대전","동구",2014,2378,1224,1154,"4",2012,2497,1283,1214,0.973302455928737,0.973295356542601,0.973318043632708
"1140","대전","동구",2015,2140,1105,1035,"4",2013,2353,1246,1107,0.929493500852959,0.904761528656927,0.957327162302648
"1141","대전","동구",2016,1971,1035,936,"4",2014,2292,1173,1119,0.878873808736671,0.90018594466851,0.856472483518508
"1142","대전","동구",2017,1953,999,954,"4",2015,2214,1103,1111,0.90152783038717,0.924016796512862,0.879228927162504
"1143","대전","동구",2018,1931,960,971,"4",2016,2094,1058,1036,0.942453882185872,0.92571106597291,0.959681508941515
"1144","대전","동구",2019,1869,929,940,"4",2017,1915,959,956,0.997458956548305,0.98829590713589,1.00678703388605
"1145","대전","동구",2020,1637,803,834,"4",2018,1794,932,862,0.932568521678956,0.879001311206712,0.990664127542926
"1146","대전","서구",2010,5198,2641,2557,"4",2008,4939,2564,2375,1.07560239431546,1.05084889125798,1.10238873461956
"1147","대전","서구",2011,5017,2593,2424,"4",2009,4459,2305,2154,1.14990282250355,1.14768175349046,1.15227083321165
"1148","대전","서구",2012,4427,2265,2162,"4",2010,4542,2377,2165,0.996132026798021,0.972140227161996,1.02250500235965
"1149","대전","서구",2013,4487,2332,2155,"4",2011,4889,2477,2412,0.937973445736851,0.960489075237206,0.9148241555835
"1150","대전","서구",2014,4873,2428,2445,"4",2012,4552,2342,2210,1.09407896756706,1.05767364224701,1.13280261324055
"1151","대전","서구",2015,4476,2316,2160,"4",2013,4383,2251,2132,1.04369383586983,1.04967039874096,1.03737123941825
"1152","대전","서구",2016,4253,2210,2043,"4",2014,4654,2393,2261,0.933949760484131,0.942192114255354,0.925199643435456
"1153","대전","서구",2017,4454,2299,2155,"4",2015,4612,2371,2241,0.986996074466066,0.989230065386739,0.984630014844892
"1154","대전","서구",2018,4459,2294,2165,"4",2016,4777,2438,2339,0.953974447975382,0.9599521867701,0.947753356824297
"1155","대전","서구",2019,4556,2339,2217,"4",2017,4315,2225,2090,1.07908940052652,1.07248220877465,1.08614312966703
"1156","대전","서구",2020,4192,2171,2021,"4",2018,4185,2151,2034,1.0237179608827,1.0296966576749,1.01737958183352
"1157","대전","유성구",2010,3738,1989,1749,"4",2008,3574,1801,1773,1.06890537313375,1.12670691641963,1.01006361335335
"1158","대전","유성구",2011,3743,1921,1822,"4",2009,3355,1780,1575,1.14020204057255,1.10102518333481,1.18450109612145
"1159","대전","유성구",2012,3627,1932,1695,"4",2010,3631,1897,1734,1.02088263816357,1.03903381362476,1.00089440566003
"1160","대전","유성구",2013,3957,2087,1870,"4",2011,4089,2087,2002,0.989016303954907,1.02021073729098,0.956412372849898
"1161","대전","유성구",2014,4268,2193,2075,"4",2012,3904,2050,1854,1.11729823589033,1.0913766570142,1.14597732282113
"1162","대전","유성구",2015,4122,2124,1998,"4",2013,3765,1942,1823,1.11891608784102,1.11582266014729,1.12221602921379
"1163","대전","유성구",2016,3830,1930,1900,"4",2014,4100,2115,1985,0.954705508861621,0.93097244584945,0.980078229460645
"1164","대전","유성구",2017,4067,2108,1959,"4",2015,4213,2201,2012,0.986591170845361,0.977103241349106,0.996951685741893
"1165","대전","유성구",2018,4099,2141,1958,"4",2016,4337,2263,2074,0.965924112297278,0.965210423570474,0.966655191840996
"1166","대전","유성구",2019,4129,2141,1988,"4",2017,3952,1993,1959,1.06778166251992,1.09597149450074,1.03908146141506
"1167","대전","유성구",2020,3737,1874,1863,"4",2018,3982,2098,1884,0.959127522619746,0.911284519391465,1.0125106707029
"1168","대전","중구",2010,2627,1357,1270,"4",2008,2456,1281,1175,1.09316626669018,1.08073846253228,1.10670916575983
"1169","대전","중구",2011,2421,1246,1175,"4",2009,2248,1135,1113,1.10065951881932,1.11998465080578,1.0809618198507
"1170","대전","중구",2012,2314,1204,1110,"4",2010,2315,1179,1136,1.0215670358231,1.04184370457874,1.00048895796984
"1171","대전","중구",2013,2339,1191,1148,"4",2011,2576,1331,1245,0.927980551488743,0.912900817515819,0.944148242540828
"1172","대전","중구",2014,2546,1329,1217,"4",2012,2463,1311,1152,1.05644890857833,1.0342182073682,1.08169731470596
"1173","대전","중구",2015,2374,1255,1119,"4",2013,2274,1169,1105,1.06695171434535,1.09526473507286,1.03689662512571
"1174","대전","중구",2016,2067,1053,1014,"4",2014,2248,1128,1120,0.939720456587994,0.952377576566844,0.9270167572726
"1175","대전","중구",2017,2166,1086,1080,"4",2015,2224,1137,1087,0.995355408596994,0.974449305802992,1.01733002872112
"1176","대전","중구",2018,2057,1067,990,"4",2016,2185,1122,1063,0.962137986877805,0.970200407031616,0.953607334071687
"1177","대전","중구",2019,2024,1038,986,"4",2017,1886,984,902,1.09678961853554,1.07619791189841,1.11927816051037
"1178","대전","중구",2020,1788,920,868,"4",2018,1817,913,904,1.00569686991049,1.02803272541917,0.983148106541746
"1179","부산","강서구",2010,437,235,202,"4",2008,265,137,128,1.68534987952842,1.74999652017066,1.61587980126166
"1180","부산","강서구",2011,430,232,198,"4",2009,437,228,209,1.00563766251205,1.03810917127854,0.970033106333209
"1181","부산","강서구",2012,467,243,224,"4",2010,456,237,219,1.04666222219398,1.04603885722239,1.04730109095742
"1182","부산","강서구",2013,474,233,241,"4",2011,583,295,288,0.830929730493519,0.805793565385755,0.856825153144245
"1183","부산","강서구",2014,692,356,336,"4",2012,608,304,304,1.16320705207425,1.1947204686697,1.13170529072208
"1184","부산","강서구",2015,898,438,460,"4",2013,752,397,355,1.22043037280107,1.12557255146964,1.32677454606451
"1185","부산","강서구",2016,1191,623,568,"4",2014,1032,525,507,1.17946912135987,1.21065007491863,1.14711782638045
"1186","부산","강서구",2017,1561,789,772,"4",2015,1372,707,665,1.16279539451188,1.13853786665146,1.18867548903054
"1187","부산","강서구",2018,1750,887,863,"4",2016,1749,925,824,1.02259284695053,0.978299377272538,1.07238624895804
"1188","부산","강서구",2019,1958,1033,925,"4",2017,1878,976,902,1.065544546868,1.07979271682539,1.05003275707109
"1189","부산","강서구",2020,1956,1014,942,"4",2018,2058,1086,972,0.971355025268094,0.952572456365609,0.992321246979411
"1190","부산","금정구",2010,1820,948,872,"4",2008,1657,822,835,1.12254404640262,1.17659340505091,1.06929530976238
"1191","부산","금정구",2011,1724,870,854,"4",2009,1449,768,681,1.21597147557197,1.15570747583744,1.28403958095633
"1192","부산","금정구",2012,1583,825,758,"4",2010,1490,809,681,1.08579830097334,1.04038795830044,1.13969789504086
"1193","부산","금정구",2013,1625,866,759,"4",2011,1725,868,857,0.962761638141378,1.01786002130644,0.906835694699288
"1194","부산","금정구",2014,1782,923,859,"4",2012,1614,865,749,1.12838857594688,1.0886179312365,1.17429983151345
"1195","부산","금정구",2015,1612,854,758,"4",2013,1534,796,738,1.07397504249513,1.09454770056092,1.05167244786291
"1196","부산","금정구",2016,1534,806,728,"4",2014,1679,898,781,0.933746903841227,0.915690260864731,0.954438606259848
"1197","부산","금정구",2017,1656,874,782,"4",2015,1669,860,809,1.01404798654732,1.03681881906083,0.989750851112404
"1198","부산","금정구",2018,1709,859,850,"4",2016,1612,838,774,1.08350653875997,1.04577687748562,1.12446415929381
"1199","부산","금정구",2019,1702,890,812,"4",2017,1529,782,747,1.13764452643807,1.16110940689127,1.11302028592211
"1200","부산","금정구",2020,1527,765,762,"4",2018,1516,805,711,1.02942413719799,0.969517036059128,1.09736984790531
"1201","부산","기장군",2010,927,497,430,"4",2008,697,365,332,1.35925665291771,1.38916366146196,1.32616641210548
"1202","부산","기장군",2011,970,501,469,"4",2009,772,432,340,1.28412986131531,1.18316106338606,1.41241258342079
"1203","부산","기장군",2012,1036,556,480,"4",2010,969,506,463,1.09267369914898,1.12102207496795,1.06151931002626
"1204","부산","기장군",2013,1207,628,579,"4",2011,1189,611,578,1.03748046204734,1.04859630608631,1.02569532898612
"1205","부산","기장군",2014,1702,888,814,"4",2012,1283,660,623,1.35577434210741,1.37264717380968,1.33783948836717
"1206","부산","기장군",2015,1720,880,840,"4",2013,1605,817,788,1.0952365321315,1.09888059830607,1.09149241237155
"1207","부산","기장군",2016,1799,919,880,"4",2014,1936,981,955,0.949686625112265,0.955732586718052,0.943510967881981
"1208","부산","기장군",2017,1987,990,997,"4",2015,2201,1129,1072,0.922640120743,0.894604632345499,0.95228737216366
"1209","부산","기장군",2018,2106,1074,1032,"4",2016,2324,1203,1121,0.926140240201749,0.910811580923117,0.942631041182554
"1210","부산","기장군",2019,2166,1100,1066,"4",2017,2142,1107,1035,1.03345958390276,1.01375954021687,1.05459208457718
"1211","부산","기장군",2020,2038,1061,977,"4",2018,2233,1165,1068,0.932760116288655,0.929136130700195,0.936679387893433
"1212","부산","남구",2010,2289,1215,1074,"4",2008,2374,1241,1133,0.985415954181112,0.99883645915273,0.970603881917989
"1213","부산","남구",2011,2110,1104,1006,"4",2009,2213,1169,1044,0.974441008703836,0.963483878502344,0.986654576120315
"1214","부산","남구",2012,1950,1045,905,"4",2010,2164,1099,1065,0.920941123360745,0.970082093238464,0.870094901585787
"1215","부산","남구",2013,1895,968,927,"4",2011,2312,1209,1103,0.837675658738194,0.816843667243728,0.86054160883685
"1216","부산","남구",2014,2222,1183,1039,"4",2012,2164,1084,1080,1.04940060313209,1.1133849651432,0.985052651858224
"1217","부산","남구",2015,2073,1041,1032,"4",2013,2099,1066,1033,1.00934904119052,0.996284594296349,1.0229326206831
"1218","부산","남구",2016,1932,971,961,"4",2014,2293,1172,1121,0.861107910076492,0.845242854871621,0.877779486992669
"1219","부산","남구",2017,2120,1069,1051,"4",2015,2235,1122,1113,0.969421940645815,0.972018964495593,0.966885849074965
"1220","부산","남구",2018,2139,1093,1046,"4",2016,2163,1105,1058,1.01066860795138,1.00913152566429,1.01231033161448
"1221","부산","남구",2019,2214,1116,1098,"4",2017,1917,988,929,1.18034785451873,1.15238378827604,1.2101920024114
"1222","부산","남구",2020,2013,1034,979,"4",2018,2078,1068,1010,0.990040003353246,0.98773211831355,0.992496469246646
"1223","부산","동구",2010,591,314,277,"4",2008,612,339,273,0.986939588782485,0.94497395725477,1.03892638148793
"1224","부산","동구",2011,517,281,236,"4",2009,505,260,245,1.04629385887029,1.10261237376448,0.986310305849912
"1225","부산","동구",2012,448,225,223,"4",2010,504,246,258,0.908452007271864,0.933119576790528,0.885019438314773
"1226","부산","동구",2013,454,216,238,"4",2011,602,301,301,0.770750602515124,0.732111359650669,0.809614194691542
"1227","부산","동구",2014,507,256,251,"4",2012,517,268,249,1.00224045192977,0.974529659501829,1.03214812228984
"1228","부산","동구",2015,428,219,209,"4",2013,509,260,249,0.859370611987039,0.859331351795093,0.859438077922618
"1229","부산","동구",2016,388,192,196,"4",2014,484,244,240,0.819296076806134,0.802788776884704,0.836204464811313
"1230","부산","동구",2017,403,203,200,"4",2015,523,267,256,0.787513248177594,0.775665841460931,0.799940495674087
"1231","부산","동구",2018,435,223,212,"4",2016,508,261,247,0.875145080824151,0.871674308106851,0.878833412575386
"1232","부산","동구",2019,404,206,198,"4",2017,424,223,201,0.973800559681751,0.942436824582697,1.00864138917234
"1233","부산","동구",2020,422,224,198,"4",2018,432,220,212,0.998350903824809,1.03876002342354,0.956306222753022
"1234","부산","동래구",2010,2088,1101,987,"4",2008,2008,1047,961,1.0627259786263,1.07282905611974,1.05162624829845
"1235","부산","동래구",2011,2018,1032,986,"4",2009,1768,932,836,1.16652328592135,1.12967540867413,1.20764222581382
"1236","부산","동래구",2012,1738,904,834,"4",2010,1907,953,954,0.931437224550767,0.967754991092386,0.895128383587004
"1237","부산","동래구",2013,1857,950,907,"4",2011,2121,1133,988,0.894799528378988,0.855428243977431,0.939978661799381
"1238","부산","동래구",2014,2140,1139,1001,"4",2012,1978,1030,948,1.10571193503894,1.12817478618876,1.08116852141065
"1239","부산","동래구",2015,2021,1054,967,"4",2013,1787,896,891,1.15583614719278,1.20011396998291,1.11126189441701
"1240","부산","동래구",2016,1856,970,886,"4",2014,2069,1065,1004,0.916794485830668,0.929206023635914,0.90358218857975
"1241","부산","동래구",2017,2214,1167,1047,"4",2015,1964,995,969,1.15210124089226,1.19656877429002,1.10634494807284
"1242","부산","동래구",2018,2004,1032,972,"4",2016,2208,1162,1046,0.927583809055443,0.906073563583726,0.951485628200643
"1243","부산","동래구",2019,2225,1167,1058,"4",2017,1931,997,934,1.17761208218663,1.19416843572575,1.15986233068702
"1244","부산","동래구",2020,2036,1080,956,"4",2018,1897,997,900,1.09689474046189,1.10514302535031,1.08763465082941
"1245","부산","부산진구",2010,3108,1602,1506,"4",2008,2973,1554,1419,1.06841656354728,1.05172303805672,1.08670140570897
"1246","부산","부산진구",2011,2917,1540,1377,"4",2009,2691,1354,1337,1.10784051221239,1.16035785482135,1.05455730744601
"1247","부산","부산진구",2012,2661,1350,1311,"4",2010,2710,1374,1336,1.00352938755322,1.0023904624038,1.00476358306944
"1248","부산","부산진구",2013,2738,1404,1334,"4",2011,3003,1511,1492,0.931821277189198,0.947965503081756,0.915492221966098
"1249","부산","부산진구",2014,2900,1454,1446,"4",2012,2797,1431,1366,1.05964414505701,1.03660825438231,1.08389009123957
"1250","부산","부산진구",2015,2724,1421,1303,"4",2013,2670,1345,1325,1.04267834317776,1.07785833285538,1.00692283494722
"1251","부산","부산진구",2016,2550,1288,1262,"4",2014,2885,1503,1382,0.903335076554995,0.874272408270645,0.935015831470401
"1252","부산","부산진구",2017,2673,1395,1278,"4",2015,2795,1357,1438,0.977398476696746,1.04877964518859,0.909996286817454
"1253","부산","부산진구",2018,2659,1292,1367,"4",2016,2833,1438,1395,0.959237777357174,0.916628840458931,1.00337195821555
"1254","부산","부산진구",2019,2739,1386,1353,"4",2017,2452,1233,1219,1.14163185314329,1.14680623023949,1.13647985892388
"1255","부산","부산진구",2020,2372,1180,1192,"4",2018,2471,1279,1192,0.981061991665305,0.941242118845468,1.02392383446283
"1256","부산","북구",2010,2638,1369,1269,"4",2008,2713,1387,1326,0.993755416358671,1.00697079982073,0.979909008999498
"1257","부산","북구",2011,2472,1262,1210,"4",2009,2376,1254,1122,1.06330178123866,1.026719258741,1.10423158618541
"1258","부산","북구",2012,2240,1200,1040,"4",2010,2235,1186,1049,1.02429488068237,1.03225369709037,1.01513897792311
"1259","부산","북구",2013,2273,1219,1054,"4",2011,2370,1228,1142,0.980179467972602,1.01273362276686,0.945022523225766
"1260","부산","북구",2014,2304,1184,1120,"4",2012,2405,1249,1156,0.979088400352878,0.967117304205379,0.992036933043574
"1261","부산","북구",2015,2252,1165,1087,"4",2013,2242,1135,1107,1.02656697610315,1.04717665986255,1.00542475886278
"1262","부산","북구",2016,2203,1096,1107,"4",2014,2319,1211,1108,0.970886047228291,0.923328627639068,1.02299971547866
"1263","부산","북구",2017,2235,1186,1049,"4",2015,2407,1236,1171,0.948977571991772,0.97894007639733,0.9172468850141
"1264","부산","북구",2018,2224,1141,1083,"4",2016,2590,1358,1232,0.877585684244867,0.85718737205376,0.900088890197441
"1265","부산","북구",2019,2275,1195,1080,"4",2017,2295,1174,1121,1.01310211595269,1.03845982202957,0.986474345423603
"1266","부산","북구",2020,2038,1029,1009,"4",2018,2197,1110,1087,0.948044305722607,0.945762926731907,0.950449999055195
"1267","부산","사상구",2010,1826,956,870,"4",2008,2054,1075,979,0.908562578353567,0.907275781255977,0.909922100084437
"1268","부산","사상구",2011,1732,886,846,"4",2009,1706,871,835,1.03758425332311,1.0377803825945,1.03741265144378
"1269","부산","사상구",2012,1510,748,762,"4",2010,1765,920,845,0.874352888018742,0.829475686406143,0.923349067290743
"1270","부산","사상구",2013,1526,784,742,"4",2011,1935,1023,912,0.805987071567945,0.78186238322202,0.833060839003751
"1271","부산","사상구",2014,1660,877,783,"4",2012,1868,942,926,0.908208845599682,0.949814030365379,0.86580168724017
"1272","부산","사상구",2015,1562,791,771,"4",2013,1642,842,800,0.972215158208577,0.958416500234161,0.986806595463554
"1273","부산","사상구",2016,1394,726,668,"4",2014,1791,953,838,0.795466142045841,0.777201464085257,0.816206588808081
"1274","부산","사상구",2017,1462,746,716,"4",2015,1811,936,875,0.825056012678299,0.813116677370801,0.837862246257586
"1275","부산","사상구",2018,1434,748,686,"4",2016,1856,928,928,0.789633728842314,0.822325033937124,0.756909213837826
"1276","부산","사상구",2019,1489,750,739,"4",2017,1616,805,811,0.941689770223565,0.950506898097184,0.933020608715207
"1277","부산","사상구",2020,1280,628,652,"4",2018,1528,783,745,0.856132781722176,0.818253311645893,0.896105154456062
"1278","부산","사하구",2010,2915,1522,1393,"4",2008,3040,1547,1493,0.979985132022095,1.00372381522745,0.955342197861169
"1279","부산","사하구",2011,2765,1411,1354,"4",2009,2645,1335,1310,1.06837562386391,1.07829015005061,1.05831516936082
"1280","부산","사하구",2012,2478,1230,1248,"4",2010,2692,1372,1320,0.940764146832147,0.914620413169025,0.968073443492132
"1281","부산","사하구",2013,2520,1280,1240,"4",2011,2985,1585,1400,0.862801152635087,0.823892582796499,0.90690396766708
"1282","부산","사하구",2014,2714,1420,1294,"4",2012,2839,1433,1406,0.977009894752666,1.0109555107838,0.942359489185565
"1283","부산","사하구",2015,2545,1285,1260,"4",2013,2695,1385,1310,0.965124917744066,0.946549312215817,0.984842772078754
"1284","부산","사하구",2016,2413,1253,1160,"4",2014,2808,1421,1387,0.878243066324923,0.899594689532439,0.856345816854279
"1285","부산","사하구",2017,2498,1250,1248,"4",2015,2843,1429,1414,0.897987074722391,0.892416670128567,0.903717783175116
"1286","부산","사하구",2018,2577,1310,1267,"4",2016,2892,1483,1409,0.910690154074012,0.901197616892233,0.920732078257209
"1287","부산","사하구",2019,2572,1290,1282,"4",2017,2457,1231,1226,1.06984366424141,1.06910792128786,1.07069360177924
"1288","부산","사하구",2020,2145,1094,1051,"4",2018,2427,1253,1174,0.903258446661688,0.890750635751261,0.916647316882825
"1289","부산","서구",2010,761,415,346,"4",2008,793,396,397,0.980767307346311,1.06916024236302,0.892387019456272
"1290","부산","서구",2011,711,342,369,"4",2009,679,348,331,1.07017385760911,1.00262089699286,1.14147400276974
"1291","부산","서구",2012,589,303,286,"4",2010,675,336,339,0.891797053805214,0.9200114684499,0.863841347068938
"1292","부산","서구",2013,626,316,310,"4",2011,757,386,371,0.845148383251269,0.835198427419557,0.855569780818
"1293","부산","서구",2014,688,354,334,"4",2012,637,316,321,1.10383336519376,1.14289430696521,1.06539115486164
"1294","부산","서구",2015,599,283,316,"4",2013,599,351,248,1.02200850818085,0.822563073086458,1.30467714391232
"1295","부산","서구",2016,572,304,268,"4",2014,661,309,352,0.88440070602034,1.00370247293352,0.77957837396602
"1296","부산","서구",2017,644,317,327,"4",2015,658,343,315,1.00026364630466,0.942876978779125,1.06293045672808
"1297","부산","서구",2018,615,323,292,"4",2016,631,324,307,0.996093870889415,1.01706193871909,0.973894982616114
"1298","부산","서구",2019,655,336,319,"4",2017,559,327,232,1.19752338615108,1.04828993189532,1.40789527238639
"1299","부산","서구",2020,561,322,239,"4",2018,614,316,298,0.933789532718983,1.03958182723954,0.821200659183278
"1300","부산","수영구",2010,1273,657,616,"4",2008,1237,655,582,1.05175168222653,1.02332588458042,1.08374069077166
"1301","부산","수영구",2011,1172,616,556,"4",2009,1206,662,544,0.993195664666628,0.94931996098375,1.04651038963481
"1302","부산","수영구",2012,1058,565,493,"4",2010,1058,551,507,1.02200850818085,1.046132607204,0.995649803530919
"1303","부산","수영구",2013,1010,545,465,"4",2011,1305,676,629,0.790979764952227,0.822507177253821,0.756954821979677
"1304","부산","수영구",2014,1098,550,548,"4",2012,1217,609,608,0.922075055039088,0.921372587044397,0.922878719219789
"1305","부산","수영구",2015,1102,557,545,"4",2013,1092,573,519,1.03136756045357,0.99172317743643,1.07521867010066
"1306","부산","수영구",2016,1017,532,485,"4",2014,1127,588,539,0.922256124951128,0.923047809929932,0.921341483700322
"1307","부산","수영구",2017,992,528,464,"4",2015,1205,618,587,0.841354722087469,0.871636358073845,0.809370799302818
"1308","부산","수영구",2018,1089,555,534,"4",2016,1259,642,617,0.884008947902258,0.881957880368369,0.886183675207702
"1309","부산","수영구",2019,1042,535,507,"4",2017,1132,587,545,0.940753414774243,0.929834317633174,0.952530979949827
"1310","부산","수영구",2020,970,518,452,"4",2018,1106,568,538,0.896336575890978,0.930403454078744,0.860248277281041
"1311","부산","연제구",2010,1765,879,886,"4",2008,1572,773,799,1.14748410746768,1.1601102691834,1.13541491531173
"1312","부산","연제구",2011,1596,820,776,"4",2009,1531,826,705,1.06539881061831,1.0128000055431,1.12704240502576
"1313","부산","연제구",2012,1576,844,732,"4",2010,1552,811,741,1.03781276346199,1.06172362795757,1.01148751258677
"1314","부산","연제구",2013,1552,818,734,"4",2011,1763,939,824,0.899692118375879,0.888745881899915,0.912087493320047
"1315","부산","연제구",2014,1657,882,775,"4",2012,1580,808,772,1.07181525193396,1.11364587907258,1.02790281309416
"1316","부산","연제구",2015,1570,806,764,"4",2013,1440,766,674,1.1142731651694,1.07348544942106,1.16064956903502
"1317","부산","연제구",2016,1472,783,689,"4",2014,1568,787,781,0.959436558700387,1.01502542223486,0.903307966638785
"1318","부산","연제구",2017,1650,824,826,"4",2015,1667,868,799,1.01158610587786,0.968494985631067,1.05852451472628
"1319","부산","연제구",2018,1675,885,790,"4",2016,1694,844,850,1.01054560283525,1.06977073756222,0.951646857912514
"1320","부산","연제구",2019,1654,829,825,"4",2017,1512,734,778,1.11799078871106,1.15225436132728,1.08578041572215
"1321","부산","연제구",2020,1564,764,800,"4",2018,1641,850,791,0.974053203409412,0.916989415635655,1.03557404244029
"1322","부산","영도구",2010,965,522,443,"4",2008,944,454,490,1.04474386694335,1.17301763186319,0.92571073197354
"1323","부산","영도구",2011,832,416,416,"4",2009,811,388,423,1.04847235364546,1.0938341925594,1.00697946840789
"1324","부산","영도구",2012,716,357,359,"4",2010,857,447,410,0.853860083847709,0.814799179447157,0.89655769895648
"1325","부산","영도구",2013,746,377,369,"4",2011,891,449,442,0.855688380586882,0.8566134698412,0.854814241893179
"1326","부산","영도구",2014,776,404,372,"4",2012,851,436,415,0.931937253053276,0.945332885012741,0.917830521494394
"1327","부산","영도구",2015,731,371,360,"4",2013,713,363,350,1.04780956448836,1.04269472048196,1.05317880116177
"1328","부산","영도구",2016,617,316,301,"4",2014,814,402,412,0.774667382736588,0.801956698965047,0.748060859643962
"1329","부산","영도구",2017,708,359,349,"4",2015,762,373,389,0.949582708388504,0.981918645274695,0.918636036574623
"1330","부산","영도구",2018,686,321,365,"4",2016,722,385,337,0.971049635196761,0.850617264078971,1.1089976248633
"1331","부산","영도구",2019,645,348,297,"4",2017,653,339,314,1.00948773013269,1.04729597810401,0.968488467628857
"1332","부산","영도구",2020,589,302,287,"4",2018,624,323,301,0.964684313010447,0.953881246631193,0.976299470069212
"1333","부산","중구",2010,365,208,157,"4",2008,279,125,154,1.33703622037996,1.69763066685219,1.04387040266665
"1334","부산","중구",2011,341,161,180,"4",2009,233,121,112,1.49572919008442,1.35747048515576,1.64559187681527
"1335","부산","중구",2012,316,162,154,"4",2010,248,125,123,1.30223664752076,1.32219311552911,1.28198593908355
"1336","부산","중구",2013,275,142,133,"4",2011,251,116,135,1.11973043724993,1.24887866116654,1.00875459247079
"1337","부산","중구",2014,280,135,145,"4",2012,226,111,115,1.2662052313745,1.24079684265119,1.29103439997488
"1338","부산","중구",2015,250,138,112,"4",2013,212,113,99,1.20519871247741,1.2459210773996,1.15837847939229
"1339","부산","중구",2016,245,135,110,"4",2014,251,126,125,0.997578025913576,1.09308293281176,0.901052974327292
"1340","부산","중구",2017,270,129,141,"4",2015,233,136,97,1.18430170475892,0.967699890518648,1.48838413050783
"1341","부산","중구",2018,229,115,114,"4",2016,209,107,102,1.11980836542303,1.09648817559311,1.14438546204669
"1342","부산","중구",2019,229,125,104,"4",2017,193,95,98,1.21264221955137,1.34238254906708,1.0866130488177
"1343","부산","중구",2020,209,114,95,"4",2018,180,98,82,1.18666543449887,1.1867757556242,1.18625322285328
"1344","부산","해운대구",2010,3965,2094,1871,"4",2008,3789,1955,1834,1.06948105962973,1.0927474597889,1.04458096743727
"1345","부산","해운대구",2011,3703,1915,1788,"4",2009,3477,1801,1676,1.08843759154262,1.08478820761367,1.09234833891381
"1346","부산","해운대구",2012,3386,1774,1612,"4",2010,3502,1789,1713,0.988155570731111,1.01165670651436,0.96355237662235
"1347","부산","해운대구",2013,3499,1789,1710,"4",2011,3800,1903,1897,0.941054676348628,0.959094592229931,0.922988801756164
"1348","부산","해운대구",2014,3694,1874,1820,"4",2012,3560,1817,1743,1.06047736775844,1.05221514677121,1.06915741751139
"1349","부산","해운대구",2015,3424,1774,1650,"4",2013,3316,1710,1606,1.05529467189723,1.05839406313111,1.05197654225633
"1350","부산","해운대구",2016,3149,1615,1534,"4",2014,3561,1848,1713,0.903764333687585,0.891580270955048,0.91692887452772
"1351","부산","해운대구",2017,3285,1711,1574,"4",2015,3618,1859,1759,0.92794304847266,0.93898901103005,0.916234289621659
"1352","부산","해운대구",2018,3294,1710,1584,"4",2016,3613,1917,1696,0.931773048975287,0.910047136550638,0.956306222753022
"1353","부산","해운대구",2019,3398,1793,1605,"4",2017,3223,1714,1509,1.0775007479983,1.06723328585923,1.08906411816623
"1354","부산","해운대구",2020,3075,1598,1477,"4",2018,3102,1639,1463,1.01311288286786,0.994689907377048,1.03372214866822
"1355","서울","강남구",2010,3545,1848,1697,"4",2008,3854,2003,1851,0.940067504281553,0.941262827016339,0.938735141590181
"1356","서울","강남구",2011,3548,1876,1672,"4",2009,3474,1794,1680,1.04377840731884,1.06684244323181,1.01904800667968
"1357","서울","강남구",2012,3132,1645,1487,"4",2010,3805,1915,1890,0.841243271385654,0.876369014539769,0.805595101505942
"1358","서울","강남구",2013,3320,1698,1622,"4",2011,4263,2176,2087,0.795934376533055,0.796101944816213,0.795785557977342
"1359","서울","강남구",2014,3846,2003,1843,"4",2012,4187,2169,2018,0.938773518620382,0.942130985151604,0.93512964663776
"1360","서울","강남구",2015,3970,2089,1881,"4",2013,3955,2005,1950,1.02588464664424,1.06295273326726,0.987692683397224
"1361","서울","강남구",2016,3703,1896,1807,"4",2014,4339,2249,2090,0.872205002487596,0.860079838996751,0.885277688456621
"1362","서울","강남구",2017,3957,2060,1897,"4",2015,4493,2291,2202,0.900086282410775,0.91734356997792,0.882099688454129
"1363","서울","강남구",2018,3938,2056,1882,"4",2016,4496,2304,2192,0.895166704896836,0.910396387096463,0.879117087800661
"1364","서울","강남구",2019,4096,2116,1980,"4",2017,4069,2094,1975,1.02879008343788,1.03092928371906,1.02651604670198
"1365","서울","강남구",2020,3913,2064,1849,"4",2018,3797,1981,1816,1.05323131222324,1.06295555869186,1.04253037991287
"1366","서울","강동구",2010,3930,2025,1905,"4",2008,3826,1988,1838,1.0497891890096,1.03919856288442,1.06124858794978
"1367","서울","강동구",2011,3823,1997,1826,"4",2009,3668,1886,1782,1.06519589061488,1.08025495353663,1.04920590444957
"1368","서울","강동구",2012,3433,1774,1659,"4",2010,3902,2030,1872,0.89916842864809,0.891553619681869,0.907419680221067
"1369","서울","강동구",2013,3587,1873,1714,"4",2011,4426,2352,2074,0.82827485739826,0.812438227443028,0.846193564257133
"1370","서울","강동구",2014,3845,2032,1813,"4",2012,4248,2215,2033,0.925052427955593,0.935922446128789,0.91312046821501
"1371","서울","강동구",2015,3665,1924,1741,"4",2013,3835,1978,1857,0.976704350060706,0.992358674695572,0.959963056434998
"1372","서울","강동구",2016,3229,1646,1583,"4",2014,4024,2085,1939,0.82009579346818,0.805403776297817,0.835931629682652
"1373","서울","강동구",2017,3470,1806,1664,"4",2015,3677,1925,1752,0.964473626159244,0.957143164440263,0.972493870174745
"1374","서울","강동구",2018,3210,1697,1513,"4",2016,3682,1878,1804,0.890996010662825,0.921883717349728,0.858756519701921
"1375","서울","강동구",2019,3292,1711,1581,"4",2017,3270,1687,1583,1.02888440640102,1.03472470154408,1.02263018464039
"1376","서울","강동구",2020,3404,1798,1606,"4",2018,3291,1696,1595,1.05710026188016,1.08156775097239,1.03098537814878
"1377","서울","강북구",2010,2358,1207,1151,"4",2008,2737,1333,1404,0.880488148443711,0.923776714111185,0.839413342925014
"1378","서울","강북구",2011,2155,1050,1105,"4",2009,2426,1237,1189,0.907843501702278,0.865983245073182,0.951586069875046
"1379","서울","강북구",2012,1945,990,955,"4",2010,2498,1300,1198,0.795759226746096,0.776929715321591,0.816233106771289
"1380","서울","강북구",2013,1972,1012,960,"4",2011,2689,1399,1290,0.749498244006185,0.737993757068241,0.761989830297921
"1381","서울","강북구",2014,2041,1062,979,"4",2012,2521,1257,1264,0.827417439586319,0.861944155133666,0.793054931913855
"1382","서울","강북구",2015,1855,928,927,"4",2013,2503,1292,1211,0.757421407381331,0.73278294443191,0.783796362136288
"1383","서울","강북구",2016,1778,898,880,"4",2014,2466,1259,1207,0.736873936555372,0.727680096971643,0.746522762491543
"1384","서울","강북구",2017,1791,911,880,"4",2015,2354,1197,1157,0.777577416377187,0.776451112508004,0.778783901752197
"1385","서울","강북구",2018,1753,897,856,"4",2016,2387,1260,1127,0.750557568010484,0.726292882023815,0.777709673735745
"1386","서울","강북구",2019,1706,892,814,"4",2017,2065,1082,983,0.844332452763451,0.841060977507904,0.847888098934634
"1387","서울","강북구",2020,1528,810,718,"4",2018,1885,967,918,0.828450398143414,0.85457155864084,0.800846746344568
"1388","서울","강서구",2010,5328,2743,2585,"4",2008,5525,2875,2650,0.985567661825802,0.973369757352749,0.998808721542046
"1389","서울","강서구",2011,4919,2540,2379,"4",2009,4927,2524,2403,1.02034906672247,1.0266780002849,1.0136973791873
"1390","서울","강서구",2012,4386,2224,2162,"4",2010,4966,2597,2369,0.902643841498429,0.873680662200668,0.934454761548604
"1391","서울","강서구",2013,4427,2324,2103,"4",2011,5236,2682,2554,0.864100776492859,0.884030482276,0.843113478416341
"1392","서울","강서구",2014,4807,2442,2365,"4",2012,4818,2447,2371,1.01967515542244,1.01812612197163,1.02133271552282
"1393","서울","강서구",2015,4757,2433,2324,"4",2013,4555,2321,2234,1.06733138823629,1.06944107015465,1.06517412322812
"1394","서울","강서구",2016,4413,2289,2124,"4",2014,4923,2599,2324,0.916133159984172,0.898523423493285,0.935806464887717
"1395","서울","강서구",2017,4529,2353,2176,"4",2015,5266,2663,2603,0.878973895471147,0.90144794023495,0.85595784240919
"1396","서울","강서구",2018,4816,2460,2356,"4",2016,5556,2851,2705,0.88588786454265,0.880294077073239,0.891816840663376
"1397","서울","강서구",2019,4946,2556,2390,"4",2017,4983,2509,2474,1.01441984376128,1.03932189897,0.989158433454393
"1398","서울","강서구",2020,4277,2180,2097,"4",2018,4823,2400,2423,0.906309431783016,0.926691419705971,0.886161073408402
"1399","서울","관악구",2010,3663,1895,1768,"4",2008,4317,2244,2073,0.867180256072839,0.861541598559003,0.873274162725657
"1400","서울","관악구",2011,3379,1767,1612,"4",2009,3959,2007,1952,0.872282583769407,0.898212442846616,0.845576445263363
"1401","서울","관악구",2012,3148,1594,1554,"4",2010,3882,2015,1867,0.828769393032794,0.807055044785022,0.852264402118501
"1402","서울","관악구",2013,3029,1606,1423,"4",2011,4009,2024,1985,0.772178541102466,0.809515041546102,0.734027010801315
"1403","서울","관악구",2014,3225,1623,1602,"4",2012,3781,1925,1856,0.871721089363457,0.860156896947146,0.88379632694475
"1404","서울","관악구",2015,3014,1560,1454,"4",2013,3373,1742,1631,0.913232624861273,0.913621555782965,0.912805184125664
"1405","서울","관악구",2016,2732,1422,1310,"4",2014,3445,1760,1685,0.810486863381734,0.824283902515779,0.796047610175852
"1406","서울","관악구",2017,2769,1411,1358,"4",2015,3445,1760,1685,0.821463442424606,0.81790758540771,0.825215766884585
"1407","서울","관악구",2018,2687,1393,1294,"4",2016,3343,1717,1626,0.821458827843834,0.827695723381673,0.814856975273619
"1408","서울","관악구",2019,2581,1318,1263,"4",2017,2875,1465,1410,0.917497029431223,0.917841468770996,0.917174328316707
"1409","서울","관악구",2020,2302,1169,1133,"4",2018,2838,1433,1405,0.82898646435247,0.832258445145257,0.825698010282127
"1410","서울","광진구",2010,2935,1539,1396,"4",2008,3063,1582,1481,0.979299696869339,0.992480609791918,0.96515710527354
"1411","서울","광진구",2011,2839,1442,1397,"4",2009,2652,1319,1333,1.09407321068078,1.11534790233024,1.0730844686756
"1412","서울","광진구",2012,2528,1266,1262,"4",2010,2791,1392,1399,0.925703156102179,0.927864075725846,0.923653952174477
"1413","서울","광진구",2013,2689,1341,1348,"4",2011,2885,1468,1417,0.952575694453483,0.931949999119347,0.974064452262454
"1414","서울","광진구",2014,2817,1416,1401,"4",2012,2707,1438,1269,1.06353822221849,1.00460250626149,1.13043127823674
"1415","서울","광진구",2015,2601,1364,1237,"4",2013,2526,1298,1228,1.0523531788513,1.07208585952611,1.03142816223984
"1416","서울","광진구",2016,2407,1246,1161,"4",2014,2661,1381,1280,0.924454896351484,0.920479781799101,0.928730915477616
"1417","서울","광진구",2017,2550,1366,1184,"4",2015,2525,1231,1294,1.03212740430145,1.1320941244025,0.93688239567542
"1418","서울","광진구",2018,2480,1248,1232,"4",2016,2623,1373,1250,0.966290926530119,0.92732920621933,1.00917933124657
"1419","서울","광진구",2019,2599,1350,1249,"4",2017,2356,1211,1145,1.12741940270035,1.13731172200068,1.11692652335727
"1420","서울","광진구",2020,2244,1124,1120,"4",2018,2331,1226,1105,0.983864046485552,0.935331866814893,1.0378232530302
"1421","서울","구로구",2010,3539,1820,1719,"4",2008,3997,2081,1916,0.90490070314036,0.892255426174714,0.91864565315324
"1422","서울","구로구",2011,3447,1795,1652,"4",2009,3729,2016,1713,0.944720656395651,0.908372159443108,0.987461864876006
"1423","서울","구로구",2012,3288,1778,1510,"4",2010,3862,1992,1870,0.870109781175201,0.910609784590039,0.82680480750742
"1424","서울","구로구",2013,3371,1726,1645,"4",2011,4211,2108,2103,0.818140745922022,0.835333838977338,0.800929485350147
"1425","서울","구로구",2014,3665,1867,1798,"4",2012,4098,2122,1976,0.914021762440899,0.897612368766379,0.93168778054867
"1426","서울","구로구",2015,3516,1788,1728,"4",2013,3902,1999,1903,0.920907717776489,0.912524661468869,0.929763734078704
"1427","서울","구로구",2016,3329,1689,1640,"4",2014,4095,2068,2027,0.83083426709012,0.833237879731364,0.828433689451921
"1428","서울","구로구",2017,3464,1761,1703,"4",2015,3948,2041,1907,0.896716684989477,0.880250420563161,0.914390293702256
"1429","서울","구로구",2018,3320,1684,1636,"4",2016,3926,1960,1966,0.864255793978709,0.876548408978575,0.852054625219325
"1430","서울","구로구",2019,3305,1615,1690,"4",2017,3544,1789,1755,0.953086376844724,0.920983980282241,0.986000729482727
"1431","서울","구로구",2020,3014,1551,1463,"4",2018,3167,1604,1563,0.972634557517232,0.986500532131114,0.9584136723091
"1432","서울","금천구",2010,1994,1025,969,"4",2008,2110,1077,1033,0.965822258441995,0.970952651553623,0.960486152560004
"1433","서울","금천구",2011,1799,926,873,"4",2009,1850,939,911,0.993834219576943,1.0060864139845,0.981213509863943
"1434","서울","금천구",2012,1645,842,803,"4",2010,1883,967,916,0.892832711607803,0.888332410340231,0.89761008632495
"1435","서울","금천구",2013,1661,850,811,"4",2011,1867,923,944,0.909242705992709,0.939522347451063,0.879663378971776
"1436","서울","금천구",2014,1715,860,855,"4",2012,1712,872,840,1.02379941094051,1.00617113998881,1.04220818864967
"1437","서울","금천구",2015,1550,797,753,"4",2013,1660,841,819,0.954285052819466,0.96683467017944,0.941409825824801
"1438","서울","금천구",2016,1510,776,734,"4",2014,1682,887,795,0.917498720186135,0.892540622477789,0.945358609428577
"1439","서울","금천구",2017,1610,828,782,"4",2015,1625,838,787,1.01257458348995,1.00803638481734,1.01741860044464
"1440","서울","금천구",2018,1561,786,775,"4",2016,1814,932,882,0.879468181516154,0.860392317071576,0.899706317130039
"1441","서울","금천구",2019,1656,844,812,"4",2017,1430,728,702,1.18352873394929,1.18277178883734,1.18436774014789
"1442","서울","금천구",2020,1336,676,660,"4",2018,1503,769,734,0.908452007271864,0.896830245004813,0.920694456056497
"1443","서울","노원구",2010,5881,3089,2792,"4",2008,5791,2949,2842,1.03789190754819,1.06864393607726,1.00590969240684
"1444","서울","노원구",2011,5545,2878,2667,"4",2009,5049,2597,2452,1.12240783875278,1.13059934613917,1.11370508422201
"1445","서울","노원구",2012,4907,2527,2380,"4",2010,4938,2568,2370,1.01559249689012,1.00392232598688,1.02824418819474
"1446","서울","노원구",2013,4883,2532,2351,"4",2011,5271,2709,2562,0.946778134214964,0.953552449915377,0.939595993295128
"1447","서울","노원구",2014,5183,2664,2519,"4",2012,4979,2532,2447,1.06388232534672,1.07339707904548,1.0540515484315
"1448","서울","노원구",2015,4895,2507,2388,"4",2013,4420,2278,2142,1.13183973926363,1.12276923546465,1.1415173280566
"1449","서울","노원구",2016,4329,2220,2109,"4",2014,4604,2361,2243,0.960963256280384,0.959283285381606,0.962753172930055
"1450","서울","노원구",2017,4470,2271,2199,"4",2015,4342,2216,2126,1.05213681058692,1.04553185216056,1.0590820846584
"1451","서울","노원구",2018,4236,2146,2090,"4",2016,4533,2318,2215,0.955046997717642,0.944509164032113,0.966140322359963
"1452","서울","노원구",2019,4318,2217,2101,"4",2017,3863,1983,1880,1.1423848662503,1.14059869116193,1.14428934904596
"1453","서울","노원구",2020,3821,1979,1842,"4",2018,3812,1945,1867,1.02442143487907,1.03804475532074,1.01021301718293
"1454","서울","도봉구",2010,3432,1741,1691,"4",2008,3248,1664,1584,1.07990554189553,1.06742000818726,1.09309040661405
"1455","서울","도봉구",2011,3209,1631,1578,"4",2009,2751,1408,1343,1.19215750736181,1.18179240946135,1.20309144510972
"1456","서울","도봉구",2012,2781,1452,1329,"4",2010,2712,1421,1291,1.04801093703943,1.04246726991309,1.05406256855237
"1457","서울","도봉구",2013,2891,1517,1374,"4",2011,3014,1523,1491,0.980300795338696,1.01619152230493,0.943575686486875
"1458","서울","도봉구",2014,3151,1619,1532,"4",2012,2731,1426,1305,1.17918301328372,1.15828975012209,1.20203165854181
"1459","서울","도봉구",2015,2813,1464,1349,"4",2013,2572,1311,1261,1.11777213589142,1.13927423294736,1.0953792646236
"1460","서울","도봉구",2016,2684,1360,1324,"4",2014,2710,1415,1295,1.01220326050088,0.980555902979314,1.04685340295659
"1461","서울","도봉구",2017,2737,1411,1326,"4",2015,2617,1354,1263,1.06887171833817,1.0631590475019,1.07499842002986
"1462","서울","도봉구",2018,2572,1313,1259,"4",2016,2650,1385,1265,0.991926748317411,0.967174511236862,1.01906727872625
"1463","서울","도봉구",2019,2601,1348,1253,"4",2017,2276,1183,1093,1.16794557547381,1.16250555694695,1.17381204444824
"1464","서울","도봉구",2020,2214,1137,1077,"4",2018,2345,1210,1135,0.964915495570318,0.958660833305654,0.971599973318476
"1465","서울","동대문구",2010,2808,1450,1358,"4",2008,2975,1532,1443,0.964638618814057,0.965604157357649,0.963609540679505
"1466","서울","동대문구",2011,2664,1371,1293,"4",2009,2683,1394,1289,1.01477102713149,1.00337799198417,1.02710125520593
"1467","서울","동대문구",2012,2384,1249,1135,"4",2010,2712,1358,1354,0.898402759403813,0.93832342479855,0.858311338342182
"1468","서울","동대문구",2013,2501,1260,1241,"4",2011,2973,1550,1423,0.859752196084864,0.829332599346214,0.892965199275035
"1469","서울","동대문구",2014,2693,1430,1263,"4",2012,2771,1409,1362,0.993240314879474,1.03541614927331,0.94949765266267
"1470","서울","동대문구",2015,2596,1329,1267,"4",2013,2614,1335,1279,1.01497095915741,1.01562552049416,1.01431704320908
"1471","서울","동대문구",2016,2348,1218,1130,"4",2014,2767,1411,1356,0.867248275102504,0.880663839844373,0.85326986205236
"1472","서울","동대문구",2017,2396,1217,1179,"4",2015,2658,1352,1306,0.921268768096806,0.91834058231,0.924353905690413
"1473","서울","동대문구",2018,2284,1168,1116,"4",2016,2728,1369,1359,0.855669880016516,0.870420848178132,0.840838115717822
"1474","서울","동대문구",2019,2386,1227,1159,"4",2017,2363,1259,1104,1.03195611532776,0.994280043412256,1.0749345327377
"1475","서울","동대문구",2020,2136,1117,1019,"4",2018,2390,1224,1166,0.913393378022715,0.93102564832845,0.894835666653195
"1476","서울","동작구",2010,3219,1675,1544,"4",2008,3512,1816,1696,0.936744130932274,0.940998339736998,0.932157075713805
"1477","서울","동작구",2011,3075,1588,1487,"4",2009,3191,1603,1588,0.984856208917614,1.01066416145856,0.958800215268407
"1478","서울","동작구",2012,2821,1432,1389,"4",2010,3147,1603,1544,0.916137909621281,0.911379772801422,0.921133553153416
"1479","서울","동작구",2013,3028,1552,1476,"4",2011,3417,1817,1600,0.90566045149886,0.871418307251292,0.944569737291962
"1480","서울","동작구",2014,3176,1718,1458,"4",2012,3297,1684,1613,0.984500764932475,1.04080881630992,0.925530657561568
"1481","서울","동작구",2015,2904,1475,1429,"4",2013,3114,1552,1562,0.953086932484644,0.969594611793938,0.936739538698711
"1482","서울","동작구",2016,2807,1412,1395,"4",2014,3305,1739,1566,0.868011462167515,0.828371225448454,0.912116059435281
"1483","서울","동작구",2017,2950,1561,1389,"4",2015,3173,1646,1527,0.95018124775717,0.967526707722489,0.931388478106662
"1484","서울","동작구",2018,2801,1419,1382,"4",2016,3270,1697,1573,0.875426859759802,0.853081341317559,0.899594875542043
"1485","서울","동작구",2019,2805,1427,1378,"4",2017,2906,1456,1450,0.986487909651506,0.999890605847682,0.973080719923988
"1486","서울","동작구",2020,2545,1287,1258,"4",2018,2897,1511,1386,0.897829359102609,0.868968377824943,0.929362325941012
"1487","서울","마포구",2010,3122,1603,1519,"4",2008,3560,1824,1736,0.896267011949608,0.896599677564385,0.895933355154978
"1488","서울","마포구",2011,3052,1548,1504,"4",2009,3089,1610,1479,1.00976690416573,0.980923118836294,1.04123153957546
"1489","서울","마포구",2012,2774,1427,1347,"4",2010,3306,1662,1644,0.857547368933355,0.875957113185454,0.83894489356535
"1490","서울","마포구",2013,2813,1439,1374,"4",2011,3642,1873,1769,0.789376697834356,0.783813801901611,0.795291887253777
"1491","서울","마포구",2014,3100,1583,1517,"4",2012,3328,1753,1575,0.951991098365573,0.921274156949012,0.986217432939756
"1492","서울","마포구",2015,2917,1505,1412,"4",2013,3029,1588,1441,0.984218824154352,0.96688738011519,1.00331745611486
"1493","서울","마포구",2016,2638,1363,1275,"4",2014,3161,1612,1549,0.852913142860195,0.862622354173451,0.842803672653396
"1494","서울","마포구",2017,2676,1366,1310,"4",2015,3056,1537,1519,0.894926298393962,0.90670648480122,0.883041621557808
"1495","서울","마포구",2018,2458,1223,1235,"4",2016,3129,1594,1535,0.8028433726777,0.782758928297908,0.823808427075959
"1496","서울","마포구",2019,2572,1312,1260,"4",2017,2731,1360,1371,0.962506731249044,0.984203299504237,0.941024092941771
"1497","서울","마포구",2020,2211,1092,1119,"4",2018,2821,1405,1416,0.801014112579884,0.792932473396262,0.809160148844568
"1498","서울","서대문구",2010,2666,1342,1324,"4",2008,2863,1426,1437,0.95168518435562,0.960114172120962,0.94340651136311
"1499","서울","서대문구",2011,2435,1235,1200,"4",2009,2405,1206,1199,1.03475705506044,1.04474316795552,1.02477781597615
"1500","서울","서대문구",2012,2166,1096,1070,"4",2010,2476,1249,1227,0.894051061680014,0.895236964027952,0.892908315301736
"1501","서울","서대문구",2013,2272,1152,1120,"4",2011,2344,1178,1166,0.990615755369832,0.997693352596949,0.983528897597231
"1502","서울","서대문구",2014,2204,1102,1102,"4",2012,2245,1186,1059,1.00334376482432,0.947952978494652,1.06549958978096
"1503","서울","서대문구",2015,2109,1080,1029,"4",2013,2232,1148,1084,0.965688146842924,0.959780136127401,0.971971979393223
"1504","서울","서대문구",2016,2213,1110,1103,"4",2014,2214,1184,1030,1.02154689638853,0.956447566210292,1.09649319360437
"1505","서울","서대문구",2017,2288,1220,1068,"4",2015,2218,1100,1118,1.05426305983669,1.13150645408636,0.978131176392043
"1506","서울","서대문구",2018,2140,1054,1086,"4",2016,2361,1229,1132,0.92634400995638,0.874940697400074,0.982315622108335
"1507","서울","서대문구",2019,2243,1144,1099,"4",2017,2178,1117,1061,1.05250922123491,1.04487115797751,1.06059594163492
"1508","서울","서대문구",2020,2179,1104,1075,"4",2018,2246,1116,1130,0.991521166218195,1.00924072936312,0.974086833670393
"1509","서울","서초구",2010,3468,1819,1649,"4",2008,3316,1684,1632,1.06885570155946,1.10199722751324,1.03458970773849
"1510","서울","서초구",2011,3431,1763,1668,"4",2009,3290,1706,1584,1.06580887281717,1.05429749697772,1.07822282568435
"1511","서울","서초구",2012,3225,1683,1542,"4",2010,3534,1799,1735,0.93264783216843,0.954427276743033,0.910023373338148
"1512","서울","서초구",2013,3547,1804,1743,"4",2011,3740,1932,1808,0.969268496929804,0.952619135648511,0.987112413422963
"1513","서울","서초구",2014,3840,1982,1858,"4",2012,3896,1968,1928,1.00731844748831,1.02746833399935,0.986748176572584
"1514","서울","서초구",2015,3926,1998,1928,"4",2013,3771,1914,1857,1.06401628298011,1.06498487623165,1.06307224170401
"1515","서울","서초구",2016,3662,1865,1797,"4",2014,4396,2198,2198,0.851363775468213,0.86564741812906,0.837120623534899
"1516","서울","서초구",2017,4031,2064,1967,"4",2015,4261,2235,2026,0.966842594808025,0.942154345310326,0.994105716874823
"1517","서울","서초구",2018,3861,2018,1843,"4",2016,4384,2280,2104,0.900085504125514,0.902975994672453,0.896906666784695
"1518","서울","서초구",2019,3854,1984,1870,"4",2017,3921,2018,1903,1.00454496060418,1.00302185470035,1.00616792981897
"1519","서울","서초구",2020,3479,1831,1648,"4",2018,3724,1931,1793,0.954771106326844,0.967377452086888,0.941119062573757
"1520","서울","성동구",2010,2581,1270,1311,"4",2008,2922,1541,1381,0.902739205891433,0.840796649162584,0.972023278045455
"1521","서울","성동구",2011,2472,1282,1190,"4",2009,2581,1309,1272,0.978847358474643,0.999167429493532,0.95791616588897
"1522","서울","성동구",2012,2192,1127,1065,"4",2010,2542,1329,1213,0.88129136504029,0.865144846446149,0.898993308905949
"1523","서울","성동구",2013,2223,1155,1068,"4",2011,2751,1396,1355,0.825854203448209,0.844085531211375,0.807048454026793
"1524","서울","성동구",2014,2396,1186,1210,"4",2012,2493,1305,1188,0.982243235299362,0.927180026380919,1.04288538695288
"1525","서울","성동구",2015,2147,1107,1040,"4",2013,2205,1106,1099,0.995125744700353,1.02113317014567,0.96895431104763
"1526","서울","성동구",2016,1995,1006,989,"4",2014,2348,1196,1152,0.86835901781124,0.858137125179535,0.879045722468525
"1527","서울","성동구",2017,2111,1092,1019,"4",2015,2394,1235,1159,0.90119463691302,0.902081072973075,0.90024019613255
"1528","서울","성동구",2018,2100,1069,1031,"4",2016,2447,1259,1188,0.877081269791491,0.866247242386065,0.888607300783821
"1529","서울","성동구",2019,2102,1042,1060,"4",2017,2438,1253,1185,0.881157458653052,0.848411483046448,0.915914991165065
"1530","서울","성동구",2020,1891,987,904,"4",2018,2425,1210,1215,0.796955912977312,0.83218842785636,0.761833042266996
"1531","서울","성북구",2010,4427,2315,2112,"4",2008,4475,2371,2104,1.01104618228304,0.996114659143236,1.0278170809817
"1532","서울","성북구",2011,4336,2285,2051,"4",2009,4124,2127,1997,1.07454628794184,1.09599507978838,1.05161130920544
"1533","서울","성북구",2012,3986,2079,1907,"4",2010,4275,2188,2087,0.952918342364645,0.969386710616062,0.935612243565223
"1534","서울","성북구",2013,4035,2069,1966,"4",2011,4605,2327,2278,0.895505826386475,0.907097557135811,0.883684924738335
"1535","서울","성북구",2014,4256,2171,2085,"4",2012,4171,2166,2005,1.04283582134205,1.0225657943946,1.0647786508005
"1536","서울","성북구",2015,3876,2005,1871,"4",2013,3912,2007,1905,1.01260352190924,1.01919408483727,1.00564907836218
"1537","서울","성북구",2016,3592,1841,1751,"4",2014,3923,1994,1929,0.935777354418966,0.941929772995331,0.929440453159367
"1538","서울","성북구",2017,3718,1878,1840,"4",2015,3778,1940,1838,1.00577756310651,0.987606064243534,1.02503800620871
"1539","서울","성북구",2018,3604,1859,1745,"4",2016,3733,1919,1814,0.986691310871624,0.988312538105225,0.984976345720861
"1540","서울","성북구",2019,3539,1827,1712,"4",2017,3300,1651,1649,1.09602670013698,1.1289673028653,1.06304281661635
"1541","서울","성북구",2020,3137,1558,1579,"4",2018,3183,1638,1545,1.00723867111634,0.970383595054544,1.04645678615975
"1542","서울","송파구",2010,5705,2999,2706,"4",2008,5867,2998,2869,0.993788740271303,1.02055103440148,0.965750399461981
"1543","서울","송파구",2011,5636,2906,2730,"4",2009,5467,2825,2642,1.05360160089761,1.04946279736906,1.05802879185599
"1544","서울","송파구",2012,5046,2619,2427,"4",2010,5586,2899,2687,0.9232106932117,0.921673653316685,0.924846723573239
"1545","서울","송파구",2013,5184,2699,2485,"4",2011,6039,3138,2901,0.877312817752859,0.877485270856708,0.877094356649479
"1546","서울","송파구",2014,5697,2942,2755,"4",2012,5611,2912,2699,1.03767286956091,1.03072115010648,1.04516864169882
"1547","서울","송파구",2015,5204,2715,2489,"4",2013,5477,2792,2685,0.971066692819633,0.992074552917265,0.94917930129534
"1548","서울","송파구",2016,5075,2599,2476,"4",2014,5856,3041,2815,0.885705802427903,0.871926243413105,0.900616488145638
"1549","서울","송파구",2017,5300,2705,2595,"4",2015,5730,3004,2726,0.945313279818236,0.918665127953427,0.974718397076687
"1550","서울","송파구",2018,5216,2717,2499,"4",2016,5807,2953,2854,0.917994899030704,0.938676794182048,0.896561199131961
"1551","서울","송파구",2019,5620,2853,2767,"4",2017,5346,2737,2609,1.07438978974492,1.06344948245932,1.08593225372122
"1552","서울","송파구",2020,4926,2515,2411,"4",2018,5422,2795,2627,0.928516029380091,0.918007157168805,0.939733675253098
"1553","서울","양천구",2010,4252,2217,2035,"4",2008,4290,2258,2032,1.01295575216433,1.00168609591413,1.02543553303733
"1554","서울","양천구",2011,4106,2175,1931,"4",2009,3822,1954,1868,1.09795053233662,1.13559792917496,1.05845659761656
"1555","서울","양천구",2012,3749,1976,1773,"4",2010,3786,1886,1900,1.01202057505811,1.06889523694961,0.955482609738211
"1556","서울","양천구",2013,3764,1877,1887,"4",2011,4271,2183,2088,0.900688369185837,0.877203643561688,0.925356453846439
"1557","서울","양천구",2014,4100,2111,1989,"4",2012,4051,2105,1946,1.03437049704801,1.02311870138777,1.04654907849259
"1558","서울","양천구",2015,4071,2096,1975,"4",2013,3656,1845,1811,1.13801877374295,1.15900363434249,1.11664802488354
"1559","서울","양천구",2016,3616,1854,1762,"4",2014,3761,1931,1830,0.982606425307616,0.979529107683829,0.985876391433612
"1560","서울","양천구",2017,3815,1936,1879,"4",2015,3757,1992,1765,1.0377861215624,0.991530114154284,1.09005829175958
"1561","서울","양천구",2018,3736,1965,1771,"4",2016,3807,1948,1859,1.00294819715357,1.02911401374578,0.975454067150982
"1562","서울","양천구",2019,3731,1899,1832,"4",2017,3466,1771,1695,1.10014822389577,1.09394702999185,1.10668346002118
"1563","서울","양천구",2020,3575,1850,1725,"4",2018,3431,1742,1689,1.06490248229278,1.08346146038364,1.04574814354552
"1564","서울","영등포구",2010,3117,1631,1486,"4",2008,3884,2030,1854,0.820185509783651,0.819686557892406,0.820685446608289
"1565","서울","영등포구",2011,2983,1555,1428,"4",2009,3388,1800,1588,0.899838069629123,0.881348720270817,0.920757705045922
"1566","서울","영등포구",2012,2571,1329,1242,"4",2010,3442,1805,1637,0.763388691032237,0.751169013772692,0.776856079659644
"1567","서울","영등포구",2013,2660,1397,1263,"4",2011,3707,1904,1803,0.733353825670638,0.748547478989231,0.717257794191102
"1568","서울","영등포구",2014,2848,1498,1350,"4",2012,3314,1664,1650,0.878298198943589,0.918434906527575,0.837755864560499
"1569","서울","영등포구",2015,2589,1324,1265,"4",2013,3087,1604,1483,0.857136387327572,0.84211908738981,0.873407721237682
"1570","서울","영등포구",2016,2377,1211,1166,"4",2014,3095,1558,1537,0.784915742793497,0.792987935083039,0.776769805454562
"1571","서울","영등포구",2017,2377,1189,1188,"4",2015,2994,1469,1525,0.811394196374708,0.825752598120472,0.797653452683177
"1572","서울","영등포구",2018,2457,1187,1270,"4",2016,3058,1525,1533,0.82114941288435,0.794091898468453,0.848260449946377
"1573","서울","영등포구",2019,2564,1285,1279,"4",2017,2702,1425,1277,0.969811182448443,0.919979506960636,1.02552747398431
"1574","서울","영등포구",2020,2265,1168,1097,"4",2018,2749,1419,1330,0.842069578402917,0.839750628016816,0.844544696545659
"1575","서울","용산구",2010,1559,795,764,"4",2008,1970,1025,945,0.808787443783726,0.791285401118368,0.827807205851432
"1576","서울","용산구",2011,1522,786,736,"4",2009,1827,960,867,0.851394061002326,0.835297541156988,0.869213312761989
"1577","서울","용산구",2012,1428,726,702,"4",2010,1828,938,890,0.798374261314141,0.789630058926706,0.80763430538529
"1578","서울","용산구",2013,1386,727,659,"4",2011,2077,1035,1042,0.681995085382116,0.716611793246899,0.647567952889641
"1579","서울","용산구",2014,1593,777,816,"4",2012,1885,951,934,0.863692070839305,0.833547574001146,0.894563007410783
"1580","서울","용산구",2015,1414,700,714,"4",2013,1711,846,865,0.844605511728649,0.844146000122558,0.845181061047933
"1581","서울","용산구",2016,1286,658,628,"4",2014,1700,845,855,0.773119377365041,0.794436290103507,0.752075050342291
"1582","서울","용산구",2017,1253,632,621,"4",2015,1760,911,849,0.727600375426478,0.707764199745223,0.748947822380941
"1583","서울","용산구",2018,1248,660,588,"4",2016,1756,880,876,0.726347732465659,0.765158052968233,0.687291340940805
"1584","서울","용산구",2019,1245,642,603,"4",2017,1564,810,754,0.813555366166979,0.808611473260257,0.818867469736191
"1585","서울","용산구",2020,1090,553,537,"4",2018,1492,780,712,0.746641604502094,0.723303253489629,0.77225716166649
"1586","서울","은평구",2010,4307,2236,2071,"4",2008,3950,2053,1897,1.1143773784139,1.11115012595354,1.11784199323802
"1587","서울","은평구",2011,4155,2143,2012,"4",2009,3590,1837,1753,1.18285385835416,1.19015329886476,1.17520522244108
"1588","서울","은평구",2012,3852,1988,1864,"4",2010,4075,2089,1986,0.966080189819049,0.970885086517216,0.961024183000362
"1589","서울","은평구",2013,4137,2127,2010,"4",2011,4477,2298,2179,0.944393388059898,0.944294272505618,0.944509824355343
"1590","서울","은평구",2014,4359,2270,2089,"4",2012,4241,2218,2023,1.05044449119555,1.0441291134583,1.0573291597592
"1591","서울","은평구",2015,3960,2062,1898,"4",2013,4060,2087,1973,0.996835884826639,1.00798971743843,0.985001235585634
"1592","서울","은평구",2016,3737,1924,1813,"4",2014,4160,2137,2023,0.918087931507651,0.918523845834273,0.917634163065306
"1593","서울","은평구",2017,3803,1941,1862,"4",2015,3970,2022,1948,0.979017218290117,0.979341761168045,0.978719804809955
"1594","서울","은평구",2018,3569,1837,1732,"4",2016,4050,2120,1930,0.900629226098134,0.884022228492229,0.918878798595661
"1595","서울","은평구",2019,3686,1930,1756,"4",2017,3464,1830,1634,1.08750674398228,1.07595995790797,1.10037347204206
"1596","서울","은평구",2020,3150,1650,1500,"4",2018,3392,1748,1644,0.949093986075964,0.963013567808989,0.93423707523981
"1597","서울","종로구",2010,1109,577,532,"4",2008,1167,628,539,0.971214597748552,0.937359228370851,1.01062612232695
"1598","서울","종로구",2011,1065,557,508,"4",2009,1026,528,498,1.0608567848076,1.07624503914976,1.04448455403036
"1599","서울","종로구",2012,954,490,464,"4",2010,1059,545,514,0.920676219834304,0.917253690408402,0.924320348620144
"1600","서울","종로구",2013,988,528,460,"4",2011,1056,534,522,0.95619735424496,1.00874769529894,0.902308359871461
"1601","서울","종로구",2014,1009,520,489,"4",2012,1037,538,499,0.994413292916562,0.986077292548901,1.00340431874213
"1602","서울","종로구",2015,976,504,472,"4",2013,893,480,413,1.11699922058735,1.07122127415553,1.17019866795752
"1603","서울","종로구",2016,876,454,422,"4",2014,966,490,476,0.926790324188843,0.945256479041028,0.907764407864107
"1604","서울","종로구",2017,926,459,467,"4",2015,881,440,441,1.07421098589724,1.06426529185582,1.08429122606382
"1605","서울","종로구",2018,862,443,419,"4",2016,992,521,471,0.888075941584567,0.867472853397127,0.910879164840608
"1606","서울","종로구",2019,946,478,468,"4",2017,859,438,421,1.12551810097681,1.11338066763719,1.13823362120809
"1607","서울","종로구",2020,764,381,383,"4",2018,880,456,424,0.887289204829736,0.852412918657593,0.924912331602039
"1608","서울","중구",2010,1138,570,568,"4",2008,1007,500,507,1.15496095562046,1.16304024051171,1.14711782638045
"1609","서울","중구",2011,1067,541,526,"4",2009,843,429,414,1.29357423277457,1.28655946124573,1.30092738388273
"1610","서울","중구",2012,976,495,481,"4",2010,850,430,420,1.17350623998177,1.17442863943961,1.1726365818491
"1611","서울","중구",2013,951,469,482,"4",2011,1078,546,532,0.901604908422993,0.876334864083276,0.92769039137422
"1612","서울","중구",2014,1089,531,558,"4",2012,939,474,465,1.18526865325766,1.14289430696521,1.2287086013554
"1613","서울","중구",2015,977,481,496,"4",2013,837,432,405,1.19295377836641,1.13592908480778,1.25399067134213
"1614","서울","중구",2016,883,443,440,"4",2014,883,442,441,1.02200850818085,1.02251890637987,1.02160201170895
"1615","서울","중구",2017,868,456,412,"4",2015,856,439,417,1.03633573025815,1.0597177590084,1.01164657026064
"1616","서울","중구",2018,898,439,459,"4",2016,871,444,427,1.05368959856074,1.0087218776368,1.10065817334529
"1617","서울","중구",2019,919,459,460,"4",2017,824,425,399,1.13983715900267,1.10182759627426,1.18046356855364
"1618","서울","중구",2020,907,455,452,"4",2018,802,397,405,1.1558126146135,1.1692591573486,1.14274956340049
"1619","서울","중랑구",2010,3259,1645,1614,"4",2008,3434,1740,1694,0.969925954618923,0.96450957634693,0.975568517605083
"1620","서울","중랑구",2011,3043,1525,1518,"4",2009,3064,1619,1445,1.015003880677,0.960976759955986,1.07565147454296
"1621","서울","중랑구",2012,2670,1410,1260,"4",2010,3170,1703,1467,0.86080842802614,0.844684168866869,0.879443784201205
"1622","서울","중랑구",2013,2747,1452,1295,"4",2011,3284,1661,1623,0.854889577336415,0.891839849817279,0.816994063850504
"1623","서울","중랑구",2014,2883,1481,1402,"4",2012,3179,1618,1561,0.926848231860768,0.933827009844214,0.91962922224016
"1624","서울","중랑구",2015,2812,1423,1389,"4",2013,2926,1449,1477,0.9821899948751,1.00190467851281,0.962918216702013
"1625","서울","중랑구",2016,2563,1281,1282,"4",2014,3030,1589,1441,0.864491025236803,0.822460638432815,0.910944035934317
"1626","서울","중랑구",2017,2652,1358,1294,"4",2015,3072,1562,1510,0.882280782452997,0.886969386197918,0.877455259466824
"1627","서울","중랑구",2018,2647,1368,1279,"4",2016,3172,1634,1538,0.852855145382945,0.854129919592447,0.851494528139117
"1628","서울","중랑구",2019,2717,1416,1301,"4",2017,2895,1489,1406,0.959169988506861,0.97019368972735,0.947457260765394
"1629","서울","중랑구",2020,2369,1218,1151,"4",2018,2605,1308,1297,0.92941963757406,0.950012750780131,0.908663325726075
"1630","울산","남구",2010,3139,1664,1475,"4",2008,3074,1641,1433,1.04361896785286,1.03450985182949,1.05393416317703
"1631","울산","남구",2011,2933,1576,1357,"4",2009,2817,1497,1320,1.06409334557843,1.0740495136744,1.05262472982277
"1632","울산","남구",2012,2648,1402,1246,"4",2010,2851,1498,1353,0.949238347829844,0.954830075889153,0.942948335358972
"1633","울산","남구",2013,2734,1383,1351,"4",2011,3090,1622,1468,0.904262544131533,0.869883754422579,0.942316825857824
"1634","울산","남구",2014,2968,1563,1405,"4",2012,2976,1553,1423,1.01926117348144,1.02678002729285,1.01097188153217
"1635","울산","남구",2015,2840,1482,1358,"4",2013,2925,1531,1394,0.992309115635421,0.987558662746721,0.997481038163935
"1636","울산","남구",2016,2702,1411,1291,"4",2014,2886,1512,1374,0.95684926857403,0.952061739628022,0.962071084637202
"1637","울산","남구",2017,2649,1410,1239,"4",2015,2927,1513,1414,0.924940395685366,0.95075818875101,0.897200587623373
"1638","울산","남구",2018,2678,1414,1264,"4",2016,3062,1581,1481,0.893840230211728,0.912446541764353,0.873895831708994
"1639","울산","남구",2019,2817,1450,1367,"4",2017,2655,1368,1287,1.08436834935798,1.08136372008181,1.08757100366021
"1640","울산","남구",2020,2519,1270,1249,"4",2018,2734,1419,1315,0.94163841701081,0.913085015052531,0.972532980413747
"1641","울산","동구",2010,1672,903,769,"4",2008,1714,902,812,0.996965125833359,1.02134179132345,0.969701266874283
"1642","울산","동구",2011,1581,825,756,"4",2009,1627,873,754,0.993113369043589,0.964116676134086,1.02663981280358
"1643","울산","동구",2012,1500,801,699,"4",2010,1632,867,765,0.939346055313279,0.942547636182322,0.935585307567999
"1644","울산","동구",2013,1650,883,767,"4",2011,1913,977,936,0.881502372450809,0.922053307091027,0.839048697684821
"1645","울산","동구",2014,1879,950,929,"4",2012,1847,994,853,1.03971520675247,0.975050503447112,1.11515268724029
"1646","울산","동구",2015,1775,941,834,"4",2013,1912,987,925,0.948778819048642,0.97266292177387,0.923191868045407
"1647","울산","동구",2016,1772,900,872,"4",2014,2006,1050,956,0.902791164753969,0.87446634624941,0.933955631434717
"1648","울산","동구",2017,1890,997,893,"4",2015,2058,1075,983,0.938579242206901,0.946186144259633,0.930176993057283
"1649","울산","동구",2018,1869,975,894,"4",2016,2182,1106,1076,0.875405087896427,0.899372033326133,0.850732256514658
"1650","울산","동구",2019,1920,981,939,"4",2017,1898,958,940,1.03385476064659,1.04470431449107,1.02283455378787
"1651","울산","동구",2020,1680,867,813,"4",2018,1927,970,957,0.891008974438933,0.91187908168173,0.869853790405729
"1652","울산","북구",2010,2132,1161,971,"4",2008,2099,1108,991,1.03807629320704,1.06901143140327,1.00325937766237
"1653","울산","북구",2011,2142,1117,1025,"4",2009,2127,1094,1033,1.02921590245575,1.04165940909874,1.01599412422498
"1654","울산","북구",2012,2068,1054,1014,"4",2010,2258,1144,1114,0.936011335216117,0.939949403063541,0.932009666198664
"1655","울산","북구",2013,2248,1152,1096,"4",2011,2656,1339,1317,0.865013225297645,0.877731717221215,0.852103661785318
"1656","울산","북구",2014,2526,1284,1242,"4",2012,2416,1241,1175,1.06854035251027,1.05556050498116,1.08230927864071
"1657","울산","북구",2015,2349,1211,1138,"4",2013,2317,1242,1075,1.03612342931239,0.994746540144424,1.08393053359879
"1658","울산","북구",2016,2278,1223,1055,"4",2014,2491,1255,1236,0.934618780263336,0.994197395782363,0.87398029559732
"1659","울산","북구",2017,2446,1225,1221,"4",2015,2431,1249,1182,1.02831460757316,1.00060700815168,1.05770812341719
"1660","울산","북구",2018,2599,1328,1271,"4",2016,2594,1336,1258,1.02397845518968,1.01410169095989,1.03450492337223
"1661","울산","북구",2019,2828,1459,1369,"4",2017,2516,1286,1230,1.14874406245447,1.15745526104785,1.13963555234115
"1662","울산","북구",2020,2713,1396,1317,"4",2018,2628,1356,1272,1.0550643389249,1.05030544930546,1.06014755502166
"1663","울산","울주군",2010,2381,1248,1133,"4",2008,2272,1192,1080,1.07103972622297,1.06814010078787,1.07417194856147
"1664","울산","울주군",2011,2323,1228,1095,"4",2009,2160,1149,1011,1.09913229838153,1.09035577492891,1.1089976248633
"1665","울산","울주군",2012,2213,1157,1056,"4",2010,2092,1121,971,1.08112085497333,1.05297397238685,1.11355671389573
"1666","울산","울주군",2013,2145,1160,985,"4",2011,2402,1230,1172,0.912659554557834,0.962149963624012,0.860550321626185
"1667","울산","울주군",2014,2461,1243,1218,"4",2012,2279,1185,1094,1.1036256861049,1.07014510249172,1.13998101496867
"1668","울산","울주군",2015,2325,1222,1103,"4",2013,2110,1076,1034,1.12614681588648,1.15864081874496,1.09225144043762
"1669","울산","울주군",2016,2179,1093,1086,"4",2014,2283,1170,1113,0.975451835009227,0.953068663127384,0.999084711793922
"1670","울산","울주군",2017,2320,1183,1137,"4",2015,2259,1166,1093,1.0496059048161,1.03508516485011,1.06514309220882
"1671","울산","울주군",2018,2262,1199,1063,"4",2016,2279,1121,1158,1.0143849256275,1.09119774666537,0.93992317446804
"1672","울산","울주군",2019,2328,1143,1185,"4",2017,2020,990,1030,1.17783950843813,1.17787966941777,1.17800946003734
"1673","울산","울주군",2020,2032,1016,1016,"4",2018,2030,1055,975,1.02301541311502,0.982496785865055,1.06698114442486
"1674","울산","중구",2010,2069,1134,935,"4",2008,1971,1027,944,1.07282374603053,1.12650338470104,1.01416184875291
"1675","울산","중구",2011,1893,1003,890,"4",2009,1704,910,794,1.13536508567274,1.12447403242072,1.14772318976312
"1676","울산","중구",2012,1696,894,802,"4",2010,1786,940,846,0.970507519526717,0.970285530998015,0.970670112575876
"1677","울산","중구",2013,1774,949,825,"4",2011,1965,1033,932,0.922668240973447,0.937250716059185,0.906370347029867
"1678","울산","중구",2014,2023,1048,975,"4",2012,1899,987,912,1.08874313430745,1.08326327525932,1.09465541513296
"1679","울산","중구",2015,2063,1059,1004,"4",2013,1920,997,923,1.0981268501964,1.08365413319072,1.11378063900399
"1680","울산","중구",2016,2079,1113,966,"4",2014,2140,1134,1006,0.992876489957001,1.00131794585966,0.983211157148206
"1681","울산","중구",2017,2179,1146,1033,"4",2015,2290,1201,1089,0.972470104509199,0.973490012435854,0.971270267217728
"1682","울산","중구",2018,2181,1134,1047,"4",2016,2355,1255,1100,0.946497051525447,0.921847789711529,0.974589322438714
"1683","울산","중구",2019,2188,1187,1001,"4",2017,2176,1132,1044,1.02764458451273,1.06977928018056,0.981750726338405
"1684","울산","중구",2020,1911,974,937,"4",2018,2043,1033,1010,0.955975653026725,0.961941198568647,0.949917458308588
"1685","인천","강화군",2010,430,230,200,"4",2008,410,205,205,1.07186258175064,1.14462668086305,0.998950082402763
"1686","인천","강화군",2011,381,188,193,"4",2009,396,198,198,0.983296064689149,0.968684942478302,0.998067171976397
"1687","인천","강화군",2012,411,203,208,"4",2010,381,183,198,1.10248161906123,1.13170917852496,1.0756371594357
"1688","인천","강화군",2013,377,183,194,"4",2011,417,212,205,0.923974118906905,0.88065360813325,0.96898157993068
"1689","인천","강화군",2014,422,217,205,"4",2012,365,176,189,1.18160983685566,1.25787346586444,1.1106052172745
"1690","인천","강화군",2015,382,186,196,"4",2013,376,195,181,1.03831715458799,0.973124087877548,1.10877940085478
"1691","인천","강화군",2016,394,210,184,"4",2014,375,199,176,1.07379027259534,1.0766042956337,1.07046582693842
"1692","인천","강화군",2017,402,213,189,"4",2015,360,185,175,1.14124283413528,1.17462101104313,1.10583774121986
"1693","인천","강화군",2018,386,204,182,"4",2016,381,195,186,1.03542069332758,1.06729738670441,1.00190396705503
"1694","인천","강화군",2019,353,183,170,"4",2017,318,157,161,1.13449372134541,1.18916283391241,1.08116181278684
"1695","인천","강화군",2020,334,166,168,"4",2018,324,160,164,1.05355198065556,1.05846863993939,1.0488975865229
"1696","인천","계양구",2010,3450,1737,1713,"4",2008,3452,1787,1665,1.02141638274158,0.991665389297386,1.05344235942032
"1697","인천","계양구",2011,3241,1688,1553,"4",2009,3071,1548,1523,1.07858338489552,1.11247785823461,1.04409304984949
"1698","인천","계양구",2012,2837,1446,1391,"4",2010,3221,1644,1577,0.900167071626533,0.897338641193889,0.903156660581991
"1699","인천","계양구",2013,2919,1512,1407,"4",2011,3470,1777,1693,0.859724160051843,0.86806901225884,0.850951467861314
"1700","인천","계양구",2014,3228,1646,1582,"4",2012,3127,1593,1534,1.05501869664464,1.05415371850656,1.05596317217744
"1701","인천","계양구",2015,2964,1488,1476,"4",2013,2998,1563,1435,1.01041801809474,0.971256287325,1.05317880116177
"1702","인천","계양구",2016,2720,1426,1294,"4",2014,3116,1591,1525,0.89212552703848,0.914406355359481,0.868824551996659
"1703","인천","계양구",2017,2836,1430,1406,"4",2015,2983,1523,1460,0.971644696346256,0.957912905007287,0.986052678941604
"1704","인천","계양구",2018,2606,1319,1287,"4",2016,2928,1476,1452,0.909615496010686,0.911692386508672,0.907568853273874
"1705","인천","계양구",2019,2465,1258,1207,"4",2017,2400,1250,1150,1.04968790527741,1.02674008600964,1.07467484191012
"1706","인천","계양구",2020,2091,1085,1006,"4",2018,2292,1174,1118,0.932382107594307,0.942869378160742,0.921348280384266
"1707","인천","남동구",2010,4753,2476,2277,"4",2008,4405,2260,2145,1.10274834038219,1.1177176042179,1.08693453196824
"1708","인천","남동구",2011,4547,2375,2172,"4",2009,4399,2237,2162,1.05639297265249,1.08314729596159,1.02865983739744
"1709","인천","남동구",2012,4400,2279,2121,"4",2010,4640,2428,2212,0.969145999137011,0.95760307672411,0.981800385576703
"1710","인천","남동구",2013,4671,2497,2174,"4",2011,5385,2749,2636,0.886499859185281,0.926688327033675,0.844465256495522
"1711","인천","남동구",2014,5134,2624,2510,"4",2012,5221,2626,2595,1.00497829553734,1.01943372987491,0.990384903468866
"1712","인천","남동구",2015,4980,2508,2472,"4",2013,5116,2656,2460,0.994840181927408,0.963361645002173,1.02891858487485
"1713","인천","남동구",2016,5079,2599,2480,"4",2014,5270,2713,2557,0.984967972115849,0.977341579881774,0.993089991970209
"1714","인천","남동구",2017,5243,2696,2547,"4",2015,5602,2898,2704,0.956513853693714,0.949098739729633,0.964472635494391
"1715","인천","남동구",2018,5242,2696,2546,"4",2016,5745,2952,2793,0.932527171433247,0.931737177417506,0.933372747061357
"1716","인천","남동구",2019,5246,2679,2567,"4",2017,5126,2596,2530,1.04593379514567,1.05282918536307,1.03889821465063
"1717","인천","남동구",2020,4656,2338,2318,"4",2018,4968,2545,2423,0.957824398971422,0.937230924866918,0.979552393018921
"1718","인천","동구",2010,796,377,419,"4",2008,721,378,343,1.12832007283211,1.0175117670865,1.25079908641378
"1719","인천","동구",2011,859,429,430,"4",2009,658,341,317,1.33420259654612,1.28349092755962,1.38891876599059
"1720","인천","동구",2012,742,382,360,"4",2010,691,363,328,1.09743894800317,1.07361019736957,1.12381884270311
"1721","인천","동구",2013,747,394,353,"4",2011,805,404,401,0.948373112560364,0.994957996268924,0.901359385449825
"1722","인천","동구",2014,839,415,424,"4",2012,695,367,328,1.23376278901256,1.15364429421187,1.32360885918366
"1723","인천","동구",2015,754,378,376,"4",2013,636,311,325,1.21162643894396,1.23999890255945,1.18460111310161
"1724","인천","동구",2016,704,332,372,"4",2014,668,347,321,1.07708681101694,0.976109408589639,1.18660332218123
"1725","인천","동구",2017,714,361,353,"4",2015,677,351,326,1.07786421689974,1.04927657026223,1.10872734222509
"1726","인천","동구",2018,663,345,318,"4",2016,653,335,318,1.03765948074104,1.05066478915041,1.02392383446283
"1727","인천","동구",2019,658,325,333,"4",2017,511,258,253,1.31601095573972,1.28514918457197,1.34769421690167
"1728","인천","동구",2020,539,286,253,"4",2018,486,271,215,1.13346211092485,1.07667996629232,1.20489641915859
"1729","인천","미추홀구",2020,2815,1453,1362,"4",2018,3234,1611,1623,0.889596150441894,0.920152825129603,0.859263254798754
"1730","인천","부평구",2010,5382,2831,2551,"4",2008,5466,2856,2610,1.00630255964678,1.01128032117323,1.00077766349222
"1731","인천","부평구",2011,4839,2526,2313,"4",2009,4984,2613,2371,0.992275114584093,0.986242756370842,0.998876351376014
"1732","인천","부평구",2012,4485,2343,2142,"4",2010,4856,2528,2328,0.943926721414971,0.945551328114225,0.942115486863997
"1733","인천","부평구",2013,4448,2329,2119,"4",2011,5433,2796,2637,0.836718911170331,0.849810732171204,0.82278900463661
"1734","인천","부평구",2014,5006,2590,2416,"4",2012,4943,2594,2349,1.03503430951918,1.01863755188266,1.0531289842751
"1735","인천","부평구",2015,4537,2358,2179,"4",2013,4723,2403,2320,0.981760025749842,1.00110566730426,0.961693980730393
"1736","인천","부평구",2016,4474,2305,2169,"4",2014,4839,2464,2375,0.944919625046727,0.954377333382997,0.935111914505214
"1737","인천","부평구",2017,4338,2237,2101,"4",2015,4797,2442,2355,0.924217825409322,0.934566510778017,0.913487887985737
"1738","인천","부평구",2018,4209,2171,2038,"4",2016,4773,2418,2355,0.901243203631508,0.915995661976308,0.88609629496189
"1739","인천","부평구",2019,4246,2170,2076,"4",2017,4257,2165,2092,1.0193676593225,1.0225668821808,1.01609267702908
"1740","인천","부평구",2020,3626,1832,1794,"4",2018,4104,2089,2015,0.902973404157834,0.894698932846851,0.911622510683037
"1741","인천","서구",2010,4697,2443,2254,"4",2008,4605,2345,2260,1.04242648489152,1.06284640989418,1.02120545260143
"1742","인천","서구",2011,4511,2310,2201,"4",2009,4164,2211,1953,1.10717588386258,1.06589181508013,1.15394590868033
"1743","인천","서구",2012,4547,2382,2165,"4",2010,4468,2329,2139,1.04007893614555,1.04342721177635,1.03636984647594
"1744","인천","서구",2013,5127,2642,2485,"4",2011,5207,2672,2535,1.00630643776516,1.0087562754202,1.00372809808289
"1745","인천","서구",2014,5649,2854,2795,"4",2012,5443,2733,2710,1.06068823492809,1.06537923316079,1.05603952668768
"1746","인천","서구",2015,5471,2745,2726,"4",2013,5405,2849,2556,1.03448816804022,0.982968927295098,1.09202518495527
"1747","인천","서구",2016,5111,2657,2454,"4",2014,5843,2996,2847,0.89397321330007,0.904773007003381,0.882581345195571
"1748","인천","서구",2017,5554,2862,2692,"4",2015,5951,3071,2880,0.953828811029479,0.950779267380911,0.957084361935397
"1749","인천","서구",2018,5863,3035,2828,"4",2016,6008,3134,2874,0.99734285676836,0.98798327622148,1.00753535276997
"1750","인천","서구",2019,5921,3095,2826,"4",2017,5438,2776,2662,1.11278270999242,1.13744676942204,1.08700554327271
"1751","인천","서구",2020,5318,2705,2613,"4",2018,5587,2870,2717,0.972801368624619,0.961557506749859,0.984730577641288
"1752","인천","연수구",2010,2810,1408,1402,"4",2008,2513,1311,1202,1.14279502904424,1.09569543715156,1.19429385683602
"1753","인천","연수구",2011,2675,1400,1275,"4",2009,2291,1160,1131,1.19330980331024,1.23128882086842,1.15429079481884
"1754","인천","연수구",2012,2614,1304,1310,"4",2010,2407,1242,1165,1.10990039068747,1.07113913158409,1.15136499840885
"1755","인천","연수구",2013,2738,1409,1329,"4",2011,2772,1445,1327,1.0094730502883,0.99479372238269,1.02546705049066
"1756","인천","연수구",2014,3203,1673,1530,"4",2012,2706,1439,1267,1.20971664881865,1.18611019005407,1.23646682456838
"1757","인천","연수구",2015,3134,1630,1504,"4",2013,2742,1439,1303,1.16811621613376,1.1556243931788,1.18187371222724
"1758","인천","연수구",2016,3226,1686,1540,"4",2014,3090,1602,1488,1.06699011242441,1.0737049332538,1.05970611900051
"1759","인천","연수구",2017,3514,1827,1687,"4",2015,3227,1660,1567,1.11290297420127,1.12284639580158,1.10233535975673
"1760","인천","연수구",2018,3667,1873,1794,"4",2016,3512,1805,1707,1.06711423675944,1.05864526922216,1.07610975924213
"1761","인천","연수구",2019,3981,2017,1964,"4",2017,3377,1719,1658,1.20480185699377,1.19707100472129,1.21289892091978
"1762","인천","연수구",2020,3979,2025,1954,"4",2018,3505,1818,1687,1.16022021513597,1.13637334599243,1.18597935538848
"1763","인천","옹진군",2010,119,64,55,"4",2008,154,74,80,0.789733847230655,0.882344421440846,0.703947636193197
"1764","인천","옹진군",2011,114,53,61,"4",2009,118,65,53,0.987364151971327,0.831864139637259,1.17847837551383
"1765","인천","옹진군",2012,90,51,39,"4",2010,151,72,79,0.60914414394885,0.722649272247776,0.50548138663355
"1766","인천","옹진군",2013,122,57,65,"4",2011,173,74,99,0.720722762994586,0.785838000345753,0.672273224647314
"1767","인천","옹진군",2014,118,50,68,"4",2012,153,70,83,0.788215712191765,0.728721955207841,0.838877358355091
"1768","인천","옹진군",2015,107,55,52,"4",2013,127,62,65,0.861062286420084,0.905025654048448,0.819139067570266
"1769","인천","옹진군",2016,114,62,52,"4",2014,131,66,65,0.889381449867302,0.958379783515767,0.819139067570266
"1770","인천","옹진군",2017,111,57,54,"4",2015,141,79,62,0.804559889418965,0.736101418045389,0.891804630016015
"1771","인천","옹진군",2018,108,63,45,"4",2016,119,56,63,0.927537133475055,1.14773707945235,0.731374167473451
"1772","인천","옹진군",2019,102,47,55,"4",2017,131,71,60,0.79576234988127,0.675350769755999,0.938596848257596
"1773","인천","옹진군",2020,97,52,45,"4",2018,113,48,65,0.877299338880905,1.10522829873189,0.708870346935807
"1774","인천","중구",2010,938,490,448,"4",2008,908,464,444,1.05577530911193,1.07737771825987,1.03314837351205
"1775","인천","중구",2011,1006,515,491,"4",2009,792,425,367,1.29815727175497,1.23625536401142,1.36988175128406
"1776","인천","중구",2012,877,477,400,"4",2010,841,445,396,1.06575679152747,1.09357420603999,1.03426649945741
"1777","인천","중구",2013,1066,572,494,"4",2011,972,517,455,1.12084472193496,1.12874379444959,1.11168873455965
"1778","인천","중구",2014,1343,668,675,"4",2012,1003,491,512,1.36845207027605,1.38798528006186,1.34989958645002
"1779","인천","중구",2015,1244,623,621,"4",2013,993,489,504,1.28034097097379,1.29977768779607,1.2616204388917
"1780","인천","중구",2016,1201,612,589,"4",2014,1165,603,562,1.05358988697442,1.03543776322069,1.07311590480179
"1781","인천","중구",2017,1244,643,601,"4",2015,1284,652,632,0.990170236897955,1.00612807373942,0.97369972232937
"1782","인천","중구",2018,1345,690,655,"4",2016,1245,635,610,1.10409754498252,1.10857544682012,1.09945919930025
"1783","인천","중구",2019,1442,746,696,"4",2017,1095,547,548,1.34587787104729,1.39136601466009,1.30045800873382
"1784","인천","중구",2020,1391,714,677,"4",2018,1113,551,562,1.27728107356654,1.32201536556399,1.23344561553619
"1785","전남","강진군",2010,257,130,127,"4",2008,287,149,138,0.915178350531282,0.890116750656558,0.942306717223041
"1786","전남","강진군",2011,231,119,112,"4",2009,273,140,133,0.864776429999179,0.867179126697331,0.862251650073964
"1787","전남","강진군",2012,227,122,105,"4",2010,306,142,164,0.75815663842174,0.876519084151404,0.655560991576813
"1788","전남","강진군",2013,223,117,106,"4",2011,337,161,176,0.676284561793261,0.741395380515804,0.616681400301478
"1789","전남","강진군",2014,249,119,130,"4",2012,303,152,151,0.839868378010003,0.79871761669491,0.881523830994491
"1790","전남","강진군",2015,239,128,111,"4",2013,257,124,133,0.950428145740166,1.05312076107456,0.854552974626875
"1791","전남","강진군",2016,194,96,98,"4",2014,291,155,136,0.681339005453898,0.631872456644735,0.737827468951158
"1792","전남","강진군",2017,219,117,102,"4",2015,302,155,147,0.741125375137767,0.77009455653577,0.710477762688496
"1793","전남","강진군",2018,223,118,105,"4",2016,247,128,119,0.92270403775032,0.94050677344012,0.903462206878969
"1794","전남","강진군",2019,192,98,94,"4",2017,225,118,107,0.87211392698099,0.847293663173863,0.899521873266413
"1795","전남","강진군",2020,181,95,86,"4",2018,204,93,111,0.906782058729085,1.0421507531467,0.793310358232464
"1796","전남","고흥군",2010,415,227,188,"4",2008,418,227,191,1.01467351888768,1.02021073729098,1.00784126114666
"1797","전남","고흥군",2011,371,206,165,"4",2009,416,218,198,0.911454703209362,0.9640523480823,0.85326986205236
"1798","전남","고흥군",2012,384,203,181,"4",2010,366,197,169,1.07227122169794,1.05128314553334,1.09662848543061
"1799","전남","고흥군",2013,350,179,171,"4",2011,409,221,188,0.87457940797872,0.826324533823914,0.931334977091193
"1800","전남","고흥군",2014,388,203,185,"4",2012,348,172,176,1.13948075050048,1.20408592831435,1.07628357599786
"1801","전남","고흥군",2015,312,157,155,"4",2013,350,183,167,0.911047584435498,0.875262763686795,0.950348469112209
"1802","전남","고흥군",2016,319,164,155,"4",2014,345,182,163,0.944987577129537,0.9193107742622,0.973669903937049
"1803","전남","고흥군",2017,326,168,158,"4",2015,316,164,152,1.05435054957898,1.04509392600539,1.06434188056005
"1804","전남","고흥군",2018,292,157,135,"4",2016,332,165,167,0.898874952978336,0.970745974270809,0.827722860194505
"1805","전남","고흥군",2019,310,148,162,"4",2017,289,154,135,1.09627210220091,0.980462267006914,1.2287086013554
"1806","전남","고흥군",2020,260,145,115,"4",2018,261,127,134,1.01809276677019,1.1648075347023,0.878740604203177
"1807","전남","곡성군",2010,196,98,98,"4",2008,211,122,89,0.949353874897849,0.819513543069802,1.12746669412761
"1808","전남","곡성군",2011,188,98,90,"4",2009,189,98,91,1.01660105575661,1.02021073729098,1.01267192419401
"1809","전남","곡성군",2012,160,85,75,"4",2010,206,119,87,0.793793016062794,0.728721955207841,0.882692960743821
"1810","전남","곡성군",2013,177,102,75,"4",2011,179,88,91,1.01058941870397,1.18251699095091,0.843893270161675
"1811","전남","곡성군",2014,154,80,74,"4",2012,192,111,81,0.819735990936721,0.735287017867371,0.935436589509254
"1812","전남","곡성군",2015,177,105,72,"4",2013,162,87,75,1.116638925605,1.23128882086842,0.982966881084319
"1813","전남","곡성군",2016,152,84,68,"4",2014,167,78,89,0.930211336787358,1.09868848631336,0.782323828578343
"1814","전남","곡성군",2017,155,73,82,"4",2015,188,91,97,0.842613397702294,0.818410811233422,0.865585097174765
"1815","전남","곡성군",2018,169,83,86,"4",2016,147,79,68,1.17496216246642,1.07186697715381,1.29496249652652
"1816","전남","곡성군",2019,129,70,59,"4",2017,137,70,67,0.96232917923598,1.02021073729098,0.901664272138912
"1817","전남","곡성군",2020,113,65,48,"4",2018,127,71,56,0.909346152948313,0.933995745407233,0.877649000968142
"1818","전남","광양시",2010,1497,806,691,"4",2008,1521,799,722,1.00588214118786,1.02914875376286,0.979960345725508
"1819","전남","광양시",2011,1518,791,727,"4",2009,1430,734,696,1.08490133945351,1.09943691171276,1.0695296374346
"1820","전남","광양시",2012,1418,726,692,"4",2010,1501,752,749,0.965495046369382,0.984937493714428,0.94600172690024
"1821","전남","광양시",2013,1462,730,732,"4",2011,1689,897,792,0.884651532836234,0.830271837483182,0.946353847003527
"1822","전남","광양시",2014,1610,845,765,"4",2012,1622,830,792,1.01444740947667,1.038648280736,0.989017340106145
"1823","전남","광양시",2015,1533,785,748,"4",2013,1562,792,770,1.00303395841309,1.01119372319876,0.994668867763894
"1824","전남","광양시",2016,1459,747,712,"4",2014,1716,901,815,0.868945462375208,0.84583509517909,0.89451996335894
"1825","전남","광양시",2017,1652,866,786,"4",2015,1692,842,850,0.997847550540638,1.04929037825889,0.94682839280916
"1826","전남","광양시",2018,1606,802,804,"4",2016,1752,901,851,0.93684113249911,0.90811211021905,0.967373399421994
"1827","전남","광양시",2019,1648,835,813,"4",2017,1587,800,787,1.06129175896789,1.06484495704746,1.05775105135741
"1828","전남","광양시",2020,1444,733,711,"4",2018,1465,721,744,1.00735855686904,1.03719066634436,0.978507857934239
"1829","전남","구례군",2010,180,100,80,"4",2008,157,84,73,1.17172949982518,1.21453659201307,1.12210831174009
"1830","전남","구례군",2011,151,76,75,"4",2009,174,88,86,0.886915429513264,0.881091091296754,0.892956832380377
"1831","전남","구례군",2012,171,91,80,"4",2010,173,86,87,1.01019338091864,1.07952531504045,0.941539158126742
"1832","전남","구례군",2013,162,83,79,"4",2011,199,111,88,0.831986825755263,0.762860281037398,0.91920435139277
"1833","전남","구례군",2014,184,98,86,"4",2012,176,98,78,1.06846344037089,1.02021073729098,1.12894166363851
"1834","전남","구례군",2015,170,97,73,"4",2013,163,90,73,1.06589844411499,1.0995604613025,1.02392383446283
"1835","전남","구례군",2016,170,87,83,"4",2014,163,81,82,1.06589844411499,1.09578190301624,1.03641071049287
"1836","전남","구례군",2017,155,80,75,"4",2015,178,92,86,0.889951229033884,0.887139771557372,0.892956832380377
"1837","전남","구례군",2018,158,75,83,"4",2016,152,68,84,1.06235094929325,1.12523243083564,1.01173426500494
"1838","전남","구례군",2019,136,59,77,"4",2017,160,80,80,0.86870723195372,0.752405418752096,0.985526690670476
"1839","전남","구례군",2020,139,70,69,"4",2018,119,65,54,1.19377464400956,1.09868848631336,1.30834712181362
"1840","전남","나주시",2010,670,326,344,"4",2008,697,387,310,0.982418508581302,0.859402326503511,1.13622515824263
"1841","전남","나주시",2011,576,311,265,"4",2009,627,343,284,0.938878629524989,0.925030726814852,0.955421887791023
"1842","전남","나주시",2012,551,309,242,"4",2010,570,313,257,0.987941557908153,1.00717290039269,0.964161742957219
"1843","전남","나주시",2013,552,290,262,"4",2011,634,324,310,0.889824442453987,0.913151585846863,0.865380789126651
"1844","전남","나주시",2014,597,315,282,"4",2012,559,293,266,1.0914831473774,1.09681359128552,1.08551323803954
"1845","전남","나주시",2015,630,333,297,"4",2013,535,285,250,1.20348665449333,1.19203570357156,1.21642151534184
"1846","전남","나주시",2016,728,369,359,"4",2014,633,332,301,1.17539051177829,1.13390892186859,1.22122477266497
"1847","전남","나주시",2017,914,479,435,"4",2015,796,385,411,1.17351228200665,1.26930115107111,1.08371500727818
"1848","전남","나주시",2018,1006,475,531,"4",2016,1080,568,512,0.951981999286975,0.853169190516223,1.06192100800735
"1849","전남","나주시",2019,1145,584,561,"4",2017,1039,542,497,1.12627501623395,1.09926765789286,1.1557772055003
"1850","전남","나주시",2020,989,520,469,"4",2018,1098,575,523,0.920552290155608,0.922625362419667,0.918203209107205
"1851","전남","담양군",2010,241,125,116,"4",2008,278,156,122,0.885985793063253,0.817476552316489,0.973566924571217
"1852","전남","담양군",2011,227,126,101,"4",2009,270,130,140,0.859244190211305,0.988819637682025,0.738687909148186
"1853","전남","담양군",2012,218,109,109,"4",2010,247,130,117,0.902015606410627,0.855407464343974,0.953911948345715
"1854","전남","담양군",2013,212,113,99,"4",2011,278,136,142,0.77937339472784,0.84767509789618,0.713862391632538
"1855","전남","담양군",2014,233,117,116,"4",2012,276,156,120,0.862782544949773,0.765158052968233,0.989793039980738
"1856","전남","담양군",2015,241,136,105,"4",2013,284,145,139,0.867267783350649,0.956887312217745,0.77346764473811
"1857","전남","담양군",2016,246,132,114,"4",2014,289,128,161,0.869944958520721,1.05209232283132,0.725014392104117
"1858","전남","담양군",2017,269,130,139,"4",2015,250,142,108,1.09968115480259,0.933995745407233,1.31782789805864
"1859","전남","담양군",2018,221,125,96,"4",2016,284,150,134,0.795295353197068,0.850175614409148,0.733557373943521
"1860","전남","담양군",2019,242,126,116,"4",2017,254,131,123,0.973724641652618,0.981271396173002,0.965651746322671
"1861","전남","담양군",2020,198,98,100,"4",2018,271,137,134,0.746707323320324,0.729785782879678,0.764122264524501
"1862","전남","목포시",2010,2887,1481,1406,"4",2008,2597,1343,1254,1.13613344748483,1.12504251818908,1.14803581439772
"1863","전남","목포시",2011,2736,1421,1315,"4",2009,2375,1199,1176,1.17735380142434,1.20910713735653,1.14494884550903
"1864","전남","목포시",2012,2501,1261,1240,"4",2010,2521,1309,1212,1.01390054698941,0.982800412317741,1.04757884053953
"1865","전남","목포시",2013,2638,1350,1288,"4",2011,2672,1385,1287,1.0090039089001,0.994429238514671,1.0247194240778
"1866","전남","목포시",2014,2741,1424,1317,"4",2012,2586,1348,1238,1.08326578535333,1.07773003701955,1.08926307753437
"1867","전남","목포시",2015,2631,1358,1273,"4",2013,2389,1226,1163,1.12553553161315,1.1300539814365,1.12076959696577
"1868","전남","목포시",2016,2538,1292,1246,"4",2014,2513,1308,1205,1.03217572374174,1.00773109524461,1.05876273671426
"1869","전남","목포시",2017,2756,1430,1326,"4",2015,2617,1310,1307,1.07629172661307,1.11366515597412,1.03880872570598
"1870","전남","목포시",2018,2756,1360,1396,"4",2016,2587,1314,1273,1.08877288308713,1.05592587725702,1.12285755923811
"1871","전남","목포시",2019,2762,1389,1373,"4",2017,2220,1122,1098,1.27152590071869,1.26298815873188,1.28037106076272
"1872","전남","목포시",2020,2389,1210,1179,"4",2018,2130,1093,1037,1.14628090424603,1.12941902298452,1.16413326984733
"1873","전남","무안군",2010,613,327,286,"4",2008,572,300,272,1.09526436278822,1.11202970364717,1.07662579653077
"1874","전남","무안군",2011,574,298,276,"4",2009,649,316,333,0.903902748375665,0.962097467445289,0.848657592527753
"1875","전남","무안군",2012,529,252,277,"4",2010,653,328,325,0.827936448434408,0.783820444504044,0.87269816044986
"1876","전남","무안군",2013,577,293,284,"4",2011,780,402,378,0.756024242590191,0.743586432901136,0.769297272453556
"1877","전남","무안군",2014,775,394,381,"4",2012,739,396,343,1.07179512021672,1.01505815780971,1.13736146043831
"1878","전남","무안군",2015,787,408,379,"4",2013,851,427,424,0.94514770380532,0.974814943359998,0.915252672786352
"1879","전남","무안군",2016,790,413,377,"4",2014,918,462,456,0.879506232530359,0.912006568184359,0.846533521036157
"1880","전남","무안군",2017,819,407,412,"4",2015,889,435,454,0.941535397300466,0.954542000177995,0.929199603080808
"1881","전남","무안군",2018,777,382,395,"4",2016,971,501,470,0.817817312931533,0.777885232824658,0.860531733218763
"1882","전남","무안군",2019,827,438,389,"4",2017,811,412,399,1.04217143805864,1.08459296828507,0.998261582972535
"1883","전남","무안군",2020,702,362,340,"4",2018,784,396,388,0.915114761151728,0.932616886109429,0.897252844632378
"1884","전남","보성군",2010,290,164,126,"4",2008,305,152,153,0.971745794663757,1.100753690235,0.843231393087038
"1885","전남","보성군",2011,244,126,118,"4",2009,285,139,146,0.874982722793427,0.924795344594699,0.827554879908316
"1886","전남","보성군",2012,229,122,107,"4",2010,328,172,156,0.713536427967726,0.723637848543601,0.702306732612327
"1887","전남","보성군",2013,252,136,116,"4",2011,364,192,172,0.70754435181751,0.722649272247776,0.690553283707491
"1888","전남","보성군",2014,256,127,129,"4",2012,313,146,167,0.835891942793281,0.887443586547631,0.790935177519194
"1889","전남","보성군",2015,222,105,117,"4",2013,271,136,135,0.837217301904606,0.787662701584946,0.887400656534454
"1890","전남","보성군",2016,214,101,113,"4",2014,304,141,163,0.719440199837833,0.730789251534672,0.709836768676687
"1891","전남","보성군",2017,224,108,116,"4",2015,308,160,148,0.743278915040616,0.68864224767141,0.802534897281679
"1892","전남","보성군",2018,238,122,116,"4",2016,296,167,129,0.821750084280546,0.745303652392211,0.920737711609988
"1893","전남","보성군",2019,200,110,90,"4",2017,223,116,107,0.91659955890659,0.967441216396617,0.861244346744438
"1894","전남","보성군",2020,170,85,85,"4",2018,213,110,103,0.815687541740582,0.788344660633937,0.844985688634376
"1895","전남","순천시",2010,2966,1552,1414,"4",2008,2756,1421,1335,1.09988288652554,1.11426253643603,1.08451558197037
"1896","전남","순천시",2011,2832,1440,1392,"4",2009,2478,1271,1207,1.16800972363525,1.15586424995988,1.18086327885026
"1897","전남","순천시",2012,2519,1275,1244,"4",2010,2492,1268,1224,1.03308163407205,1.02584281549369,1.0406546160717
"1898","전남","순천시",2013,2593,1314,1279,"4",2011,2687,1397,1290,0.98625532627947,0.959596928275122,1.01519270099067
"1899","전남","순천시",2014,2872,1524,1348,"4",2012,2524,1294,1230,1.16291934845301,1.2015464943056,1.1221539258991
"1900","전남","순천시",2015,2710,1400,1310,"4",2013,2510,1284,1226,1.10344344907175,1.11237930857272,1.09407848543745
"1901","전남","순천시",2016,2712,1397,1315,"4",2014,2609,1387,1222,1.06235610355939,1.02756625810778,1.10184929813308
"1902","전남","순천시",2017,2761,1474,1287,"4",2015,2603,1333,1270,1.08404360011038,1.12812500132551,1.03762990153832
"1903","전남","순천시",2018,2747,1408,1339,"4",2016,2751,1408,1343,1.02052249072075,1.02021073729098,1.02087417300501
"1904","전남","순천시",2019,2857,1467,1390,"4",2017,2485,1259,1226,1.17500133113589,1.18876024750267,1.1608924387466
"1905","전남","순천시",2020,2627,1330,1297,"4",2018,2442,1217,1225,1.09943339516424,1.11493860361298,1.0841054802435
"1906","전남","신안군",2010,180,85,95,"4",2008,242,126,116,0.760171617655176,0.688237402140739,0.83855831270663
"1907","전남","신안군",2011,183,90,93,"4",2009,204,96,108,0.91680174998576,0.956447566210292,0.881712190787439
"1908","전남","신안군",2012,163,73,90,"4",2010,209,94,115,0.797068836523819,0.792291317257887,0.801331696536129
"1909","전남","신안군",2013,145,62,83,"4",2011,201,114,87,0.737269819334442,0.554851453614391,0.976846876556495
"1910","전남","신안군",2014,174,98,76,"4",2012,232,122,110,0.766506381135636,0.819513543069802,0.707438285628866
"1911","전남","신안군",2015,173,87,86,"4",2013,196,98,98,0.902078938343299,0.905697287186888,0.898545405753097
"1912","전남","신안군",2016,156,75,81,"4",2014,224,125,99,0.711755925340233,0.612126442374587,0.837755864560499
"1913","전남","신안군",2017,160,89,71,"4",2015,234,106,128,0.698809236362973,0.856592034140538,0.567957751928602
"1914","전남","신안군",2018,177,80,97,"4",2016,230,105,125,0.786502199773956,0.777303418888364,0.794564895543158
"1915","전남","신안군",2019,177,87,90,"4",2017,203,112,91,0.891110866738965,0.792485126288527,1.01267192419401
"1916","전남","신안군",2020,143,76,67,"4",2018,182,93,89,0.803006684999237,0.833720602517358,0.770819066393368
"1917","전남","여수시",2010,2940,1518,1422,"4",2008,2862,1522,1340,1.04986198953588,1.01752950013647,1.08658186015384
"1918","전남","여수시",2011,2771,1469,1302,"4",2009,2504,1284,1220,1.13098465501962,1.16720371735237,1.09274494464804
"1919","전남","여수시",2012,2413,1240,1173,"4",2010,2494,1272,1222,0.98881576994402,0.994545058365419,0.982866332098938
"1920","전남","여수시",2013,2482,1276,1206,"4",2011,2803,1410,1393,0.904967933394528,0.923254539562615,0.886469593942696
"1921","전남","여수시",2014,2677,1339,1338,"4",2012,2609,1333,1276,1.04864575561523,1.02480283363287,1.07367561952294
"1922","전남","여수시",2015,2485,1292,1193,"4",2013,2458,1242,1216,1.03323480180204,1.06128202301123,1.00455685404125
"1923","전남","여수시",2016,2367,1182,1185,"4",2014,2593,1355,1238,0.932932564158915,0.889955049061207,0.980088646073066
"1924","전남","여수시",2017,2477,1287,1190,"4",2015,2699,1350,1349,0.93794556308409,0.972600902884065,0.903238964426071
"1925","전남","여수시",2018,2614,1311,1303,"4",2016,2574,1265,1309,1.03789053628001,1.0573093095561,1.01923052429723
"1926","전남","여수시",2019,2486,1209,1277,"4",2017,2393,1256,1137,1.06172718401069,0.982034061612096,1.15000064785315
"1927","전남","여수시",2020,2306,1202,1104,"4",2018,2286,1174,1112,1.03094996494533,1.04454285027577,1.01655747594152
"1928","전남","영광군",2010,424,226,198,"4",2008,433,222,211,1.00076583711011,1.03859291273766,0.960838479732894
"1929","전남","영광군",2011,397,207,190,"4",2009,392,217,175,1.03504433098928,0.973196417600149,1.11168873455965
"1930","전남","영광군",2012,361,191,170,"4",2010,390,195,195,0.946013003726374,0.999283337551676,0.892651547993238
"1931","전남","영광군",2013,373,183,190,"4",2011,457,223,234,0.834155740812814,0.837213295624435,0.831391147640761
"1932","전남","영광군",2014,425,219,206,"4",2012,393,204,189,1.10522548594621,1.09522623268002,1.11602280370023
"1933","전남","영광군",2015,391,199,192,"4",2013,412,197,215,0.969915841501727,1.0305682067051,0.914387796357506
"1934","전남","영광군",2016,373,184,189,"4",2014,429,215,214,0.888599472147916,0.873110584472279,0.90430656408166
"1935","전남","영광군",2017,387,200,187,"4",2015,433,218,215,0.913434856041543,0.935973153477961,0.890575614160696
"1936","전남","영광군",2018,372,186,186,"4",2016,447,229,218,0.850530570566611,0.828642782253807,0.873623088119664
"1937","전남","영광군",2019,375,193,182,"4",2017,352,171,181,1.08878747320403,1.15146591986643,1.02958087222229
"1938","전남","영광군",2020,312,152,160,"4",2018,355,188,167,0.898215928316689,0.824851234405471,0.981004871341635
"1939","전남","영암군",2010,570,300,270,"4",2008,570,297,273,1.02200850818085,1.03051589625351,1.01267192419401
"1940","전남","영암군",2011,480,246,234,"4",2009,518,250,268,0.947034911055612,1.00388736549432,0.894023049493667
"1941","전남","영암군",2012,458,227,231,"4",2010,513,270,243,0.91243644590025,0.857732730981674,0.973359694489359
"1942","전남","영암군",2013,471,252,219,"4",2011,610,299,311,0.789124602218326,0.859843163201761,0.721026751599229
"1943","전남","영암군",2014,497,239,258,"4",2012,548,273,275,0.926894577674966,0.893151524588072,0.960626724696039
"1944","전남","영암군",2015,445,243,202,"4",2013,548,286,262,0.829915668139557,0.86682240965632,0.789437460158367
"1945","전남","영암군",2016,453,235,218,"4",2014,566,313,253,0.817967940293152,0.765972917774376,0.882274292145839
"1946","전남","영암군",2017,448,244,204,"4",2015,541,260,281,0.846321278493567,0.957428538073071,0.743346840677643
"1947","전남","영암군",2018,413,196,217,"4",2016,505,258,247,0.835820819561762,0.775043815926479,0.899560615702164
"1948","전남","영암군",2019,414,212,202,"4",2017,483,257,226,0.876007292726441,0.841574615975437,0.915188560006602
"1949","전남","영암군",2020,412,204,208,"4",2018,381,190,191,1.10516405609058,1.09538416003873,1.1150584165878
"1950","전남","완도군",2010,358,180,178,"4",2008,393,220,173,0.930989938749983,0.834717875965346,1.05351700886927
"1951","전남","완도군",2011,402,220,182,"4",2009,363,178,185,1.13181107517548,1.26093461912368,1.00731966417425
"1952","전남","완도군",2012,359,177,182,"4",2010,367,196,171,0.999730393561101,0.921312757655628,1.08979027995459
"1953","전남","완도군",2013,369,200,169,"4",2011,392,196,196,0.962043723262073,1.04103136458263,0.882873102164381
"1954","전남","완도군",2014,376,186,190,"4",2012,321,172,149,1.19711900023676,1.10325114614024,1.30567468824119
"1955","전남","완도군",2015,308,170,138,"4",2013,337,168,169,0.93406118848576,1.03235610321111,0.836103486129413
"1956","전남","완도군",2016,323,150,173,"4",2014,406,202,204,0.813075734340921,0.757582230661617,0.868327565500343
"1957","전남","완도군",2017,390,198,192,"4",2015,382,203,179,1.0434118277239,0.995082394007949,1.09828701797131
"1958","전남","완도군",2018,354,186,168,"4",2016,416,207,209,0.869689932442356,0.916711097275951,0.82305839325242
"1959","전남","완도군",2019,387,191,196,"4",2017,358,180,178,1.10479690688823,1.08255694901432,1.12746669412761
"1960","전남","완도군",2020,315,162,153,"4",2018,381,197,184,0.844967664244008,0.83895502254385,0.851414927569637
"1961","전남","장성군",2010,363,195,168,"4",2008,347,183,164,1.06913281979726,1.08710980203137,1.0488975865229
"1962","전남","장성군",2011,325,172,153,"4",2009,326,178,148,1.01887351275698,0.985821611314877,1.05851585589739
"1963","전남","장성군",2012,331,177,154,"4",2010,337,152,185,1.00381251100255,1.18800855592436,0.852347408147438
"1964","전남","장성군",2013,343,175,168,"4",2011,346,193,153,1.01314716273419,0.925061549357104,1.12430852411605
"1965","전남","장성군",2014,340,184,156,"4",2012,344,176,168,1.01012468831828,1.06658395262239,0.950786417715487
"1966","전남","장성군",2015,346,181,165,"4",2013,311,159,152,1.13702554286358,1.16137197138155,1.11149626767347
"1967","전남","장성군",2016,309,154,155,"4",2014,344,181,163,0.918025084383377,0.868024605208898,0.973669903937049
"1968","전남","장성군",2017,339,187,152,"4",2015,383,191,192,0.904597609068687,0.998845067400067,0.810606368949742
"1969","전남","장성군",2018,366,191,175,"4",2016,338,162,176,1.10667193489405,1.20284105446035,1.01810608540338
"1970","전남","장성군",2019,322,157,165,"4",2017,308,154,154,1.06846344037089,1.04008497243301,1.09706125121018
"1971","전남","장성군",2020,271,138,133,"4",2018,328,172,156,0.844403371088444,0.818541172942761,0.872960705022799
"1972","전남","장흥군",2010,300,146,154,"4",2008,298,156,142,1.02886762568542,0.954812613105659,1.11045260920617
"1973","전남","장흥군",2011,275,149,126,"4",2009,258,129,129,1.08935015406873,1.17838294462291,1.00011165226602
"1974","전남","장흥군",2012,268,135,133,"4",2010,252,156,96,1.08689793727169,0.882874676501808,1.41856114566205
"1975","전남","장흥군",2013,246,147,99,"4",2011,265,136,129,0.948732426462221,1.10272778221892,0.785802012494731
"1976","전남","장흥군",2014,258,133,125,"4",2012,249,116,133,1.0589485747416,1.169724379825,0.96233443088612
"1977","전남","장흥군",2015,240,116,124,"4",2013,265,142,123,0.925592611182654,0.833411588209531,1.03224841848286
"1978","전남","장흥군",2016,243,129,114,"4",2014,241,120,121,1.03048990658899,1.0967265425878,0.96468857131209
"1979","전남","장흥군",2017,230,110,120,"4",2015,249,146,103,0.944023923219257,0.768651925356216,1.19292097218971
"1980","전남","장흥군",2018,233,129,104,"4",2016,254,132,122,0.937511741756447,0.997024129625274,0.872853104787988
"1981","전남","장흥군",2019,245,128,117,"4",2017,241,115,126,1.03897130499713,1.13553890759344,0.950786417715487
"1982","전남","장흥군",2020,221,100,121,"4",2018,233,119,114,0.969372876858229,0.857319947303343,1.08679635061406
"1983","전남","진도군",2010,229,102,127,"4",2008,205,95,110,1.14165828474836,1.09538416003873,1.18216660887982
"1984","전남","진도군",2011,210,104,106,"4",2009,203,113,90,1.05725018087674,0.938955014851873,1.20595473836734
"1985","전남","진도군",2012,197,110,87,"4",2010,224,120,104,0.898819982641192,0.935193175850063,0.8565516692141
"1986","전남","진도군",2013,201,111,90,"4",2011,266,124,142,0.772269587008836,0.913253159994343,0.648965810575034
"1987","전남","진도군",2014,241,113,128,"4",2012,208,114,94,1.18415408880569,1.0112615202972,1.39427926394939
"1988","전남","진도군",2015,183,99,84,"4",2013,208,106,102,0.899170947101419,0.952838330111385,0.843231393087038
"1989","전남","진도군",2016,208,108,100,"4",2014,222,120,102,0.957557521178452,0.91818966356188,1.00384689653219
"1990","전남","진도군",2017,185,102,83,"4",2015,236,107,129,0.801150737345156,0.972537338352147,0.658803707445078
"1991","전남","진도군",2018,202,89,113,"4",2016,230,126,104,0.897590081097962,0.720625044594421,1.11253262782981
"1992","전남","진도군",2019,199,105,94,"4",2017,189,96,93,1.07608303242322,1.11585549391201,1.03493376816673
"1993","전남","진도군",2020,171,93,78,"4",2018,173,92,81,1.01019338091864,1.03129998443545,0.986000729482727
"1994","전남","함평군",2010,209,106,103,"4",2008,254,135,119,0.840944008699989,0.801054356687731,0.886253402938418
"1995","전남","함평군",2011,204,110,94,"4",2009,195,95,100,1.06917813163535,1.18129664317903,0.962488404395062
"1996","전남","함평군",2012,167,84,83,"4",2010,201,93,108,0.84913144709553,0.921480665940238,0.786904428337176
"1997","전남","함평군",2013,165,77,88,"4",2011,228,116,112,0.739611420394034,0.677208851477632,0.804511584220796
"1998","전남","함평군",2014,192,97,95,"4",2012,207,105,102,0.947949920631511,0.942480395402141,0.953654551705579
"1999","전남","함평군",2015,162,87,75,"4",2013,203,116,87,0.815592996676341,0.765158052968233,0.882692960743821
"2000","전남","함평군",2016,166,94,72,"4",2014,215,112,103,0.789085638874515,0.856248297369214,0.715752583313824
"2001","전남","함평군",2017,167,87,80,"4",2015,212,121,91,0.805072739934913,0.73353995160591,0.900152821505786
"2002","전남","함평군",2018,164,89,75,"4",2016,215,119,96,0.77957858298446,0.763014753099975,0.799940495674088
"2003","전남","함평군",2019,162,87,75,"4",2017,190,99,91,0.87139672802788,0.896548829740556,0.843893270161675
"2004","전남","함평군",2020,152,78,74,"4",2018,175,84,91,0.887687389962793,0.947338541770194,0.832641359892852
"2005","전남","해남군",2010,557,290,267,"4",2008,587,304,283,0.969776386808743,0.97322734807363,0.96603414770875
"2006","전남","해남군",2011,537,278,259,"4",2009,531,265,266,1.03355662691735,1.07025881119582,0.996978470398021
"2007","전남","해남군",2012,493,233,260,"4",2010,519,262,257,0.970809623377953,0.907286648048847,1.03587625276395
"2008","전남","해남군",2013,495,255,240,"4",2011,542,276,266,0.933384154150405,0.942586007279708,0.923841053650675
"2009","전남","해남군",2014,499,239,260,"4",2012,561,299,262,0.90905926128742,0.815486174623892,1.01610762198602
"2010","전남","해남군",2015,517,274,243,"4",2013,467,233,234,1.13143126066274,1.19973279835935,1.06330552040371
"2011","전남","해남군",2016,441,221,220,"4",2014,533,273,260,0.845601786318487,0.825884882568887,0.866397090699319
"2012","전남","해남군",2017,479,264,215,"4",2015,479,232,247,1.02200850818085,1.16092945967594,0.891269734451453
"2013","전남","해남군",2018,415,205,210,"4",2016,543,253,290,0.781093058738585,0.826652968951188,0.741462087024809
"2014","전남","해남군",2019,455,211,244,"4",2017,451,199,252,1.03107288519354,1.08173098275576,0.991418315908456
"2015","전남","해남군",2020,376,173,203,"4",2018,446,213,233,0.861603585372194,0.828621866438212,0.892088147622124
"2016","전남","화순군",2010,659,347,312,"4",2008,715,362,353,0.941963086561089,0.977936811712622,0.904997836692361
"2017","전남","화순군",2011,635,328,307,"4",2009,620,346,274,1.04673452047555,0.96713619026428,1.14724312839449
"2018","전남","화순군",2012,561,296,265,"4",2010,568,299,269,1.00941333290397,1.00997450915762,1.00869820123662
"2019","전남","화순군",2013,513,269,244,"4",2011,676,335,341,0.775577462569193,0.819213995018725,0.73266104284144
"2020","전남","화순군",2014,611,298,313,"4",2012,549,280,269,1.13742659107194,1.08579571325968,1.19140579995118
"2021","전남","화순군",2015,484,242,242,"4",2013,554,285,269,0.892873859132726,0.866284204997953,0.921150810185893
"2022","전남","화순군",2016,491,262,229,"4",2014,518,275,243,0.968737794433969,0.971982593346313,0.964932337827113
"2023","전남","화순군",2017,450,237,213,"4",2015,501,270,231,0.917971713934893,0.895518313844303,0.944137561647546
"2024","전남","화순군",2018,470,238,232,"4",2016,486,240,246,0.988362137541149,1.01170898114689,0.965651746322671
"2025","전남","화순군",2019,450,226,224,"4",2017,403,213,190,1.1412005674476,1.08247712031813,1.20715231010355
"2026","전남","화순군",2020,378,199,179,"4",2018,367,183,184,1.052640915783,1.10940949027817,0.996099817221994
"2027","전북","고창군",2010,366,202,164,"4",2008,363,187,176,1.03045485948813,1.10204582316993,0.954110845749457
"2028","전북","고창군",2011,343,180,163,"4",2009,320,168,152,1.09546536970635,1.09308293281176,1.09802358564106
"2029","전북","고창군",2012,321,169,152,"4",2010,346,186,160,0.948163962792058,0.926965669904168,0.97272764273969
"2030","전북","고창군",2013,335,176,159,"4",2011,381,203,178,0.898616404830929,0.884517683562621,0.914628593705563
"2031","전북","고창군",2014,394,205,189,"4",2012,364,183,181,1.10623997863531,1.14285902264836,1.06918013653854
"2032","전북","고창군",2015,351,177,174,"4",2013,357,180,177,1.00483189459798,1.00320722500279,1.00656919320075
"2033","전북","고창군",2016,346,171,175,"4",2014,374,210,164,0.945494502220784,0.830743028936939,1.09260165262802
"2034","전북","고창군",2017,348,194,154,"4",2015,373,206,167,0.953509278410013,0.960780985604125,0.944217188666324
"2035","전북","고창군",2018,362,196,166,"4",2016,356,187,169,1.03923337067828,1.06931178881835,1.00574767172089
"2036","전북","고창군",2019,324,171,153,"4",2017,316,171,145,1.04788214129935,1.02021073729098,1.08041618395044
"2037","전북","고창군",2020,273,146,127,"4",2018,328,179,149,0.850635130284669,0.832127193544597,0.872740449508588
"2038","전북","군산시",2010,2729,1395,1334,"4",2008,2605,1343,1262,1.0706568978217,1.05971256777432,1.08234104213425
"2039","전북","군산시",2011,2645,1358,1287,"4",2009,2485,1264,1221,1.08781187289269,1.09608083958952,1.07927106875812
"2040","전북","군산시",2012,2525,1277,1248,"4",2010,2519,1307,1212,1.02444282777159,0.996793505371522,1.0543374137043
"2041","전북","군산시",2013,2525,1302,1223,"4",2011,2820,1438,1382,0.915096270622922,0.92372349092688,0.906120730497861
"2042","전북","군산시",2014,2801,1417,1384,"4",2012,2658,1408,1250,1.07699241211985,1.02673197069696,1.13368846951725
"2043","전북","군산시",2015,2618,1379,1239,"4",2013,2670,1353,1317,1.00210422262826,1.03981567385385,0.963281420576651
"2044","전북","군산시",2016,2597,1327,1270,"4",2014,2797,1416,1381,0.948929601625192,0.956087322305881,0.941624380715276
"2045","전북","군산시",2017,2708,1366,1342,"4",2015,2831,1450,1381,0.977604747493372,0.961108873889294,0.99500781017315
"2046","전북","군산시",2018,2721,1402,1319,"4",2016,2791,1457,1334,0.996375904965993,0.981699007331469,1.01241044801835
"2047","전북","군산시",2019,2706,1416,1290,"4",2017,2622,1342,1280,1.05475019951845,1.07646676900449,1.03192323941957
"2048","전북","군산시",2020,2503,1277,1226,"4",2018,2535,1300,1235,1.00910741458645,1.00216085501583,1.01646204133719
"2049","전북","김제시",2010,640,320,320,"4",2008,705,333,372,0.927780773384032,0.980382690489829,0.880794696312113
"2050","전북","김제시",2011,632,321,311,"4",2009,592,329,263,1.09106313711199,0.995403181369009,1.2107996673686
"2051","전북","김제시",2012,552,299,253,"4",2010,641,347,294,0.880107170851525,0.879086485446693,0.881131735098968
"2052","전북","김제시",2013,645,347,298,"4",2011,690,326,364,0.955355779386444,1.08592983386494,0.838267315027263
"2053","전북","김제시",2014,669,335,334,"4",2012,606,319,287,1.12825691744717,1.0713811817946,1.19160474115187
"2054","전북","김제시",2015,606,316,290,"4",2013,620,328,292,0.998930896705796,0.982885954219357,1.01691065751446
"2055","전북","김제시",2016,591,299,292,"4",2014,589,287,302,1.02547882569589,1.06286763222997,0.990019071732275
"2056","전북","김제시",2017,602,299,303,"4",2015,635,310,325,0.968896254999795,0.98400971112904,0.954612067206886
"2057","전북","김제시",2018,658,318,340,"4",2016,623,332,291,1.07942471650561,0.977189802585937,1.1963371261765
"2058","전북","김제시",2019,607,316,291,"4",2017,512,277,235,1.21163899309722,1.16385051618754,1.26792270565397
"2059","전북","김제시",2020,490,268,222,"4",2018,495,263,232,1.01168518991639,1.03960637868434,0.979789186425641
"2060","전북","남원시",2010,783,412,371,"4",2008,780,407,373,1.02593931013539,1.0327440387319,1.01843362623515
"2061","전북","남원시",2011,780,405,375,"4",2009,716,371,345,1.1133612239959,1.11370713909123,1.11296068963351
"2062","전북","남원시",2012,729,371,358,"4",2010,697,350,347,1.06892998918772,1.08142338152844,1.05638251509422
"2063","전북","남원시",2013,697,354,343,"4",2011,716,362,354,0.994888170673255,0.997664643649188,0.992106992149015
"2064","전북","남원시",2014,729,365,364,"4",2012,731,395,336,1.01921231527201,0.942726377496726,1.10925082066807
"2065","전북","남원시",2015,729,382,347,"4",2013,626,339,287,1.19016645760996,1.14961799895326,1.23798456640628
"2066","전북","남원시",2016,616,332,284,"4",2014,689,350,339,0.913726039244415,0.967742756516013,0.857800498488036
"2067","전북","남원시",2017,686,348,338,"4",2015,652,317,335,1.0753034303866,1.11997897973899,1.03309330163713
"2068","전북","남원시",2018,638,327,311,"4",2016,587,322,265,1.11080311451343,1.03605251892593,1.20166155667147
"2069","전북","남원시",2019,572,310,262,"4",2017,569,300,269,1.02739695374243,1.05421776186734,0.997278976316959
"2070","전북","남원시",2020,531,276,255,"4",2018,551,295,256,0.984912010606225,0.954502249126474,1.01992413198446
"2071","전북","무주군",2010,161,84,77,"4",2008,198,97,101,0.831027120288467,0.883481463221053,0.78061520053107
"2072","전북","무주군",2011,177,90,87,"4",2009,191,89,102,0.947096889780157,1.03167377928301,0.873346799983004
"2073","전북","무주군",2012,183,88,95,"4",2010,188,98,90,0.994827430835612,0.916107600832715,1.08080849193299
"2074","전북","무주군",2013,170,89,81,"4",2011,221,106,115,0.786160390908344,0.856592034140538,0.721198526882516
"2075","전북","무주군",2014,210,100,110,"4",2012,193,101,92,1.1120299829947,1.01010964088216,1.22425675859686
"2076","전북","무주군",2015,167,83,84,"4",2013,197,87,110,0.866372694752292,0.97330449649599,0.781905473589799
"2077","전북","무주군",2016,178,75,103,"4",2014,185,105,80,0.98333791597941,0.728721955207841,1.3183019368709
"2078","전북","무주군",2017,164,90,74,"4",2015,183,96,87,0.915898335200322,0.956447566210292,0.870923721267236
"2079","전북","무주군",2018,165,85,80,"4",2016,158,86,72,1.06728736613823,1.00834782174108,1.13769314940315
"2080","전북","무주군",2019,155,84,71,"4",2017,137,71,66,1.1562869983068,1.20700988637242,1.10149382192214
"2081","전북","무주군",2020,123,65,58,"4",2018,146,93,53,0.861007167850988,0.713050515310899,1.1205204226197
"2082","전북","부안군",2010,399,203,196,"4",2008,388,199,189,1.05098297619628,1.04071748577924,1.06184693944294
"2083","전북","부안군",2011,395,204,191,"4",2009,359,176,183,1.12449404103464,1.18251699095091,1.06868553214427
"2084","전북","부안군",2012,330,162,168,"4",2010,336,182,154,1.00375835624905,0.908099667259002,1.117007819414
"2085","전북","부안군",2013,313,166,147,"4",2011,376,195,181,0.850767720905865,0.868487089181038,0.831584550641084
"2086","전북","부안군",2014,353,177,176,"4",2012,352,179,173,1.02491194144272,1.00881173463968,1.0416797391067
"2087","전북","부안군",2015,335,173,162,"4",2013,358,181,177,0.956348743688782,0.975118550007399,0.937150628152422
"2088","전북","부안군",2016,317,156,161,"4",2014,364,186,178,0.890045871135518,0.855660618373078,0.926133355890539
"2089","전북","부안군",2017,341,182,159,"4",2015,368,195,173,0.947024188287144,0.952196688138246,0.941062946124799
"2090","전북","부안군",2018,328,173,155,"4",2016,346,190,156,0.968840435500919,0.928928723954417,1.01736022013935
"2091","전북","부안군",2019,306,167,139,"4",2017,324,162,162,0.965230257726356,1.05169872300984,0.878551932039097
"2092","전북","부안군",2020,279,146,133,"4",2018,291,146,145,0.979863827431122,1.02021073729098,0.939185310231425
"2093","전북","순창군",2010,211,102,109,"4",2008,237,128,109,0.909889431334003,0.812980431278748,1.02392383446283
"2094","전북","순창군",2011,201,109,92,"4",2009,219,110,109,0.938007808878312,1.0109360942247,0.864229291473216
"2095","전북","순창군",2012,188,103,85,"4",2010,208,115,93,0.923738459317304,0.913753964704093,0.935844364831621
"2096","전북","순창군",2013,177,96,81,"4",2011,229,117,112,0.78993670719655,0.837095989572084,0.74051634456687
"2097","전북","순창군",2014,208,111,97,"4",2012,199,88,111,1.06822999850058,1.28685672544657,0.894780287773826
"2098","전북","순창군",2015,187,85,102,"4",2013,209,113,96,0.914428665214442,0.76741515636932,1.08791907411676
"2099","전북","순창군",2016,181,94,87,"4",2014,216,115,101,0.856405277688581,0.83391138526393,0.881993798002637
"2100","전북","순창군",2017,192,104,88,"4",2015,194,93,101,1.01147233799342,1.14088082449744,0.892131657749794
"2101","전북","순창군",2018,160,72,88,"4",2016,193,107,86,0.847260939424537,0.686496944719163,1.04773601665964
"2102","전북","순창군",2019,153,87,66,"4",2017,169,86,83,0.925250306222897,1.03207365284087,0.814204494874059
"2103","전북","순창군",2020,133,74,59,"4",2018,150,79,71,0.906180877253685,0.955640437462435,0.850866284976156
"2104","전북","완주군",2010,854,446,408,"4",2008,860,461,399,1.01487821626331,0.987015160155697,1.0470198608041
"2105","전북","완주군",2011,843,466,377,"4",2009,836,428,408,1.03056599568954,1.11079019527476,0.946125699981587
"2106","전북","완주군",2012,876,469,407,"4",2010,868,426,442,1.03142794143597,1.12318975537434,0.942843892819847
"2107","전북","완주군",2013,871,444,427,"4",2011,903,471,432,0.985791152409212,0.961727319229712,1.01207286415655
"2108","전북","완주군",2014,916,475,441,"4",2012,923,476,447,1.01425763108738,1.01806743742272,1.01017989037608
"2109","전북","완주군",2015,904,477,427,"4",2013,876,441,435,1.0546754467985,1.10349324645759,1.0050930513003
"2110","전북","완주군",2016,848,443,405,"4",2014,1008,542,466,0.859784935453729,0.833862281586537,0.889890886174779
"2111","전북","완주군",2017,898,504,394,"4",2015,1026,556,470,0.894506472072516,0.924795344594699,0.858353171868842
"2112","전북","완주군",2018,829,451,378,"4",2016,1057,535,522,0.801556341799359,0.860028116856507,0.741462087024809
"2113","전북","완주군",2019,822,445,377,"4",2017,966,472,494,0.86965941379364,0.961851224776452,0.78141555787953
"2114","전북","완주군",2020,702,343,359,"4",2018,864,431,433,0.830381912896939,0.811907848934583,0.848934541737082
"2115","전북","익산시",2010,3100,1563,1537,"4",2008,2959,1500,1459,1.07070847426855,1.0630595882572,1.0786641079982
"2116","전북","익산시",2011,2858,1466,1392,"4",2009,2759,1475,1284,1.0586807960786,1.01398572262276,1.11004826913728
"2117","전북","익산시",2012,2678,1414,1264,"4",2010,2659,1356,1303,1.02931131436943,1.06384806971198,0.993276843254812
"2118","전북","익산시",2013,2643,1329,1314,"4",2011,2950,1496,1454,0.91565033461762,0.906323576109431,0.925334194280716
"2119","전북","익산시",2014,2933,1492,1441,"4",2012,2704,1375,1329,1.10856174352604,1.10702139639137,1.11021387920312
"2120","전북","익산시",2015,2674,1393,1281,"4",2013,2545,1264,1281,1.07381168993147,1.1243303457645,1.02392383446283
"2121","전북","익산시",2016,2534,1282,1252,"4",2014,2692,1384,1308,0.962024353540218,0.945021795669822,0.980086116779408
"2122","전북","익산시",2017,2651,1344,1307,"4",2015,2694,1351,1343,1.005695825979,1.01492467129465,0.996476881342458
"2123","전북","익산시",2018,2610,1309,1301,"4",2016,2782,1439,1343,0.958821785173261,0.928044374644816,0.991902389155729
"2124","전북","익산시",2019,2591,1322,1269,"4",2017,2339,1232,1107,1.1321180182542,1.0947391190736,1.17376634682325
"2125","전북","익산시",2020,2153,1149,1004,"4",2018,2202,1151,1051,0.99926626617319,1.01843799925919,0.978134662036806
"2126","전북","임실군",2010,214,122,92,"4",2008,167,97,70,1.30963964521378,1.28315164896391,1.34572846815115
"2127","전북","임실군",2011,173,97,76,"4",2009,155,77,78,1.1406933671954,1.28520053918474,0.997669377168913
"2128","전북","임실군",2012,149,80,69,"4",2010,176,91,85,0.865223112039467,0.896888560255805,0.831185230328652
"2129","전북","임실군",2013,166,82,84,"4",2011,194,99,95,0.874502125556808,0.845023034927881,0.905364232577662
"2130","전북","임실군",2014,163,84,79,"4",2012,208,110,98,0.800900898237876,0.779070017567656,0.825407989005752
"2131","전북","임실군",2015,203,103,100,"4",2013,197,102,95,1.05313567086656,1.03021280334285,1.07781456259245
"2132","전북","임실군",2016,163,84,79,"4",2014,176,88,88,0.946519243372035,0.97383752195957,0.91920435139277
"2133","전북","임실군",2017,164,78,86,"4",2015,176,93,83,0.95232610989579,0.855660618373078,1.06093312968438
"2134","전북","임실군",2018,158,91,67,"4",2016,195,102,93,0.828088945090123,0.910188010720382,0.737665558161395
"2135","전북","임실군",2019,144,69,75,"4",2017,184,87,97,0.799832745532837,0.809132653713534,0.791693686440334
"2136","전북","임실군",2020,139,64,75,"4",2018,169,93,76,0.840586879509691,0.702080507383039,1.01045115243043
"2137","전북","장수군",2010,150,73,77,"4",2008,183,93,90,0.837711891951514,0.800810578733778,0.876023725040423
"2138","전북","장수군",2011,162,82,80,"4",2009,163,84,79,1.01573851733311,0.995920005450716,1.03688489565856
"2139","전북","장수군",2012,156,81,75,"4",2010,150,73,77,1.06288884850808,1.13201465370643,0.99732841019107
"2140","전북","장수군",2013,134,71,63,"4",2011,189,84,105,0.724598624847797,0.862320980329279,0.614354300677699
"2141","전북","장수군",2014,179,76,103,"4",2012,193,98,95,0.9478731759812,0.791183837082799,1.11014899947023
"2142","전북","장수군",2015,187,92,95,"4",2013,138,75,63,1.3848955871726,1.25145850441027,1.54401213133284
"2143","전북","장수군",2016,146,78,68,"4",2014,193,109,84,0.77312560722489,0.73005905971281,0.828890723136578
"2144","전북","장수군",2017,165,90,75,"4",2015,174,85,89,0.96914599913701,1.08022313360221,0.862857163873173
"2145","전북","장수군",2018,161,78,83,"4",2016,165,87,78,0.99723254434616,0.914671695502256,1.08955997769763
"2146","전북","장수군",2019,150,76,74,"4",2017,165,95,70,0.92909864380077,0.816168589832782,1.08243376786071
"2147","전북","장수군",2020,136,75,61,"4",2018,133,65,68,1.04506133167365,1.17716623533574,0.918519910326952
"2148","전북","전주시",2010,6857,3544,3313,"4",2008,6479,3331,3148,1.08163487275754,1.08544786939634,1.07759201511289
"2149","전북","전주시",2011,6546,3346,3200,"4",2009,6024,3226,2798,1.11056900639971,1.05816029974446,1.17103512161582
"2150","전북","전주시",2012,5995,3233,2762,"4",2010,5942,3102,2840,1.0311243700007,1.06329507210243,0.995801982671247
"2151","전북","전주시",2013,5965,3098,2867,"4",2011,6621,3525,3096,0.920749245023222,0.896627762873035,0.948187866086867
"2152","전북","전주시",2014,6669,3510,3159,"4",2012,6215,3215,3000,1.09666528416059,1.11382260898642,1.07819179768936
"2153","전북","전주시",2015,6339,3241,3098,"4",2013,5925,3061,2864,1.09341973558791,1.08020352811501,1.10758241590987
"2154","전북","전주시",2016,6041,3100,2941,"4",2014,6358,3292,3066,0.971052752110805,0.960708774484214,0.982178733579644
"2155","전북","전주시",2017,6505,3346,3159,"4",2015,6290,3199,3091,1.05694202634601,1.06709131821682,1.04644949630155
"2156","전북","전주시",2018,6532,3266,3266,"4",2016,6423,3289,3134,1.03935226147241,1.01307639647076,1.06705017337448
"2157","전북","전주시",2019,6708,3435,3273,"4",2017,5783,2963,2820,1.18548038611052,1.18272827627219,1.18840521638186
"2158","전북","전주시",2020,6166,3157,3009,"4",2018,5791,2990,2801,1.0881893388781,1.07719240723332,1.09995959225229
"2159","전북","정읍시",2010,1069,554,515,"4",2008,995,517,478,1.09801718115108,1.09322388483405,1.10318153713046
"2160","전북","정읍시",2011,982,519,463,"4",2009,962,478,484,1.04325608631351,1.10771835283267,0.979497387099775
"2161","전북","정읍시",2012,935,468,467,"4",2010,884,457,427,1.08097053749897,1.04476723206166,1.11984175806591
"2162","전북","정읍시",2013,855,453,402,"4",2011,995,504,491,0.878208316074999,0.916975126969867,0.838324605812746
"2163","전북","정읍시",2014,963,488,475,"4",2012,886,468,418,1.11082866069769,1.06380948674786,1.16354981188958
"2164","전북","정읍시",2015,866,453,413,"4",2013,820,449,371,1.07934069278611,1.02929947437152,1.13983974025108
"2165","전북","정읍시",2016,812,458,354,"4",2014,857,435,422,0.968344117436229,1.07415291420521,0.858931368246072
"2166","전북","정읍시",2017,829,434,395,"4",2015,903,466,437,0.93825587295894,0.95015334760576,0.925514678747869
"2167","전북","정읍시",2018,873,455,418,"4",2016,864,444,420,1.03265443014106,1.04548622853017,1.01904800667968
"2168","전북","정읍시",2019,858,446,412,"4",2017,745,385,360,1.17702456378412,1.18185451644617,1.17182394388524
"2169","전북","정읍시",2020,698,365,333,"4",2018,743,374,369,0.960110280902061,0.995660211527291,0.924028826222556
"2170","전북","진안군",2010,159,84,75,"4",2008,180,99,81,0.902774182226415,0.865633352852951,0.948077624502622
"2171","전북","진안군",2011,156,82,74,"4",2009,172,94,78,0.926937949280303,0.88997106870064,0.971414919874994
"2172","전북","진안군",2012,140,71,69,"4",2010,196,105,91,0.730006077272034,0.689856784263423,0.776381808548741
"2173","전북","진안군",2013,169,88,81,"4",2011,208,105,103,0.830381912896939,0.855033760777201,0.805221656228052
"2174","전북","진안군",2014,163,81,82,"4",2012,190,98,92,0.876775720176201,0.843235405311931,0.912627765499481
"2175","전북","진안군",2015,135,68,67,"4",2013,186,98,88,0.741780368840938,0.707901327916189,0.77957837396602
"2176","전북","진안군",2016,152,80,72,"4",2014,192,100,92,0.809090068976504,0.816168589832782,0.801331696536129
"2177","전북","진안군",2017,166,85,81,"4",2015,192,105,87,0.883611522698024,0.825884882568887,0.953308397603326
"2178","전북","진안군",2018,146,85,61,"4",2016,184,87,97,0.810941533665238,0.996757616893484,0.643910864971472
"2179","전북","진안군",2019,148,67,81,"4",2017,147,69,78,1.02896094701201,0.990639411572399,1.06330552040371
"2180","전북","진안군",2020,116,50,66,"4",2018,133,58,75,0.891375841721641,0.879492014906015,0.901052974327292
"2181","제주","서귀포시",2010,1382,729,653,"4",2008,1455,796,659,0.970732479935348,0.934338727996386,1.01460131093206
"2182","제주","서귀포시",2011,1385,763,622,"4",2009,1354,746,608,1.04540752129282,1.04345950744372,1.04750102801954
"2183","제주","서귀포시",2012,1289,706,583,"4",2010,1391,756,635,0.947066115776501,0.952736482179141,0.940074953530443
"2184","제주","서귀포시",2013,1314,703,611,"4",2011,1469,732,737,0.914172348365986,0.979792552343658,0.84887037022631
"2185","제주","서귀포시",2014,1431,720,711,"4",2012,1364,688,676,1.07220980587008,1.06766239949056,1.07693764246017
"2186","제주","서귀포시",2015,1407,723,684,"4",2013,1340,662,678,1.07310893358989,1.11421807108969,1.03298510733418
"2187","제주","서귀포시",2016,1412,708,704,"4",2014,1387,703,684,1.04042971416825,1.02746685917783,1.05386312786818
"2188","제주","서귀포시",2017,1515,769,746,"4",2015,1491,785,706,1.03845934935881,0.999416633091416,1.08193651630209
"2189","제주","서귀포시",2018,1618,882,736,"4",2016,1597,818,779,1.03544756808805,1.10003162627218,0.967404290326886
"2190","제주","서귀포시",2019,1624,828,796,"4",2017,1507,756,751,1.10135488870982,1.11737366465202,1.08527745969696
"2191","제주","서귀포시",2020,1437,706,731,"4",2018,1498,743,755,0.980391339289638,0.969406164909058,0.991375262241497
"2192","제주","제주시",2010,5083,2663,2420,"4",2008,4673,2451,2222,1.11167756196945,1.10845417927616,1.11516457218724
"2193","제주","제주시",2011,4633,2438,2195,"4",2009,4324,2280,2044,1.09504288122152,1.09090955154184,1.09956595726317
"2194","제주","제주시",2012,4458,2348,2110,"4",2010,4487,2312,2175,1.01540314897932,1.03609637160866,0.993323811823713
"2195","제주","제주시",2013,4623,2403,2220,"4",2011,4857,2518,2339,0.97277029716287,0.973616521727649,0.971830231939926
"2196","제주","제주시",2014,5147,2655,2492,"4",2012,4537,2331,2206,1.15941763094706,1.16201609073683,1.15667189278394
"2197","제주","제주시",2015,4796,2467,2329,"4",2013,4524,2366,2158,1.08345552724035,1.06376157603417,1.10505959706392
"2198","제주","제주시",2016,4774,2502,2272,"4",2014,4866,2528,2338,1.00268570038129,1.00971806356884,0.995019226646516
"2199","제주","제주시",2017,5048,2629,2419,"4",2015,4961,2550,2411,1.03993125363776,1.05181726601489,1.02732134200149
"2200","제주","제주시",2018,5182,2667,2515,"4",2016,5316,2696,2620,0.996246818922715,1.00923666036908,0.98288871895955
"2201","제주","제주시",2019,5533,2821,2712,"4",2017,4851,2459,2392,1.16569224402487,1.1704003618942,1.1609036116485
"2202","제주","제주시",2020,4989,2567,2422,"4",2018,4962,2552,2410,1.02756961856394,1.02620727375625,1.02902221040207
"2203","충남","계룡시",2010,579,301,278,"4",2008,530,284,246,1.11649608723908,1.0812796898753,1.1571171787832
"2204","충남","계룡시",2011,550,290,260,"4",2009,526,270,256,1.06864007509404,1.09578190301624,1.03992264437631
"2205","충남","계룡시",2012,487,242,245,"4",2010,570,304,266,0.873189725410654,0.812141442185581,0.943087742268398
"2206","충남","계룡시",2013,532,275,257,"4",2011,566,280,286,0.960615770940302,1.00199268841078,0.920099389709608
"2207","충남","계룡시",2014,484,243,241,"4",2012,482,235,247,1.02624920738492,1.05494131558173,0.999051190710698
"2208","충남","계룡시",2015,441,229,212,"4",2013,475,266,209,0.948854214963692,0.87830172496103,1.03862130577091
"2209","충남","계룡시",2016,455,260,195,"4",2014,472,252,220,0.985198879708232,1.05259837974466,0.907568853273874
"2210","충남","계룡시",2017,480,249,231,"4",2015,475,256,219,1.03276649247749,0.992314349943178,1.08002925004984
"2211","충남","계룡시",2018,508,273,235,"4",2016,475,234,241,1.09301120453867,1.19024586017281,0.998431954766662
"2212","충남","계룡시",2019,475,230,245,"4",2017,460,236,224,1.05533487257805,0.994273176173411,1.11991669394372
"2213","충남","계룡시",2020,419,194,225,"4",2018,421,207,214,1.01715336087357,0.95613953156739,1.07655543343055
"2214","충남","공주시",2010,981,496,485,"4",2008,924,491,433,1.08505448758161,1.03059984866869,1.14688928340525
"2215","충남","공주시",2011,925,503,422,"4",2009,858,437,421,1.10181569937912,1.17429290814042,1.02635595758507
"2216","충남","공주시",2012,832,413,419,"4",2010,928,464,464,0.916283490093174,0.908075505390461,0.924620876379152
"2217","충남","공주시",2013,887,436,451,"4",2011,970,518,452,0.934558295625167,0.858710195866537,1.02165851624499
"2218","충남","공주시",2014,871,466,405,"4",2012,864,416,448,1.03028866970546,1.14283222013845,0.925645430708587
"2219","충남","공주시",2015,797,395,402,"4",2013,827,410,417,0.984934438960261,0.982885954219357,0.987092041856255
"2220","충남","공주시",2016,731,380,351,"4",2014,787,412,375,0.949286174688945,0.940971068375174,0.958392709057211
"2221","충남","공주시",2017,749,390,359,"4",2015,781,400,381,0.980133639727855,0.994705468858703,0.964799623548968
"2222","충남","공주시",2018,735,364,371,"4",2016,764,399,365,0.983214991509061,0.930718567353173,1.04075545913893
"2223","충남","공주시",2019,734,389,345,"4",2017,685,376,309,1.09511568613831,1.05548398086753,1.1432159316818
"2224","충남","공주시",2020,670,353,317,"4",2018,629,343,286,1.08862591491442,1.04995449056477,1.13490858575076
"2225","충남","금산군",2010,412,206,206,"4",2008,378,195,183,1.11393519939288,1.07776108657406,1.15261371529696
"2226","충남","금산군",2011,370,191,179,"4",2009,379,185,194,0.997739176852015,1.05329865309501,0.944754465818799
"2227","충남","금산군",2012,371,183,188,"4",2010,404,216,188,0.938527615185877,0.864345207982634,1.02392383446283
"2228","충남","금산군",2013,377,201,176,"4",2011,462,229,233,0.833976639792596,0.895468813080727,0.773436029465487
"2229","충남","금산군",2014,454,221,233,"4",2012,406,202,204,1.14283710028105,1.11617115317478,1.16948163446
"2230","충남","금산군",2015,378,200,178,"4",2013,396,200,196,0.975553575990809,1.02021073729098,0.929890012930531
"2231","충남","금산군",2016,377,190,187,"4",2014,417,221,196,0.923974118906905,0.877104253779574,0.976906923696681
"2232","충남","금산군",2017,400,218,182,"4",2015,384,191,193,1.06459219602172,1.16442900905462,0.965565481203292
"2233","충남","금산군",2018,370,187,183,"4",2016,345,180,165,1.09606709573018,1.05988559929674,1.13562461640423
"2234","충남","금산군",2019,322,179,143,"4",2017,310,170,140,1.06157012785236,1.07422189397109,1.04586505948704
"2235","충남","금산군",2020,298,167,131,"4",2018,270,132,138,1.1279945756959,1.29072116005753,0.971985668946601
"2236","충남","논산시",2010,1068,545,523,"4",2008,1001,481,520,1.09041467206508,1.15595603289726,1.02983108735396
"2237","충남","논산시",2011,985,489,496,"4",2009,931,472,459,1.08128719716234,1.05695561554086,1.10646235706659
"2238","충남","논산시",2012,939,483,456,"4",2010,981,510,471,0.978252792234267,0.966199580610867,0.991314795148729
"2239","충남","논산시",2013,999,518,481,"4",2011,1049,567,482,0.973295042585955,0.932044377278177,1.02179951115482
"2240","충남","논산시",2014,1065,564,501,"4",2012,973,482,491,1.11864240617945,1.19377355981766,1.04477768037857
"2241","충남","논산시",2015,1009,512,497,"4",2013,903,452,451,1.14197849917439,1.15563694135615,1.12835952489585
"2242","충남","논산시",2016,919,467,452,"4",2014,880,453,427,1.06730206706614,1.05174042895118,1.08387253671475
"2243","충남","논산시",2017,918,495,423,"4",2015,915,485,430,1.02535935574865,1.04124601022481,1.00725530692506
"2244","충남","논산시",2018,909,465,444,"4",2016,917,460,457,1.01309240342027,1.03129998443544,0.99479689825273
"2245","충남","논산시",2019,905,466,439,"4",2017,826,419,407,1.11975508462914,1.13464965054319,1.10442890252871
"2246","충남","논산시",2020,794,409,385,"4",2018,816,409,407,0.994454357224991,1.02021073729098,0.968576600167544
"2247","충남","당진시",2014,1773,923,850,"4",2012,1728,921,807,1.04862331308139,1.02242617863146,1.07848235352343
"2248","충남","당진시",2015,1734,925,809,"4",2013,1732,857,875,1.02318865657367,1.10116094748443,0.946690722377636
"2249","충남","당진시",2016,1691,845,846,"4",2014,1923,1011,912,0.898708469752373,0.852698390713033,0.949824083284601
"2250","충남","당진시",2017,1862,989,873,"4",2015,1951,999,952,0.975386900170547,1.00999841759838,0.938955365006357
"2251","충남","당진시",2018,1865,967,898,"4",2016,1943,1009,934,0.980980889221452,0.977744086184713,0.984457819430003
"2252","충남","당진시",2019,1871,975,896,"4",2017,1825,923,902,1.04776872263362,1.07768739854681,1.01711281117372
"2253","충남","당진시",2020,1703,850,853,"4",2018,1786,901,885,0.974513151977594,0.96246295970847,0.986900599770391
"2254","충남","보령시",2010,900,435,465,"4",2008,920,481,439,0.999790931916046,0.922643806073961,1.08456624834901
"2255","충남","보령시",2011,888,471,417,"4",2009,815,453,362,1.11355037455778,1.06074891228267,1.17949237284807
"2256","충남","보령시",2012,779,426,353,"4",2010,876,455,421,0.908840899398265,0.955186316672432,0.858539462150545
"2257","충남","보령시",2013,813,434,379,"4",2011,879,447,432,0.945270667976142,0.990540178935759,0.898303549216234
"2258","충남","보령시",2014,828,422,406,"4",2012,859,428,431,0.98512577971332,1.00590871760933,0.964531500677285
"2259","충남","보령시",2015,836,424,412,"4",2013,796,390,406,1.07336571964722,1.10915218618301,1.03905571378987
"2260","충남","보령시",2016,768,388,380,"4",2014,812,424,388,0.96662873680159,0.933589070917216,1.00281200282442
"2261","충남","보령시",2017,797,412,385,"4",2015,838,416,422,0.972005705274624,1.01040101866318,0.934148521962536
"2262","충남","보령시",2018,811,401,410,"4",2016,766,399,367,1.08204817249957,1.02532457557314,1.14389311207019
"2263","충남","보령시",2019,726,374,352,"4",2017,684,360,324,1.08476341657792,1.05988559929674,1.11241107941641
"2264","충남","보령시",2020,644,341,303,"4",2018,732,343,389,0.899144097361292,1.01426198663622,0.797555069003183
"2265","충남","부여군",2010,536,279,257,"4",2008,490,265,225,1.11795216405089,1.07410866303465,1.16954855758643
"2266","충남","부여군",2011,451,248,203,"4",2009,481,234,247,0.958265773782873,1.08124898653061,0.841524446947186
"2267","충남","부여군",2012,451,220,231,"4",2010,460,240,220,1.00201268954253,0.935193175850063,1.07512002618597
"2268","충남","부여군",2013,455,243,212,"4",2011,456,237,219,1.01976726145238,1.04603885722239,0.991195675370413
"2269","충남","부여군",2014,442,230,212,"4",2012,429,230,199,1.05297846297421,1.02021073729098,1.09081333118653
"2270","충남","부여군",2015,408,210,198,"4",2013,412,205,207,1.01208609548006,1.04509392600539,0.979405406877491
"2271","충남","부여군",2016,377,200,177,"4",2014,409,229,180,0.942046962308507,0.891013744358933,1.00685843722178
"2272","충남","부여군",2017,380,212,168,"4",2015,385,214,171,1.00873567041226,1.01067605750321,1.00596025841962
"2273","충남","부여군",2018,359,198,161,"4",2016,403,214,189,0.910424452697082,0.943933298988849,0.872231414542412
"2274","충남","부여군",2019,370,190,180,"4",2017,337,183,154,1.12208649266146,1.05923519172287,1.19679409222928
"2275","충남","부여군",2020,314,176,138,"4",2018,352,188,164,0.911678044229506,0.955090902995809,0.861594446072383
"2276","충남","서산시",2010,1714,911,803,"4",2008,1692,897,795,1.03529703488296,1.03613375883175,1.0342274705329
"2277","충남","서산시",2011,1711,912,799,"4",2009,1556,798,758,1.12381526831454,1.16595512833255,1.07930757748787
"2278","충남","서산시",2012,1492,762,730,"4",2010,1620,831,789,0.941257218645571,0.935500098454543,0.947356652925054
"2279","충남","서산시",2013,1599,831,768,"4",2011,1855,955,900,0.880965824572062,0.887743583967333,0.873748338741617
"2280","충남","서산시",2014,1873,967,906,"4",2012,1718,914,804,1.11421532934967,1.07936956560216,1.153824619432
"2281","충남","서산시",2015,1724,901,823,"4",2013,1665,894,771,1.05822382468696,1.02819896454046,1.09298225131376
"2282","충남","서산시",2016,1641,884,757,"4",2014,1807,934,873,0.92812172768388,0.965595601461696,0.887869808348641
"2283","충남","서산시",2017,1716,889,827,"4",2015,1771,927,844,0.990269113516846,0.978389800918748,1.00329977618574
"2284","충남","서산시",2018,1716,904,812,"4",2016,1838,955,883,0.954171164329888,0.965728279069156,0.941592472914858
"2285","충남","서산시",2019,1834,948,886,"4",2017,1658,823,835,1.13049674547869,1.17516376543359,1.08646289501086
"2286","충남","서산시",2020,1655,816,839,"4",2018,1719,903,816,0.983958162326529,0.92191800844899,1.05278443273813
"2287","충남","서천군",2010,405,215,190,"4",2008,358,176,182,1.1561828095342,1.24628016203159,1.06893147553812
"2288","충남","서천군",2011,339,164,175,"4",2009,380,192,188,0.911739169140282,0.871430004769377,0.953120590590402
"2289","충남","서천군",2012,360,180,180,"4",2010,339,181,158,1.08531876974957,1.01457421388053,1.16649550761588
"2290","충남","서천군",2013,310,160,150,"4",2011,341,166,175,0.92909864380077,0.983335650400942,0.877649000968142
"2291","충남","서천군",2014,328,166,162,"4",2012,336,160,176,0.99767497227178,1.05846863993939,0.942475347630561
"2292","충남","서천군",2015,315,154,161,"4",2013,313,162,151,1.02853891398392,0.969829960140806,1.09173335992395
"2293","충남","서천군",2016,293,149,144,"4",2014,333,167,166,0.899244723414379,0.910247903331471,0.888223085317155
"2294","충남","서천군",2017,316,154,162,"4",2015,338,173,165,0.955487244334757,0.908164471345726,1.0053070374726
"2295","충남","서천군",2018,306,156,150,"4",2016,299,152,147,1.04593512877371,1.04705838827232,1.04482023924779
"2296","충남","서천군",2019,266,133,133,"4",2017,278,133,145,0.977893033007573,1.02021073729098,0.939185310231425
"2297","충남","서천군",2020,261,127,134,"4",2018,278,138,140,0.959511585018709,0.938889591564885,0.980041384414425
"2298","충남","아산시",2010,3124,1649,1475,"4",2008,3132,1600,1532,1.01939801390708,1.05145469112051,0.985827451587909
"2299","충남","아산시",2011,3259,1634,1625,"4",2009,3077,1573,1504,1.08245880018244,1.05977390002127,1.10630068550672
"2300","충남","아산시",2012,2953,1548,1405,"4",2010,3368,1726,1642,0.896078124898469,0.914997810733739,0.876134584299804
"2301","충남","아산시",2013,3235,1662,1573,"4",2011,3819,1972,1847,0.865723363174926,0.859832781631646,0.872026091830013
"2302","충남","아산시",2014,3701,1934,1767,"4",2012,3705,1865,1840,1.02090512517606,1.05795579942131,0.983300769291209
"2303","충남","아산시",2015,3494,1782,1712,"4",2013,3738,1892,1846,0.955296342317785,0.960896159541502,0.949597835644837
"2304","충남","아산시",2016,3564,1817,1747,"4",2014,4062,2127,1935,0.896710567000625,0.871519938720125,0.924441828840603
"2305","충남","아산시",2017,3824,1990,1834,"4",2015,4121,2123,1998,0.948352471556312,0.956297393880851,0.939878034236654
"2306","충남","아산시",2018,3957,2034,1923,"4",2016,4273,2201,2072,0.946428192574681,0.942802653180304,0.950292245980707
"2307","충남","아산시",2019,4141,2111,2030,"4",2017,3929,2045,1884,1.07715378782817,1.05313685399572,1.10327249679382
"2308","충남","아산시",2020,3646,1895,1751,"4",2018,3668,1885,1783,1.01587868615795,1.02562299584425,1.00554718684488
"2309","충남","연기군",2010,736,382,354,"4",2008,726,372,354,1.03608576035965,1.04763575711063,1.02392383446283
"2310","충남","연기군",2011,719,371,348,"4",2009,710,348,362,1.03496354560849,1.08763845843377,0.98432457014659
"2311","충남","연기군",2012,783,388,395,"4",2010,717,346,371,1.11608460516821,1.14405134701994,1.09016149491326
"2312","충남","연기군",2013,0,0,0,"4",2011,828,416,412,0,0,0
"2313","충남","예산군",2010,580,282,298,"4",2008,591,315,276,1.00298635320625,0.913331517193828,1.10554095170262
"2314","충남","예산군",2011,560,293,267,"4",2009,567,299,268,1.00939111919096,0.999738281024269,1.02010322314021
"2315","충남","예산군",2012,539,281,258,"4",2010,568,280,288,0.969828496319501,1.02385434706702,0.917265101706287
"2316","충남","예산군",2013,557,271,286,"4",2011,640,355,285,0.889466779776144,0.778808760016493,1.02751654967147
"2317","충남","예산군",2014,614,338,276,"4",2012,543,280,263,1.15564129654335,1.23154010430125,1.07453603920814
"2318","충남","예산군",2015,512,256,256,"4",2013,528,278,250,0.991038553387488,0.939474635778742,1.04849800648994
"2319","충남","예산군",2016,484,264,220,"4",2014,537,273,264,0.921139884468399,0.986577416281385,0.85326986205236
"2320","충남","예산군",2017,496,259,237,"4",2015,517,263,254,0.980495590053579,1.00469422417629,0.955393499085398
"2321","충남","예산군",2018,497,262,235,"4",2016,473,256,217,1.07386517667205,1.04412192644624,1.10885760875007
"2322","충남","예산군",2019,486,265,221,"4",2017,427,216,211,1.16322279853839,1.25164743232458,1.07245103040894
"2323","충남","예산군",2020,441,229,212,"4",2018,400,191,209,1.12676438026938,1.22318460125463,1.03862130577091
"2324","충남","천안시",2010,6122,3184,2938,"4",2008,6326,3297,3029,0.989050914809224,0.985244460883977,0.9931621742
"2325","충남","천안시",2011,6315,3307,3008,"4",2009,5708,2926,2782,1.13069091260723,1.15305430902982,1.1071038440202
"2326","충남","천안시",2012,6027,3089,2938,"4",2010,5988,3125,2863,1.0286648762201,1.00845790959739,1.05074684793985
"2327","충남","천안시",2013,6104,3190,2914,"4",2011,6821,3517,3304,0.914578497864813,0.925354635188575,0.903061154244762
"2328","충남","천안시",2014,6797,3506,3291,"4",2012,6610,3441,3169,1.05092160818536,1.03948237283992,1.06334280189876
"2329","충남","천안시",2015,6599,3425,3174,"4",2013,6324,3262,3062,1.06645068714191,1.07118999853513,1.06137630652679
"2330","충남","천안시",2016,6326,3273,3053,"4",2014,6611,3376,3235,0.977949753857516,0.989084639559648,0.966318227701708
"2331","충남","천안시",2017,6857,3517,3340,"4",2015,6685,3488,3197,1.04830401504803,1.02869299399437,1.06972336787797
"2332","충남","천안시",2018,7076,3700,3376,"4",2016,7130,3555,3575,1.01426819128859,1.06182270829159,0.966927794446579
"2333","충남","천안시",2019,7491,3751,3740,"4",2017,6612,3373,3239,1.1578744305479,1.13454209178134,1.1823016798058
"2334","충남","천안시",2020,6790,3458,3332,"4",2018,6731,3411,3320,1.03096683561847,1.03426817049317,1.02762476398499
"2335","충남","청양군",2010,189,103,86,"4",2008,215,112,103,0.89841678161014,0.938229517330096,0.854926696735957
"2336","충남","청양군",2011,196,96,100,"4",2009,174,87,87,1.15122797473245,1.1257497790797,1.17692394765843
"2337","충남","청양군",2012,159,86,73,"4",2010,192,106,86,0.846350795837264,0.827718145349284,0.869144650183567
"2338","충남","청양군",2013,173,88,85,"4",2011,180,84,96,0.982263732862703,1.0687922009715,0.906599228430632
"2339","충남","청양군",2014,162,76,86,"4",2012,184,110,74,0.899811838724442,0.704872873037403,1.1899655373487
"2340","충남","청양군",2015,171,99,72,"4",2013,167,72,95,1.04648775388578,1.40278976377509,0.776026485066567
"2341","충남","청양군",2016,144,63,81,"4",2014,181,92,89,0.813089641867636,0.698622570101431,0.931885736983027
"2342","충남","청양군",2017,165,88,77,"4",2015,191,105,86,0.882886931150994,0.855033760777201,0.916769014577187
"2343","충남","청양군",2018,169,89,80,"4",2016,192,97,95,0.89958040563835,0.936069645555639,0.862251650073964
"2344","충남","청양군",2019,159,80,79,"4",2017,168,84,84,0.967258052385445,0.971629273610455,0.962975987173378
"2345","충남","청양군",2020,143,74,69,"4",2018,140,66,74,1.04390869049901,1.1438726448414,0.954739791593722
"2346","충남","태안군",2010,442,217,225,"4",2008,435,215,220,1.0384546221056,1.02970106973089,1.04719483070062
"2347","충남","태안군",2011,436,219,217,"4",2009,430,215,215,1.03626909201593,1.03919140217081,1.03344870734156
"2348","충남","태안군",2012,414,209,205,"4",2010,434,218,216,0.974911341905232,0.97809194538447,0.971779565115188
"2349","충남","태안군",2013,429,212,217,"4",2011,443,240,203,0.989710270901994,0.901186151273697,1.09453927132234
"2350","충남","태안군",2014,438,235,203,"4",2012,427,216,211,1.04833659621361,1.10995149658972,0.985102077705947
"2351","충남","태안군",2015,429,217,212,"4",2013,419,234,185,1.04640011935461,0.946092863214283,1.17336136706011
"2352","충남","태안군",2016,429,224,205,"4",2014,354,193,161,1.23853573449035,1.18407878317709,1.30375395071354
"2353","충남","태안군",2017,349,189,160,"4",2015,434,220,214,0.821845551509483,0.876453769763613,0.7655505304395
"2354","충남","태안군",2018,422,221,201,"4",2016,421,206,215,1.02443608183448,1.09449792689954,0.957249724311764
"2355","충남","태안군",2019,392,186,206,"4",2017,380,190,190,1.05428246107077,0.998732616505905,1.11014899947023
"2356","충남","태안군",2020,356,174,182,"4",2018,332,157,175,1.09588864130235,1.13067941585115,1.06488078784135
"2357","충남","홍성군",2010,749,398,351,"4",2008,726,363,363,1.05438618819209,1.11857816375154,0.990075112662408
"2358","충남","홍성군",2011,733,365,368,"4",2009,678,333,345,1.10491480309227,1.11824900633996,1.09218542342702
"2359","충남","홍성군",2012,661,315,346,"4",2010,661,334,327,1.02200850818085,0.962174797145683,1.08341787989034
"2360","충남","홍성군",2013,716,378,338,"4",2011,704,361,343,1.03942910775211,1.06825390220496,1.00899783104501
"2361","충남","홍성군",2014,773,396,377,"4",2012,706,353,353,1.11899798416968,1.14448569962387,1.09353905266994
"2362","충남","홍성군",2015,827,412,415,"4",2013,696,339,357,1.21436930497925,1.2399021349967,1.19027560588817
"2363","충남","홍성군",2016,849,429,420,"4",2014,744,376,368,1.16624357989992,1.16401703802614,1.16860872411519
"2364","충남","홍성군",2017,950,478,472,"4",2015,794,429,365,1.22280614958666,1.13673830402118,1.32408780785331
"2365","충남","홍성군",2018,942,490,452,"4",2016,923,485,438,1.04304660314882,1.0307283737579,1.05665199355525
"2366","충남","홍성군",2019,943,482,461,"4",2017,852,453,399,1.13116669391378,1.08552224144426,1.18302979370267
"2367","충남","홍성군",2020,865,462,403,"4",2018,836,445,391,1.05746095643114,1.05918508006389,1.05534860687601
"2368","충북","괴산군",2010,200,112,88,"4",2008,186,83,103,1.09893387976435,1.37666991056132,0.874808712939119
"2369","충북","괴산군",2011,177,88,89,"4",2009,165,73,92,1.09633639968491,1.22984308056995,0.990535013773827
"2370","충북","괴산군",2012,167,79,88,"4",2010,160,79,81,1.06672138041376,1.02021073729098,1.11241107941641
"2371","충북","괴산군",2013,166,83,83,"4",2011,206,94,112,0.823560254165149,0.900824374416502,0.758800698753706
"2372","충북","괴산군",2014,191,90,101,"4",2012,185,89,96,1.05515473006779,1.03167377928301,1.0772532008411
"2373","충북","괴산군",2015,189,79,110,"4",2013,199,96,103,0.970651296714473,0.839548419229034,1.0935108911739
"2374","충북","괴산군",2016,182,77,105,"4",2014,196,110,86,0.949007900453644,0.714147516103685,1.25013956533253
"2375","충북","괴산군",2017,190,104,86,"4",2015,153,68,85,1.26916089251216,1.56032230409208,1.03596999722122
"2376","충북","괴산군",2018,142,61,81,"4",2016,187,97,90,0.776070631880644,0.641575824481955,0.921531451016549
"2377","충북","괴산군",2019,170,96,74,"4",2017,142,68,74,1.22353131261087,1.44029751146962,1.02392383446283
"2378","충북","괴산군",2020,143,62,81,"4",2018,164,81,83,0.891141565060129,0.780902045827662,0.9992509709818
"2379","충북","단양군",2010,203,103,100,"4",2008,227,125,102,0.913954745201375,0.840653647527766,1.00384689653219
"2380","충북","단양군",2011,205,114,91,"4",2009,222,111,111,0.943746595392224,1.047784000461,0.839433053478538
"2381","충북","단양군",2012,200,106,94,"4",2010,209,106,103,0.977998572421863,1.02021073729098,0.934454761548604
"2382","충북","단양군",2013,184,95,89,"4",2011,207,103,104,0.908452007271864,0.940971068375174,0.876242512184539
"2383","충북","단양군",2014,211,108,103,"4",2012,187,90,97,1.15317537554096,1.22425288474917,1.08725932937806
"2384","충북","단양군",2015,182,86,96,"4",2013,186,102,84,1.00002983058556,0.860177680461021,1.17019866795752
"2385","충북","단양군",2016,175,100,75,"4",2014,162,95,67,1.10402153661511,1.07390603925366,1.14618339678675
"2386","충북","단양군",2017,152,88,64,"4",2015,164,93,71,0.947227397826151,0.965360697651678,0.922973597262271
"2387","충북","단양군",2018,164,92,72,"4",2016,160,81,79,1.04755872088537,1.15875787445395,0.933196406092708
"2388","충북","단양군",2019,155,78,77,"4",2017,136,71,65,1.16478910858847,1.12079489448868,1.21295592697905
"2389","충북","단양군",2020,117,60,57,"4",2018,136,77,59,0.879227907773229,0.794969405681281,0.989214551938668
"2390","충북","보은군",2010,209,90,119,"4",2008,207,102,105,1.03188298652076,0.90018594466851,1.16044701239121
"2391","충북","보은군",2011,210,113,97,"4",2009,203,114,89,1.05725018087674,1.0112615202972,1.11596193194264
"2392","충북","보은군",2012,199,108,91,"4",2010,191,109,82,1.06481514726696,1.0108510057562,1.13630571873314
"2393","충북","보은군",2013,188,103,85,"4",2011,186,103,83,1.03299784697849,1.02021073729098,1.04859669794386
"2394","충북","보은군",2014,191,115,76,"4",2012,198,105,93,0.985876894255262,1.11737366465202,0.836754961496508
"2395","충북","보은군",2015,180,100,80,"4",2013,185,90,95,0.994386656608392,1.13356748587886,0.862251650073964
"2396","충북","보은군",2016,196,101,95,"4",2014,167,101,66,1.19948303954159,1.02021073729098,1.4738297617268
"2397","충북","보은군",2017,185,110,75,"4",2015,194,97,97,0.974595742337406,1.1569400113609,0.791693686440334
"2398","충북","보은군",2018,202,101,101,"4",2016,194,104,90,1.06415318893057,0.990781581407584,1.14907008089718
"2399","충북","보은군",2019,184,93,91,"4",2017,158,73,85,1.19018712345111,1.2997205283296,1.09620081101315
"2400","충북","보은군",2020,146,67,79,"4",2018,156,82,74,0.956495142271819,0.833586821932872,1.09310787733194
"2401","충북","영동군",2010,339,163,176,"4",2008,331,164,167,1.04670962016105,1.01398994011237,1.0791053584758
"2402","충북","영동군",2011,320,162,158,"4",2009,298,158,140,1.09745880073111,1.0460388572224,1.15557118460805
"2403","충북","영동군",2012,295,154,141,"4",2010,287,149,138,1.05049655022073,1.05444599693161,1.0461830482555
"2404","충북","영동군",2013,296,150,146,"4",2011,360,191,169,0.840318106726474,0.801212620909145,0.884573253441263
"2405","충북","영동군",2014,343,178,165,"4",2012,304,169,135,1.15312144179615,1.07454148661417,1.25146246434346
"2406","충북","영동군",2015,294,159,135,"4",2013,305,164,141,0.985149184934981,0.98910675139796,0.980352607464414
"2407","충북","영동군",2016,272,143,129,"4",2014,352,199,153,0.789733847230655,0.733116258455326,0.863308331017682
"2408","충북","영동군",2017,298,181,117,"4",2015,299,156,143,1.01859041952472,1.18370604775428,0.837755864560499
"2409","충북","영동군",2018,279,141,138,"4",2016,303,143,160,0.941057339216028,1.00594205565054,0.883134307224193
"2410","충북","영동군",2019,266,132,134,"4",2017,255,135,120,1.06609514971022,0.997539387573401,1.14338161515016
"2411","충북","영동군",2020,224,113,111,"4",2018,261,122,139,0.877126075986628,0.944949289458037,0.817665795866003
"2412","충북","옥천군",2010,408,221,187,"4",2008,421,222,199,0.990450050683577,1.01561519342931,0.962179683640953
"2413","충북","옥천군",2011,392,191,201,"4",2009,365,175,190,1.09760913755313,1.11348714755758,1.08320363540542
"2414","충북","옥천군",2012,354,176,178,"4",2010,392,199,193,0.922936254836786,0.902296933483478,0.944344261836187
"2415","충북","옥천군",2013,374,198,176,"4",2011,438,218,220,0.872673931643007,0.926613421943182,0.819139067570265
"2416","충북","옥천군",2014,396,200,196,"4",2012,370,188,182,1.09382532226923,1.08533057158615,1.10268720634459
"2417","충북","옥천군",2015,357,183,174,"4",2013,376,191,185,0.9703644612249,0.977479397509157,0.963041876738015
"2418","충북","옥천군",2016,350,179,171,"4",2014,350,190,160,1.02200850818085,0.961145905132026,1.09431859808215
"2419","충북","옥천군",2017,362,195,167,"4",2015,389,220,169,0.951072184990917,0.904277698962458,1.01180639263487
"2420","충북","옥천군",2018,379,210,169,"4",2016,328,161,167,1.18091836768458,1.33070965733606,1.0361863953546
"2421","충북","옥천군",2019,334,163,171,"4",2017,288,151,137,1.18524597823751,1.10128708727437,1.27803631892806
"2422","충북","옥천군",2020,272,148,124,"4",2018,309,148,161,0.899632084871167,1.02021073729098,0.788612145797461
"2423","충북","음성군",2010,824,427,397,"4",2008,880,467,413,0.956971603114794,0.932826519964127,0.984256083006645
"2424","충북","음성군",2011,786,443,343,"4",2009,785,399,386,1.02331042984732,1.1327151794985,0.909859780364641
"2425","충북","음성군",2012,720,376,344,"4",2010,793,394,399,0.927927018777062,0.973602124927431,0.882781451266201
"2426","충북","음성군",2013,727,349,378,"4",2011,877,461,416,0.847206596861432,0.772350428014211,0.930392330353246
"2427","충북","음성군",2014,836,436,400,"4",2012,806,414,392,1.06004852709577,1.07442483444171,1.04482023924779
"2428","충북","음성군",2015,797,413,384,"4",2013,791,420,371,1.02976078510763,1.00320722500279,1.05980256720681
"2429","충북","음성군",2016,785,427,358,"4",2014,845,457,388,0.949439856712385,0.953238478825487,0.944754465818799
"2430","충북","음성군",2017,823,454,369,"4",2015,875,477,398,0.961272002551814,0.971018186016989,0.949316318886394
"2431","충북","음성군",2018,801,428,373,"4",2016,894,493,401,0.915692186860021,0.885700193834764,0.952427905871911
"2432","충북","음성군",2019,756,411,345,"4",2017,763,395,368,1.01263228333515,1.06153572918125,0.959928594808905
"2433","충북","음성군",2020,670,340,330,"4",2018,694,352,342,0.986665274468541,0.985430825792422,0.987996682376417
"2434","충북","제천시",2010,1162,605,557,"4",2008,1130,606,524,1.05095034204084,1.01852722122284,1.08840758739656
"2435","충북","제천시",2011,1162,618,544,"4",2009,1028,527,501,1.15522751605656,1.19637615872073,1.11180552085385
"2436","충북","제천시",2012,1053,536,517,"4",2010,1067,551,516,1.00859883703321,0.992437305241314,1.02590818297923
"2437","충북","제천시",2013,1082,562,520,"4",2011,1134,582,552,0.975143920504124,0.98515194906792,0.964565931015711
"2438","충북","제천시",2014,1105,568,537,"4",2012,1115,598,517,1.01284251259178,0.969029596624206,1.06353404082503
"2439","충북","제천시",2015,1079,572,507,"4",2013,1026,517,509,1.07480232000695,1.12874379444959,1.01990055809952
"2440","충북","제천시",2016,993,496,497,"4",2014,1108,538,570,0.915933617891319,0.940566032892797,0.892789729347417
"2441","충북","제천시",2017,1061,511,550,"4",2015,1082,553,529,1.00217285321615,0.942726377496726,1.06457109443206
"2442","충북","제천시",2018,1057,524,533,"4",2016,1116,574,542,0.967977592425767,0.93134220616807,1.00692140916732
"2443","충북","제천시",2019,1078,536,542,"4",2017,964,476,488,1.14286843549684,1.14880872938648,1.13722688171897
"2444","충북","제천시",2020,931,477,454,"4",2018,1022,507,515,0.931007750603101,0.959843238042991,0.902643535623545
"2445","충북","증평군",2010,311,165,146,"4",2008,348,171,177,0.913346684035183,0.984413869315856,0.844592541421319
"2446","충북","증평군",2011,332,165,167,"4",2009,345,175,170,0.983498042655192,0.961912980874351,1.00585459032525
"2447","충북","증평군",2012,319,163,156,"4",2010,330,173,157,0.987941557908153,0.961239018372424,1.01740202660001
"2448","충북","증평군",2013,323,172,151,"4",2011,389,208,181,0.848608607049907,0.843635801990616,0.854212701678937
"2449","충북","증평군",2014,367,192,175,"4",2012,385,203,182,0.974226292213951,0.964928382068314,0.984542148521954
"2450","충북","증평군",2015,352,183,169,"4",2013,368,194,174,0.977573355651245,0.962363736722933,0.994500735771371
"2451","충북","증평군",2016,341,193,148,"4",2014,436,228,208,0.799323168095571,0.863599439899819,0.728561189906246
"2452","충북","증평군",2017,397,214,183,"4",2015,402,213,189,1.00929695957163,1.0250004590623,0.991418315908456
"2453","충북","증평군",2018,381,192,189,"4",2016,418,208,210,0.931543640231825,0.941732988268595,0.921531451016549
"2454","충북","증평군",2019,369,188,181,"4",2017,423,228,195,0.891539336923718,0.841226397415368,0.950411354039859
"2455","충북","증평군",2020,355,184,171,"4",2018,384,171,213,0.944825573969273,1.09777061790374,0.82202336006171
"2456","충북","진천군",2010,632,336,296,"4",2008,653,363,290,0.989141465804434,0.944327294021401,1.04510846552068
"2457","충북","진천군",2011,644,356,288,"4",2009,586,319,267,1.12316293390523,1.13854239020561,1.10445716975766
"2458","충북","진천군",2012,598,325,273,"4",2010,547,291,256,1.11729632155786,1.13941061724937,1.09191877659513
"2459","충북","진천군",2013,564,300,264,"4",2011,700,357,343,0.823446855162854,0.857319947303343,0.788092980461188
"2460","충북","진천군",2014,698,355,343,"4",2012,613,339,274,1.16372257538374,1.06836227651415,1.28177326722902
"2461","충북","진천군",2015,670,369,301,"4",2013,567,280,287,1.20766437474633,1.34449200735847,1.07387133858297
"2462","충북","진천군",2016,681,325,356,"4",2014,639,327,312,1.08918277632419,1.01397091626779,1.16832334957939
"2463","충북","진천군",2017,767,392,375,"4",2015,696,353,343,1.12626512323953,1.13292523801151,1.11945025633692
"2464","충북","진천군",2018,852,437,415,"4",2016,702,360,342,1.24038639454428,1.23842247832266,1.24248067632186
"2465","충북","진천군",2019,904,455,449,"4",2017,705,348,357,1.31049034240494,1.33389622260746,1.28779216155129
"2466","충북","진천군",2020,837,415,422,"4",2018,772,412,360,1.10805844734115,1.02763945625183,1.20026627262032
"2467","충북","청원군",2010,1453,777,676,"4",2008,1711,864,847,0.867900854697119,0.917481183883206,0.817204854895956
"2468","충북","청원군",2011,1558,793,765,"4",2009,1534,816,718,1.03799821104678,0.991454797391845,1.09094948936499
"2469","충북","청원군",2012,1530,813,717,"4",2010,1632,819,813,0.958132976419545,1.01273666595551,0.903017699028106
"2470","충북","청원군",2013,1618,825,793,"4",2011,1957,1016,941,0.844971776308948,0.828419151835686,0.862881616077604
"2471","충북","청원군",2014,1759,922,837,"4",2012,1845,943,902,0.974370171214152,0.997491304116948,0.95013774883081
"2472","충북","청원군",2015,0,0,0,"4",2013,1791,953,838,0,0,0
"2473","충북","청주시",2010,7191,3773,3418,"4",2008,6759,3537,3222,1.08732995743874,1.08828247435648,1.08621094543574
"2474","충북","청주시",2011,6977,3643,3334,"4",2009,6334,3250,3084,1.12575834568642,1.14357775875416,1.10692673933174
"2475","충북","청주시",2012,6402,3293,3109,"4",2010,6568,3346,3222,0.996178207882732,1.00405079435122,0.988013408238654
"2476","충북","청주시",2013,6508,3290,3218,"4",2011,7227,3742,3485,0.92033089404192,0.896978440857113,0.945476872109439
"2477","충북","청주시",2014,7226,3741,3485,"4",2012,6803,3458,3345,1.08555541380491,1.10370398155163,1.06677864367802
"2478","충북","청주시",2015,8391,4303,4088,"4",2013,6697,3508,3189,1.28052462179267,1.25141585021752,1.31257467396803
"2479","충북","청주시",2016,8134,4263,3871,"4",2014,8843,4553,4290,0.940067534269254,0.955229161667349,0.92391821986145
"2480","충북","청주시",2017,8554,4407,4147,"4",2015,8785,4415,4370,0.995134977686849,1.01836211081344,0.971673258928458
"2481","충북","청주시",2018,8496,4284,4212,"4",2016,9141,4671,4470,0.949894353517611,0.935684606841051,0.964824874889809
"2482","충북","청주시",2019,8854,4511,4343,"4",2017,8228,4219,4009,1.09976462462728,1.09082025027722,1.1092295368102
"2483","충북","청주시",2020,8056,4118,3938,"4",2018,7938,4005,3933,1.03720087451561,1.04899570940431,1.02522554287176
"2484","충북","충주시",2010,1918,977,941,"4",2008,1841,955,886,1.06475411118461,1.04371297417098,1.08748569777599
"2485","충북","충주시",2011,1818,948,870,"4",2009,1643,866,777,1.13086516608203,1.1168126777735,1.14647842468811
"2486","충북","충주시",2012,1624,845,779,"4",2010,1694,872,822,0.979776751644449,0.988621643361097,0.970360908815749
"2487","충북","충주시",2013,1676,865,811,"4",2011,1847,982,865,0.927388337688739,0.898658134171788,0.960002577744921
"2488","충북","충주시",2014,1837,957,880,"4",2012,1730,916,814,1.08521943903365,1.06587519168937,1.10694468590576
"2489","충북","충주시",2015,1701,902,799,"4",2013,1588,802,786,1.09473329497205,1.14741905864896,1.04085896149593
"2490","충북","충주시",2016,1594,789,805,"4",2014,1736,860,876,0.938411038041631,0.935984036886723,0.940934573907054
"2491","충북","충주시",2017,1738,874,864,"4",2015,1731,928,803,1.02614141375986,0.960845026284822,1.10170634243572
"2492","충북","충주시",2018,1735,914,821,"4",2016,1654,815,839,1.07205850162864,1.14413817654473,1.00195645779974
"2493","충북","충주시",2019,1682,828,854,"4",2017,1544,774,770,1.11335382821256,1.09138823059035,1.13562461640423
"2494","충북","충주시",2020,1598,806,792,"4",2018,1565,769,796,1.04355884733099,1.06929759981343,1.01877848856101
