,prov,distinct,입학년도,총입학자,남자입학,여자입학,인구나이,인구연도,인구총합,인구남자,인구여자,(입학합계)/(인구총합*총합보정),(입학남자)/(인구남자*남자보정),(입학여자)/(인구여자*여자보정),,,
1,강원,강릉시,2010,2054,1059,995,4,2008,2018,1050,968,1.038957509,1.027673102,1.051199598,,총합보정,0.9796738
2,강원,강릉시,2011,1935,989,946,4,2009,1763,912,851,1.120333097,1.104968206,1.136839197,,남자보정,0.9814127
3,강원,강릉시,2012,1735,919,816,4,2010,1729,957,772,1.024290146,0.978479885,1.080961737,,여자보정,0.9778282
4,강원,강릉시,2013,1704,923,781,4,2011,1903,1016,887,0.914006557,0.925670283,0.900460936,,,
5,강원,강릉시,2014,1839,999,840,4,2012,1639,844,795,1.145305337,1.206066821,1.080561825,,,
6,강원,강릉시,2015,1627,850,777,4,2013,1662,819,843,0.999252037,1.057507248,0.942607535,,,
7,강원,강릉시,2016,1659,820,839,4,2014,1652,868,784,1.025073136,0.962592461,1.094418337,,,
8,강원,강릉시,2017,1625,869,756,4,2015,1650,873,777,1.005282055,1.014270657,0.99503473,,,
9,강원,강릉시,2018,1662,875,787,4,2016,1627,823,804,1.042706247,1.083319465,1.001050868,,,
10,강원,강릉시,2019,1627,824,803,4,2017,1447,778,669,1.147724178,1.079185107,1.227515233,,,
11,강원,강릉시,2020,1451,770,681,4,2018,1373,693,680,1.078736526,1.132154818,1.024178517,,,
12,강원,고성군,2010,196,99,97,4,2008,219,111,108,0.913546095,0.908783732,0.918513284,,,
13,강원,고성군,2011,175,97,78,4,2009,194,98,96,0.920777774,1.008541996,0.8309231,,,
14,강원,고성군,2012,183,102,81,4,2010,195,104,91,0.957932675,0.999344349,0.910292762,,,
15,강원,고성군,2013,181,99,82,4,2011,169,97,72,1.093227076,1.039948395,1.164712721,,,
16,강원,고성군,2014,162,91,71,4,2012,157,89,68,1.053255828,1.04183685,1.06779258,,,
17,강원,고성군,2015,160,94,66,4,2013,146,70,76,1.118627871,1.368289966,0.888112139,,,
18,강원,고성군,2016,144,69,75,4,2014,153,83,70,0.960703937,0.847070051,1.095722769,,,
19,강원,고성군,2017,154,82,72,4,2015,161,91,70,0.976367588,0.918165116,1.051893858,,,
20,강원,고성군,2018,163,90,73,4,2016,169,94,75,0.984508361,0.975580216,0.995403262,,,
21,강원,고성군,2019,155,78,77,4,2017,144,68,76,1.098721733,1.168783356,1.036130829,,,
22,강원,고성군,2020,150,76,74,4,2018,143,75,68,1.070714615,1.032525194,1.112910577,,,
23,강원,동해시,2010,980,531,449,4,2008,920,496,424,1.08731845,1.090840298,1.082973793,,,
24,강원,동해시,2011,943,507,436,4,2009,848,464,384,1.13510059,1.113366904,1.161161767,,,
25,강원,동해시,2012,845,436,409,4,2010,827,435,392,1.042964937,1.021281726,1.067025268,,,
26,강원,동해시,2013,845,445,400,4,2011,877,455,422,0.983502854,0.996545065,0.969359795,,,
27,강원,동해시,2014,928,484,444,4,2012,786,423,363,1.205157864,1.165878579,1.250874698,,,
28,강원,동해시,2015,836,452,384,4,2013,843,425,418,1.012271971,1.083671953,0.939490527,,,
29,강원,동해시,2016,869,429,440,4,2014,843,449,394,1.052230075,0.973552284,1.14207314,,,
30,강원,동해시,2017,810,426,384,4,2015,827,431,396,0.999765206,1.007118694,0.991684445,,,
31,강원,동해시,2018,829,436,393,4,2016,868,440,428,0.974884834,1.009676251,0.939044653,,,
32,강원,동해시,2019,861,439,422,4,2017,759,394,365,1.157923544,1.135315656,1.18237993,,,
33,강원,동해시,2020,756,386,370,4,2018,734,393,341,1.051342557,1.00079029,1.109646909,,,
34,강원,삼척시,2010,522,267,255,4,2008,573,271,302,0.929896022,1.003899641,0.863516619,,,
35,강원,삼척시,2011,547,268,279,4,2009,491,247,244,1.137167249,1.105569806,1.169369709,,,
36,강원,삼척시,2012,473,234,239,4,2010,488,268,220,0.989372484,0.889670913,1.11099648,,,
37,강원,삼척시,2013,464,256,208,4,2011,537,285,252,0.88198704,0.91525779,0.844112355,,,
38,강원,삼척시,2014,500,266,234,4,2012,478,231,247,1.067727963,1.173324084,0.968849606,,,
39,강원,삼척시,2015,447,216,231,4,2013,485,264,221,0.940771806,0.833677639,1.068949452,,,
40,강원,삼척시,2016,461,249,212,4,2014,486,246,240,0.968240323,1.031365426,0.903362549,,,
41,강원,삼척시,2017,464,236,228,4,2015,473,243,230,1.001325667,0.989587174,1.013781762,,,
42,강원,삼척시,2018,450,233,217,4,2016,511,269,242,0.898897397,0.882575708,0.917026383,,,
43,강원,삼척시,2019,486,260,226,4,2017,439,218,221,1.130030741,1.21524875,1.045812018,,,
44,강원,삼척시,2020,400,199,201,4,2018,426,223,203,0.958448763,0.909277704,1.012598972,,,
45,강원,속초시,2010,847,429,418,4,2008,805,423,382,1.074004346,1.033392377,1.119052294,,,
46,강원,속초시,2011,803,424,379,4,2009,680,340,340,1.20538322,1.27067729,1.139981375,,,
47,강원,속초시,2012,677,339,338,4,2010,688,342,346,1.004427835,1.010001272,0.999028929,,,
48,강원,속초시,2013,680,340,340,4,2011,712,383,329,0.974871621,0.904541447,1.056867351,,,
49,강원,속초시,2014,712,399,313,4,2012,630,320,310,1.153607187,1.270489985,1.032571435,,,
50,강원,속초시,2015,644,312,332,4,2013,614,325,289,1.07062161,0.978181763,1.174837238,,,
51,강원,속초시,2016,597,314,283,4,2014,708,348,360,0.860715418,0.919387792,0.803935854,,,
52,강원,속초시,2017,666,316,350,4,2015,673,355,318,1.010130941,0.906999522,1.125585234,,,
53,강원,속초시,2018,648,342,306,4,2016,671,314,357,0.985759553,1.109800169,0.876578215,,,
54,강원,속초시,2019,663,324,339,4,2017,612,301,311,1.10581026,1.096798488,1.11474818,,,
55,강원,속초시,2020,579,274,305,4,2018,630,309,321,0.938115957,0.903525496,0.97170015,,,
56,강원,양구군,2010,210,106,104,4,2008,235,115,120,0.912157727,0.939196258,0.886317973,,,
57,강원,양구군,2011,222,105,117,4,2009,209,118,91,1.084239431,0.906683308,1.314867322,,,
58,강원,양구군,2012,192,100,92,4,2010,212,108,104,0.924450958,0.943462348,0.904673671,,,
59,강원,양구군,2013,199,110,89,4,2011,211,115,96,0.962695917,0.974637626,0.948104562,,,
60,강원,양구군,2014,209,115,94,4,2012,211,106,105,1.011072597,1.105453054,0.915537247,,,
61,강원,양구군,2015,197,106,91,4,2013,177,88,89,1.136086682,1.227358746,1.045656035,,,
62,강원,양구군,2016,166,85,81,4,2014,215,106,109,0.788112357,0.817073996,0.759969186,,,
63,강원,양구군,2017,197,93,104,4,2015,218,120,98,0.922419003,0.789677986,1.085287314,,,
64,강원,양구군,2018,199,110,89,4,2016,229,114,115,0.887025496,0.983187079,0.7914612,,,
65,강원,양구군,2019,195,97,98,4,2017,179,84,95,1.111987971,1.176632329,1.054969571,,,
66,강원,양구군,2020,166,83,83,4,2018,186,94,92,0.91099009,0.899701754,0.922630331,,,
67,강원,양양군,2010,207,113,94,4,2008,206,117,89,1.02570302,0.984103803,1.080128212,,,
68,강원,양양군,2011,180,103,77,4,2009,189,97,92,0.972140888,1.081966512,0.855934163,,,
69,강원,양양군,2012,169,85,84,4,2010,170,85,85,1.014743533,1.018939336,1.010643118,,,
70,강원,양양군,2013,168,82,86,4,2011,197,97,100,0.870485547,0.861371398,0.879500142,,,
71,강원,양양군,2014,175,89,86,4,2012,166,93,73,1.076089688,0.975113989,1.204794716,,,
72,강원,양양군,2015,150,87,63,4,2013,167,80,87,0.91683946,1.108096528,0.740557457,,,
73,강원,양양군,2016,151,70,81,4,2014,158,76,82,0.975524923,0.938496757,1.010202943,,,
74,강원,양양군,2017,158,85,73,4,2015,160,84,76,1.007988583,1.031069567,0.982305851,,,
75,강원,양양군,2018,146,74,72,4,2016,155,79,76,0.961478698,0.954449505,0.968849606,,,
76,강원,양양군,2019,154,83,71,4,2017,145,80,65,1.084104701,1.057149561,1.117075315,,,
77,강원,양양군,2020,141,76,65,4,2018,133,70,63,1.082146304,1.106276994,1.055140444,,,
78,강원,영월군,2010,283,144,139,4,2008,297,144,153,0.972631868,1.018939336,0.929096518,,,
79,강원,영월군,2011,287,147,140,4,2009,255,142,113,1.148841791,1.054817482,1.267030458,,,
80,강원,영월군,2012,244,132,112,4,2010,256,134,122,0.972900373,1.003731287,0.938848799,,,
81,강원,영월군,2013,253,137,116,4,2011,268,132,136,0.963616518,1.057535523,0.872281263,,,
82,강원,영월군,2014,254,136,118,4,2012,239,121,118,1.08481161,1.14525413,1.022674584,,,
83,강원,영월군,2015,232,120,112,4,2013,216,113,103,1.09635889,1.082059472,1.112034499,,,
84,강원,영월군,2016,205,113,92,4,2014,223,125,98,0.938355723,0.92112116,0.960061854,,,
85,강원,영월군,2017,221,121,100,4,2015,251,128,123,0.898746188,0.963216091,0.831442751,,,
86,강원,영월군,2018,238,115,123,4,2016,202,111,91,1.202663406,1.055657871,1.382296416,,,
87,강원,영월군,2019,198,117,81,4,2017,177,92,85,1.141853619,1.295825026,0.974548721,,,
88,강원,영월군,2020,168,88,80,4,2018,188,104,84,0.912157727,0.862179438,0.973975794,,,
89,강원,원주시,2010,3262,1724,1538,4,2008,3127,1613,1514,1.06481604,1.089058534,1.03888607,,,
90,강원,원주시,2011,3221,1671,1550,4,2009,2983,1571,1412,1.102188767,1.083798619,1.122624366,,,
91,강원,원주시,2012,3041,1599,1442,4,2010,3014,1543,1471,1.029891992,1.055919636,1.002513087,,,
92,강원,원주시,2013,3061,1576,1485,4,2011,3389,1739,1650,0.921956159,0.923432084,0.920407126,,,
93,강원,원주시,2014,3415,1764,1651,4,2012,3063,1566,1497,1.138052298,1.147770747,1.127879585,,,
94,강원,원주시,2015,3085,1569,1516,4,2013,3010,1587,1423,1.046181851,1.007382368,1.089511363,,,
95,강원,원주시,2016,3173,1655,1518,4,2014,3108,1561,1547,1.042095621,1.080297631,1.003503567,,,
96,강원,원주시,2017,3285,1649,1636,4,2015,3200,1645,1555,1.047861549,1.021417,1.075945736,,,
97,강원,원주시,2018,3224,1648,1576,4,2016,3302,1648,1654,0.996635777,1.018939336,0.974446883,,,
98,강원,원주시,2019,3303,1634,1669,4,2017,2860,1444,1416,1.178856791,1.153010302,1.205398221,,,
99,강원,원주시,2020,3008,1537,1471,4,2018,2846,1443,1403,1.078850942,1.085315149,1.072241136,,,
100,강원,인제군,2010,305,165,140,4,2008,334,180,154,0.932120118,0.934027725,0.929704167,,,
101,강원,인제군,2011,323,167,156,4,2009,326,184,142,1.011354547,0.924798202,1.123501656,,,
102,강원,인제군,2012,279,146,133,4,2010,323,166,157,0.881698679,0.896175561,0.866342164,,,
103,강원,인제군,2013,291,140,151,4,2011,337,178,159,0.881417354,0.801412961,0.971219259,,,
104,강원,인제군,2014,310,159,151,4,2012,286,146,140,1.106405102,1.109666812,1.103027587,,,
105,강원,인제군,2015,282,138,144,4,2013,301,160,141,0.956315339,0.878835178,1.044433618,,,
106,강원,인제군,2016,264,137,127,4,2014,335,185,150,0.804410311,0.754565887,0.865864481,,,
107,강원,인제군,2017,300,163,137,4,2015,292,161,131,1.048713629,1.031596968,1.069514641,,,
108,강원,인제군,2018,253,152,101,4,2016,326,163,163,0.792175543,0.950176559,0.633681798,,,
109,강원,인제군,2019,274,140,134,4,2017,280,144,136,0.998874763,0.990635466,1.007635252,,,
110,강원,인제군,2020,251,123,128,4,2018,243,137,106,1.054352803,0.914814149,1.2349278,,,
111,강원,정선군,2010,251,125,126,4,2008,279,144,135,0.91830728,0.884495952,0.954496279,,,
112,강원,정선군,2011,256,142,114,4,2009,275,138,137,0.95022353,1.04847381,0.85098469,,,
113,강원,정선군,2012,255,124,131,4,2010,237,113,124,1.098273092,1.118128121,1.080406214,,,
114,강원,정선군,2013,227,112,115,4,2011,286,148,138,0.810174058,0.771089228,0.85222882,,,
115,강원,정선군,2014,289,148,141,4,2012,252,123,129,1.170619653,1.226040827,1.117807104,,,
116,강원,정선군,2015,238,114,124,4,2013,280,146,134,0.867635743,0.795610167,0.946355585,,,
117,강원,정선군,2016,267,143,124,4,2014,259,131,128,1.052276826,1.112277291,0.990716003,,,
118,강원,정선군,2017,262,134,128,4,2015,237,115,122,1.128421765,1.187285835,1.072970055,,,
119,강원,정선군,2018,218,108,110,4,2016,269,140,129,0.827223232,0.786038917,0.872048095,,,
120,강원,정선군,2019,251,136,115,4,2017,196,98,98,1.307182301,1.414038263,1.200077318,,,
121,강원,정선군,2020,187,95,92,4,2018,221,109,112,0.863709789,0.888066394,0.840054123,,,
122,강원,철원군,2010,416,216,200,4,2008,432,235,197,0.982942454,0.936557007,1.038248309,,,
123,강원,철원군,2011,432,241,191,4,2009,429,216,213,1.02788603,1.13687213,0.917046223,,,
124,강원,철원군,2012,402,200,202,4,2010,476,237,239,0.862060229,0.859864419,0.864352577,,,
125,강원,철원군,2013,441,225,216,4,2011,448,227,221,1.004798746,1.009961897,0.99953715,,,
126,강원,철원군,2014,427,216,211,4,2012,453,243,210,0.962161958,0.905723855,1.027544463,,,
127,강원,철원군,2015,418,221,197,4,2013,404,204,200,1.056120386,1.103850948,1.007334465,,,
128,강원,철원군,2016,361,184,177,4,2014,427,222,205,0.862974247,0.844526297,0.882992202,,,
129,강원,철원군,2017,371,200,171,4,2015,371,206,165,1.020747933,0.989261492,1.059862751,,,
130,강원,철원군,2018,359,200,159,4,2016,400,202,198,0.916121269,1.008850828,0.821238681,,,
131,강원,철원군,2019,336,160,176,4,2017,323,163,160,1.061830667,1.000185852,1.124942043,,,
132,강원,철원군,2020,301,141,160,4,2018,368,190,178,0.834905238,0.756160244,0.919258053,,,
133,강원,춘천시,2010,2590,1314,1276,4,2008,2405,1271,1134,1.099267004,1.053411714,1.150734364,,,
134,강원,춘천시,2011,2406,1264,1142,4,2009,2367,1237,1130,1.03756634,1.041179726,1.033534845,,,
135,강원,춘천시,2012,2418,1265,1153,4,2010,2264,1183,1081,1.090180433,1.089567422,1.09078982,,,
136,강원,춘천시,2013,2271,1199,1072,4,2011,2528,1301,1227,0.916977276,0.939053239,0.893485863,,,
137,강원,춘천시,2014,2517,1289,1228,4,2012,2415,1265,1150,1.063860268,1.038270992,1.092038599,,,
138,강원,춘천시,2015,2436,1277,1159,4,2013,2254,1178,1076,1.103168573,1.104571759,1.101561192,,,
139,강원,춘천시,2016,2297,1190,1107,4,2014,2478,1273,1205,0.94618967,0.952504171,0.939502709,,,
140,강원,춘천시,2017,2485,1289,1196,4,2015,2594,1336,1258,0.977856057,0.983093417,0.972272498,,,
141,강원,춘천시,2018,2570,1337,1233,4,2016,2568,1337,1231,1.021542908,1.018939336,1.024336119,,,
142,강원,춘천시,2019,2544,1308,1236,4,2017,2383,1205,1178,1.089711599,1.106035396,1.073026983,,,
143,강원,춘천시,2020,2377,1212,1165,4,2018,2267,1167,1100,1.070276946,1.058230056,1.083105355,,,
144,강원,태백시,2010,437,224,213,4,2008,434,225,209,1.027803794,1.014410717,1.042247303,,,
145,강원,태백시,2011,397,195,202,4,2009,418,222,196,0.969466338,0.895014282,1.053980949,,,
146,강원,태백시,2012,406,221,185,4,2010,442,220,222,0.937610092,1.023570879,0.85222882,,,
147,강원,태백시,2013,415,196,219,4,2011,485,265,220,0.873423489,0.753630603,1.018026063,,,
148,강원,태백시,2014,449,244,205,4,2012,444,227,217,1.032242842,1.095247569,0.966121151,,,
149,강원,태백시,2015,399,204,195,4,2013,413,193,220,0.986146308,1.077013599,0.906461563,,,
150,강원,태백시,2016,399,189,210,4,2014,432,217,215,0.942774132,0.887463293,0.998891454,,,
151,강원,태백시,2017,397,193,204,4,2015,393,189,204,1.031137224,1.04050419,1.022674584,,,
152,강원,태백시,2018,373,181,192,4,2016,394,196,198,0.966342586,0.940959285,0.991684445,,,
153,강원,태백시,2019,360,179,181,4,2017,312,164,148,1.177786076,1.112135007,1.250703377,,,
154,강원,태백시,2020,284,152,132,4,2018,310,160,150,0.935136816,0.96799237,0.899953634,,,
155,강원,평창군,2010,336,171,165,4,2008,326,181,145,1.052059219,0.962644345,1.163733147,,,
156,강원,평창군,2011,314,178,136,4,2009,279,151,128,1.148798748,1.201133787,1.086591746,,,
157,강원,평창군,2012,304,175,129,4,2010,297,159,138,1.044805965,1.121474112,0.955978416,,,
158,강원,평창군,2013,286,146,140,4,2011,332,177,155,0.879319002,0.840481035,0.923706076,,,
159,강원,평창군,2014,313,163,150,4,2012,327,167,160,0.977046186,0.994533604,0.958757423,,,
160,강원,평창군,2015,312,156,156,4,2013,274,136,138,1.162311514,1.168783356,1.156066921,,,
161,강원,평창군,2016,258,128,130,4,2014,286,157,129,0.920814569,0.830727612,1.030602294,,,
162,강원,평창군,2017,278,157,121,4,2015,244,125,119,1.1629833,1.279787806,1.039862392,,,
163,강원,평창군,2018,237,116,121,4,2016,261,133,128,0.926886054,0.88869897,0.966747068,,,
164,강원,평창군,2019,261,132,129,4,2017,229,125,104,1.163385198,1.075999939,1.268509821,,,
165,강원,평창군,2020,213,119,94,4,2018,191,86,105,1.138320993,1.409927686,0.915537247,,,
166,강원,홍천군,2010,588,324,264,4,2008,583,281,302,1.029502203,1.174862438,0.893993676,,,
167,강원,홍천군,2011,530,259,271,4,2009,517,262,255,1.046414708,1.007272092,1.086842401,,,
168,강원,홍천군,2012,495,250,245,4,2010,478,251,227,1.057050683,1.014879817,1.103767723,,,
169,강원,홍천군,2013,456,240,216,4,2011,573,286,287,0.812322962,0.855053989,0.769678433,,,
170,강원,홍천군,2014,569,287,282,4,2012,518,241,277,1.121246281,1.213425683,1.041134414,,,
171,강원,홍천군,2015,494,241,253,4,2013,516,284,232,0.977227672,0.86466331,1.115244266,,,
172,강원,홍천군,2016,504,274,230,4,2014,528,278,250,0.974350299,1.004278339,0.940860617,,,
173,강원,홍천군,2017,495,240,255,4,2015,497,234,263,1.016640295,1.045065986,0.991566612,,,
174,강원,홍천군,2018,474,232,242,4,2016,485,240,245,0.997596948,0.984974692,1.010152038,,,
175,강원,홍천군,2019,443,220,223,4,2017,419,213,206,1.079215595,1.052425606,1.10707006,,,
176,강원,홍천군,2020,384,195,189,4,2018,402,195,207,0.975042801,1.018939336,0.933746359,,,
177,강원,화천군,2010,200,95,105,4,2008,236,123,113,0.865040621,0.786985666,0.950272844,,,
178,강원,화천군,2011,221,120,101,4,2009,221,120,101,1.020747933,1.018939336,1.022674584,,,
179,강원,화천군,2012,188,112,76,4,2010,217,112,105,0.884334614,1.018939336,0.740221604,,,
180,강원,화천군,2013,190,93,97,4,2011,252,130,122,0.769611536,0.728933525,0.81311012,,,
181,강원,화천군,2014,243,117,126,4,2012,234,126,108,1.060007468,0.946157955,1.193120348,,,
182,강원,화천군,2015,191,99,92,4,2013,231,121,110,0.843995044,0.833677639,0.855327834,,,
183,강원,화천군,2016,208,97,111,4,2014,255,121,134,0.832610078,0.816835666,0.847140887,,,
184,강원,화천군,2017,197,101,96,4,2015,223,114,109,0.901736963,0.9027445,0.900704221,,,
185,강원,화천군,2018,190,100,90,4,2016,231,111,120,0.839576222,0.917963366,0.767005938,,,
186,강원,화천군,2019,191,87,104,4,2017,219,111,108,0.890241348,0.798628128,0.984797748,,,
187,강원,화천군,2020,180,94,86,4,2018,208,117,91,0.883339557,0.818635022,0.966483673,,,
188,강원,횡성군,2010,292,152,140,4,2008,305,164,141,0.977240644,0.9443828,1.015421573,,,
189,강원,횡성군,2011,309,164,145,4,2009,293,138,155,1.076488434,1.210913414,0.956695579,,,
190,강원,횡성군,2012,291,148,143,4,2010,276,132,144,1.076223364,1.142447135,1.015572677,,,
191,강원,횡성군,2013,292,156,136,4,2011,325,158,167,0.917102758,1.00604137,0.832836787,,,
192,강원,횡성군,2014,314,159,155,4,2012,280,152,128,1.144695896,1.065864174,1.238395004,,,
193,강원,횡성군,2015,293,156,137,4,2013,288,142,146,1.038469251,1.119398144,0.959633,,,
194,강원,횡성군,2016,260,135,125,4,2014,274,137,137,0.968592929,1.00406431,0.933097248,,,
195,강원,횡성군,2017,255,126,129,4,2015,259,139,120,1.004983486,0.923642852,1.099375178,,,
196,강원,횡성군,2018,268,143,125,4,2016,263,125,138,1.040153787,1.165666601,0.926335674,,,
197,강원,횡성군,2019,265,132,133,4,2017,230,114,116,1.17607914,1.179824495,1.172549308,,,
198,강원,횡성군,2020,221,114,107,4,2018,230,117,113,0.980805622,0.992812687,0.968373279,,,
199,경기,가평군,2010,463,254,209,4,2008,480,249,231,0.984596443,1.039399966,0.925277005,,,
200,경기,가평군,2011,494,261,233,4,2009,441,221,220,1.143422854,1.203362746,1.083105355,,,
201,경기,가평군,2012,447,236,211,4,2010,428,229,199,1.066061509,1.050085954,1.084343403,,,
202,경기,가평군,2013,440,233,207,4,2011,439,229,210,1.023073099,1.036737403,1.008064947,,,
203,경기,가평군,2014,450,234,216,4,2012,465,253,212,0.98782058,0.9424182,1.041970331,,,
204,경기,가평군,2015,438,224,214,4,2013,424,220,204,1.054451874,1.037465506,1.072805691,,,
205,경기,가평군,2016,418,217,201,4,2014,442,222,220,0.965322705,0.995990252,0.934352688,,,
206,경기,가평군,2017,459,238,221,4,2015,449,215,234,1.043481739,1.127942149,0.965859329,,,
207,경기,가평군,2018,422,196,226,4,2016,463,220,243,0.930357727,0.907782318,0.951129449,,,
208,경기,가평군,2019,436,204,232,4,2017,366,197,169,1.215972947,1.055145303,1.403908305,,,
209,경기,가평군,2020,357,189,168,4,2018,353,183,170,1.032314481,1.052347183,1.010643118,,,
210,경기,고양시,2010,9935,5232,4703,4,2008,9909,5040,4869,1.02342625,1.057756073,0.987808291,,,
211,경기,고양시,2011,9446,4811,4635,4,2009,8670,4430,4240,1.112108993,1.106572719,1.117947334,,,
212,경기,고양시,2012,8370,4267,4103,4,2010,8869,4572,4297,0.963317194,0.950965474,0.9765031,,,
213,경기,고양시,2013,8587,4387,4200,4,2011,9599,5008,4591,0.913132878,0.892589231,0.935576836,,,
214,경기,고양시,2014,9425,4870,4555,4,2012,9142,4632,4510,1.052346233,1.071294164,1.032878654,,,
215,경기,고양시,2015,9234,4715,4519,4,2013,8768,4473,4295,1.07499845,1.074066392,1.076010814,,,
216,경기,고양시,2016,8646,4490,4156,4,2014,9363,4841,4522,0.942581077,0.945060446,0.939901719,,,
217,경기,고양시,2017,9165,4721,4444,4,2015,9564,4869,4695,0.978163405,0.987967264,0.968001246,,,
218,경기,고양시,2018,9095,4631,4464,4,2016,9910,5105,4805,0.936801458,0.924330669,0.950097678,,,
219,경기,고양시,2019,9283,4787,4496,4,2017,8710,4465,4245,1.087899318,1.092421636,1.083143682,,,
220,경기,고양시,2020,8550,4305,4245,4,2018,8622,4425,4197,1.012223941,0.991307083,1.034370648,,,
221,경기,과천시,2010,711,391,320,4,2008,707,370,337,1.026523027,1.076771028,0.971085659,,,
222,경기,과천시,2011,677,349,328,4,2009,729,373,356,0.94793738,0.953377556,0.942239504,,,
223,경기,과천시,2012,606,312,294,4,2010,659,370,289,0.938654396,0.859213711,1.040367916,,,
224,경기,과천시,2013,590,331,259,4,2011,631,338,293,0.954423582,0.997837042,0.904002448,,,
225,경기,과천시,2014,578,304,274,4,2012,656,337,319,0.899378514,0.919161894,0.878410144,,,
226,경기,과천시,2015,554,278,276,4,2013,586,302,284,0.965007431,0.937964025,0.993866849,,,
227,경기,과천시,2016,496,258,238,4,2014,569,305,264,0.889790816,0.861922455,0.921956633,,,
228,경기,과천시,2017,440,229,211,4,2015,551,278,273,0.815116316,0.839342115,0.790418818,,,
229,경기,과천시,2018,418,205,213,4,2016,529,270,259,0.806564529,0.773639126,0.84104126,,,
230,경기,과천시,2019,466,242,224,4,2017,440,225,215,1.081064856,1.095925864,1.065484218,,,
231,경기,과천시,2020,483,253,230,4,2018,462,243,219,1.067145566,1.060870996,1.074041801,,,
232,경기,광명시,2010,3376,1785,1591,4,2008,3285,1644,1641,1.049024359,1.106330119,0.991514481,,,
233,경기,광명시,2011,3560,1794,1766,4,2009,2995,1573,1422,1.213309729,1.162096103,1.270072655,,,
234,경기,광명시,2012,3308,1765,1543,4,2010,3617,1880,1737,0.933545524,0.9566106,0.908455316,,,
235,경기,광명시,2013,3595,1859,1736,4,2011,4078,2027,2051,0.899850127,0.934488518,0.865608522,,,
236,경기,광명시,2014,3800,1877,1923,4,2012,3990,2017,1973,0.972140888,0.948214742,0.996757844,,,
237,경기,광명시,2015,3612,1822,1790,4,2013,3621,1903,1718,1.018210862,0.975568823,1.065534054,,,
238,경기,광명시,2016,3274,1735,1539,4,2014,3646,1864,1782,0.916601407,0.948422612,0.883218959,,,
239,경기,광명시,2017,3272,1651,1621,4,2015,3630,1883,1747,0.920079128,0.893398218,0.94891557,,,
240,경기,광명시,2018,3176,1654,1522,4,2016,3486,1797,1689,0.929975741,0.937855127,0.921557559,,,
241,경기,광명시,2019,3071,1575,1496,4,2017,2932,1503,1429,1.069139461,1.067750802,1.070623637,,,
242,경기,광명시,2020,2623,1355,1268,4,2018,2851,1479,1372,0.93911674,0.933511021,0.945154062,,,
243,경기,광주시,2010,2600,1361,1239,4,2008,2875,1473,1402,0.923111174,0.941463976,0.903775899,,,
244,경기,광주시,2011,2694,1385,1309,4,2009,2586,1304,1282,1.063377777,1.082232347,1.044212972,,,
245,경기,광주시,2012,2576,1312,1264,4,2010,2749,1411,1338,0.956510249,0.947447491,0.966114106,,,
246,경기,광주시,2013,2725,1405,1320,4,2011,3215,1572,1643,0.865175153,0.910693236,0.821625351,,,
247,경기,광주시,2014,3122,1535,1587,4,2012,3055,1530,1525,1.043134221,1.022269203,1.064252174,,,
248,경기,광주시,2015,2939,1461,1478,4,2013,3046,1597,1449,0.984891062,0.932166794,1.043142191,,,
249,경기,광주시,2016,2816,1424,1392,4,2014,3402,1787,1615,0.844922451,0.811958374,0.881463171,,,
250,경기,광주시,2017,3151,1628,1523,4,2015,3527,1824,1703,0.911929894,0.909448048,0.914582144,,,
251,경기,광주시,2018,3451,1781,1670,4,2016,3814,1969,1845,0.923597566,0.921651071,0.92567293,,,
252,경기,광주시,2019,3728,1931,1797,4,2017,3541,1808,1733,1.07465357,1.088258771,1.060442139,,,
253,경기,광주시,2020,3312,1680,1632,4,2018,3945,2039,1906,0.856962523,0.839538051,0.875658406,,,
254,경기,구리시,2010,1999,1015,984,4,2008,2130,1073,1057,0.957969539,0.963861534,0.952045214,,,
255,경기,구리시,2011,1831,938,893,4,2009,1838,1017,821,1.016860427,0.93978869,1.112361028,,,
256,경기,구리시,2012,1653,919,734,4,2010,1939,1042,897,0.870188929,0.898661468,0.836837397,,,
257,경기,구리시,2013,1736,946,790,4,2011,2073,1098,975,0.854808688,0.877883982,0.828628637,,,
258,경기,구리시,2014,1802,954,848,4,2012,1829,878,951,1.005679483,1.107139097,0.911911722,,,
259,경기,구리시,2015,1607,784,823,4,2013,1713,906,807,0.957584313,0.88173117,1.04295066,,,
260,경기,구리시,2016,1524,804,720,4,2014,1681,856,825,0.925413355,0.957041152,0.892516001,,,
261,경기,구리시,2017,1598,839,759,4,2015,1612,804,808,1.011882876,1.063296148,0.960655952,,,
262,경기,구리시,2018,1693,853,840,4,2016,1852,966,886,0.933113526,0.89974664,0.969578612,,,
263,경기,구리시,2019,1806,929,877,4,2017,1752,935,817,1.052209341,1.012400688,1.097779205,,,
264,경기,구리시,2020,1598,845,753,4,2018,1881,948,933,0.86717448,0.908231792,0.825374021,,,
265,경기,군포시,2010,3089,1593,1496,4,2008,3081,1600,1481,1.023398365,1.014481477,1.033032531,,,
266,경기,군포시,2011,2990,1550,1440,4,2009,2845,1458,1387,1.072771992,1.083234548,1.061752993,,,
267,경기,군포시,2012,2753,1400,1353,4,2010,3122,1624,1498,0.900102197,0.87839598,0.923684054,,,
268,경기,군포시,2013,2838,1463,1375,4,2011,3245,1670,1575,0.892721921,0.89263967,0.892811145,,,
269,경기,군포시,2014,2995,1551,1444,4,2012,3119,1615,1504,0.980166739,0.978560316,0.981876396,,,
270,경기,군포시,2015,2892,1507,1385,4,2013,2882,1473,1409,1.024289737,1.042458642,1.005255003,,,
271,경기,군포시,2016,2679,1361,1318,4,2014,3050,1585,1465,0.896584823,0.874937815,0.92005809,,,
272,경기,군포시,2017,2682,1415,1267,4,2015,3006,1545,1461,0.910727197,0.93320334,0.886877959,,,
273,경기,군포시,2018,2625,1346,1279,4,2016,2904,1488,1416,0.922680208,0.921701846,0.923729374,,,
274,경기,군포시,2019,2511,1291,1220,4,2017,2603,1310,1293,0.984670787,1.004160827,0.964936576,,,
275,경기,군포시,2020,2338,1185,1153,4,2018,2430,1250,1180,0.982102332,0.965954491,0.999274403,,,
276,경기,김포시,2010,2576,1335,1241,4,2008,2461,1279,1182,1.068446434,1.063552787,1.073721793,,,
277,경기,김포시,2011,2662,1400,1262,4,2009,2192,1156,1036,1.239612681,1.234009577,1.245767688,,,
278,경기,김포시,2012,2601,1357,1244,4,2010,2456,1285,1171,1.081011959,1.076031657,1.086427995,,,
279,경기,김포시,2013,3302,1719,1583,4,2011,2931,1483,1448,1.149952123,1.181090168,1.118020626,,,
280,경기,김포시,2014,3827,1938,1889,4,2012,3522,1794,1728,1.109143196,1.100727109,1.117958501,,,
281,경기,김포시,2015,4265,2158,2107,4,2013,3679,1928,1751,1.183335127,1.140493303,1.230597001,,,
282,경기,김포시,2016,4133,2137,1996,4,2014,4485,2377,2108,0.94063572,0.916059471,0.968338933,,,
283,경기,김포시,2017,4856,2591,2265,4,2015,4703,2386,2317,1.053955339,1.106484418,0.999722889,,,
284,경기,김포시,2018,5362,2712,2650,4,2016,5090,2528,2562,1.075294777,1.093102642,1.05780158,,,
285,경기,김포시,2019,6010,3023,2987,4,2017,4921,2525,2396,1.246635862,1.219902421,1.274928624,,,
286,경기,김포시,2020,5412,2756,2656,4,2018,5572,2854,2718,0.991437152,0.98395123,0.999346466,,,
287,경기,남양주시,2010,6436,3320,3116,4,2008,6300,3242,3058,1.042783126,1.043454225,1.04207129,,,
288,경기,남양주시,2011,6648,3403,3245,4,2009,5995,3107,2888,1.131931986,1.116012411,1.14909246,,,
289,경기,남양주시,2012,6176,3235,2941,4,2010,6875,3555,3320,0.916965706,0.927220465,0.905929504,,,
290,경기,남양주시,2013,6846,3544,3302,4,2011,7610,3912,3698,0.918270742,0.923088192,0.913161568,,,
291,경기,남양주시,2014,7590,3918,3672,4,2012,7389,3889,3500,1.048514929,1.026537495,1.072931735,,,
292,경기,남양주시,2015,7243,3775,3468,4,2013,7197,3667,3530,1.027272096,1.048949003,1.004712594,,,
293,경기,남양주시,2016,7049,3628,3421,4,2014,7544,3889,3655,0.953771497,0.950555904,0.957201027,,,
294,경기,남양주시,2017,7192,3700,3492,4,2015,7698,3947,3751,0.953652784,0.955174954,0.95206069,,,
295,경기,남양주시,2018,7351,3780,3571,4,2016,7752,3927,3825,0.967946085,0.980797222,0.954763644,,,
296,경기,남양주시,2019,7734,3947,3787,4,2017,6848,3555,3293,1.152813159,1.131294954,1.1760913,,,
297,경기,남양주시,2020,7055,3634,3421,4,2018,6943,3590,3353,1.03721398,1.031427729,1.043414778,,,
298,경기,동두천시,2010,1015,526,489,4,2008,939,481,458,1.103364379,1.114266301,1.091894916,,,
299,경기,동두천시,2011,931,459,472,4,2009,876,440,436,1.084835988,1.06293899,1.107115605,,,
300,경기,동두천시,2012,804,413,391,4,2010,953,493,460,0.861155653,0.853594211,0.869273396,,,
301,경기,동두천시,2013,896,460,436,4,2011,1040,524,516,0.879413603,0.89448873,0.864120385,,,
302,경기,동두천시,2014,983,491,492,4,2012,929,449,480,1.080080966,1.114252147,1.048241449,,,
303,경기,동두천시,2015,866,414,452,4,2013,908,435,473,0.97353272,0.969749161,0.977270427,,,
304,경기,동두천시,2016,863,431,432,4,2014,980,510,470,0.898883128,0.861103635,0.939990256,,,
305,경기,동두천시,2017,923,482,441,4,2015,924,483,441,1.019643227,1.016829731,1.022674584,,,
306,경기,동두천시,2018,835,439,396,4,2016,878,442,436,0.970756861,1.012023459,0.928851228,,,
307,경기,동두천시,2019,803,401,402,4,2017,807,412,395,1.015688463,0.991734645,1.040797931,,,
308,경기,동두천시,2020,733,377,356,4,2018,775,407,368,0.96542998,0.943833243,0.9893265,,,
309,경기,부천시,2010,8247,4254,3993,4,2008,8283,4273,4010,1.016311505,1.014408597,1.018339056,,,
310,경기,부천시,2011,7620,3898,3722,4,2009,7626,3920,3706,1.019944826,1.013220799,1.027089801,,,
311,경기,부천시,2012,6986,3558,3428,4,2010,7835,4113,3722,0.910139765,0.881445699,0.941893733,,,
312,경기,부천시,2013,7249,3755,3494,4,2011,8476,4360,4116,0.872982747,0.877549818,0.868130466,,,
313,경기,부천시,2014,7777,3979,3798,4,2012,7711,3888,3823,1.029484719,1.042787968,1.01598694,,,
314,경기,부천시,2015,7048,3609,3439,4,2013,7356,3785,3571,0.978008623,0.97155933,0.984871995,,,
315,경기,부천시,2016,6657,3403,3254,4,2014,7433,3772,3661,0.914182562,0.919260488,0.908981999,,,
316,경기,부천시,2017,6934,3528,3406,4,2015,7349,3741,3608,0.963106023,0.960924346,0.965418413,,,
317,경기,부천시,2018,7070,3575,3495,4,2016,7499,3893,3606,0.962353365,0.935707199,0.991194584,,,
318,경기,부천시,2019,7059,3638,3421,4,2017,6769,3485,3284,1.064479193,1.063673258,1.065337927,,,
319,경기,부천시,2020,6172,3198,2974,4,2018,6960,3562,3398,0.905180494,0.914814149,0.895065984,,,
320,경기,성남시,2010,8852,4638,4214,4,2008,8708,4508,4200,1.037627549,1.048323124,1.026083499,,,
321,경기,성남시,2011,8517,4411,4106,4,2009,8093,4127,3966,1.074225892,1.089057769,1.058775049,,,
322,경기,성남시,2012,7665,3948,3717,4,2010,8385,4300,4085,0.933098736,0.935528488,0.930546249,,,
323,경기,성남시,2013,7917,4076,3841,4,2011,9120,4664,4456,0.886103222,0.890479574,0.881528967,,,
324,경기,성남시,2014,8606,4427,4179,4,2012,8400,4297,4103,1.04578056,1.049765986,1.041617618,,,
325,경기,성남시,2015,7921,4067,3854,4,2013,8090,4109,3981,0.999424521,1.008524284,0.990049698,,,
326,경기,성남시,2016,7483,3825,3658,4,2014,8626,4456,4170,0.885492323,0.874650575,0.897108784,,,
327,경기,성남시,2017,8106,4157,3949,4,2015,8364,4373,3991,0.989261447,0.968609838,1.011912286,,,
328,경기,성남시,2018,7902,4071,3831,4,2016,8519,4466,4053,0.946818895,0.92881819,0.96665836,,,
329,경기,성남시,2019,7813,4093,3720,4,2017,7999,4063,3936,0.997012576,1.026462885,0.966552198,,,
330,경기,성남시,2020,7248,3704,3544,4,2018,7646,3855,3791,0.967614572,0.979027575,0.956042924,,,
331,경기,수원시,2010,11610,6047,5563,4,2008,11484,5928,5556,1.031947361,1.039393753,1.023963051,,,
332,경기,수원시,2011,10941,5633,5308,4,2009,10383,5323,5060,1.075604655,1.078280158,1.072797765,,,
333,경기,수원시,2012,10298,5241,5057,4,2010,10493,5379,5114,1.001778539,0.992798115,1.011275982,,,
334,경기,수원시,2013,11042,5631,5411,4,2011,11642,6033,5609,0.968141099,0.951043826,0.986573752,,,
335,경기,수원시,2014,12350,6416,5934,4,2012,11444,5874,5570,1.10155863,1.112957913,1.08950646,,,
336,경기,수원시,2015,11849,6089,5760,4,2013,11187,5755,5432,1.081151538,1.078074999,1.084426658,,,
337,경기,수원시,2016,11258,5747,5511,4,2014,12069,6238,5831,0.952156784,0.938737475,0.966551129,,,
338,경기,수원시,2017,11580,5984,5596,4,2015,12098,6262,5836,0.977042574,0.973703767,0.980618056,,,
339,경기,수원시,2018,11749,6072,5677,4,2016,12698,6478,6220,0.944461132,0.955078674,0.933396079,,,
340,경기,수원시,2019,12205,6273,5932,4,2017,11370,5865,5505,1.095710512,1.089822073,1.101999207,,,
341,경기,수원시,2020,10731,5521,5210,4,2018,11271,5828,5443,0.97184332,0.965264941,0.978896672,,,
342,경기,시흥시,2010,4860,2513,2347,4,2008,4859,2482,2377,1.020958006,1.031665815,1.009767459,,,
343,경기,시흥시,2011,4589,2386,2203,4,2009,4418,2235,2183,1.060256284,1.087780428,1.032044026,,,
344,경기,시흥시,2012,4164,2099,2065,4,2010,4557,2276,2281,0.932717663,0.939698448,0.925832098,,,
345,경기,시흥시,2013,4245,2122,2123,4,2011,4702,2335,2367,0.921538701,0.925991123,0.917253123,,,
346,경기,시흥시,2014,4395,2199,2196,4,2012,4370,2277,2093,1.026587452,0.984034959,1.073002096,,,
347,경기,시흥시,2015,4152,2179,1973,4,2013,4152,2150,2002,1.020747933,1.032683169,1.007860617,,,
348,경기,시흥시,2016,4069,2106,1963,4,2014,4105,2086,2019,1.011796185,1.028708649,0.994309167,,,
349,경기,시흥시,2017,4248,2165,2083,4,2015,4110,2112,1998,1.055021221,1.04450931,1.066181761,,,
350,경기,시흥시,2018,4662,2422,2240,4,2016,4147,2170,1977,1.147510697,1.137267775,1.158720824,,,
351,경기,시흥시,2019,5317,2756,2561,4,2017,3965,2038,1927,1.368806244,1.377917964,1.359143544,,,
352,경기,시흥시,2020,4959,2537,2422,4,2018,4527,2344,2183,1.11815529,1.102836645,1.134639415,,,
353,경기,안산시,2010,7654,3947,3707,4,2008,7961,4148,3813,0.981384836,0.969564504,0.994244606,,,
354,경기,안산시,2011,7397,3852,3545,4,2009,7008,3586,3422,1.077407599,1.094521563,1.059433489,,,
355,경기,안산시,2012,6600,3390,3210,4,2010,6813,3513,3300,0.988835514,0.983263407,0.994783459,,,
356,경기,안산시,2013,6424,3298,3126,4,2011,7561,3887,3674,0.867250988,0.864538701,0.870136296,,,
357,경기,안산시,2014,7139,3668,3471,4,2012,6823,3501,3322,1.068022789,1.067543412,1.068544094,,,
358,경기,안산시,2015,6508,3354,3154,4,2013,6359,3306,3053,1.044665442,1.033733374,1.056506924,,,
359,경기,안산시,2016,5900,3037,2863,4,2014,6488,3347,3141,0.928238718,0.924564913,0.932160883,,,
360,경기,안산시,2017,6090,3146,2944,4,2015,6313,3183,3130,0.984691099,1.007094927,0.961902229,,,
361,경기,안산시,2018,5745,2909,2836,4,2016,6147,3051,3096,0.953993309,0.971515742,0.93679106,,,
362,경기,안산시,2019,5611,2815,2796,4,2017,5376,2744,2632,1.06536768,1.04530402,1.086397469,,,
363,경기,안산시,2020,5094,2610,2484,4,2018,4934,2489,2445,1.053848798,1.068473953,1.038987185,,,
364,경기,안성시,2010,1798,937,861,4,2008,1863,946,917,0.985134076,1.00924541,0.960221174,,,
365,경기,안성시,2011,1852,948,904,4,2009,1696,875,821,1.114637483,1.10394799,1.126063123,,,
366,경기,안성시,2012,1696,876,820,4,2010,1859,990,869,0.931247172,0.901606928,0.965009389,,,
367,경기,안성시,2013,1813,966,847,4,2011,2104,1077,1027,0.879570343,0.913923304,0.84343269,,,
368,경기,안성시,2014,2031,1044,987,4,2012,2024,1058,966,1.024278187,1.005456207,1.04490664,,,
369,경기,안성시,2015,1926,990,936,4,2013,1939,984,955,1.013904341,1.025152381,1.002328179,,,
370,경기,안성시,2016,1802,919,883,4,2014,1889,967,922,0.973736249,0.968361169,0.979416115,,,
371,경기,안성시,2017,1809,938,871,4,2015,1933,993,940,0.955267982,0.962502616,0.947605918,,,
372,경기,안성시,2018,1888,984,904,4,2016,1887,946,941,1.021288869,1.059869246,0.98246315,,,
373,경기,안성시,2019,1787,897,890,4,2017,1690,895,795,1.07933524,1.021216296,1.144880981,,,
374,경기,안성시,2020,1681,886,795,4,2018,1579,782,797,1.086686051,1.15445045,1.020108274,,,
375,경기,안양시,2010,6023,3126,2897,4,2008,5832,3041,2791,1.054177777,1.047420048,1.061514966,,,
376,경기,안양시,2011,5482,2893,2589,4,2009,5291,2730,2561,1.057595949,1.079777106,1.03385572,,,
377,경기,안양시,2012,5104,2628,2476,4,2010,5504,2809,2695,0.94656567,0.953283224,0.939570416,,,
378,경기,안양시,2013,5291,2688,2603,4,2011,5686,2980,2706,0.949837726,0.919096958,0.983747946,,,
379,경기,안양시,2014,5378,2845,2533,4,2012,5422,2766,2656,1.012464475,1.048041364,0.975314278,,,
380,경기,안양시,2015,5127,2626,2501,4,2013,4934,2563,2371,1.060675851,1.043985446,1.078746999,,,
381,경기,안양시,2016,4642,2389,2253,4,2014,5338,2802,2536,0.887656782,0.86875306,0.908551198,,,
382,경기,안양시,2017,4978,2583,2395,4,2015,5218,2680,2538,0.973799005,0.982059816,0.965053439,,,
383,경기,안양시,2018,4837,2443,2394,4,2016,5241,2704,2537,0.942064062,0.920587573,0.965030727,,,
384,경기,안양시,2019,4602,2360,2242,4,2017,4579,2330,2249,1.025875079,1.032058727,1.019491515,,,
385,경기,안양시,2020,4147,2145,2002,4,2018,4606,2332,2274,0.91902772,0.937231937,0.900349392,,,
386,경기,양주시,2010,2278,1155,1123,4,2008,2214,1176,1038,1.050254648,1.000743991,1.106419613,,,
387,경기,양주시,2011,2334,1242,1092,4,2009,2102,1120,982,1.133408979,1.129930943,1.1372308,,,
388,경기,양주시,2012,2112,1104,1008,4,2010,2280,1197,1083,0.945534927,0.939773624,0.951852244,,,
389,경기,양주시,2013,2158,1144,1014,4,2011,2559,1290,1269,0.860794857,0.90361752,0.817172599,,,
390,경기,양주시,2014,2361,1220,1141,4,2012,2285,1161,1124,1.054698411,1.070720061,1.038142082,,,
391,경기,양주시,2015,2212,1111,1101,4,2013,2188,1105,1083,1.031944436,1.024472039,1.039671946,,,
392,경기,양주시,2016,2141,1089,1052,4,2014,2200,1107,1093,0.993373329,1.002371217,0.984312591,,,
393,경기,양주시,2017,2136,1074,1062,4,2015,2233,1140,1093,0.976407337,0.959948112,0.993669175,,,
394,경기,양주시,2018,2187,1100,1087,4,2016,2285,1127,1158,0.976969684,0.99452819,0.959971738,,,
395,경기,양주시,2019,2359,1179,1180,4,2017,1988,1016,972,1.211239624,1.182410903,1.241518528,,,
396,경기,양주시,2020,2065,1035,1030,4,2018,1994,1022,972,1.057093521,1.031900404,1.083698376,,,
397,경기,양평군,2010,722,380,342,4,2008,699,385,314,1.054334774,1.005706358,1.113868496,,,
398,경기,양평군,2011,790,429,361,4,2009,618,319,299,1.30483959,1.370297728,1.234734197,,,
399,경기,양평군,2012,681,361,320,4,2010,746,386,360,0.93180877,0.952945856,0.909044075,,,
400,경기,양평군,2013,776,390,386,4,2011,782,393,389,1.012916107,1.011161173,1.014787634,,,
401,경기,양평군,2014,847,422,425,4,2012,784,387,397,1.10277232,1.111091473,1.094802766,,,
402,경기,양평군,2015,816,410,406,4,2013,782,406,376,1.065128277,1.028978148,1.104270961,,,
403,경기,양평군,2016,822,431,391,4,2014,798,397,401,1.051447118,1.106203662,0.997171477,,,
404,경기,양평군,2017,831,421,410,4,2015,859,442,417,0.98747559,0.970528191,1.005507385,,,
405,경기,양평군,2018,873,444,429,4,2016,869,470,399,1.025446427,0.962572479,1.09956741,,,
406,경기,양평군,2019,840,438,402,4,2017,800,394,406,1.071785329,1.132729516,1.012598972,,,
407,경기,양평군,2020,746,373,373,4,2018,796,420,376,0.9566306,0.904915173,1.014514946,,,
408,경기,여주시,2015,884,475,409,4,2013,918,487,431,0.982942454,0.993832002,0.970473097,,,
409,경기,여주시,2016,908,481,427,4,2014,962,478,484,0.963450232,1.025334353,0.902235635,,,
410,경기,여주시,2017,939,463,476,4,2015,1004,520,484,0.954663654,0.907247909,1.005770872,,,
411,경기,여주시,2018,955,494,461,4,2016,918,478,440,1.061889189,1.053046092,1.071484053,,,
412,경기,여주시,2019,868,457,411,4,2017,879,494,385,1.007974068,0.942622018,1.091738322,,,
413,경기,여주시,2020,804,428,376,4,2018,821,421,400,0.999611861,1.035881321,0.961314109,,,
414,경기,연천군,2010,333,192,141,4,2008,381,183,198,0.892149768,1.069051107,0.728268264,,,
415,경기,연천군,2011,334,159,175,4,2009,364,199,165,0.936620356,0.814127409,1.084654862,,,
416,경기,연천군,2012,329,186,143,4,2010,322,159,163,1.042938105,1.191966771,0.89719304,,,
417,경기,연천군,2013,281,147,134,4,2011,329,172,157,0.871824222,0.870837689,0.872856014,,,
418,경기,연천군,2014,312,170,142,4,2012,329,170,159,0.968004118,1.018939336,0.913332019,,,
419,경기,연천군,2015,300,157,143,4,2013,322,184,138,0.951007391,0.869421064,1.059728011,,,
420,경기,연천군,2016,271,147,124,4,2014,352,174,178,0.785859914,0.86082806,0.712424991,,,
421,경기,연천군,2017,334,165,169,4,2015,343,182,161,0.993964459,0.923763684,1.073490713,,,
422,경기,연천군,2018,300,166,134,4,2016,378,197,181,0.810117407,0.858598629,0.7571182,,,
423,경기,연천군,2019,286,156,130,4,2017,366,188,178,0.79763363,0.845502854,0.746897168,,,
424,경기,연천군,2020,284,143,141,4,2018,330,148,182,0.878461857,0.98451571,0.792291848,,,
425,경기,오산시,2010,2310,1200,1110,4,2008,2186,1110,1076,1.078649462,1.101556039,1.05498958,,,
426,경기,오산시,2011,2447,1243,1204,4,2009,2157,1096,1061,1.157983399,1.155603645,1.160509142,,,
427,경기,오산시,2012,2479,1264,1215,4,2010,2556,1240,1316,0.989997701,1.038660743,0.944186641,,,
428,경기,오산시,2013,2583,1276,1307,4,2011,3037,1565,1472,0.868156704,0.830777376,0.908040544,,,
429,경기,오산시,2014,2993,1554,1439,4,2012,3018,1627,1391,1.012292433,0.973221714,1.057964577,,,
430,경기,오산시,2015,2971,1600,1371,4,2013,2953,1538,1415,1.026969898,1.060014914,0.990874102,,,
431,경기,오산시,2016,2728,1427,1301,4,2014,3081,1561,1520,0.903797585,0.931471129,0.875328707,,,
432,경기,오산시,2017,2839,1439,1400,4,2015,3037,1555,1482,0.954199335,0.942928428,0.966089351,,,
433,경기,오산시,2018,2943,1502,1441,4,2016,3014,1559,1455,0.996702444,0.98168498,1.012834416,,,
434,경기,오산시,2019,2979,1555,1424,4,2017,2715,1392,1323,1.12000298,1.13825479,1.100747247,,,
435,경기,오산시,2020,2677,1378,1299,4,2018,2739,1383,1356,0.997642284,1.015255535,0.979686051,,,
436,경기,용인시,2010,11092,5717,5375,4,2008,11143,5713,5430,1.016076108,1.019652754,1.012316002,,,
437,경기,용인시,2011,11162,5763,5399,4,2009,10583,5484,5099,1.076593444,1.070778154,1.08284371,,,
438,경기,용인시,2012,10455,5449,5006,4,2010,11285,5869,5416,0.945672985,0.946021544,0.945256456,,,
439,경기,용인시,2013,11055,5738,5317,4,2011,12579,6447,6132,0.897079926,0.906882878,0.886751592,,,
440,경기,용인시,2014,12253,6241,6012,4,2012,11919,6161,5758,1.049351826,1.032170167,1.067787357,,,
441,경기,용인시,2015,11757,6077,5680,4,2013,11427,5854,5573,1.050226082,1.057754415,1.042309643,,,
442,경기,용인시,2016,10993,5693,5300,4,2014,12006,6139,5867,0.934622857,0.94491312,0.923841025,,,
443,경기,용인시,2017,11437,5882,5555,4,2015,11775,5987,5788,0.991447482,1.001069179,0.981506101,,,
444,경기,용인시,2018,11495,5866,5629,4,2016,12150,6212,5938,0.965719958,0.962185793,0.969456927,,,
445,경기,용인시,2019,11990,6091,5899,4,2017,10738,5509,5229,1.139762312,1.126585496,1.153711488,,,
446,경기,용인시,2020,10958,5579,5379,4,2018,11093,5672,5421,1.008325597,1.002232468,1.014751261,,,
447,경기,의왕시,2010,1394,727,667,4,2008,1384,668,716,1.028123279,1.108935475,0.952687078,,,
448,경기,의왕시,2011,1331,657,674,4,2009,1323,680,643,1.026920256,0.984475212,1.071979269,,,
449,경기,의왕시,2012,1198,606,592,4,2010,1513,777,736,0.808232666,0.794694,0.822586079,,,
450,경기,의왕시,2013,1407,721,686,4,2011,1616,828,788,0.888732884,0.887264809,0.890297925,,,
451,경기,의왕시,2014,1503,767,736,4,2012,1608,837,771,0.954094616,0.933723382,0.976249668,,,
452,경기,의왕시,2015,1397,729,668,4,2013,1633,812,821,0.873230166,0.91478667,0.832090892,,,
453,경기,의왕시,2016,1368,701,667,4,2014,1645,870,775,0.84886515,0.821007442,0.880159932,,,
454,경기,의왕시,2017,1326,708,618,4,2015,1618,832,786,0.836533843,0.867078185,0.80408765,,,
455,경기,의왕시,2018,1237,647,590,4,2016,1550,834,716,0.814622705,0.790472123,0.84270671,,,
456,경기,의왕시,2019,1313,686,627,4,2017,1390,669,721,0.964202903,1.044831666,0.889343917,,,
457,경기,의왕시,2020,1257,590,667,4,2018,1295,667,628,0.990795484,0.901310657,1.08618463,,,
458,경기,의정부시,2010,4414,2261,2153,4,2008,4524,2306,2218,0.995928686,0.999055438,0.992704409,,,
459,경기,의정부시,2011,4024,2034,1990,4,2009,4194,2165,2029,0.979372838,0.95728527,1.003017458,,,
460,경기,의정부시,2012,3709,1908,1801,4,2010,4070,2059,2011,0.930209848,0.944213819,0.915881117,,,
461,경기,의정부시,2013,3720,1873,1847,4,2011,4391,2295,2096,0.864764816,0.831578814,0.901183186,,,
462,경기,의정부시,2014,4073,2144,1929,4,2012,3895,1995,1900,1.06739572,1.09504057,1.038283828,,,
463,경기,의정부시,2015,3574,1856,1718,4,2013,3798,1918,1880,0.960545843,0.986001777,0.934550498,,,
464,경기,의정부시,2016,3466,1731,1735,4,2014,3935,2012,1923,0.899088268,0.876632202,0.922693918,,,
465,경기,의정부시,2017,3749,1897,1852,4,2015,3842,1954,1888,0.996039562,0.989215927,1.003174433,,,
466,경기,의정부시,2018,3683,1884,1799,4,2016,4007,2046,1961,0.938211788,0.938260855,0.938190503,,,
467,경기,의정부시,2019,3868,1967,1901,4,2017,3666,1907,1759,1.07699209,1.050998256,1.105232737,,,
468,경기,의정부시,2020,3502,1812,1690,4,2018,3654,1866,1788,0.978286606,0.989452346,0.96662195,,,
469,경기,이천시,2010,2251,1164,1087,4,2008,2246,1185,1061,1.023020301,1.000882184,1.047735413,,,
470,경기,이천시,2011,2187,1158,1029,4,2009,2108,1123,985,1.059001769,1.050696128,1.06835751,,,
471,경기,이천시,2012,2124,1116,1008,4,2010,2233,1182,1051,0.970921903,0.962044247,0.980833474,,,
472,경기,이천시,2013,2165,1142,1023,4,2011,2497,1255,1242,0.885029745,0.927194201,0.842347906,,,
473,경기,이천시,2014,2377,1210,1167,4,2012,2287,1168,1119,1.060917287,1.055579278,1.066542663,,,
474,경기,이천시,2015,2168,1141,1027,4,2013,2153,1129,1024,1.027859507,1.029769515,1.025670701,,,
475,경기,이천시,2016,2032,1064,968,4,2014,2304,1222,1082,0.900242968,0.887194316,0.914925136,,,
476,경기,이천시,2017,2274,1203,1071,4,2015,2251,1178,1073,1.031177609,1.040563686,1.020768387,,,
477,경기,이천시,2018,2274,1181,1093,4,2016,2368,1195,1173,0.980228378,1.007001972,0.952926957,,,
478,경기,이천시,2019,2291,1163,1128,4,2017,2106,1042,1064,1.110414774,1.137261467,1.084188845,,,
479,경기,이천시,2020,2035,1016,1019,4,2018,2162,1165,997,0.960787254,0.888620056,1.045241125,,,
480,경기,파주시,2010,3766,1961,1805,4,2008,3678,1905,1773,1.045170395,1.048892409,1.041132332,,,
481,경기,파주시,2011,4048,2133,1915,4,2009,3485,1796,1689,1.185649248,1.210132296,1.159515588,,,
482,경기,파주시,2012,4011,2075,1936,4,2010,4069,2089,1980,1.006198073,1.012110638,0.999948482,,,
483,경기,파주시,2013,4441,2243,2198,4,2011,4833,2462,2371,0.937956046,0.928302572,0.94805514,,,
484,경기,파주시,2014,4943,2512,2431,4,2012,4836,2506,2330,1.043332719,1.021378936,1.067005113,,,
485,경기,파주시,2015,4757,2456,2301,4,2013,4551,2406,2145,1.06695186,1.040114302,1.097050918,,,
486,경기,파주시,2016,4591,2396,2195,4,2014,5101,2538,2563,0.91869315,0.961930122,0.875837188,,,
487,경기,파주시,2017,4992,2492,2500,4,2015,5016,2585,2431,1.015863971,0.982281171,1.051701547,,,
488,경기,파주시,2018,4847,2483,2364,4,2016,5222,2672,2550,0.947446425,0.946866157,0.948079497,,,
489,경기,파주시,2019,5245,2689,2556,4,2017,4707,2357,2350,1.137417231,1.162464097,1.112321803,,,
490,경기,파주시,2020,4595,2333,2262,4,2018,4998,2572,2426,0.938442727,0.924255627,0.953540771,,,
491,경기,평택시,2010,4672,2350,2322,4,2008,4681,2457,2224,1.018785375,0.974565503,1.067738482,,,
492,경기,평택시,2011,4523,2376,2147,4,2009,4268,2134,2134,1.081734512,1.134489158,1.02890456,,,
493,경기,평택시,2012,4190,2142,2048,4,2010,4450,2289,2161,0.961108727,0.953502865,0.96919831,,,
494,경기,평택시,2013,4508,2318,2190,4,2011,4907,2496,2411,0.937748457,0.946274592,0.928932949,,,
495,경기,평택시,2014,4946,2541,2405,4,2012,4632,2366,2266,1.089943712,1.094304672,1.08540705,,,
496,경기,평택시,2015,4718,2401,2317,4,2013,4566,2333,2233,1.054728153,1.048638383,1.061145101,,,
497,경기,평택시,2016,4704,2401,2303,4,2014,4818,2517,2301,0.99659574,0.971979875,1.02356348,,,
498,경기,평택시,2017,4918,2572,2346,4,2015,4872,2503,2369,1.030385536,1.047028355,1.012745705,,,
499,경기,평택시,2018,5043,2593,2450,4,2016,5130,2660,2470,1.003437003,0.993274323,1.014393818,,,
500,경기,평택시,2019,5410,2767,2643,4,2017,4679,2340,2339,1.180219345,1.204873993,1.155591674,,,
501,경기,평택시,2020,5066,2515,2551,4,2018,4837,2460,2377,1.069073605,1.0417205,1.097535913,,,
502,경기,포천시,2010,1571,773,798,4,2008,1427,715,712,1.123752629,1.101594555,1.146199885,,,
503,경기,포천시,2011,1273,642,631,4,2009,1358,734,624,0.95685723,0.891224869,1.034146895,,,
504,경기,포천시,2012,1263,683,580,4,2010,1414,746,668,0.911743026,0.9328895,0.887950986,,,
505,경기,포천시,2013,1322,689,633,4,2011,1404,758,646,0.9611316,0.926186283,1.002094445,,,
506,경기,포천시,2014,1335,733,602,4,2012,1282,666,616,1.06294734,1.121445246,0.99943198,,,
507,경기,포천시,2015,1240,653,587,4,2013,1253,617,636,1.010157571,1.078391226,0.943883618,,,
508,경기,포천시,2016,1192,603,589,4,2014,1256,652,604,0.968735299,0.942362607,0.997277036,,,
509,경기,포천시,2017,1171,605,566,4,2015,1184,643,541,1.009540396,0.958722082,1.069933114,,,
510,경기,포천시,2018,1110,606,504,4,2016,1262,636,626,0.897805234,0.97087616,0.823367397,,,
511,경기,포천시,2019,1127,553,574,4,2017,1034,535,499,1.112556015,1.053221407,1.176383189,,,
512,경기,포천시,2020,922,486,436,4,2018,997,502,495,0.943961478,0.986463182,0.900780038,,,
513,경기,하남시,2010,1286,666,620,4,2008,1470,730,740,0.892980844,0.929607669,0.856835462,,,
514,경기,하남시,2011,1320,676,644,4,2009,1328,715,613,1.014598849,0.963360827,1.074392222,,,
515,경기,하남시,2012,1109,598,511,4,2010,1405,740,665,0.805700681,0.823413139,0.78584468,,,
516,경기,하남시,2013,1189,624,565,4,2011,1543,808,735,0.786564674,0.786903646,0.786137605,,,
517,경기,하남시,2014,1328,699,629,4,2012,1389,700,689,0.97592027,1.017483709,0.933617291,,,
518,경기,하남시,2015,1390,709,681,4,2013,1251,631,620,1.134164369,1.144893803,1.123292567,,,
519,경기,하남시,2016,1652,836,816,4,2014,1435,750,685,1.175104937,1.135777714,1.218251767,,,
520,경기,하남시,2017,2477,1269,1208,4,2015,1846,908,938,1.369660146,1.424046275,1.317047865,,,
521,경기,하남시,2018,2735,1333,1402,4,2016,2668,1413,1255,1.046381408,0.961249919,1.142461966,,,
522,경기,하남시,2019,3089,1646,1443,4,2017,2749,1406,1343,1.146995403,1.192869237,1.098823101,,,
523,경기,하남시,2020,3027,1522,1505,4,2018,3073,1561,1512,1.005468269,0.993482172,1.01793998,,,
524,경기,화성시,2010,7266,3772,3494,4,2008,7062,3652,3410,1.050234279,1.052420366,1.047866568,,,
525,경기,화성시,2011,7373,3783,3590,4,2009,7115,3645,3470,1.057761702,1.057516463,1.058040852,,,
526,경기,화성시,2012,6814,3475,3339,4,2010,7805,4003,3802,0.891143679,0.884540143,0.898135307,,,
527,경기,화성시,2013,7351,3762,3589,4,2011,8533,4313,4220,0.879352871,0.88876647,0.869758076,,,
528,경기,화성시,2014,8041,4064,3977,4,2012,8376,4311,4065,0.97992289,0.96055891,1.000535503,,,
529,경기,화성시,2015,8225,4211,4014,4,2013,7877,4090,3787,1.065843817,1.049083996,1.083975648,,,
530,경기,화성시,2016,8751,4483,4268,4,2014,8201,4191,4010,1.089204385,1.089932008,1.0884726,,,
531,경기,화성시,2017,9716,4984,4732,4,2015,9097,4664,4433,1.090204124,1.088849411,1.091652635,,,
532,경기,화성시,2018,10549,5378,5171,4,2016,9939,5075,4864,1.083395708,1.079774532,1.087222507,,,
533,경기,화성시,2019,11743,5921,5822,4,2017,9585,5003,4582,1.250562647,1.205904419,1.299435056,,,
534,경기,화성시,2020,11118,5741,5377,4,2018,10480,5251,5229,1.082888885,1.11402223,1.051620049,,,
535,경남,거제시,2010,2755,1388,1367,4,2008,2777,1458,1319,1.012661345,0.970019066,1.059890945,,,
536,경남,거제시,2011,2706,1429,1277,4,2009,2603,1333,1270,1.06113865,1.092321314,1.028311373,,,
537,경남,거제시,2012,2467,1272,1195,4,2010,2760,1416,1344,0.912385924,0.915318387,0.909297714,,,
538,경남,거제시,2013,2643,1349,1294,4,2011,3134,1641,1493,0.860828585,0.837628985,0.886363638,,,
539,경남,거제시,2014,3060,1594,1466,4,2012,3048,1537,1511,1.024766625,1.056726937,0.992217697,,,
540,경남,거제시,2015,3028,1546,1482,4,2013,3077,1633,1444,1.004492928,0.964654142,1.049587073,,,
541,경남,거제시,2016,3054,1595,1459,4,2014,3360,1709,1651,0.92778696,0.950970299,0.90374453,,,
542,경남,거제시,2017,3305,1674,1631,4,2015,3570,1810,1760,0.944978128,0.942378149,0.947717186,,,
543,경남,거제시,2018,3396,1731,1665,4,2016,3671,1936,1735,0.944282206,0.91104545,0.981413938,,,
544,경남,거제시,2019,3412,1791,1621,4,2017,3285,1703,1582,1.060210638,1.071591516,1.047885904,,,
545,경남,거제시,2020,3038,1573,1465,4,2018,3275,1671,1604,0.946880067,0.959181075,0.934051288,,,
546,경남,거창군,2010,473,280,193,4,2008,488,254,234,0.989372484,1.123240213,0.843488012,,,
547,경남,거창군,2011,484,249,235,4,2009,437,232,205,1.130530891,1.093602995,1.172334279,,,
548,경남,거창군,2012,453,239,214,4,2010,424,217,207,1.090563239,1.122241942,1.057257783,,,
549,경남,거창군,2013,428,216,212,4,2011,506,265,241,0.863399437,0.830531685,0.899614157,,,
550,경남,거창군,2014,495,246,249,4,2012,468,247,221,1.079637236,1.014814076,1.152244215,,,
551,경남,거창군,2015,483,252,231,4,2013,458,248,210,1.076465614,1.035373842,1.124942043,,,
552,경남,거창군,2016,490,260,230,4,2014,437,231,206,1.144545737,1.146858128,1.141821138,,,
553,경남,거창군,2017,454,240,214,4,2015,500,264,236,0.926839123,0.926308488,0.927340513,,,
554,경남,거창군,2018,519,269,250,4,2016,465,246,219,1.139286402,1.114206022,1.16743674,,,
555,경남,거창군,2019,482,255,227,4,2017,437,222,215,1.125859276,1.170403292,1.079754096,,,
556,경남,거창군,2020,427,219,208,4,2018,449,226,223,0.970733557,0.987379268,0.953884814,,,
557,경남,고성군,2010,356,176,180,4,2008,343,171,172,1.059435172,1.048732884,1.070240844,,,
558,경남,고성군,2011,339,165,174,4,2009,346,150,196,1.000096963,1.12083327,0.90788458,,,
559,경남,고성군,2012,333,155,178,4,2010,371,188,183,0.916196931,0.840082963,0.994732656,,,
560,경남,고성군,2013,374,193,181,4,2011,398,227,171,0.959195293,0.866322872,1.082480115,,,
561,경남,고성군,2014,382,210,172,4,2012,420,217,203,0.928394548,0.986070326,0.866502603,,,
562,경남,고성군,2015,397,207,190,4,2013,382,204,178,1.060829658,1.033923738,1.091618938,,,
563,경남,고성군,2016,364,187,177,4,2014,424,227,197,0.87630247,0.839390555,0.918849753,,,
564,경남,고성군,2017,397,214,183,4,2015,400,214,186,1.013092323,1.018939336,1.006179833,,,
565,경남,고성군,2018,368,194,174,4,2016,427,218,209,0.87970782,0.906762529,0.85141329,,,
566,경남,고성군,2019,382,197,185,4,2017,338,156,182,1.153626362,1.286737495,1.039531857,,,
567,경남,고성군,2020,309,142,167,4,2018,332,151,181,0.950033467,0.958207853,0.943572683,,,
568,경남,김해시,2010,6399,3400,2999,4,2008,6091,3191,2900,1.07236349,1.08567651,1.057586579,,,
569,경남,김해시,2011,6059,3190,2869,4,2009,5638,2967,2671,1.096969089,1.095522913,1.09848498,,,
570,경남,김해시,2012,5594,2977,2617,4,2010,5965,3077,2888,0.957261347,0.985824636,0.926710314,,,
571,경남,김해시,2013,5830,3015,2815,4,2011,6474,3279,3195,0.919209213,0.936902135,0.901041926,,,
572,경남,김해시,2014,6507,3312,3195,4,2012,6062,3117,2945,1.095679115,1.082684338,1.109489065,,,
573,경남,김해시,2015,6072,3127,2945,4,2013,5801,2981,2820,1.068433278,1.068843779,1.068005904,,,
574,경남,김해시,2016,5671,2930,2741,4,2014,6075,3165,2910,0.952866095,0.943283493,0.963282143,,,
575,경남,김해시,2017,5886,3038,2848,4,2015,6030,3027,3003,0.996371863,1.022642122,0.969889183,,,
576,경남,김해시,2018,5838,2909,2929,4,2016,6069,3020,3049,0.981895935,0.981488255,0.98242501,,,
577,경남,김해시,2019,6171,3071,3100,4,2017,5472,2769,2703,1.151139527,1.130069593,1.172878731,,,
578,경남,김해시,2020,5602,2829,2773,4,2018,5441,2765,2676,1.050952016,1.042524189,1.059744627,,,
579,경남,남해군,2010,259,128,131,4,2008,282,149,133,0.937495442,0.875330437,1.007296019,,,
580,경남,남해군,2011,244,129,115,4,2009,227,116,111,1.09719161,1.133130814,1.059527722,,,
581,경남,남해군,2012,218,118,100,4,2010,232,125,107,0.959151075,0.961878734,0.955770639,,,
582,경남,남해군,2013,218,120,98,4,2011,278,138,140,0.800442623,0.886034206,0.715872209,,,
583,경남,남해군,2014,245,121,124,4,2012,243,130,113,1.02914915,0.948397382,1.122226977,,,
584,경남,남해군,2015,237,131,106,4,2013,227,129,98,1.065714802,1.034736845,1.106158224,,,
585,경남,남해군,2016,226,132,94,4,2014,233,121,112,0.990081686,1.111570185,0.858316169,,,
586,경남,남해군,2017,221,114,107,4,2015,206,120,86,1.095074238,0.96799237,1.272397448,,,
587,경남,남해군,2018,197,119,78,4,2016,196,100,96,1.02595583,1.21253781,0.8309231,,,
588,경남,남해군,2019,183,91,92,4,2017,152,71,81,1.228926787,1.305964502,1.161556318,,,
589,경남,남해군,2020,152,71,81,4,2018,188,107,81,0.825285562,0.676118625,1.022674584,,,
590,경남,마산시,2010,3481,1875,1606,4,2008,3493,1833,1660,1.017241212,1.042286555,0.989406857,,,
591,경남,마산시,2011,0,0,0,4,2009,3120,1619,1501,0,0,0,,,
592,경남,밀양시,2010,774,394,380,4,2008,751,398,353,1.052009187,1.00869874,1.100896153,,,
593,경남,밀양시,2011,728,391,337,4,2009,725,372,353,1.024971717,1.070981937,0.976321062,,,
594,경남,밀양시,2012,681,348,333,4,2010,684,348,336,1.016270968,1.018939336,1.013543561,,,
595,경남,밀양시,2013,667,344,323,4,2011,802,409,393,0.848926273,0.857005212,0.840518806,,,
596,경남,밀양시,2014,782,402,380,4,2012,723,356,367,1.104045482,1.150600037,1.058900114,,,
597,경남,밀양시,2015,739,364,375,4,2013,628,338,290,1.201166755,1.097319285,1.322424031,,,
598,경남,밀양시,2016,635,330,305,4,2014,684,362,322,0.947624177,0.928867351,0.968682448,,,
599,경남,밀양시,2017,692,359,333,4,2015,676,338,338,1.044907647,1.082246218,1.007546262,,,
600,경남,밀양시,2018,648,333,315,4,2016,702,369,333,0.942228861,0.919530621,0.967394877,,,
601,경남,밀양시,2019,673,359,314,4,2017,631,302,329,1.08868995,1.211255701,0.976048083,,,
602,경남,밀양시,2020,607,298,309,4,2018,613,313,300,1.010756925,0.970108378,1.053354822,,,
603,경남,사천시,2010,1083,564,519,4,2008,1113,581,532,0.993234511,0.989125277,0.997684416,,,
604,경남,사천시,2011,1052,555,497,4,2009,1054,531,523,1.018811029,1.064993092,0.971834165,,,
605,경남,사천시,2012,972,497,475,4,2010,1071,562,509,0.926393082,0.901090481,0.954362333,,,
606,경남,사천시,2013,1065,555,510,4,2011,1156,568,588,0.940394938,0.995618542,0.88701367,,,
607,경남,사천시,2014,1172,587,585,4,2012,1185,630,555,1.009549854,0.949392683,1.077954291,,,
608,경남,사천시,2015,1166,602,564,4,2013,1210,607,603,0.983629826,1.010546096,0.956531452,,,
609,경남,사천시,2016,1121,546,575,4,2014,1258,643,615,0.909585399,0.86522687,0.956159164,,,
610,경남,사천시,2017,1167,619,548,4,2015,1147,598,549,1.038546502,1.054721487,1.020811789,,,
611,경남,사천시,2018,1061,554,507,4,2016,1133,593,540,0.955881338,0.951926463,0.960177804,,,
612,경남,사천시,2019,1068,551,517,4,2017,991,528,463,1.100059326,1.063324951,1.141949806,,,
613,경남,사천시,2020,904,481,423,4,2018,973,490,483,0.948361902,1.000224124,0.895634263,,,
614,경남,산청군,2010,187,98,89,4,2008,198,108,90,0.964039714,0.924593102,1.011311533,,,
615,경남,산청군,2011,184,99,85,4,2009,202,89,113,0.929790196,1.133426902,0.769268492,,,
616,경남,산청군,2012,181,86,95,4,2010,202,100,102,0.914630573,0.876287829,0.952491034,,,
617,경남,산청군,2013,181,92,89,4,2011,245,124,121,0.754103575,0.75598725,0.75221519,,,
618,경남,산청군,2014,215,110,105,4,2012,176,105,71,1.246936395,1.067460257,1.512406075,,,
619,경남,산청군,2015,175,107,68,4,2013,181,99,82,0.986910984,1.101277869,0.848071606,,,
620,경남,산청군,2016,159,77,82,4,2014,209,112,97,0.776549863,0.700520794,0.86452903,,,
621,경남,산청군,2017,194,108,86,4,2015,179,106,73,1.106285469,1.038164607,1.204794716,,,
622,경남,산청군,2018,149,88,61,4,2016,179,91,88,0.84967286,0.98534793,0.708899428,,,
623,경남,산청군,2019,159,90,69,4,2017,179,94,85,0.906697884,0.975580216,0.830171133,,,
624,경남,산청군,2020,139,77,62,4,2018,143,78,65,0.992195543,1.005876012,0.975474219,,,
625,경남,양산시,2010,2902,1539,1363,4,2008,2798,1456,1342,1.058688528,1.077024477,1.038677689,,,
626,경남,양산시,2011,2830,1462,1368,4,2009,2679,1383,1296,1.078281691,1.077143391,1.079489839,,,
627,경남,양산시,2012,2683,1385,1298,4,2010,2805,1466,1339,0.976351766,0.962640505,0.991360426,,,
628,경남,양산시,2013,2741,1394,1347,4,2011,3179,1652,1527,0.880110124,0.859807164,0.902123553,,,
629,경남,양산시,2014,3194,1612,1582,4,2012,3000,1589,1411,1.086756299,1.033687986,1.146613177,,,
630,경남,양산시,2015,3213,1671,1542,4,2013,2880,1472,1408,1.138771912,1.156689967,1.120002989,,,
631,경남,양산시,2016,3092,1584,1508,4,2014,3339,1717,1622,0.945238876,0.940011595,0.950797332,,,
632,경남,양산시,2017,3559,1800,1759,4,2015,3514,1780,1734,1.033819548,1.030388093,1.037419027,,,
633,경남,양산시,2018,3935,1987,1948,4,2016,3723,1929,1794,1.078872714,1.049576185,1.110462703,,,
634,경남,양산시,2019,4026,2088,1938,4,2017,3754,1852,1902,1.094707293,1.148782578,1.042031201,,,
635,경남,양산시,2020,3713,1862,1851,4,2018,4007,2095,1912,0.945854024,0.905615773,0.990047414,,,
636,경남,의령군,2010,156,93,63,4,2008,185,94,91,0.860738797,1.008099556,0.708005481,,,
637,경남,의령군,2011,161,85,76,4,2009,156,79,77,1.053464212,1.096327134,1.009393096,,,
638,경남,의령군,2012,130,70,60,4,2010,140,73,67,0.947837366,0.977065117,0.915827986,,,
639,경남,의령군,2013,129,66,63,4,2011,180,88,92,0.731536018,0.764204502,0.70030977,,,
640,경남,의령군,2014,142,69,73,4,2012,184,97,87,0.787751122,0.724812518,0.85810626,,,
641,경남,의령군,2015,131,65,66,4,2013,193,95,98,0.69283927,0.69716902,0.688740026,,,
642,경남,의령군,2016,143,80,63,4,2014,167,84,83,0.874053619,0.970418416,0.776246973,,,
643,경남,의령군,2017,127,66,61,4,2015,156,73,83,0.830993509,0.921232825,0.751604212,,,
644,경남,의령군,2018,120,54,66,4,2016,171,97,74,0.716314339,0.567244579,0.91211517,,,
645,경남,의령군,2019,129,79,50,4,2017,131,75,56,1.005163995,1.073282768,0.913102307,,,
646,경남,의령군,2020,96,52,44,4,2018,134,81,53,0.731282101,0.654133895,0.849012862,,,
647,경남,진주시,2010,3296,1769,1527,4,2008,3033,1685,1348,1.10925987,1.069735125,1.158474844,,,
648,경남,진주시,2011,3165,1765,1400,4,2009,2703,1426,1277,1.195215393,1.261169655,1.121178088,,,
649,경남,진주시,2012,2845,1478,1367,4,2010,2973,1553,1420,0.976800494,0.969731062,0.984504336,,,
650,경남,진주시,2013,3054,1594,1460,4,2011,3263,1668,1595,0.95536751,0.973734594,0.93611592,,,
651,경남,진주시,2014,3364,1716,1648,4,2012,3036,1568,1468,1.131026365,1.115114733,1.14807065,,,
652,경남,진주시,2015,3261,1679,1582,4,2013,2745,1466,1279,1.212626232,1.16698441,1.264950111,,,
653,경남,진주시,2016,3086,1650,1436,4,2014,3150,1675,1475,1.000008927,1.003731287,0.995634375,,,
654,경남,진주시,2017,3352,1776,1576,4,2015,3317,1769,1548,1.031518562,1.022971318,1.041172574,,,
655,경남,진주시,2018,3368,1789,1579,4,2016,3336,1703,1633,1.03053928,1.070394875,0.988856809,,,
656,경남,진주시,2019,3444,1791,1653,4,2017,2994,1601,1393,1.17416696,1.139862805,1.213554262,,,
657,경남,진주시,2020,3121,1670,1451,4,2018,3174,1649,1525,1.003703307,1.03191552,0.973049719,,,
658,경남,진해시,2010,2224,1190,1034,4,2008,2257,1221,1036,1.005823395,0.99306946,1.020700309,,,
659,경남,진해시,2011,0,0,0,4,2009,2055,1047,1008,0,0,0,,,
660,경남,창녕군,2010,345,168,177,4,2008,358,201,157,0.983681667,0.851650789,1.152951601,,,
661,경남,창녕군,2011,331,192,139,4,2009,326,176,150,1.036403576,1.111570185,0.947678448,,,
662,경남,창녕군,2012,322,171,151,4,2010,346,184,162,0.949944608,0.946949057,0.953233717,,,
663,경남,창녕군,2013,369,197,172,4,2011,404,213,191,0.9323168,0.942399292,0.920942557,,,
664,경남,창녕군,2014,399,220,179,4,2012,378,199,179,1.077456151,1.126465598,1.022674584,,,
665,경남,창녕군,2015,379,201,178,4,2013,380,201,179,1.018061754,1.018939336,1.016961318,,,
666,경남,창녕군,2016,355,192,163,4,2014,406,208,198,0.892525902,0.940559387,0.841898774,,,
667,경남,창녕군,2017,382,203,179,4,2015,414,216,198,0.941849542,0.957614284,0.924539144,,,
668,경남,창녕군,2018,391,200,191,4,2016,407,212,195,0.98062025,0.961263525,1.001696644,,,
669,경남,창녕군,2019,392,186,206,4,2017,402,223,179,0.995356193,0.849877653,1.176932762,,,
670,경남,창녕군,2020,354,193,161,4,2018,371,194,177,0.973975116,1.013687072,0.930229424,,,
671,경남,창원시,2010,4988,2665,2323,4,2008,4825,2550,2275,1.055231231,1.064891503,1.044251894,,,
672,경남,창원시,2011,10242,5418,4824,4,2009,4464,2374,2090,2.341957958,2.325447904,2.360469949,,,
673,경남,통영시,2010,1290,680,610,4,2008,1271,685,586,1.03600695,1.011501823,1.064558867,,,
674,경남,통영시,2011,1279,684,595,4,2009,1243,640,603,1.050311026,1.088991416,1.009106762,,,
675,경남,통영시,2012,1235,651,584,4,2010,1275,648,627,0.988724468,1.023656648,0.952539007,,,
676,경남,통영시,2013,1254,637,617,4,2011,1554,799,755,0.823692347,0.812345879,0.835748634,,,
677,경남,통영시,2014,1483,754,729,4,2012,1470,723,747,1.029774955,1.062628298,0.998031823,,,
678,경남,통영시,2015,1439,714,725,4,2013,1422,755,667,1.032950967,0.963606207,1.111602809,,,
679,경남,통영시,2016,1411,756,655,4,2014,1591,820,771,0.905264194,0.939412364,0.868809147,,,
680,경남,통영시,2017,1522,789,733,4,2015,1531,777,754,1.014747455,1.034675851,0.994191605,,,
681,경남,통영시,2018,1455,732,723,4,2016,1515,781,734,0.980322272,0.955011004,1.007348398,,,
682,경남,통영시,2019,1427,742,685,4,2017,1206,620,586,1.207800414,1.219440303,1.195447253,,,
683,경남,통영시,2020,1103,569,534,4,2018,1249,645,604,0.901429119,0.898878267,0.904152695,,,
684,경남,하동군,2010,304,169,135,4,2008,352,187,165,0.881555033,0.920859614,0.836733751,,,
685,경남,하동군,2011,281,151,130,4,2009,320,169,151,0.896344278,0.910413253,0.880448317,,,
686,경남,하동군,2012,294,158,136,4,2010,285,143,142,1.052982078,1.125821085,0.979462982,,,
687,경남,하동군,2013,261,130,131,4,2011,360,188,172,0.740042251,0.704585711,0.778897503,,,
688,경남,하동군,2014,296,163,133,4,2012,305,150,155,0.990627502,1.107247412,0.877520772,,,
689,경남,하동군,2015,268,138,130,4,2013,256,112,144,1.068595492,1.255478825,0.923247888,,,
690,경남,하동군,2016,217,91,126,4,2014,295,157,138,0.750855259,0.590595412,0.933746359,,,
691,경남,하동군,2017,266,150,116,4,2015,267,143,124,1.016924907,1.068817486,0.956695579,,,
692,경남,하동군,2018,226,131,95,4,2016,263,137,126,0.877144611,0.974314256,0.771064171,,,
693,경남,하동군,2019,214,113,101,4,2017,201,108,93,1.086766456,1.066112454,1.110646591,,,
694,경남,하동군,2020,171,96,75,4,2018,229,128,101,0.762217888,0.764204502,0.75941182,,,
695,경남,함안군,2010,599,325,274,4,2008,578,313,265,1.05783393,1.058004103,1.057406928,,,
696,경남,함안군,2011,543,295,248,4,2009,587,320,267,0.944235311,0.939334701,0.949899988,,,
697,경남,함안군,2012,554,306,248,4,2010,627,336,291,0.901904872,0.92796261,0.871557721,,,
698,경남,함안군,2013,547,293,254,4,2011,656,324,332,0.85114195,0.921448227,0.782407664,,,
699,경남,함안군,2014,630,325,305,4,2012,672,358,314,0.956951187,0.925014761,0.993362255,,,
700,경남,함안군,2015,686,360,326,4,2013,628,322,306,1.115020831,1.139186836,1.08951606,,,
701,경남,함안군,2016,646,329,317,4,2014,620,322,298,1.063553491,1.041090191,1.087878668,,,
702,경남,함안군,2017,628,337,291,4,2015,624,299,325,1.027291189,1.148436643,0.915687089,,,
703,경남,함안군,2018,598,290,308,4,2016,623,311,312,0.97978694,0.950136359,1.009563371,,,
704,경남,함안군,2019,592,304,288,4,2017,552,273,279,1.094715174,1.134643071,1.055664087,,,
705,경남,함안군,2020,502,245,257,4,2018,498,246,252,1.028946711,1.014797307,1.042965746,,,
706,경남,함양군,2010,267,127,140,4,2008,268,145,123,1.016939172,0.892450315,1.164019852,,,
707,경남,함양군,2011,270,148,122,4,2009,267,135,132,1.03221701,1.117059421,0.945199237,,,
708,경남,함양군,2012,266,136,130,4,2010,289,144,145,0.939511938,0.962331595,0.916880662,,,
709,경남,함양군,2013,283,149,134,4,2011,300,155,145,0.96290555,0.979496523,0.945092374,,,
710,경남,함양군,2014,283,155,128,4,2012,300,149,151,0.96290555,1.059970451,0.866902959,,,
711,경남,함양군,2015,283,143,140,4,2013,270,130,140,1.069895055,1.12083327,1.022674584,,,
712,경남,함양군,2016,241,115,126,4,2014,277,149,128,0.888087551,0.786429689,1.006695294,,,
713,경남,함양군,2017,253,142,111,4,2015,214,103,111,1.206772088,1.404751318,1.022674584,,,
714,경남,함양군,2018,191,93,98,4,2016,238,134,104,0.81917166,0.707174316,0.963674127,,,
715,경남,함양군,2019,222,132,90,4,2017,221,111,110,1.025366701,1.211711643,0.836733751,,,
716,경남,함양군,2020,216,105,111,4,2018,228,119,109,0.967024357,0.89906412,1.041439255,,,
717,경남,합천군,2010,258,142,116,4,2008,324,158,166,0.812817798,0.915755606,0.714640071,,,
718,경남,합천군,2011,244,112,132,4,2009,277,136,141,0.899142583,0.839126512,0.957397483,,,
719,경남,합천군,2012,214,105,109,4,2010,253,135,118,0.863399437,0.792508373,0.94467398,,,
720,경남,합천군,2013,205,107,98,4,2011,311,159,152,0.672840277,0.685701314,0.659355982,,,
721,경남,합천군,2014,273,146,127,4,2012,286,160,126,0.974350299,0.929782144,1.030791049,,,
722,경남,합천군,2015,226,120,106,4,2013,258,120,138,0.894143538,1.018939336,0.785532652,,,
723,경남,합천군,2016,210,101,109,4,2014,230,117,113,0.931987243,0.879597205,0.986473714,,,
724,경남,합천군,2017,165,85,80,4,2015,262,131,131,0.642837438,0.661143844,0.624534097,,,
725,경남,합천군,2018,212,109,103,4,2016,240,121,119,0.901660674,0.917887501,0.885172119,,,
726,경남,합천군,2019,177,97,80,4,2017,227,117,110,0.795913586,0.844761672,0.743763334,,,
727,경남,합천군,2020,183,95,88,4,2018,187,94,93,0.998913752,1.029779117,0.96769208,,,
728,경북,경산시,2010,2359,1274,1085,4,2008,2622,1359,1263,0.918361698,0.955208767,0.878544674,,,
729,경북,경산시,2011,2320,1193,1127,4,2009,2246,1158,1088,1.054378986,1.049736294,1.059332956,,,
730,경북,경산시,2012,2048,1052,996,4,2010,2237,1177,1060,0.934506824,0.910725728,0.960928194,,,
731,경북,경산시,2013,2128,1139,989,4,2011,2574,1328,1246,0.843881741,0.873924627,0.811737692,,,
732,경북,경산시,2014,2386,1227,1159,4,2012,2335,1220,1115,1.043042641,1.02478571,1.063031249,,,
733,경북,경산시,2015,2156,1132,1024,4,2013,2306,1191,1115,0.954350626,0.968462912,0.939209663,,,
734,경북,경산시,2016,2155,1109,1046,4,2014,2369,1176,1193,0.928540226,0.96088752,0.896661873,,,
735,경북,경산시,2017,2164,1102,1062,4,2015,2441,1265,1176,0.904915414,0.887645177,0.923537762,,,
736,경북,경산시,2018,2342,1220,1122,4,2016,2540,1272,1268,0.941177818,0.977284584,0.904921832,,,
737,경북,경산시,2019,2437,1241,1196,4,2017,2322,1194,1128,1.071301771,1.059048339,1.08432518,,,
738,경북,경산시,2020,2228,1130,1098,4,2018,2380,1188,1192,0.955557308,0.96919314,0.942027427,,,
739,경북,경주시,2010,2304,1208,1096,4,2008,2280,1248,1032,1.031492648,0.986281024,1.086096264,,,
740,경북,경주시,2011,2130,1134,996,4,2009,2070,1079,991,1.050334829,1.070877857,1.027834395,,,
741,경북,경주시,2012,1947,1026,921,4,2010,2136,1102,1034,0.930428944,0.948667658,0.910912275,,,
742,경북,경주시,2013,2046,1061,985,4,2011,2302,1194,1108,0.907232958,0.905439394,0.909146629,,,
743,경북,경주시,2014,2153,1109,1044,4,2012,2099,1083,1016,1.047008241,1.043401407,1.050858529,,,
744,경북,경주시,2015,1973,1007,966,4,2013,1936,1011,925,1.040256028,1.014907925,1.068003944,,,
745,경북,경주시,2016,1909,990,919,4,2014,1995,1014,981,0.976745766,0.994822429,0.958040716,,,
746,경북,경주시,2017,1946,992,954,4,2015,1965,1011,954,1.010878105,0.99979013,1.022674584,,,
747,경북,경주시,2018,1939,993,946,4,2016,2028,1024,1004,0.975951795,0.98809254,0.963595773,,,
748,경북,경주시,2019,1984,1010,974,4,2017,1808,944,864,1.120112776,1.090178739,1.152876209,,,
749,경북,경주시,2020,1768,941,827,4,2018,1766,926,840,1.021903932,1.035444833,1.006847477,,,
750,경북,고령군,2010,209,106,103,4,2008,241,135,106,0.885212937,0.800056072,0.993730964,,,
751,경북,고령군,2011,205,117,88,4,2009,218,126,92,0.959877643,0.946157955,0.978210472,,,
752,경북,고령군,2012,193,115,78,4,2010,253,125,128,0.778673324,0.937424189,0.623192325,,,
753,경북,고령군,2013,230,112,118,4,2011,276,153,123,0.850623277,0.745890233,0.981102447,,,
754,경북,고령군,2014,247,128,119,4,2012,246,139,107,1.024897314,0.938303849,1.137367061,,,
755,경북,고령군,2015,230,131,99,4,2013,234,124,110,1.00329925,1.076460105,0.920407126,,,
756,경북,고령군,2016,213,114,99,4,2014,236,119,117,0.921268261,0.976126759,0.865340033,,,
757,경북,고령군,2017,191,99,92,4,2015,214,101,113,0.911041379,0.99876232,0.832620015,,,
758,경북,고령군,2018,160,76,84,4,2016,235,123,112,0.694977316,0.629588533,0.767005938,,,
759,경북,고령군,2019,188,100,88,4,2017,203,100,103,0.945323208,1.018939336,0.873741392,,,
760,경북,고령군,2020,153,76,77,4,2018,204,105,99,0.765560949,0.737517996,0.795413565,,,
761,경북,구미시,2010,4998,2687,2311,4,2008,4706,2482,2224,1.084083758,1.103098307,1.06268029,,,
762,경북,구미시,2011,4722,2489,2233,4,2009,4450,2319,2131,1.083139716,1.093635191,1.071624752,,,
763,경북,구미시,2012,4463,2284,2179,4,2010,4516,2329,2187,1.008768384,0.999251801,1.018933662,,,
764,경북,구미시,2013,4506,2346,2160,4,2011,5086,2632,2454,0.904343331,0.908218725,0.900153668,,,
765,경북,구미시,2014,4962,2582,2380,4,2012,4845,2474,2371,1.045397573,1.063420116,1.026556521,,,
766,경북,구미시,2015,4723,2422,2301,4,2013,4516,2347,2169,1.06753598,1.051500244,1.084912042,,,
767,경북,구미시,2016,4405,2311,2094,4,2014,4744,2472,2272,0.947806628,0.952576378,0.942553072,,,
768,경북,구미시,2017,4667,2411,2256,4,2015,4977,2619,2358,0.957169098,0.938015556,0.978436752,,,
769,경북,구미시,2018,4998,2616,2382,4,2016,5214,2680,2534,0.978461482,0.994606457,0.961330252,,,
770,경북,구미시,2019,5161,2660,2501,4,2017,4626,2405,2221,1.138798115,1.126976563,1.151602492,,,
771,경북,구미시,2020,4552,2362,2190,4,2018,4812,2503,2309,0.965595301,0.961540037,0.969968531,,,
772,경북,군위군,2010,77,43,34,4,2008,97,49,48,0.810284441,0.894171254,0.724394497,,,
773,경북,군위군,2011,68,36,32,4,2009,101,57,44,0.687236232,0.643540633,0.743763334,,,
774,경북,군위군,2012,77,42,35,4,2010,92,47,45,0.854321639,0.910541535,0.795413565,,,
775,경북,군위군,2013,77,37,40,4,2011,104,57,47,0.755746065,0.661416762,0.870361348,,,
776,경북,군위군,2014,80,43,37,4,2012,101,54,47,0.808513214,0.81137762,0.805084247,,,
777,경북,군위군,2015,93,52,41,4,2013,76,47,29,1.249073128,1.127337138,1.445850274,,,
778,경북,군위군,2016,70,39,31,4,2014,85,40,45,0.840615944,0.993465853,0.704509158,,,
779,경북,군위군,2017,78,38,40,4,2015,96,49,47,0.829357695,0.790197853,0.870361348,,,
780,경북,군위군,2018,79,43,36,4,2016,111,56,55,0.726478258,0.782399848,0.669387001,,,
781,경북,군위군,2019,87,50,37,4,2017,74,44,30,1.200068515,1.157885609,1.261298654,,,
782,경북,군위군,2020,66,44,22,4,2018,79,43,36,0.852776754,1.0426356,0.624967801,,,
783,경북,김천시,2010,1026,547,479,4,2008,1127,587,540,0.929270079,0.949505651,0.907150233,,,
784,경북,김천시,2011,1002,513,489,4,2009,972,480,492,1.052252498,1.088991416,1.016438763,,,
785,경북,김천시,2012,913,452,461,4,2010,963,535,428,0.967749598,0.860860897,1.101525662,,,
786,경북,김천시,2013,884,503,381,4,2011,1104,565,539,0.817338018,0.907126524,0.722892424,,,
787,경북,김천시,2014,1028,538,490,4,2012,1101,593,508,0.953068914,0.924434002,0.986438083,,,
788,경북,김천시,2015,1077,577,500,4,2013,1010,515,495,1.088460914,1.141607761,1.03300463,,,
789,경북,김천시,2016,1021,528,493,4,2014,1102,548,554,0.945720181,0.981751769,0.910069621,,,
790,경북,김천시,2017,1130,568,562,4,2015,1157,608,549,0.99692754,0.951903854,1.046890922,,,
791,경북,김천시,2018,1131,605,526,4,2016,1303,655,648,0.886006072,0.941157708,0.830133999,,,
792,경북,김천시,2019,1228,630,598,4,2017,1184,628,556,1.058681133,1.022184366,1.099926981,,,
793,경북,김천시,2020,1118,602,516,4,2018,1158,587,571,0.985488937,1.044976968,0.924168276,,,
794,경북,문경시,2010,518,283,235,4,2008,452,245,207,1.169795197,1.176978907,1.161007378,,,
795,경북,문경시,2011,485,259,226,4,2009,494,265,229,1.00215131,0.995869012,1.0092771,,,
796,경북,문경시,2012,485,256,229,4,2010,447,252,195,1.107522925,1.035112977,1.200987076,,,
797,경북,문경시,2013,464,257,207,4,2011,536,296,240,0.883632539,0.884687194,0.882056829,,,
798,경북,문경시,2014,507,279,228,4,2012,478,248,230,1.082676154,1.146306753,1.013781762,,,
799,경북,문경시,2015,484,256,228,4,2013,455,242,213,1.085806592,1.07788624,1.094693921,,,
800,경북,문경시,2016,456,249,207,4,2014,497,263,234,0.936541363,0.96469922,0.904673671,,,
801,경북,문경시,2017,464,238,226,4,2015,564,305,259,0.839764257,0.795106761,0.892372417,,,
802,경북,문경시,2018,513,278,235,4,2016,535,286,249,0.978773251,0.990437537,0.965174808,,,
803,경북,문경시,2019,486,256,230,4,2017,471,254,217,1.053255828,1.026962481,1.083940803,,,
804,경북,문경시,2020,415,223,192,4,2018,418,211,207,1.01342199,1.076888493,0.94856773,,,
805,경북,봉화군,2010,192,99,93,4,2008,198,106,92,0.989816177,0.95165089,1.033790612,,,
806,경북,봉화군,2011,186,98,88,4,2009,164,87,77,1.157677533,1.147770747,1.168770953,,,
807,경북,봉화군,2012,140,69,71,4,2010,190,98,92,0.752130056,0.717416472,0.789237994,,,
808,경북,봉화군,2013,171,88,83,4,2011,214,91,123,0.815644376,0.98534793,0.690097484,,,
809,경북,봉화군,2014,186,80,106,4,2012,217,121,96,0.874926799,0.6736789,1.129203187,,,
810,경북,봉화군,2015,175,102,73,4,2013,194,108,86,0.920777774,0.962331595,0.86808424,,,
811,경북,봉화군,2016,157,91,66,4,2014,234,123,111,0.684860792,0.753849428,0.60807678,,,
812,경북,봉화군,2017,177,89,88,4,2015,218,103,115,0.828772404,0.880442728,0.782568377,,,
813,경북,봉화군,2018,160,82,78,4,2016,208,106,102,0.785190717,0.78823609,0.78204527,,,
814,경북,봉화군,2019,141,78,63,4,2017,175,89,86,0.822431191,0.893003014,0.749168591,,,
815,경북,봉화군,2020,132,69,63,4,2018,186,95,91,0.724401759,0.740071729,0.708005481,,,
816,경북,상주시,2010,696,359,337,4,2008,658,347,311,1.079696901,1.054176432,1.108171495,,,
817,경북,상주시,2011,634,336,298,4,2009,669,334,335,0.967345574,1.02504077,0.909722466,,,
818,경북,상주시,2012,650,329,321,4,2010,642,351,291,1.033467533,0.955074193,1.128104954,,,
819,경북,상주시,2013,619,331,288,4,2011,705,387,318,0.896231163,0.871495918,0.92619585,,,
820,경북,상주시,2014,703,379,324,4,2012,691,363,328,1.03847438,1.063851263,1.010202943,,,
821,경북,상주시,2015,712,372,340,4,2013,668,344,324,1.087982826,1.101876259,1.073177033,,,
822,경북,상주시,2016,658,339,319,4,2014,661,357,304,1.016115189,0.967564244,1.073135501,,,
823,경북,상주시,2017,637,348,289,4,2015,617,316,301,1.053835386,1.122123067,0.981903504,,,
824,경북,상주시,2018,609,305,304,4,2016,638,348,290,0.974350299,0.893035913,1.072045081,,,
825,경북,상주시,2019,606,320,286,4,2017,593,301,292,1.043125206,1.083257766,1.001660723,,,
826,경북,상주시,2020,564,288,276,4,2018,547,288,259,1.05247136,1.018939336,1.089799943,,,
827,경북,성주군,2010,227,131,96,4,2008,235,142,93,0.985999067,0.940007416,1.055664087,,,
828,경북,성주군,2011,214,141,73,4,2009,230,119,111,0.949739381,1.207314676,0.672569772,,,
829,경북,성주군,2012,196,100,96,4,2010,226,121,105,0.885250419,0.842098625,0.935016763,,,
830,경북,성주군,2013,207,118,89,4,2011,234,112,122,0.902969325,1.073525372,0.746049492,,,
831,경북,성주군,2014,203,107,96,4,2012,223,121,102,0.929201033,0.901045529,0.962517256,,,
832,경북,성주군,2015,207,114,93,4,2013,230,125,105,0.918673139,0.929272675,0.905797489,,,
833,경북,성주군,2016,218,126,92,4,2014,229,111,118,0.971716372,1.156633841,0.797339506,,,
834,경북,성주군,2017,178,84,94,4,2015,241,117,124,0.753913411,0.73154619,0.775253314,,,
835,경북,성주군,2018,192,92,100,4,2016,256,125,131,0.765560949,0.749939352,0.780667621,,,
836,경북,성주군,2019,193,94,99,4,2017,210,106,104,0.938115957,0.903587713,0.973507537,,,
837,경북,성주군,2020,162,80,82,4,2018,202,102,100,0.818619629,0.799168107,0.838593159,,,
838,경북,안동시,2010,1370,700,670,4,2008,1355,707,648,1.032047725,1.008850828,1.057395018,,,
839,경북,안동시,2011,1374,718,656,4,2009,1282,680,602,1.093999734,1.075880064,1.114409514,,,
840,경북,안동시,2012,1267,669,598,4,2010,1278,653,625,1.011962152,1.043905691,0.978495042,,,
841,경북,안동시,2013,1244,635,609,4,2011,1445,760,685,0.878761542,0.85135063,0.909209959,,,
842,경북,안동시,2014,1391,726,665,4,2012,1361,685,676,1.043247887,1.079926946,1.00603343,,,
843,경북,안동시,2015,1318,674,644,4,2013,1314,669,645,1.023855232,1.026554728,1.021089042,,,
844,경북,안동시,2016,1302,665,637,4,2014,1377,728,649,0.96515164,0.930761894,1.003765347,,,
845,경북,안동시,2017,1407,743,664,4,2015,1407,738,669,1.020747933,1.025842719,1.015031276,,,
846,경북,안동시,2018,1473,776,697,4,2016,1466,771,695,1.025621899,1.025547244,1.025617533,,,
847,경북,안동시,2019,1424,759,665,4,2017,1296,679,617,1.121562543,1.138991099,1.102234357,,,
848,경북,안동시,2020,1315,686,629,4,2018,1067,545,522,1.257997686,1.282554834,1.232303282,,,
849,경북,영덕군,2010,245,125,120,4,2008,243,128,115,1.02914915,0.995057946,1.067138696,,,
850,경북,영덕군,2011,212,109,103,4,2009,230,124,106,0.940863312,0.895680546,0.993730964,,,
851,경북,영덕군,2012,200,99,101,4,2010,227,108,119,0.899337385,0.934027725,0.867984311,,,
852,경북,영덕군,2013,205,99,106,4,2011,237,128,109,0.882925427,0.788085893,0.994527577,,,
853,경북,영덕군,2014,216,118,98,4,2012,172,86,86,1.281869497,1.398079555,1.165373363,,,
854,경북,영덕군,2015,168,86,82,4,2013,211,112,99,0.812728212,0.782399848,0.847063797,,,
855,경북,영덕군,2016,191,98,93,4,2014,198,99,99,0.984660884,1.00864702,0.960694306,,,
856,경북,영덕군,2017,203,106,97,4,2015,211,106,105,0.982046589,1.018939336,0.944756521,,,
857,경북,영덕군,2018,186,94,92,4,2016,194,101,93,0.978655234,0.948319778,1.011678083,,,
858,경북,영덕군,2019,174,87,87,4,2017,201,106,95,0.883632539,0.836299267,0.936554619,,,
859,경북,영덕군,2020,169,88,81,4,2018,214,108,106,0.806104676,0.830246867,0.781477748,,,
860,경북,영양군,2010,104,52,52,4,2008,76,39,37,1.39681296,1.358585782,1.437272388,,,
861,경북,영양군,2011,75,34,41,4,2009,101,52,49,0.757981138,0.666229566,0.855707305,,,
862,경북,영양군,2012,95,51,44,4,2010,82,47,35,1.182573824,1.105657578,1.285648049,,,
863,경북,영양군,2013,87,45,42,4,2011,115,56,59,0.772218001,0.818790538,0.728005636,,,
864,경북,영양군,2014,107,56,51,4,2012,105,51,54,1.04019075,1.11883535,0.965859329,,,
865,경북,영양군,2015,105,54,51,4,2013,79,43,36,1.35669029,1.279598236,1.448788994,,,
866,경북,영양군,2016,81,45,36,4,2014,95,50,45,0.870321921,0.917045403,0.818139667,,,
867,경북,영양군,2017,93,46,47,4,2015,88,56,32,1.078744974,0.836985883,1.502053295,,,
868,경북,영양군,2018,71,45,26,4,2016,91,51,40,0.796407728,0.89906412,0.66473848,,,
869,경북,영양군,2019,70,42,28,4,2017,95,54,41,0.752130056,0.792508373,0.698411911,,,
870,경북,영양군,2020,77,46,31,4,2018,93,37,56,0.845135385,1.266789445,0.56612343,,,
871,경북,영주시,2010,937,471,466,4,2008,868,456,412,1.101890337,1.052457078,1.156714457,,,
872,경북,영주시,2011,874,463,411,4,2009,850,460,390,1.049569051,1.025584593,1.077741677,,,
873,경북,영주시,2012,836,461,375,4,2010,837,435,402,1.019528401,1.079841458,0.953987485,,,
874,경북,영주시,2013,826,440,386,4,2011,868,427,441,0.971356904,1.049960909,0.895130135,,,
875,경북,영주시,2014,840,419,421,4,2012,785,394,391,1.092265304,1.083592848,1.101140665,,,
876,경북,영주시,2015,816,402,414,4,2013,769,381,388,1.083134347,1.075101347,1.091204324,,,
877,경북,영주시,2016,787,396,391,4,2014,787,401,386,1.020747933,1.006234357,1.035921664,,,
878,경북,영주시,2017,830,427,403,4,2015,772,389,383,1.097436249,1.118475827,1.076077957,,,
879,경북,영주시,2018,809,403,406,4,2016,836,437,399,0.987781193,0.939662592,1.040616243,,,
880,경북,영주시,2019,845,445,400,4,2017,705,365,340,1.22344965,1.242268506,1.20314657,,,
881,경북,영주시,2020,666,333,333,4,2018,677,381,296,1.004162663,0.890569026,1.150508907,,,
882,경북,영천시,2010,728,393,335,4,2008,750,407,343,0.990805993,0.983889826,0.998822116,,,
883,경북,영천시,2011,648,352,296,4,2009,634,305,329,1.043288108,1.175956218,0.920096282,,,
884,경북,영천시,2012,579,279,300,4,2010,642,329,313,0.920581079,0.864085334,0.980199282,,,
885,경북,영천시,2013,568,292,276,4,2011,722,379,343,0.803026074,0.785040333,0.822910161,,,
886,경북,영천시,2014,644,348,296,4,2012,622,333,289,1.056851557,1.064837505,1.047445249,,,
887,경북,영천시,2015,578,313,265,4,2013,614,343,271,0.96089952,0.929819278,1.000032342,,,
888,경북,영천시,2016,577,325,252,4,2014,642,333,309,0.917401179,0.994460313,0.834025874,,,
889,경북,영천시,2017,615,324,291,4,2015,635,319,316,0.988598391,1.034910172,0.941766785,,,
890,경북,영천시,2018,552,274,278,4,2016,671,338,333,0.839721101,0.826004077,0.853764368,,,
891,경북,영천시,2019,610,291,319,4,2017,599,307,292,1.039492886,0.965835006,1.11723696,,,
892,경북,영천시,2020,542,271,271,4,2018,583,304,279,0.948962915,0.90833079,0.993350582,,,
893,경북,예천군,2010,233,124,109,4,2008,269,146,123,0.884142261,0.865400532,0.906272599,,,
894,경북,예천군,2011,232,129,103,4,2009,227,118,109,1.043231367,1.113925207,0.96638057,,,
895,경북,예천군,2012,211,104,107,4,2010,260,145,115,0.828376207,0.730825455,0.951532004,,,
896,경북,예천군,2013,253,139,114,4,2011,287,148,139,0.89982309,0.956976809,0.838740306,,,
897,경북,예천군,2014,248,141,107,4,2012,274,159,115,0.92388864,0.903587713,0.951532004,,,
898,경북,예천군,2015,243,144,99,4,2013,275,150,125,0.901969991,0.978181763,0.809958271,,,
899,경북,예천군,2016,243,138,105,4,2014,263,139,124,0.943124516,1.011608838,0.865974446,,,
900,경북,예천군,2017,208,108,100,4,2015,295,150,145,0.719713796,0.733636322,0.705292817,,,
901,경북,예천군,2018,219,108,111,4,2016,325,169,156,0.687827068,0.651156499,0.7276723,,,
902,경북,예천군,2019,367,210,157,4,2017,393,201,192,0.953217535,1.064563486,0.83624953,,,
903,경북,예천군,2020,394,204,190,4,2018,422,221,201,0.953020582,0.940559387,0.966707318,,,
904,경북,울릉군,2010,58,31,27,4,2008,61,35,26,0.970547215,0.902489126,1.062008222,,,
905,경북,울릉군,2011,48,29,19,4,2009,64,37,27,0.765560949,0.798628128,0.719659893,,,
906,경북,울릉군,2012,57,27,30,4,2010,63,34,29,0.923533844,0.809157708,1.057939225,,,
907,경북,울릉군,2013,51,25,26,4,2011,64,24,40,0.813408509,1.061395142,0.66473848,,,
908,경북,울릉군,2014,54,19,35,4,2012,58,31,27,0.950351523,0.624511206,1.325689276,,,
909,경북,울릉군,2015,57,32,25,4,2013,52,24,28,1.118896772,1.358585782,0.913102307,,,
910,경북,울릉군,2016,41,21,20,4,2014,40,21,19,1.046266631,1.018939336,1.076499562,,,
911,경북,울릉군,2017,40,22,18,4,2015,56,34,22,0.729105666,0.659313688,0.836733751,,,
912,경북,울릉군,2018,50,29,21,4,2016,51,25,26,1.000733267,1.18196963,0.826006395,,,
913,경북,울릉군,2019,50,20,30,4,2017,50,20,30,1.020747933,1.018939336,1.022674584,,,
914,경북,울릉군,2020,50,22,28,4,2018,49,27,22,1.041579523,0.830246867,1.301585834,,,
915,경북,울진군,2010,396,186,210,4,2008,423,205,218,0.955593809,0.924501056,0.985145242,,,
916,경북,울진군,2011,413,205,208,4,2009,409,202,207,1.030730797,1.034072099,1.027615041,,,
917,경북,울진군,2012,397,191,206,4,2010,379,214,165,1.069226726,0.909427165,1.276793723,,,
918,경북,울진군,2013,362,196,166,4,2011,427,241,186,0.865364758,0.828680954,0.912709575,,,
919,경북,울진군,2014,400,220,180,4,2012,406,206,200,1.005662988,1.088187641,0.920407126,,,
920,경북,울진군,2015,368,189,179,4,2013,394,202,192,0.953388932,0.953364033,0.953430992,,,
921,경북,울진군,2016,332,169,163,4,2014,369,184,185,0.918396514,0.93587363,0.901059228,,,
922,경북,울진군,2017,335,181,154,4,2015,397,195,202,0.861336417,0.945784717,0.779662802,,,
923,경북,울진군,2018,343,166,177,4,2016,391,218,173,0.895438723,0.775889586,1.046320239,,,
924,경북,울진군,2019,330,185,145,4,2017,363,189,174,0.927952666,0.997374483,0.85222882,,,
925,경북,울진군,2020,299,148,151,4,2018,340,159,181,0.897657741,0.948446678,0.853170509,,,
926,경북,의성군,2010,231,123,108,4,2008,257,139,118,0.917481605,0.901651355,0.936007246,,,
927,경북,의성군,2011,223,123,100,4,2009,237,125,112,0.960450586,1.002636307,0.913102307,,,
928,경북,의성군,2012,214,115,99,4,2010,222,107,115,0.983964223,1.095121717,0.880389425,,,
929,경북,의성군,2013,217,110,107,4,2011,243,111,132,0.911532104,1.009759703,0.828986216,,,
930,경북,의성군,2014,225,105,120,4,2012,251,153,98,0.915013087,0.699272094,1.252254593,,,
931,경북,의성군,2015,220,135,85,4,2013,216,104,112,1.039650672,1.322661639,0.776136961,,,
932,경북,의성군,2016,193,95,98,4,2014,216,114,102,0.91205718,0.849116114,0.982569698,,,
933,경북,의성군,2017,192,104,88,4,2015,220,107,113,0.890834559,0.990370944,0.796419145,,,
934,경북,의성군,2018,183,88,95,4,2016,209,109,100,0.893764936,0.822629923,0.971540855,,,
935,경북,의성군,2019,177,90,87,4,2017,207,110,97,0.87281345,0.833677639,0.917244215,,,
936,경북,의성군,2020,162,83,79,4,2018,202,108,94,0.818619629,0.783073749,0.859481831,,,
937,경북,청도군,2010,181,90,91,4,2008,224,122,102,0.824800785,0.75167656,0.912386149,,,
938,경북,청도군,2011,198,110,88,4,2009,183,98,85,1.104415796,1.143707418,1.058768981,,,
939,경북,청도군,2012,163,80,83,4,2010,200,104,96,0.831909565,0.78379949,0.884187401,,,
940,경북,청도군,2013,184,98,86,4,2011,246,107,139,0.763486258,0.933234159,0.632733915,,,
941,경북,청도군,2014,216,102,114,4,2012,182,97,85,1.211437107,1.071461983,1.371587089,,,
942,경북,청도군,2015,176,92,84,4,2013,182,91,91,0.987096902,1.030136472,0.944007308,,,
943,경북,청도군,2016,175,82,93,4,2014,195,103,92,0.916055837,0.811194423,1.033790612,,,
944,경북,청도군,2017,182,97,85,4,2015,205,96,109,0.906224994,1.029553288,0.797498529,,,
945,경북,청도군,2018,174,83,91,4,2016,195,103,92,0.910821232,0.821087038,1.011558556,,,
946,경북,청도군,2019,183,98,85,4,2017,158,77,81,1.182258681,1.296831883,1.073177033,,,
947,경북,청도군,2020,145,74,71,4,2018,166,87,79,0.89161717,0.866684033,0.919112601,,,
948,경북,청송군,2010,151,85,66,4,2008,144,78,66,1.070367624,1.11038261,1.022674584,,,
949,경북,청송군,2011,121,61,60,4,2009,142,67,75,0.869792252,0.927691038,0.818139667,,,
950,경북,청송군,2012,120,62,58,4,2010,130,66,64,0.942228861,0.957185437,0.926798842,,,
951,경북,청송군,2013,118,58,60,4,2011,132,59,73,0.912486788,1.001669178,0.840554453,,,
952,경북,청송군,2014,125,63,62,4,2012,140,85,55,0.911382083,0.755213861,1.152833168,,,
953,경북,청송군,2015,123,74,49,4,2013,112,54,58,1.120999962,1.396324276,0.8639837,,,
954,경북,청송군,2016,106,49,57,4,2014,101,53,48,1.071280008,0.942038254,1.214426069,,,
955,경북,청송군,2017,98,50,48,4,2015,121,67,54,0.826721466,0.76040249,0.909044075,,,
956,경북,청송군,2018,116,64,52,4,2016,130,67,63,0.910821232,0.973315187,0.844112355,,,
957,경북,청송군,2019,115,59,56,4,2017,127,62,65,0.924299309,0.96963582,0.881073488,,,
958,경북,청송군,2020,104,45,59,4,2018,113,49,64,0.939449425,0.935760615,0.942778132,,,
959,경북,칠곡군,2010,1282,655,627,4,2008,1384,746,638,0.9455194,0.894645128,1.005042264,,,
960,경북,칠곡군,2011,1207,666,541,4,2009,1348,710,638,0.913978305,0.9557938,0.867189577,,,
961,경북,칠곡군,2012,1153,616,537,4,2010,1353,698,655,0.86986132,0.899235861,0.838437025,,,
962,경북,칠곡군,2013,1214,633,581,4,2011,1472,771,701,0.841839667,0.836561089,0.847609035,,,
963,경북,칠곡군,2014,1316,709,607,4,2012,1340,697,643,1.00246588,1.036482051,0.965417531,,,
964,경북,칠곡군,2015,1235,635,600,4,2013,1275,656,619,0.988724468,0.986320852,0.991283926,,,
965,경북,칠곡군,2016,1212,623,589,4,2014,1322,705,617,0.935814292,0.900424406,0.976264716,,,
966,경북,칠곡군,2017,1223,651,572,4,2015,1387,676,711,0.900053873,0.981256669,0.822742422,,,
967,경북,칠곡군,2018,1206,591,615,4,2016,1377,724,653,0.893988385,0.831758491,0.963162127,,,
968,경북,칠곡군,2019,1244,649,595,4,2017,1228,661,567,1.03404758,1.000441194,1.073177033,,,
969,경북,칠곡군,2020,1123,600,523,4,2018,1102,596,506,1.040199572,1.025777855,1.057033216,,,
970,경북,포항시,2010,4670,2451,2219,4,2008,4395,2336,2059,1.084617257,1.069101162,1.102144197,,,
971,경북,포항시,2011,4461,2357,2104,4,2009,4260,2248,2012,1.068909983,1.068345203,1.06943704,,,
972,경북,포항시,2012,4263,2245,2018,4,2010,4272,2239,2033,1.01859748,1.021669857,1.015129026,,,
973,경북,포항시,2013,4337,2271,2066,4,2011,4631,2385,2246,0.955945537,0.970235318,0.940714911,,,
974,경북,포항시,2014,4684,2428,2256,4,2012,4508,2299,2209,1.060599671,1.076113401,1.044433618,,,
975,경북,포항시,2015,4423,2262,2161,4,2013,4435,2331,2104,1.017986044,0.988777683,1.050380122,,,
976,경북,포항시,2016,4355,2275,2080,4,2014,4845,2490,2355,0.917514395,0.930958631,0.903253985,,,
977,경북,포항시,2017,4712,2432,2280,4,2015,4797,2535,2262,1.002660883,0.977538645,1.030812578,,,
978,경북,포항시,2018,4691,2485,2206,4,2016,5070,2673,2397,0.944443501,0.947274318,0.94118487,,,
979,경북,포항시,2019,4866,2559,2307,4,2017,4588,2363,2225,1.08259796,1.103455676,1.060364164,,,
980,경북,포항시,2020,4488,2298,2190,4,2018,4468,2324,2144,1.025317082,1.007539843,1.044616296,,,
981,광주,광산구,2010,5399,2796,2603,4,2008,4443,2290,2153,1.240382194,1.244084884,1.236424497,,,
982,광주,광산구,2011,5118,2683,2435,4,2009,4553,2372,2181,1.147416631,1.152535514,1.141775613,,,
983,광주,광산구,2012,4901,2544,2357,4,2010,4967,2622,2345,1.007184541,0.98862764,1.027907887,,,
984,광주,광산구,2013,5131,2682,2449,4,2011,5626,2946,2680,0.930938081,0.92762909,0.93452614,,,
985,광주,광산구,2014,5817,3039,2778,4,2012,5297,2672,2625,1.120953506,1.158890959,1.082281903,,,
986,광주,광산구,2015,5397,2739,2658,4,2013,5186,2608,2578,1.062278556,1.070120722,1.054410025,,,
987,광주,광산구,2016,5163,2606,2557,4,2014,5470,2818,2652,0.963459155,0.942283858,0.986040314,,,
988,광주,광산구,2017,5323,2737,2586,4,2015,5269,2762,2507,1.031209194,1.009716497,1.054900867,,,
989,광주,광산구,2018,5100,2664,2436,4,2016,5367,2794,2573,0.969967292,0.971529847,0.968222031,,,
990,광주,광산구,2019,5395,2820,2575,4,2017,4692,2357,2335,1.173686082,1.219095854,1.127788888,,,
991,광주,광산구,2020,4616,2337,2279,4,2018,4524,2333,2191,1.041505848,1.020686339,1.063749602,,,
992,광주,남구,2010,1931,1029,902,4,2008,1634,857,777,1.206281675,1.22344058,1.187197522,,,
993,광주,남구,2011,1908,1008,900,4,2009,1574,818,756,1.237348828,1.255612287,1.217469743,,,
994,광주,남구,2012,1764,923,841,4,2010,1716,874,842,1.049300322,1.076065226,1.021460006,,,
995,광주,남구,2013,1941,990,951,4,2011,1855,968,887,1.068071017,1.042097049,1.096463957,,,
996,광주,남구,2014,2074,1054,1020,4,2012,1804,923,881,1.173520628,1.163555862,1.184027328,,,
997,광주,남구,2015,2076,1076,1000,4,2013,1719,869,850,1.232735723,1.261655611,1.20314657,,,
998,광주,남구,2016,1985,1030,955,4,2014,1971,1007,964,1.027998298,1.042212032,1.013126792,,,
999,광주,남구,2017,2240,1143,1097,4,2015,1985,993,992,1.15187676,1.172857665,1.13092139,,,
1000,광주,남구,2018,2195,1123,1072,4,2016,2059,1076,983,1.088169846,1.06344691,1.115266688,,,
1001,광주,남구,2019,2317,1205,1112,4,2017,1839,942,897,1.286064687,1.303420276,1.267797255,,,
1002,광주,남구,2020,2173,1101,1072,4,2018,1876,970,906,1.182348218,1.156548669,1.210052047,,,
1003,광주,동구,2010,810,460,350,4,2008,766,405,361,1.079380973,1.157313814,0.991512755,,,
1004,광주,동구,2011,742,361,381,4,2009,615,325,290,1.23153653,1.131806463,1.343582816,,,
1005,광주,동구,2012,619,331,288,4,2010,604,314,290,1.046097633,1.074104842,1.015621656,,,
1006,광주,동구,2013,673,350,323,4,2011,705,352,353,0.974416111,1.013149908,0.93576173,,,
1007,광주,동구,2014,608,303,305,4,2012,662,354,308,0.937484506,0.872142991,1.012713468,,,
1008,광주,동구,2015,530,270,260,4,2013,596,309,287,0.907712088,0.890335342,0.92646478,,,
1009,광주,동구,2016,496,263,233,4,2014,649,340,309,0.78010936,0.788179545,0.771142971,,,
1010,광주,동구,2017,560,300,260,4,2015,709,351,358,0.8062325,0.870888322,0.742724558,,,
1011,광주,동구,2018,578,276,302,4,2016,716,374,342,0.824011599,0.751944537,0.903063522,,,
1012,광주,동구,2019,587,292,295,4,2017,619,311,308,0.967979057,0.956689023,0.979509748,,,
1013,광주,동구,2020,571,295,276,4,2018,694,366,328,0.839837276,0.821276241,0.860543248,,,
1014,광주,북구,2010,4979,2630,2349,4,2008,4853,2524,2329,1.047249939,1.061731559,1.031456676,,,
1015,광주,북구,2011,4554,2408,2146,4,2009,4277,2210,2067,1.086856695,1.110228924,1.061760841,,,
1016,광주,북구,2012,3765,1960,1805,4,2010,4323,2235,2088,0.888992821,0.893566487,0.884064954,,,
1017,광주,북구,2013,3856,2003,1853,4,2011,4407,2322,2085,0.893125489,0.878955853,0.908880578,,,
1018,광주,북구,2014,4308,2305,2003,4,2012,3999,2048,1951,1.099620428,1.146804282,1.049931928,,,
1019,광주,북구,2015,3986,2051,1935,4,2013,3906,2090,1816,1.041654188,0.999925636,1.089689053,,,
1020,광주,북구,2016,3883,2076,1807,4,2014,4049,2071,1978,0.978899536,1.021399354,0.934263384,,,
1021,광주,북구,2017,3957,2018,1939,4,2015,4052,2113,1939,0.996816281,0.973128055,1.022674584,,,
1022,광주,북구,2018,3978,2058,1920,4,2016,4123,2140,1983,0.984849691,0.979895866,0.990184166,,,
1023,광주,북구,2019,4081,2110,1971,4,2017,3683,1942,1741,1.131054117,1.107086509,1.157778062,,,
1024,광주,북구,2020,3635,1904,1731,4,2018,3846,1943,1903,0.964747461,0.998487131,0.930241569,,,
1025,광주,서구,2010,3339,1788,1551,4,2008,3257,1641,1616,1.046446837,1.110215438,0.981539777,,,
1026,광주,서구,2011,3064,1571,1493,4,2009,2814,1466,1348,1.111432717,1.091919302,1.132680381,,,
1027,광주,서구,2012,2893,1482,1411,4,2010,2791,1444,1347,1.058052228,1.045753529,1.071264913,,,
1028,광주,서구,2013,2924,1520,1404,4,2011,3319,1743,1576,0.899266934,0.888575899,0.911062891,,,
1029,광주,서구,2014,3174,1665,1509,4,2012,3075,1577,1498,1.053611037,1.075798348,1.030184211,,,
1030,광주,서구,2015,2852,1455,1397,4,2013,2854,1460,1394,1.020032622,1.015449818,1.024875462,,,
1031,광주,서구,2016,2724,1387,1337,4,2014,2855,1497,1358,0.973911513,0.944067374,1.006860029,,,
1032,광주,서구,2017,2820,1472,1348,4,2015,2725,1394,1331,1.05633364,1.075953159,1.035736543,,,
1033,광주,서구,2018,2794,1445,1349,4,2016,2894,1509,1385,0.985476753,0.975723884,0.996092429,,,
1034,광주,서구,2019,2803,1472,1331,4,2017,2615,1335,1280,1.094132488,1.123504647,1.063421775,,,
1035,광주,서구,2020,2547,1313,1234,4,2018,2469,1248,1221,1.052995133,1.072009093,1.033563011,,,
1036,대구,남구,2010,1102,568,534,4,2008,1194,621,573,0.942097338,0.93197672,0.953068461,,,
1037,대구,남구,2011,954,497,457,4,2009,1118,567,551,0.871013889,0.893144357,0.848207414,,,
1038,대구,남구,2012,894,476,418,4,2010,994,542,452,0.918056994,0.894861853,0.945747735,,,
1039,대구,남구,2013,857,475,382,4,2011,1103,560,543,0.793092455,0.864278901,0.719450628,,,
1040,대구,남구,2014,938,495,443,4,2012,1006,540,466,0.951751054,0.934027725,0.972199229,,,
1041,대구,남구,2015,832,445,387,4,2013,934,460,474,0.90927439,0.985713054,0.83496849,,,
1042,대구,남구,2016,779,382,397,4,2014,931,499,432,0.854095209,0.780029712,0.939819004,,,
1043,대구,남구,2017,731,386,345,4,2015,953,512,441,0.782966148,0.768184734,0.800051545,,,
1044,대구,남구,2018,732,389,343,4,2016,922,449,473,0.810398576,0.882778178,0.741601231,,,
1045,대구,남구,2019,737,371,366,4,2017,831,422,409,0.905284267,0.895797379,0.915156229,,,
1046,대구,남구,2020,720,353,367,4,2018,759,391,368,0.968298434,0.919911984,1.019895577,,,
1047,대구,달서구,2010,6108,3217,2891,4,2008,5333,2805,2528,1.169084638,1.168601727,1.16952224,,,
1048,대구,달서구,2011,5784,3043,2741,4,2009,4911,2587,2324,1.202200375,1.198543641,1.206175144,,,
1049,대구,달서구,2012,5386,2812,2574,4,2010,5055,2613,2442,1.087586224,1.096539385,1.077954291,,,
1050,대구,달서구,2013,5330,2746,2584,4,2011,5679,2912,2767,0.958018398,0.960854196,0.955038354,,,
1051,대구,달서구,2014,5906,2978,2928,4,2012,5237,2734,2503,1.151143267,1.109876132,1.196320888,,,
1052,대구,달서구,2015,5526,2906,2620,4,2013,5188,2731,2457,1.087250014,1.084232044,1.090519907,,,
1053,대구,달서구,2016,5193,2742,2451,4,2014,5563,2848,2715,0.952857094,0.98101533,0.923232194,,,
1054,대구,달서구,2017,5415,2796,2619,4,2015,5397,2737,2660,1.024152317,1.04090405,1.006911555,,,
1055,대구,달서구,2018,5249,2636,2613,4,2016,5403,2756,2647,0.991653877,0.974573328,1.009538605,,,
1056,대구,달서구,2019,5343,2677,2666,4,2017,4622,2320,2302,1.179977543,1.175733019,1.184383337,,,
1057,대구,달서구,2020,4632,2364,2268,4,2018,4571,2334,2237,1.034369815,1.032036243,1.03684665,,,
1058,대구,달성군,2010,1945,1021,924,4,2008,1921,981,940,1.03350064,1.060486302,1.005267357,,,
1059,대구,달성군,2011,1797,935,862,4,2009,1988,1044,944,0.922678086,0.912555823,0.933840563,,,
1060,대구,달성군,2012,1772,930,842,4,2010,1914,985,929,0.945018462,0.962044247,0.926902045,,,
1061,대구,달성군,2013,1761,917,844,4,2011,2084,1070,1014,0.862541799,0.873240534,0.851220265,,,
1062,대구,달성군,2014,1921,986,935,4,2012,2085,1089,996,0.940458887,0.922565827,0.9600409,,,
1063,대구,달성군,2015,1896,986,910,4,2013,1860,946,914,1.040504344,1.062023452,1.018198984,,,
1064,대구,달성군,2016,1916,955,961,4,2014,2127,1090,1037,0.91948897,0.892740428,0.94772447,,,
1065,대구,달성군,2017,2687,1377,1310,4,2015,2266,1189,1077,1.210392628,1.180050014,1.243921732,,,
1066,대구,달성군,2018,2910,1510,1400,4,2016,2800,1415,1385,1.060848744,1.087348691,1.033750482,,,
1067,대구,달성군,2019,3044,1569,1475,4,2017,2965,1538,1427,1.047944926,1.039477125,1.05707429,,,
1068,대구,달성군,2020,2880,1481,1399,4,2018,3208,1622,1586,0.916382184,0.930363229,0.902094416,,,
1069,대구,동구,2010,2923,1465,1458,4,2008,2903,1553,1350,1.027780299,0.961201628,1.104488551,,,
1070,대구,동구,2011,2814,1469,1345,4,2009,2645,1412,1233,1.085967744,1.060072157,1.115569599,,,
1071,대구,동구,2012,2567,1364,1203,4,2010,2660,1430,1230,0.985060129,0.971911367,1.00022563,,,
1072,대구,동구,2013,2592,1385,1207,4,2011,3081,1544,1537,0.858740228,0.914009703,0.803102292,,,
1073,대구,동구,2014,3072,1524,1548,4,2012,2966,1523,1443,1.057227798,1.019608371,1.097089575,,,
1074,대구,동구,2015,2929,1485,1444,4,2013,2865,1510,1355,1.043549981,1.00206948,1.089846568,,,
1075,대구,동구,2016,2890,1518,1372,4,2014,3245,1702,1543,0.909079052,0.908783732,0.909338645,,,
1076,대구,동구,2017,3072,1578,1494,4,2015,3185,1646,1539,0.984533014,0.976844637,0.992771818,,,
1077,대구,동구,2018,3015,1579,1436,4,2016,3397,1765,1632,0.905962619,0.911561027,0.899853372,,,
1078,대구,동구,2019,3154,1644,1510,4,2017,2952,1499,1453,1.09059586,1.117502514,1.06279327,,,
1079,대구,동구,2020,2723,1361,1362,4,2018,3055,1541,1514,0.909818861,0.899919816,0.920001839,,,
1080,대구,북구,2010,5034,2655,2379,4,2008,5165,2705,2460,0.994858682,1.000104968,0.989001153,,,
1081,대구,북구,2011,4559,2390,2169,4,2009,4601,2441,2160,1.011430086,0.997650559,1.026935728,,,
1082,대구,북구,2012,4205,2215,1990,4,2010,4444,2322,2122,0.965851723,0.971985629,0.959058634,,,
1083,대구,북구,2013,4109,2121,1988,4,2011,4877,2540,2337,0.860006819,0.850854462,0.869951679,,,
1084,대구,북구,2014,4452,2303,2149,4,2012,4434,2331,2103,1.0248917,1.006699825,1.045044071,,,
1085,대구,북구,2015,4014,2085,1929,4,2013,4032,2074,1958,1.016191022,1.024343547,1.007527718,,,
1086,대구,북구,2016,3662,1862,1800,4,2014,4160,2201,1959,0.898552627,0.862001383,0.939670368,,,
1087,대구,북구,2017,3816,1988,1828,4,2015,4230,2176,2054,0.920844943,0.930905975,0.910150506,,,
1088,대구,북구,2018,3807,1943,1864,4,2016,4224,2188,2036,0.919978073,0.90484421,0.936279678,,,
1089,대구,북구,2019,3864,1967,1897,4,2017,3815,1947,1868,1.033858456,1.029406099,1.038551224,,,
1090,대구,북구,2020,3458,1754,1704,4,2018,3790,1952,1838,0.931331491,0.915583809,0.948116154,,,
1091,대구,서구,2010,1514,794,720,4,2008,1481,782,699,1.043492485,1.034575234,1.053398713,,,
1092,대구,서구,2011,1332,693,639,4,2009,1253,644,609,1.085104746,1.096467329,1.073052642,,,
1093,대구,서구,2012,1158,609,549,4,2010,1256,641,615,0.941103587,0.96807185,0.912924141,,,
1094,대구,서구,2013,1136,570,566,4,2011,1379,693,686,0.840877195,0.838088632,0.843781071,,,
1095,대구,서구,2014,1204,600,604,4,2012,1290,649,641,0.95269807,0.942008631,0.963643446,,,
1096,대구,서구,2015,1080,548,532,4,2013,1180,592,588,0.93424387,0.943207359,0.925277005,,,
1097,대구,서구,2016,1028,498,530,4,2014,1213,628,585,0.865069146,0.808012404,0.926525692,,,
1098,대구,서구,2017,991,509,482,4,2015,1246,620,626,0.811846871,0.836516326,0.787426756,,,
1099,대구,서구,2018,1018,531,487,4,2016,1228,632,596,0.846190061,0.856102512,0.835641816,,,
1100,대구,서구,2019,1024,509,515,4,2017,1052,530,522,0.993579737,0.978566268,1.008960557,,,
1101,대구,서구,2020,869,424,445,4,2018,937,477,460,0.946670174,0.905723855,0.9893265,,,
1102,대구,수성구,2010,4270,2302,1968,4,2008,3578,1839,1739,1.218164805,1.275474906,1.15734536,,,
1103,대구,수성구,2011,3937,2079,1858,4,2009,3457,1817,1640,1.162477469,1.165863996,1.158615474,,,
1104,대구,수성구,2012,3731,1986,1745,4,2010,3512,1842,1670,1.084399355,1.098595832,1.068603083,,,
1105,대구,수성구,2013,3735,1982,1753,4,2011,3827,1964,1863,0.99620944,1.028277884,0.962291222,,,
1106,대구,수성구,2014,4119,2146,1973,4,2012,3582,1859,1723,1.173774633,1.176247346,1.171060333,,,
1107,대구,수성구,2015,3821,1990,1831,4,2013,3456,1790,1666,1.128552619,1.132787307,1.123959882,,,
1108,대구,수성구,2016,3558,1874,1684,4,2014,3354,1727,1627,1.08283278,1.105670131,1.058502766,,,
1109,대구,수성구,2017,3571,1852,1719,4,2015,3500,1755,1745,1.041454533,1.075256781,1.007437026,,,
1110,대구,수성구,2018,3553,1778,1775,4,2016,3544,1821,1723,1.023340125,0.994878715,1.05353882,,,
1111,대구,수성구,2019,3675,1919,1756,4,2017,3108,1576,1532,1.206965461,1.24070088,1.172204027,,,
1112,대구,수성구,2020,3323,1689,1634,4,2018,3106,1592,1514,1.09206226,1.081022952,1.103732015,,,
1113,대구,중구,2010,760,405,355,4,2008,509,256,253,1.524103003,1.611993872,1.434978171,,,
1114,대구,중구,2011,717,359,358,4,2009,492,254,238,1.487553389,1.440154416,1.538308828,,,
1115,대구,중구,2012,626,330,296,4,2010,512,257,255,1.248023839,1.308365685,1.187104615,,,
1116,대구,중구,2013,701,346,355,4,2011,524,291,233,1.365542559,1.211522372,1.558152263,,,
1117,대구,중구,2014,735,391,344,4,2012,488,256,232,1.537396989,1.556270627,1.516379556,,,
1118,대구,중구,2015,725,380,345,4,2013,448,255,193,1.651880025,1.518419403,1.828097055,,,
1119,대구,중구,2016,686,370,316,4,2014,578,295,283,1.21147592,1.27799171,1.141926391,,,
1120,대구,중구,2017,735,385,350,4,2015,606,304,302,1.238035859,1.290433041,1.185218889,,,
1121,대구,중구,2018,797,416,381,4,2016,637,353,284,1.277136738,1.2007897,1.371968368,,,
1122,대구,중구,2019,787,436,351,4,2017,570,283,287,1.409348461,1.569814667,1.250727453,,,
1123,대구,중구,2020,717,361,356,4,2018,594,310,284,1.232114929,1.186571292,1.281944197,,,
1124,대전,대덕구,2010,2264,1141,1123,4,2008,2232,1186,1046,1.035382311,0.980278063,1.097957512,,,
1125,대전,대덕구,2011,2074,1093,981,4,2009,1886,1001,885,1.122497992,1.112588107,1.133608776,,,
1126,대전,대덕구,2012,1747,916,831,4,2010,1822,957,865,0.978730317,0.975285718,0.98247697,,,
1127,대전,대덕구,2013,1763,927,836,4,2011,2018,1041,977,0.891763432,0.907355202,0.875082858,,,
1128,대전,대덕구,2014,1929,997,932,4,2012,1822,878,944,1.080693064,1.157041593,1.009674483,,,
1129,대전,대덕구,2015,1721,849,872,4,2013,1733,910,823,1.013679857,0.950636809,1.083562864,,,
1130,대전,대덕구,2016,1575,834,741,4,2014,1776,955,821,0.905224096,0.889838122,0.92302298,,,
1131,대전,대덕구,2017,1553,831,722,4,2015,1689,881,808,0.93855627,0.96111077,0.913825557,,,
1132,대전,대덕구,2018,1510,792,718,4,2016,1629,835,794,0.946181325,0.966467011,0.924786337,,,
1133,대전,대덕구,2019,1376,716,660,4,2017,1429,729,700,0.982889542,1.00076895,0.964236036,,,
1134,대전,대덕구,2020,1269,661,608,4,2018,1332,712,620,0.972469314,0.945953513,1.002880882,,,
1135,대전,동구,2010,2165,1116,1049,4,2008,2365,1240,1125,0.934426754,0.917045403,0.953587234,,,
1136,대전,동구,2011,2111,1076,1035,4,2009,2147,1103,1044,1.003632457,0.993997032,1.013858424,,,
1137,대전,동구,2012,2070,1077,993,4,2010,2309,1214,1095,0.915092343,0.903951948,0.927411746,,,
1138,대전,동구,2013,2170,1115,1055,4,2011,2570,1310,1260,0.861876659,0.86726516,0.856287053,,,
1139,대전,동구,2014,2378,1224,1154,4,2012,2497,1283,1214,0.972101956,0.972082422,0.972130535,,,
1140,대전,동구,2015,2140,1105,1035,4,2013,2353,1246,1107,0.928347036,0.903634002,0.956159164,,,
1141,대전,동구,2016,1971,1035,936,4,2014,2292,1173,1119,0.87778978,0.89906412,0.855427534,,,
1142,대전,동구,2017,1953,999,954,4,2015,2214,1103,1111,0.900415859,0.922865274,0.878156214,,,
1143,대전,동구,2018,1931,960,971,4,2016,2094,1058,1036,0.941291432,0.924557432,0.958510638,,,
1144,대전,동구,2019,1869,929,940,4,2017,1915,959,956,0.996228661,0.987064279,1.005558691,,,
1145,대전,동구,2020,1637,803,834,4,2018,1794,932,862,0.931418264,0.877905887,0.989455456,,,
1146,대전,서구,2010,5198,2641,2557,4,2008,4939,2564,2375,1.074275714,1.049539309,1.101043752,,,
1147,대전,서구,2011,5017,2593,2424,4,2009,4459,2305,2154,1.148484498,1.146251496,1.150864992,,,
1148,대전,서구,2012,4427,2265,2162,4,2010,4542,2377,2165,0.994903368,0.970928732,1.021257483,,,
1149,대전,서구,2013,4487,2332,2155,4,2011,4889,2477,2412,0.936816521,0.9592921,0.913708014,,,
1150,대전,서구,2014,4873,2428,2445,4,2012,4552,2342,2210,1.092729498,1.056355555,1.131420524,,,
1151,대전,서구,2015,4476,2316,2160,4,2013,4383,2251,2132,1.042406513,1.048362285,1.036105582,,,
1152,대전,서구,2016,4253,2210,2043,4,2014,4654,2393,2261,0.932797799,0.941017941,0.924070843,,,
1153,대전,서구,2017,4454,2299,2155,4,2015,4612,2371,2241,0.985778684,0.987997273,0.983428705,,,
1154,대전,서구,2018,4459,2294,2165,4,2016,4777,2438,2339,0.952797788,0.958755881,0.946597039,,,
1155,대전,서구,2019,4556,2339,2217,4,2017,4315,2225,2090,1.07775842,1.071145666,1.084817968,,,
1156,대전,서구,2020,4192,2171,2021,4,2018,4185,2151,2034,1.022455277,1.028413435,1.016138316,,,
1157,대전,유성구,2010,3738,1989,1749,4,2008,3574,1801,1773,1.067586953,1.125302798,1.008831273,,,
1158,대전,유성구,2011,3743,1921,1822,4,2009,3355,1780,1575,1.138795682,1.09965307,1.183055932,,,
1159,대전,유성구,2012,3627,1932,1695,4,2010,3631,1897,1734,1.019623451,1.037738955,0.999673253,,,
1160,대전,유성구,2013,3957,2087,1870,4,2011,4089,2087,2002,0.987796422,1.018939336,0.955245491,,,
1161,대전,유성구,2014,4268,2193,2075,4,2012,3904,2050,1854,1.115920127,1.090016568,1.14457916,,,
1162,대전,유성구,2015,4122,2124,1998,4,2013,3765,1942,1823,1.117535984,1.114432106,1.120846856,,,
1163,대전,유성구,2016,3830,1930,1900,4,2014,4100,2115,1985,0.953527947,0.929812255,0.978882473,,,
1164,대전,유성구,2017,4067,2108,1959,4,2015,4213,2201,2012,0.98537428,0.975885562,0.995735343,,,
1165,대전,유성구,2018,4099,2141,1958,4,2016,4337,2263,2074,0.964732713,0.964007565,0.965475813,,,
1166,대전,유성구,2019,4129,2141,1988,4,2017,3952,1993,1959,1.066464629,1.094605679,1.037813718,,,
1167,대전,유성구,2020,3737,1874,1863,4,2018,3982,2098,1884,0.957944506,0.910148864,1.011275345,,,
1168,대전,중구,2010,2627,1357,1270,4,2008,2456,1281,1175,1.091817923,1.079391631,1.105358912,,,
1169,대전,중구,2011,2421,1246,1175,4,2009,2248,1135,1113,1.099301933,1.11858891,1.07964298,,,
1170,대전,중구,2012,2314,1204,1110,4,2010,2315,1179,1136,1.020307005,1.040545344,0.9992683,,,
1171,대전,중구,2013,2339,1191,1148,4,2011,2576,1331,1245,0.926835953,0.911763148,0.942996323,,,
1172,대전,중구,2014,2546,1329,1217,4,2012,2463,1311,1152,1.055145853,1.03292935,1.080377577,,,
1173,대전,중구,2015,2374,1255,1119,4,2013,2274,1169,1105,1.065635704,1.093899801,1.035631547,,,
1174,대전,중구,2016,2067,1053,1014,4,2014,2248,1128,1120,0.938561377,0.95119071,0.92588574,,,
1175,대전,중구,2017,2166,1086,1080,4,2015,2224,1137,1087,0.994127708,0.973234933,1.016088823,,,
1176,대전,중구,2018,2057,1067,990,4,2016,2185,1122,1063,0.960951257,0.96899133,0.952443874,,,
1177,대전,중구,2019,2024,1038,986,4,2017,1886,984,902,1.095436806,1.074856739,1.117912572,,,
1178,대전,중구,2020,1788,920,868,4,2018,1817,913,904,1.004456414,1.026751577,0.981948605,,,
1179,부산,강서구,2010,437,235,202,4,2008,265,137,128,1.683271119,1.74781565,1.613908328,,,
1180,부산,강서구,2011,430,232,198,4,2009,437,228,209,1.004397279,1.036815465,0.968849606,,,
1181,부산,강서구,2012,467,243,224,4,2010,456,237,219,1.045371238,1.044735269,1.046023319,,,
1182,부산,강서구,2013,474,233,241,4,2011,583,295,288,0.829904837,0.804789374,0.855779774,,,
1183,부산,강서구,2014,692,356,336,4,2012,608,304,304,1.161772318,1.193231591,1.13032454,,,
1184,부산,강서구,2015,898,438,460,4,2013,752,397,355,1.218925058,1.124169847,1.325155799,,,
1185,부산,강서구,2016,1191,623,568,4,2014,1032,525,507,1.178014329,1.209141346,1.145718272,,,
1186,부산,강서구,2017,1561,789,772,4,2015,1372,707,665,1.161361168,1.137119005,1.187225231,,,
1187,부산,강서구,2018,1750,887,863,4,2016,1749,925,824,1.021331551,0.977080207,1.071077871,,,
1188,부산,강서구,2019,1958,1033,925,4,2017,1878,976,902,1.064230273,1.078447064,1.048751652,,,
1189,부산,강서구,2020,1956,1014,942,4,2018,2058,1086,972,0.970156927,0.951385347,0.991110554,,,
1190,부산,금정구,2010,1820,948,872,4,2008,1657,822,835,1.121159467,1.175127118,1.067990703,,,
1191,부산,금정구,2011,1724,870,854,4,2009,1449,768,681,1.21447166,1.154267217,1.282472973,,,
1192,부산,금정구,2012,1583,825,758,4,2010,1490,809,681,1.084459045,1.039091412,1.138307393,,,
1193,부산,금정구,2013,1625,866,759,4,2011,1725,868,857,0.961574139,1.01659155,0.905729299,,,
1194,부산,금정구,2014,1782,923,859,4,2012,1614,865,749,1.126996788,1.08726128,1.172867113,,,
1195,부산,금정구,2015,1612,854,758,4,2013,1534,796,738,1.07265037,1.09318366,1.050389342,,,
1196,부산,금정구,2016,1534,806,728,4,2014,1679,898,781,0.932595193,0.914549115,0.953274132,,,
1197,부산,금정구,2017,1656,874,782,4,2015,1669,860,809,1.01279723,1.035526721,0.988543294,,,
1198,부산,금정구,2018,1709,859,850,4,2016,1612,838,774,1.08217011,1.044473616,1.123092244,,,
1199,부산,금정구,2019,1702,890,812,4,2017,1529,782,747,1.136241322,1.159662416,1.111662332,,,
1200,부산,금정구,2020,1527,765,762,4,2018,1516,805,711,1.028154415,0.96830881,1.096030989,,,
1201,부산,기장군,2010,927,497,430,4,2008,697,365,332,1.357580105,1.387432466,1.324548407,,,
1202,부산,기장군,2011,970,501,469,4,2009,772,432,340,1.282545977,1.181686591,1.410689353,,,
1203,부산,기장군,2012,1036,556,480,4,2010,969,506,463,1.091325963,1.119625042,1.060224191,,,
1204,부산,기장군,2013,1207,628,579,4,2011,1189,611,578,1.036200803,1.047289531,1.024443917,,,
1205,부산,기장군,2014,1702,888,814,4,2012,1283,660,623,1.35410209,1.370936562,1.336207242,,,
1206,부산,기장군,2015,1720,880,840,4,2013,1605,817,788,1.093885635,1.097511158,1.090160724,,,
1207,부산,기장군,2016,1799,919,880,4,2014,1936,981,955,0.948515253,0.954541539,0.942359826,,,
1208,부산,기장군,2017,1987,990,997,4,2015,2201,1129,1072,0.921502109,0.893489764,0.951125523,,,
1209,부산,기장군,2018,2106,1074,1032,4,2016,2324,1203,1121,0.924997911,0.909676515,0.941480973,,,
1210,부산,기장군,2019,2166,1100,1066,4,2017,2142,1107,1035,1.032184884,1.012496179,1.053305417,,,
1211,부산,기장군,2020,2038,1061,977,4,2018,2233,1165,1068,0.931609622,0.927978228,0.935536581,,,
1212,부산,남구,2010,2289,1215,1074,4,2008,2374,1241,1133,0.984200513,0.997591695,0.969419685,,,
1213,부산,남구,2011,2110,1104,1006,4,2009,2213,1169,1044,0.973239104,0.962283171,0.985450797,,,
1214,부산,남구,2012,1950,1045,905,4,2010,2164,1099,1065,0.919805207,0.968873163,0.869033332,,,
1215,부산,남구,2013,1895,968,927,4,2011,2312,1209,1103,0.836642445,0.815825705,0.859491695,,,
1216,부산,남구,2014,2222,1183,1039,4,2012,2164,1084,1080,1.048106241,1.111997449,0.983850827,,,
1217,부산,남구,2015,2073,1041,1032,4,2013,2099,1066,1033,1.00810408,0.99504301,1.02168458,,,
1218,부산,남구,2016,1932,971,961,4,2014,2293,1172,1121,0.860045794,0.844189501,0.876708542,,,
1219,부산,남구,2017,2120,1069,1051,4,2015,2235,1122,1113,0.968226227,0.970807621,0.965706189,,,
1220,부산,남구,2018,2139,1093,1046,4,2016,2163,1105,1058,1.009422019,1.007873932,1.01107525,,,
1221,부산,남구,2019,2214,1116,1098,4,2017,1917,988,929,1.178891978,1.150947671,1.208715493,,,
1222,부산,남구,2020,2013,1034,979,4,2018,2078,1068,1010,0.988818859,0.986501193,0.991285562,,,
1223,부산,동구,2010,591,314,277,4,2008,612,339,273,0.985722268,0.943796317,1.037658827,,,
1224,부산,동구,2011,517,281,236,4,2009,505,260,245,1.045003329,1.101238283,0.985106946,,,
1225,부산,동구,2012,448,225,223,4,2010,504,246,258,0.907331496,0.93195671,0.88393966,,,
1226,부산,동구,2013,454,216,238,4,2011,602,301,301,0.769799936,0.731198992,0.808626415,,,
1227,부산,동구,2014,507,256,251,4,2012,517,268,249,1.001004259,0.973315187,1.030888838,,,
1228,부산,동구,2015,428,219,209,4,2013,509,260,249,0.858310639,0.858260441,0.85838951,,,
1229,부산,동구,2016,388,192,196,4,2014,484,244,240,0.818285533,0.80178833,0.835184244,,,
1230,부산,동구,2017,403,203,200,4,2015,523,267,256,0.786541906,0.774699196,0.798964519,,,
1231,부산,동구,2018,435,223,212,4,2016,508,261,247,0.874065651,0.870588015,0.877761182,,,
1232,부산,동구,2019,404,206,198,4,2017,424,223,201,0.972599445,0.941262347,1.007410784,,,
1233,부산,동구,2020,422,224,198,4,2018,432,220,212,0.997119508,1.037465506,0.95513947,,,
1234,부산,동래구,2010,2088,1101,987,4,2008,2008,1047,961,1.061415181,1.071492081,1.050343199,,,
1235,부산,동래구,2011,2018,1032,986,4,2009,1768,932,836,1.165084461,1.128267591,1.206168828,,,
1236,부산,동래구,2012,1738,904,834,4,2010,1907,953,954,0.930288362,0.966548961,0.894036272,,,
1237,부산,동래구,2013,1857,950,907,4,2011,2121,1133,988,0.893695856,0.854362197,0.93883183,,,
1238,부산,동래구,2014,2140,1139,1001,4,2012,1978,1030,948,1.104348117,1.126768839,1.079849429,,,
1239,부산,동래구,2015,2021,1054,967,4,2013,1787,896,891,1.154410505,1.198618371,1.109906086,,,
1240,부산,동래구,2016,1856,970,886,4,2014,2069,1065,1004,0.915663684,0.928048034,0.902479762,,,
1241,부산,동래구,2017,2214,1167,1047,4,2015,1964,995,969,1.150680205,1.195077593,1.104995139,,,
1242,부산,동래구,2018,2004,1032,972,4,2016,2208,1162,1046,0.9264397,0.904944402,0.950324757,,,
1243,부산,동래구,2019,2225,1167,1058,4,2017,1931,997,934,1.17615958,1.192680246,1.158447227,,,
1244,부산,동래구,2020,2036,1080,956,4,2018,1897,997,900,1.095541798,1.103765781,1.086307669,,,
1245,부산,부산진구,2010,3108,1602,1506,4,2008,2973,1554,1419,1.067098747,1.050412366,1.085375563,,,
1246,부산,부산진구,2011,2917,1540,1377,4,2009,2691,1354,1337,1.106474069,1.158911801,1.053270682,,,
1247,부산,부산진구,2012,2661,1350,1311,4,2010,2710,1374,1336,1.002291605,1.001141269,1.003537709,,,
1248,부산,부산진구,2013,2738,1404,1334,4,2011,3003,1511,1492,0.930671941,0.946784135,0.914375265,,,
1249,부산,부산진구,2014,2900,1454,1446,4,2012,2797,1431,1366,1.058337148,1.035316419,1.082567678,,,
1250,부산,부산진구,2015,2724,1421,1303,4,2013,2670,1345,1325,1.041392273,1.076515091,1.005694327,,,
1251,부산,부산진구,2016,2550,1288,1262,4,2014,2885,1503,1382,0.902220876,0.873182878,0.933875054,,,
1252,부산,부산진구,2017,2673,1395,1278,4,2015,2795,1357,1438,0.976192924,1.047472641,0.908886035,,,
1253,부산,부산진구,2018,2659,1292,1367,4,2016,2833,1438,1395,0.958054625,0.915486525,1.002147782,,,
1254,부산,부산진구,2019,2739,1386,1353,4,2017,2452,1233,1219,1.140223731,1.145377064,1.135093283,,,
1255,부산,부산진구,2020,2372,1180,1192,4,2018,2471,1279,1192,0.979851921,0.94006913,1.022674584,,,
1256,부산,북구,2010,2638,1369,1269,4,2008,2713,1387,1326,0.992529689,1.005715899,0.978713459,,,
1257,부산,북구,2011,2472,1262,1210,4,2009,2376,1254,1122,1.061990273,1.025439747,1.102884355,,,
1258,부산,북구,2012,2240,1200,1040,4,2010,2235,1186,1049,1.023031485,1.030967288,1.013900446,,,
1259,부산,북구,2013,2273,1219,1054,4,2011,2370,1228,1142,0.978970486,1.01147154,0.943869537,,,
1260,부산,북구,2014,2304,1184,1120,4,2012,2405,1249,1156,0.977880764,0.965912069,0.990826587,,,
1261,부산,북구,2015,2252,1165,1087,4,2013,2242,1135,1107,1.025300778,1.045871654,1.004198079,,,
1262,부산,북구,2016,2203,1096,1107,4,2014,2319,1211,1108,0.969688528,0.922177963,1.021751593,,,
1263,부산,북구,2017,2235,1186,1049,4,2015,2407,1236,1171,0.947807075,0.977720108,0.916127787,,,
1264,부산,북구,2018,2224,1141,1083,4,2016,2590,1358,1232,0.876503244,0.856119133,0.898990726,,,
1265,부산,북구,2019,2275,1195,1080,4,2017,2295,1174,1121,1.011852526,1.037165679,0.985270786,,,
1266,부산,북구,2020,2038,1029,1009,4,2018,2197,1110,1087,0.94687496,0.944584304,0.949290391,,,
1267,부산,사상구,2010,1826,956,870,4,2008,2054,1075,979,0.90744193,0.906145121,0.908811939,,,
1268,부산,사상구,2011,1732,886,846,4,2009,1706,871,835,1.036304466,1.036487086,1.036146944,,,
1269,부산,사상구,2012,1510,748,762,4,2010,1765,920,845,0.873274435,0.828441982,0.922222524,,,
1270,부산,사상구,2013,1526,784,742,4,2011,1935,1023,912,0.804992943,0.780888015,0.832044453,,,
1271,부산,사상구,2014,1660,877,783,4,2012,1868,942,926,0.907088634,0.948630359,0.864745356,,,
1272,부산,사상구,2015,1562,791,771,4,2013,1642,842,800,0.971015999,0.957222108,0.98560263,,,
1273,부산,사상구,2016,1394,726,668,4,2014,1791,953,838,0.79448499,0.776232905,0.815210766,,,
1274,부산,사상구,2017,1462,746,716,4,2015,1811,936,875,0.824038364,0.81210336,0.836840003,,,
1275,부산,사상구,2018,1434,748,686,4,2016,1856,928,928,0.788659771,0.821300241,0.755985738,,,
1276,부산,사상구,2019,1489,750,739,4,2017,1616,805,811,0.940528262,0.949322363,0.931882266,,,
1277,부산,사상구,2020,1280,628,652,4,2018,1528,783,745,0.855076802,0.817233593,0.895011851,,,
1278,부산,사하구,2010,2915,1522,1393,4,2008,3040,1547,1493,0.978776389,1.002472961,0.954176621,,,
1279,부산,사하구,2011,2765,1411,1354,4,2009,2645,1335,1310,1.067057858,1.07694637,1.057023959,,,
1280,부산,사하구,2012,2478,1230,1248,4,2010,2692,1372,1320,0.93960378,0.9134806,0.966892334,,,
1281,부산,사하구,2013,2520,1280,1240,4,2011,2985,1585,1400,0.861736948,0.822865836,0.905797489,,,
1282,부산,사하구,2014,2714,1420,1294,4,2012,2839,1433,1406,0.975804822,1.009695644,0.941209752,,,
1283,부산,사하구,2015,2545,1285,1260,4,2013,2695,1385,1310,0.963934504,0.945369709,0.983641203,,,
1284,부산,사하구,2016,2413,1253,1160,4,2014,2808,1421,1387,0.877159815,0.898473602,0.855301022,,,
1285,부산,사하구,2017,2498,1250,1248,4,2015,2843,1429,1414,0.896879471,0.891304528,0.902615192,,,
1286,부산,사하구,2018,2577,1310,1267,4,2016,2892,1483,1409,0.909566882,0.900074532,0.919608728,,,
1287,부산,사하구,2019,2572,1290,1282,4,2017,2457,1231,1226,1.068524087,1.067775584,1.069387289,,,
1288,부산,사하구,2020,2145,1094,1051,4,2018,2427,1253,1174,0.902144341,0.88964057,0.915528951,,,
1289,부산,서구,2010,761,415,346,4,2008,793,396,397,0.9795576,1.06782784,0.891298252,,,
1290,부산,서구,2011,711,342,369,4,2009,679,348,331,1.068853873,1.001371417,1.140081334,,,
1291,부산,서구,2012,589,303,286,4,2010,675,336,339,0.890697085,0.918864937,0.862787407,,,
1292,부산,서구,2013,626,316,310,4,2011,757,386,371,0.844105952,0.834157591,0.854525933,,,
1293,부산,서구,2014,688,354,334,4,2012,637,316,321,1.102471864,1.141470016,1.064091312,,,
1294,부산,서구,2015,599,283,316,4,2013,599,351,248,1.020747933,0.821537983,1.303085357,,,
1295,부산,서구,2016,572,304,268,4,2014,661,309,352,0.88330986,1.002451645,0.77862724,,,
1296,부산,서구,2017,644,317,327,4,2015,658,343,315,0.999029891,0.941701952,1.061633616,,,
1297,부산,서구,2018,615,323,292,4,2016,631,324,307,0.994865259,1.015794462,0.972706771,,,
1298,부산,서구,2019,655,336,319,4,2017,559,327,232,1.196046325,1.046983538,1.406177553,,,
1299,부산,서구,2020,561,322,239,4,2018,614,316,298,0.932637769,1.038286286,0.820198744,,,
1300,부산,수영구,2010,1273,657,616,4,2008,1237,655,582,1.05045442,1.022050602,1.08241846,,,
1301,부산,수영구,2011,1172,616,556,4,2009,1206,662,544,0.991970628,0.948136905,1.045233582,,,
1302,부산,수영구,2012,1058,565,493,4,2010,1058,551,507,1.020747933,1.044828902,0.994435049,,,
1303,부산,수영구,2013,1010,545,465,4,2011,1305,676,629,0.790004147,0.821482157,0.75603129,,,
1304,부산,수영구,2014,1098,550,548,4,2012,1217,609,608,0.92093774,0.92022436,0.92175275,,,
1305,부산,수영구,2015,1102,557,545,4,2013,1092,573,519,1.030095441,0.990487278,1.073906837,,,
1306,부산,수영구,2016,1017,532,485,4,2014,1127,588,539,0.921118587,0.921897495,0.92021739,,,
1307,부산,수영구,2017,992,528,464,4,2015,1205,618,587,0.84031697,0.870550113,0.808383317,,,
1308,부산,수영구,2018,1089,555,534,4,2016,1259,642,617,0.882918585,0.880858772,0.885102476,,,
1309,부산,수영구,2019,1042,535,507,4,2017,1132,587,545,0.939593062,0.928675545,0.951368833,,,
1310,부산,수영구,2020,970,518,452,4,2018,1106,568,538,0.895231008,0.929243972,0.859198721,,,
1311,부산,연제구,2010,1765,879,886,4,2008,1572,773,799,1.146068766,1.158664523,1.134029639,,,
1312,부산,연제구,2011,1596,820,776,4,2009,1531,826,705,1.064084716,1.01153784,1.125667344,,,
1313,부산,연제구,2012,1576,844,732,4,2010,1552,811,741,1.036532694,1.060400493,1.010253435,,,
1314,부산,연제구,2013,1552,818,734,4,2011,1763,939,824,0.898582411,0.887638314,0.91097469,,,
1315,부산,연제구,2014,1657,882,775,4,2012,1580,808,772,1.070493243,1.112258038,1.026648708,,,
1316,부산,연제구,2015,1570,806,764,4,2013,1440,766,674,1.112898788,1.072147657,1.159233505,,,
1317,부산,연제구,2016,1472,783,689,4,2014,1568,787,781,0.958253161,1.013760483,0.902205875,,,
1318,부산,연제구,2017,1650,824,826,4,2015,1667,868,799,1.010338386,0.967288034,1.057233049,,,
1319,부산,연제구,2018,1675,885,790,4,2016,1694,844,850,1.009299166,1.068437574,0.95048579,,,
1320,부산,연제구,2019,1654,829,825,4,2017,1512,734,778,1.116611826,1.150818406,1.084455697,,,
1321,부산,연제구,2020,1564,764,800,4,2018,1641,850,791,0.972851777,0.915846651,1.034310578,,,
1322,부산,영도구,2010,965,522,443,4,2008,944,454,490,1.043455249,1.171555801,0.924581308,,,
1323,부산,영도구,2011,832,416,416,4,2009,811,388,423,1.047179137,1.092471041,1.005750891,,,
1324,부산,영도구,2012,716,357,359,4,2010,857,447,410,0.852806907,0.813783765,0.895463843,,,
1325,부산,영도구,2013,746,377,369,4,2011,891,449,442,0.854632949,0.855545946,0.853771316,,,
1326,부산,영도구,2014,776,404,372,4,2012,851,436,415,0.930787774,0.944154798,0.916710712,,,
1327,부산,영도구,2015,731,371,360,4,2013,713,363,350,1.046517165,1.0413953,1.051893858,,,
1328,부산,영도구,2016,617,316,301,4,2014,814,402,412,0.773711885,0.800957289,0.747148179,,,
1329,부산,영도구,2017,708,359,349,4,2015,762,373,389,0.948411465,0.980694964,0.917515244,,,
1330,부산,영도구,2018,686,321,365,4,2016,722,385,337,0.969851914,0.849557213,1.107644579,,,
1331,부산,영도구,2019,645,348,297,4,2017,653,339,314,1.008242598,1.045990823,0.967306852,,,
1332,부산,영도구,2020,589,302,287,4,2018,624,323,301,0.963494443,0.952692506,0.975108324,,,
1333,부산,중구,2010,365,208,157,4,2008,279,125,154,1.33538708,1.695515056,1.042596816,,,
1334,부산,중구,2011,341,161,180,4,2009,233,121,112,1.493884313,1.355778786,1.643584153,,,
1335,부산,중구,2012,316,162,154,4,2010,248,125,123,1.30063043,1.32054538,1.280421837,,,
1336,부산,중구,2013,275,142,133,4,2011,251,116,135,1.118349328,1.247322291,1.00752385,,,
1337,부산,중구,2014,280,135,145,4,2012,226,111,115,1.264643456,1.239250544,1.289459258,,,
1338,부산,중구,2015,250,138,112,4,2013,212,113,99,1.203712185,1.244368393,1.156965186,,,
1339,부산,중구,2016,245,135,110,4,2014,251,126,125,0.996347584,1.091720718,0.899953634,,,
1340,부산,중구,2017,270,129,141,4,2015,233,136,97,1.182840952,0.966493929,1.48656821,,,
1341,부산,중구,2018,229,115,114,4,2016,209,107,102,1.118427161,1.095121717,1.142989241,,,
1342,부산,중구,2019,229,125,104,4,2017,193,95,98,1.211146511,1.340709653,1.085287314,,,
1343,부산,중구,2020,209,114,95,4,2018,180,98,82,1.185201766,1.185296779,1.184805921,,,
1344,부산,해운대구,2010,3965,2094,1871,4,2008,3789,1955,1834,1.06816193,1.091385663,1.043306514,,,
1345,부산,해운대구,2011,3703,1915,1788,4,2009,3477,1801,1676,1.08709508,1.083436329,1.091015606,,,
1346,부산,해운대구,2012,3386,1774,1612,4,2010,3502,1789,1713,0.98693675,1.010395966,0.962376783,,,
1347,부산,해운대구,2013,3499,1789,1710,4,2011,3800,1903,1897,0.939893952,0.957899355,0.921862698,,,
1348,부산,해운대구,2014,3694,1874,1820,4,2012,3560,1817,1743,1.059169343,1.050903861,1.067852979,,,
1349,부산,해운대구,2015,3424,1774,1650,4,2013,3316,1710,1606,1.05399304,1.057075078,1.050693066,,,
1350,부산,해운대구,2016,3149,1615,1534,4,2014,3561,1848,1713,0.902649604,0.890469171,0.915810165,,,
1351,부산,해운대구,2017,3285,1711,1574,4,2015,3618,1859,1759,0.926798496,0.93781883,0.915116427,,,
1352,부산,해운대구,2018,3294,1710,1584,4,2016,3613,1917,1696,0.930623772,0.908913023,0.95513947,,,
1353,부산,해운대구,2019,3398,1793,1605,4,2017,3223,1714,1509,1.076171727,1.065903285,1.087735393,,,
1354,부산,해운대구,2020,3075,1598,1477,4,2018,3102,1639,1463,1.011863279,0.993450311,1.032460944,,,
1355,서울,강남구,2010,3545,1848,1697,4,2008,3854,2003,1851,0.938907997,0.940089812,0.937589827,,,
1356,서울,강남구,2011,3548,1876,1672,4,2009,3474,1794,1680,1.04249098,1.065512929,1.017804705,,,
1357,서울,강남구,2012,3132,1645,1487,4,2010,3805,1915,1890,0.840205657,0.875276871,0.804612226,,,
1358,서울,강남구,2013,3320,1698,1622,4,2011,4263,2176,2087,0.794952647,0.795109831,0.79481465,,,
1359,서울,강남구,2014,3846,2003,1843,4,2012,4187,2169,2018,0.937615607,0.940956888,0.933988731,,,
1360,서울,강남구,2015,3970,2089,1881,4,2013,3955,2005,1950,1.02461929,1.061628067,0.986487637,,,
1361,서울,강남구,2016,3703,1896,1807,4,2014,4339,2249,2090,0.871129199,0.859007995,0.884197595,,,
1362,서울,강남구,2017,3957,2060,1897,4,2015,4493,2291,2202,0.898976089,0.916200364,0.881023472,,,
1363,서울,강남구,2018,3938,2056,1882,4,2016,4496,2304,2192,0.89406258,0.909261838,0.878044511,,,
1364,서울,강남구,2019,4096,2116,1980,4,2017,4069,2094,1975,1.027521143,1.029644525,1.025263634,,,
1365,서울,강남구,2020,3913,2064,1849,4,2018,3797,1981,1816,1.051932225,1.061630889,1.041258428,,,
1366,서울,강동구,2010,3930,2025,1905,4,2008,3826,1988,1838,1.048494348,1.037903499,1.059953799,,,
1367,서울,강동구,2011,3823,1997,1826,4,2009,3668,1886,1782,1.063882046,1.078908725,1.047925808,,,
1368,서울,강동구,2012,3433,1774,1659,4,2010,3902,2030,1872,0.898059368,0.890442553,0.906312572,,,
1369,서울,강동구,2013,3587,1873,1714,4,2011,4426,2352,2074,0.827253239,0.811425756,0.845161156,,,
1370,서울,강동구,2014,3845,2032,1813,4,2012,4248,2215,2033,0.923911441,0.934756086,0.912006405,,,
1371,서울,강동구,2015,3665,1924,1741,4,2013,3835,1978,1857,0.975499654,0.991121983,0.958791842,,,
1372,서울,강동구,2016,3229,1646,1583,4,2014,4024,2085,1939,0.819084263,0.804400071,0.834911741,,,
1373,서울,강동구,2017,3470,1806,1664,4,2015,3677,1925,1752,0.963284016,0.955950359,0.971307368,,,
1374,서울,강동구,2018,3210,1697,1513,4,2016,3682,1878,1804,0.88989703,0.920734853,0.857708784,,,
1375,서울,강동구,2019,3292,1711,1581,4,2017,3270,1687,1583,1.02761535,1.033435213,1.021382513,,,
1376,서울,강동구,2020,3404,1798,1606,4,2018,3291,1696,1595,1.055796403,1.080219886,1.029727512,,,
1377,서울,강북구,2010,2358,1207,1151,4,2008,2737,1333,1404,0.879402128,0.922625491,0.838389207,,,
1378,서울,강북구,2011,2155,1050,1105,4,2009,2426,1237,1189,0.906723741,0.864904045,0.950425076,,,
1379,서울,강북구,2012,1945,990,955,4,2010,2498,1300,1198,0.794777714,0.775961495,0.815237252,,,
1380,서울,강북구,2013,1972,1012,960,4,2011,2689,1399,1290,0.748573791,0.737074059,0.761060156,,,
1381,서울,강북구,2014,2041,1062,979,4,2012,2521,1257,1264,0.826396878,0.860869988,0.792087356,,,
1382,서울,강북구,2015,1855,928,927,4,2013,2503,1292,1211,0.756487181,0.73186974,0.782840082,,,
1383,서울,강북구,2016,1778,898,880,4,2014,2466,1259,1207,0.735965054,0.726773252,0.745611959,,,
1384,서울,강북구,2017,1791,911,880,4,2015,2354,1197,1157,0.776618329,0.775483488,0.777833737,,,
1385,서울,강북구,2018,1753,897,856,4,2016,2387,1260,1127,0.749631808,0.725387766,0.77676082,,,
1386,서울,강북구,2019,1706,892,814,4,2017,2065,1082,983,0.843291028,0.840012836,0.846853623,,,
1387,서울,강북구,2020,1528,810,718,4,2018,1885,967,918,0.827428563,0.85350658,0.799869664,,,
1388,서울,강서구,2010,5328,2743,2585,4,2008,5525,2875,2650,0.984352033,0.97215673,0.997590113,,,
1389,서울,강서구,2011,4919,2540,2379,4,2009,4927,2524,2403,1.019090538,1.02539854,1.012460606,,,
1390,서울,강서구,2012,4386,2224,2162,4,2010,4966,2597,2369,0.901530494,0.872591869,0.933314669,,,
1391,서울,강서구,2013,4427,2324,2103,4,2011,5236,2682,2554,0.863034969,0.882928791,0.842084828,,,
1392,서울,강서구,2014,4807,2442,2365,4,2012,4818,2447,2371,1.018417458,1.016857319,1.020086626,,,
1393,서울,강서구,2015,4757,2433,2324,4,2013,4555,2321,2234,1.06601491,1.068108318,1.063874545,,,
1394,서울,강서구,2016,4413,2289,2124,4,2014,4923,2599,2324,0.915003174,0.897403671,0.934664723,,,
1395,서울,강서구,2017,4529,2353,2176,4,2015,5266,2663,2603,0.877889743,0.900324543,0.854913521,,,
1396,서울,강서구,2018,4816,2460,2356,4,2016,5556,2851,2705,0.884795184,0.879197042,0.890728769,,,
1397,서울,강서구,2019,4946,2556,2390,4,2017,4983,2509,2474,1.013168628,1.038026681,0.987951599,,,
1398,서울,강서구,2020,4277,2180,2097,4,2018,4823,2400,2423,0.905191563,0.925536564,0.885079902,,,
1399,서울,관악구,2010,3663,1895,1768,4,2008,4317,2244,2073,0.86611065,0.860467933,0.872208714,,,
1400,서울,관악구,2011,3379,1767,1612,4,2009,3959,2007,1952,0.871206685,0.897093078,0.84454479,,,
1401,서울,관악구,2012,3148,1594,1554,4,2010,3882,2015,1867,0.827747164,0.806049281,0.851224587,,,
1402,서울,관악구,2013,3029,1606,1423,4,2011,4009,2024,1985,0.771226113,0.808506213,0.733131452,,,
1403,서울,관악구,2014,3225,1623,1602,4,2012,3781,1925,1856,0.870645883,0.859084957,0.882718041,,,
1404,서울,관악구,2015,3014,1560,1454,4,2013,3373,1742,1631,0.912106217,0.912482988,0.911691505,,,
1405,서울,관악구,2016,2732,1422,1310,4,2014,3445,1760,1685,0.809487185,0.823256668,0.795076383,,,
1406,서울,관악구,2017,2769,1411,1358,4,2015,3445,1760,1685,0.820450225,0.816888297,0.824208953,,,
1407,서울,관악구,2018,2687,1393,1294,4,2016,3343,1717,1626,0.820445616,0.826664237,0.813862799,,,
1408,서울,관악구,2019,2581,1318,1263,4,2017,2875,1465,1410,0.916365361,0.916697642,0.916055319,,,
1409,서울,관악구,2020,2302,1169,1133,4,2018,2838,1433,1405,0.827963968,0.831221273,0.824690608,,,
1410,서울,광진구,2010,2935,1539,1396,4,2008,3063,1582,1481,0.9780918,0.991243767,0.963979554,,,
1411,서울,광진구,2011,2839,1442,1397,4,2009,2652,1319,1333,1.092723748,1.11395794,1.071775239,,,
1412,서울,광진구,2012,2528,1266,1262,4,2010,2791,1392,1399,0.924561366,0.926707758,0.922527037,,,
1413,서울,광진구,2013,2689,1341,1348,4,2011,2885,1468,1417,0.951400759,0.93078859,0.972876033,,,
1414,서울,광진구,2014,2817,1416,1401,4,2012,2707,1438,1269,1.062226423,1.003350557,1.129052082,,,
1415,서울,광진구,2015,2601,1364,1237,4,2013,2526,1298,1228,1.051055175,1.070749811,1.030169756,,,
1416,서울,광진구,2016,2407,1246,1161,4,2014,2661,1381,1280,0.923314646,0.919332667,0.927597806,,,
1417,서울,광진구,2017,2550,1366,1184,4,2015,2525,1231,1294,1.030854348,1.130683293,0.935739341,,,
1418,서울,광진구,2018,2480,1248,1232,4,2016,2623,1373,1250,0.965099075,0.926173556,1.00794807,,,
1419,서울,광진구,2019,2599,1350,1249,4,2017,2356,1211,1145,1.12602881,1.135894388,1.115563804,,,
1420,서울,광진구,2020,2244,1124,1120,4,2018,2331,1226,1105,0.982650519,0.934166243,1.036557045,,,
1421,서울,구로구,2010,3539,1820,1719,4,2008,3997,2081,1916,0.903784572,0.891143485,0.917524849,,,
1422,서울,구로구,2011,3447,1795,1652,4,2009,3729,2016,1713,0.94355541,0.907240133,0.9862571,,,
1423,서울,구로구,2012,3288,1778,1510,4,2010,3862,1992,1870,0.869036562,0.90947497,0.825796055,,,
1424,서울,구로구,2013,3371,1726,1645,4,2011,4211,2108,2103,0.817131627,0.834292834,0.799952302,,,
1425,서울,구로구,2014,3665,1867,1798,4,2012,4098,2122,1976,0.912894381,0.896493752,0.930551064,,,
1426,서울,구로구,2015,3516,1788,1728,4,2013,3902,1999,1903,0.919771843,0.91138746,0.928629365,,,
1427,서울,구로구,2016,3329,1689,1640,4,2014,4095,2068,2027,0.829809491,0.832199487,0.827422949,,,
1428,서울,구로구,2017,3464,1761,1703,4,2015,3948,2041,1907,0.895610648,0.87915344,0.913274681,,,
1429,서울,구로구,2018,3320,1684,1636,4,2016,3926,1960,1966,0.863189795,0.875456042,0.851015066,,,
1430,서울,구로구,2019,3305,1615,1690,4,2017,3544,1789,1755,0.951910812,0.919836237,0.984797748,,,
1431,서울,구로구,2020,3014,1551,1463,4,2018,3167,1604,1563,0.971434881,0.985271141,0.957244348,,,
1432,서울,금천구,2010,1994,1025,969,4,2008,2110,1077,1033,0.964630985,0.969742637,0.9593143,,,
1433,서울,금천구,2011,1799,926,873,4,2009,1850,939,911,0.992608395,1.004832615,0.980016369,,,
1434,서울,금천구,2012,1645,842,803,4,2010,1883,967,916,0.891731465,0.887225358,0.896514947,,,
1435,서울,금천구,2013,1661,850,811,4,2011,1867,923,944,0.908121219,0.938351502,0.878590135,,,
1436,서울,금천구,2014,1715,860,855,4,2012,1712,872,840,1.022536626,1.004917235,1.04093663,,,
1437,서울,금천구,2015,1550,797,753,4,2013,1660,841,819,0.953108009,0.965629787,0.940261248,,,
1438,서울,금천구,2016,1510,776,734,4,2014,1682,887,795,0.91636705,0.891428326,0.944205214,,,
1439,서울,금천구,2017,1610,828,782,4,2015,1625,838,787,1.011325644,1.006780156,1.016177287,,,
1440,서울,금천구,2018,1561,786,775,4,2016,1814,932,882,0.878383419,0.859320084,0.89860862,,,
1441,서울,금천구,2019,1656,844,812,4,2017,1430,728,702,1.182068934,1.181297802,1.182922738,,,
1442,서울,금천구,2020,1336,676,660,4,2018,1503,769,734,0.907331496,0.895712603,0.919571152,,,
1443,서울,노원구,2010,5881,3089,2792,4,2008,5791,2949,2842,1.036611741,1.067312177,1.00468242,,,
1444,서울,노원구,2011,5545,2878,2667,4,2009,5049,2597,2452,1.121023428,1.129190377,1.112346295,,,
1445,서울,노원구,2012,4907,2527,2380,4,2010,4938,2568,2370,1.014339835,1.002671224,1.026989667,,,
1446,서울,노원구,2013,4883,2532,2351,4,2011,5271,2709,2562,0.94561035,0.952364119,0.938449628,,,
1447,서울,노원구,2014,5183,2664,2519,4,2012,4979,2532,2447,1.062570101,1.072059397,1.05276554,,,
1448,서울,노원구,2015,4895,2507,2388,4,2013,4420,2278,2142,1.130443695,1.121370025,1.140124606,,,
1449,서울,노원구,2016,4329,2220,2109,4,2014,4604,2361,2243,0.959777976,0.958087813,0.961578555,,,
1450,서울,노원구,2017,4470,2271,2199,4,2015,4342,2216,2126,1.050839074,1.044228896,1.057789939,,,
1451,서울,노원구,2018,4236,2146,2090,4,2016,4533,2318,2215,0.953869014,0.943332103,0.964961571,,,
1452,서울,노원구,2019,4318,2217,2101,4,2017,3863,1983,1880,1.140975815,1.139177261,1.142893245,,,
1453,서울,노원구,2020,3821,1979,1842,4,2018,3812,1945,1867,1.023157883,1.036751129,1.008980495,,,
1454,서울,도봉구,2010,3432,1741,1691,4,2008,3248,1664,1584,1.078573554,1.066089774,1.091756769,,,
1455,서울,도봉구,2011,3209,1631,1578,4,2009,2751,1408,1343,1.190687065,1.180319643,1.201623599,,,
1456,서울,도봉구,2012,2781,1452,1329,4,2010,2712,1421,1291,1.046718289,1.041168133,1.052776547,,,
1457,서울,도봉구,2013,2891,1517,1374,4,2011,3014,1523,1491,0.979091663,1.01492513,0.942424466,,,
1458,서울,도봉구,2014,3151,1619,1532,4,2012,2731,1426,1305,1.177728574,1.156846273,1.200565106,,,
1459,서울,도봉구,2015,2813,1464,1349,4,2013,2572,1311,1261,1.116393443,1.137854453,1.094042834,,,
1460,서울,도봉구,2016,2684,1360,1324,4,2014,2710,1415,1295,1.010954779,0.97933392,1.045576177,,,
1461,서울,도봉구,2017,2737,1411,1326,4,2015,2617,1354,1263,1.06755334,1.061834124,1.073686856,,,
1462,서울,도봉구,2018,2572,1313,1259,4,2016,2650,1385,1265,0.990703276,0.965969205,1.017823954,,,
1463,서울,도봉구,2019,2601,1348,1253,4,2017,2276,1183,1093,1.166504997,1.161056826,1.172379921,,,
1464,서울,도봉구,2020,2214,1137,1077,4,2018,2345,1210,1135,0.96372534,0.957466137,0.970414561,,,
1465,서울,동대문구,2010,2808,1450,1358,4,2008,2975,1532,1443,0.963448805,0.964400808,0.962433877,,,
1466,서울,동대문구,2011,2664,1371,1293,4,2009,2683,1394,1289,1.013519378,1.002127568,1.025848128,,,
1467,서울,동대문구,2012,2384,1249,1135,4,2010,2712,1358,1354,0.897294643,0.937154073,0.857264145,,,
1468,서울,동대문구,2013,2501,1260,1241,4,2011,2973,1550,1423,0.858691752,0.828299073,0.891875727,,,
1469,서울,동대문구,2014,2693,1430,1263,4,2012,2771,1409,1362,0.992015223,1.034125799,0.948339207,,,
1470,서울,동대문구,2015,2596,1329,1267,4,2013,2614,1335,1279,1.013719064,1.014359834,1.013079514,,,
1471,서울,동대문구,2016,2348,1218,1130,4,2014,2767,1411,1356,0.866178585,0.879566344,0.85222882,,,
1472,서울,동대문구,2017,2396,1217,1179,4,2015,2658,1352,1306,0.920132448,0.917196133,0.923226137,,,
1473,서울,동대문구,2018,2284,1168,1116,4,2016,2728,1369,1359,0.854614471,0.869336118,0.839812241,,,
1474,서울,동대문구,2019,2386,1227,1159,4,2017,2363,1259,1104,1.03068327,0.993040958,1.073623046,,,
1475,서울,동대문구,2020,2136,1117,1019,4,2018,2390,1224,1166,0.912266772,0.929865391,0.893743912,,,
1476,서울,동작구,2010,3219,1675,1544,4,2008,3512,1816,1696,0.935588723,0.939825654,0.931019786,,,
1477,서울,동작구,2011,3075,1588,1487,4,2009,3191,1603,1588,0.983641458,1.009404658,0.95763042,,,
1478,서울,동작구,2012,2821,1432,1389,4,2010,3147,1603,1544,0.915007918,0.910243999,0.920009713,,,
1479,서울,동작구,2013,3028,1552,1476,4,2011,3417,1817,1600,0.904543383,0.870332334,0.943417304,,,
1480,서울,동작구,2014,3176,1718,1458,4,2012,3297,1684,1613,0.983286452,1.039511746,0.924401453,,,
1481,서울,동작구,2015,2904,1475,1429,4,2013,3114,1552,1562,0.951911367,0.968386289,0.935596659,,,
1482,서울,동작구,2016,2807,1412,1395,4,2014,3305,1739,1566,0.866940831,0.827338898,0.911003221,,,
1483,서울,동작구,2017,2950,1561,1389,4,2015,3173,1646,1527,0.949009266,0.966320962,0.930252127,,,
1484,서울,동작구,2018,2801,1419,1382,4,2016,3270,1697,1573,0.874347082,0.852018219,0.898497314,,,
1485,서울,동작구,2019,2805,1427,1378,4,2017,2906,1456,1450,0.985271146,0.998644528,0.971893501,,,
1486,서울,동작구,2020,2545,1287,1258,4,2018,2897,1511,1386,0.89672195,0.867885457,0.928228446,,,
1487,서울,마포구,2010,3122,1603,1519,4,2008,3560,1824,1736,0.89516153,0.895482322,0.894840261,,,
1488,서울,마포구,2011,3052,1548,1504,4,2009,3089,1610,1479,1.008521428,0.979700679,1.039961173,,,
1489,서울,마포구,2012,2774,1427,1347,4,2010,3306,1662,1644,0.856489645,0.874865483,0.837921329,,,
1490,서울,마포구,2013,2813,1439,1374,4,2011,3642,1873,1769,0.788403057,0.782837002,0.794321582,,,
1491,서울,마포구,2014,3100,1583,1517,4,2012,3328,1753,1575,0.950816884,0.920126052,0.985014187,,,
1492,서울,마포구,2015,2917,1505,1412,4,2013,3029,1588,1441,0.983004859,0.965682431,1.002093347,,,
1493,서울,마포구,2016,2638,1363,1275,4,2014,3161,1612,1549,0.851861134,0.861547342,0.8417754,,,
1494,서울,마포구,2017,2676,1366,1310,4,2015,3056,1537,1519,0.89382247,0.905576534,0.881964256,,,
1495,서울,마포구,2018,2458,1223,1235,4,2016,3129,1594,1535,0.801853122,0.781783443,0.82280333,,,
1496,서울,마포구,2019,2572,1312,1260,4,2017,2731,1360,1371,0.961319547,0.982976772,0.939875985,,,
1497,서울,마포구,2020,2211,1092,1119,4,2018,2821,1405,1416,0.800026118,0.79194431,0.808172923,,,
1498,서울,서대문구,2010,2666,1342,1324,4,2008,2863,1426,1437,0.950511348,0.958917664,0.942255497,,,
1499,서울,서대문구,2011,2435,1235,1200,4,2009,2405,1206,1199,1.033480755,1.043441194,1.023527524,,,
1500,서울,서대문구,2012,2166,1096,1070,4,2010,2476,1249,1227,0.892948313,0.894121307,0.891818912,,,
1501,서울,서대문구,2013,2272,1152,1120,4,2011,2344,1178,1166,0.9893939,0.996450013,0.982328932,,,
1502,서울,서대문구,2014,2204,1102,1102,4,2012,2245,1186,1059,1.002106211,0.946771626,1.064199614,,,
1503,서울,서대문구,2015,2109,1080,1029,4,2013,2232,1148,1084,0.964497038,0.958584045,0.970786114,,,
1504,서울,서대문구,2016,2213,1110,1103,4,2014,2214,1184,1030,1.02028689,0.955255628,1.095155404,,,
1505,서울,서대문구,2017,2288,1220,1068,4,2015,2218,1100,1118,1.0529627,1.130096355,0.976937796,,,
1506,서울,서대문구,2018,2140,1054,1086,4,2016,2361,1229,1132,0.92520143,0.873850334,0.981117136,,,
1507,서울,서대문구,2019,2243,1144,1099,4,2017,2178,1117,1061,1.051211025,1.043569025,1.059301949,,,
1508,서울,서대문구,2020,2179,1104,1075,4,2018,2246,1116,1130,0.990298195,1.007982999,0.972898388,,,
1509,서울,서초구,2010,3468,1819,1649,4,2008,3316,1684,1632,1.067537343,1.100623903,1.033327444,,,
1510,서울,서초구,2011,3431,1763,1668,4,2009,3290,1706,1584,1.064494272,1.052983617,1.076907327,,,
1511,서울,서초구,2012,3225,1683,1542,4,2010,3534,1799,1735,0.931497477,0.953237856,0.908913089,,,
1512,서울,서초구,2013,3547,1804,1743,4,2011,3740,1932,1808,0.968072972,0.951431968,0.985908075,,,
1513,서울,서초구,2014,3840,1982,1858,4,2012,3896,1968,1928,1.006075991,1.026187889,0.985544283,,,
1514,서울,서초구,2015,3926,1998,1928,4,2013,3771,1914,1857,1.062703894,1.063657677,1.061775228,,,
1515,서울,서초구,2016,3662,1865,1797,4,2014,4396,2198,2198,0.850313678,0.864568636,0.836099285,,,
1516,서울,서초구,2017,4031,2064,1967,4,2015,4261,2235,2026,0.965650062,0.940980219,0.992892846,,,
1517,서울,서초구,2018,3861,2018,1843,4,2016,4384,2280,2104,0.898975312,0.901850693,0.895812385,,,
1518,서울,서초구,2019,3854,1984,1870,4,2017,3921,2018,1903,1.003305925,1.001771875,1.004940343,,,
1519,서울,서초구,2020,3479,1831,1648,4,2018,3724,1931,1793,0.953593463,0.966171893,0.939970839,,,
1520,서울,성동구,2010,2581,1270,1311,4,2008,2922,1541,1381,0.901625741,0.839748837,0.97083735,,,
1521,서울,성동구,2011,2472,1282,1190,4,2009,2581,1309,1272,0.977640019,0.997922253,0.956747449,,,
1522,서울,성동구,2012,2192,1127,1065,4,2010,2542,1329,1213,0.880204354,0.864066691,0.897896482,,,
1523,서울,성동구,2013,2223,1155,1068,4,2011,2751,1396,1355,0.82483557,0.84303362,0.806063805,,,
1524,서울,성동구,2014,2396,1186,1210,4,2012,2493,1305,1188,0.981031707,0.926024562,1.041613002,,,
1525,서울,성동구,2015,2147,1107,1040,4,2013,2205,1106,1099,0.993898327,1.01986062,0.967772127,,,
1526,서울,성동구,2016,1995,1006,989,4,2014,2348,1196,1152,0.867287958,0.857067703,0.877973232,,,
1527,서울,성동구,2017,2111,1092,1019,4,2015,2394,1235,1159,0.900083077,0.900956887,0.899141847,,,
1528,서울,성동구,2018,2100,1069,1031,4,2016,2447,1259,1188,0.875999452,0.865167713,0.887523145,,,
1529,서울,성동구,2019,2102,1042,1060,4,2017,2438,1253,1185,0.880070613,0.847354181,0.914797518,,,
1530,서울,성동구,2020,1891,987,904,4,2018,2425,1210,1215,0.795972924,0.831151343,0.760903559,,,
1531,서울,성북구,2010,4427,2315,2112,4,2008,4475,2371,2104,1.009799128,0.994873287,1.026563081,,,
1532,서울,성북구,2011,4336,2285,2051,4,2009,4124,2127,1997,1.073220911,1.094629235,1.050328278,,,
1533,서울,성북구,2012,3986,2079,1907,4,2010,4275,2188,2087,0.951742985,0.968178647,0.934470739,,,
1534,서울,성북구,2013,4035,2069,1966,4,2011,4605,2327,2278,0.894401283,0.905967119,0.882606775,,,
1535,서울,성북구,2014,4256,2171,2085,4,2012,4171,2166,2005,1.041549557,1.021291459,1.063479555,,,
1536,서울,성북구,2015,3876,2005,1871,4,2013,3912,2007,1905,1.011354547,1.017923951,1.004422124,,,
1537,서울,성북구,2016,3592,1841,1751,4,2014,3923,1994,1929,0.934623139,0.940755927,0.928306478,,,
1538,서울,성북구,2017,3718,1878,1840,4,2015,3778,1940,1838,1.004537007,0.986375296,1.023787396,,,
1539,서울,성북구,2018,3604,1859,1745,4,2016,3733,1919,1814,0.985474297,0.987080889,0.983774614,,,
1540,서울,성북구,2019,3539,1827,1712,4,2017,3300,1651,1649,1.094674828,1.127560368,1.061745839,,,
1541,서울,성북구,2020,3137,1558,1579,4,2018,3183,1638,1545,1.005996313,0.969174289,1.045180044,,,
1542,서울,송파구,2010,5705,2999,2706,4,2008,5867,2998,2869,0.992562972,1.019279209,0.964572124,,,
1543,서울,송파구,2011,5636,2906,2730,4,2009,5467,2825,2642,1.052302057,1.048154942,1.056737931,,,
1544,서울,송파구,2012,5046,2619,2427,4,2010,5586,2899,2687,0.922071978,0.920525051,0.923718353,,,
1545,서울,송파구,2013,5184,2699,2485,4,2011,6039,3138,2901,0.876230714,0.876391736,0.876024247,,,
1546,서울,송파구,2014,5697,2942,2755,4,2012,5611,2912,2699,1.036392973,1.029436651,1.043893471,,,
1547,서울,송파구,2015,5204,2715,2489,4,2013,5477,2792,2685,0.96986895,0.990838216,0.948021244,,,
1548,서울,송파구,2016,5075,2599,2476,4,2014,5856,3041,2815,0.884613347,0.870839637,0.89951768,,,
1549,서울,송파구,2017,5300,2705,2595,4,2015,5730,3004,2726,0.944147302,0.917520275,0.97352918,,,
1550,서울,송파구,2018,5216,2717,2499,4,2016,5807,2953,2854,0.916862617,0.937507002,0.895467339,,,
1551,서울,송파구,2019,5620,2853,2767,4,2017,5346,2737,2609,1.073064605,1.062124197,1.084607349,,,
1552,서울,송파구,2020,4926,2515,2411,4,2018,5422,2795,2627,0.92737077,0.916863124,0.938587142,,,
1553,서울,양천구,2010,4252,2217,2035,4,2008,4290,2258,2032,1.011706342,1.000437781,1.024184438,,,
1554,서울,양천구,2011,4106,2175,1931,4,2009,3822,1954,1868,1.096596288,1.134182731,1.057165215,,,
1555,서울,양천구,2012,3749,1976,1773,4,2010,3786,1886,1900,1.010772319,1.067563165,0.954316862,,,
1556,서울,양천구,2013,3764,1877,1887,4,2011,4271,2183,2088,0.899577433,0.87611046,0.924227462,,,
1557,서울,양천구,2014,4100,2111,1989,4,2012,4051,2105,1946,1.033094674,1.021843677,1.045272224,,,
1558,서울,양천구,2015,4071,2096,1975,4,2013,3656,1845,1811,1.136615108,1.157559268,1.115285645,,,
1559,서울,양천구,2016,3616,1854,1762,4,2014,3761,1931,1830,0.981394449,0.978308405,0.984673561,,,
1560,서울,양천구,2017,3815,1936,1879,4,2015,3757,1992,1765,1.036506085,0.990294455,1.088728353,,,
1561,서울,양천구,2018,3736,1965,1771,4,2016,3807,1948,1859,1.001711131,1.027831517,0.974263953,,,
1562,서울,양천구,2019,3731,1899,1832,4,2017,3466,1771,1695,1.098791268,1.092583738,1.105333238,,,
1563,서울,양천구,2020,3575,1850,1725,4,2018,3431,1742,1689,1.063589,1.082111236,1.044472266,,,
1564,서울,영등포구,2010,3117,1631,1486,4,2008,3884,2030,1854,0.819173869,0.818665053,0.81968416,,,
1565,서울,영등포구,2011,2983,1555,1428,4,2009,3388,1800,1588,0.898728183,0.880250371,0.919634324,,,
1566,서울,영등포구,2012,2571,1329,1242,4,2010,3442,1805,1637,0.762447105,0.750232896,0.775908267,,,
1567,서울,영등포구,2013,2660,1397,1263,4,2011,3707,1904,1803,0.732449285,0.747614629,0.716382695,,,
1568,서울,영등포구,2014,2848,1498,1350,4,2012,3314,1664,1650,0.87721488,0.91729034,0.836733751,,,
1569,서울,영등포구,2015,2589,1324,1265,4,2013,3087,1604,1483,0.85607917,0.841069627,0.87234211,,,
1570,서울,영등포구,2016,2377,1211,1166,4,2014,3095,1558,1537,0.783947604,0.791999702,0.775822098,,,
1571,서울,영등포구,2017,2377,1189,1188,4,2015,2994,1469,1525,0.810393399,0.824723534,0.796680266,,,
1572,서울,영등포구,2018,2457,1187,1270,4,2016,3058,1525,1533,0.820136583,0.79310229,0.84722552,,,
1573,서울,영등포구,2019,2564,1285,1279,4,2017,2702,1425,1277,0.968614989,0.918833016,1.024276267,,,
1574,서울,영등포구,2020,2265,1168,1097,4,2018,2749,1419,1330,0.841030945,0.838704119,0.8435143,,,
1575,서울,용산구,2010,1559,795,764,4,2008,1970,1025,945,0.807789861,0.79029929,0.82679723,,,
1576,서울,용산구,2011,1522,786,736,4,2009,1827,960,867,0.850343926,0.834256582,0.868152819,,,
1577,서울,용산구,2012,1428,726,702,4,2010,1828,938,890,0.797389523,0.788646011,0.806648942,,,
1578,서울,용산구,2013,1386,727,659,4,2011,2077,1035,1042,0.681153892,0.715718742,0.64677788,,,
1579,서울,용산구,2014,1593,777,816,4,2012,1885,951,934,0.862626767,0.832508795,0.893471585,,,
1580,서울,용산구,2015,1414,700,714,4,2013,1711,846,865,0.84356375,0.843094014,0.844149888,,,
1581,서울,용산구,2016,1286,658,628,4,2014,1700,845,855,0.772165789,0.793446252,0.751157472,,,
1582,서울,용산구,2017,1253,632,621,4,2015,1760,911,849,0.726702932,0.706882174,0.74803406,,,
1583,서울,용산구,2018,1248,660,588,4,2016,1756,880,876,0.725451834,0.764204502,0.686452803,,,
1584,서울,용산구,2019,1245,642,603,4,2017,1564,810,754,0.812551903,0.80760377,0.817868401,,,
1585,서울,용산구,2020,1090,553,537,4,2018,1492,780,712,0.745720675,0.722401863,0.77131496,,,
1586,서울,은평구,2010,4307,2236,2071,4,2008,3950,2053,1897,1.113002872,1.109765395,1.116478157,,,
1587,서울,은평구,2011,4155,2143,2012,4,2009,3590,1837,1753,1.181394891,1.188670113,1.173771399,,,
1588,서울,은평구,2012,3852,1988,1864,4,2010,4075,2089,1986,0.964888598,0.969675156,0.959851674,,,
1589,서울,은평구,2013,4137,2127,2010,4,2011,4477,2298,2179,0.943228545,0.94311748,0.943357464,,,
1590,서울,은평구,2014,4359,2270,2089,4,2012,4241,2218,2023,1.049148842,1.042827905,1.056039153,,,
1591,서울,은평구,2015,3960,2062,1898,4,2013,4060,2087,1973,0.995606358,1.006733547,0.983799473,,,
1592,서울,은평구,2016,3737,1924,1813,4,2014,4160,2137,2023,0.916955535,0.917379169,0.916514593,,,
1593,서울,은평구,2017,3803,1941,1862,4,2015,3970,2022,1948,0.977809669,0.978121292,0.977525706,,,
1594,서울,은평구,2018,3569,1837,1732,4,2016,4050,2120,1930,0.899518363,0.882920548,0.91775771,,,
1595,서울,은평구,2019,3686,1930,1756,4,2017,3464,1830,1634,1.086165381,1.074619082,1.099030948,,,
1596,서울,은평구,2020,3150,1650,1500,4,2018,3392,1748,1644,0.947923345,0.961813447,0.933097248,,,
1597,서울,종로구,2010,1109,577,532,4,2008,1167,628,539,0.970016673,0.936191078,1.009393096,,,
1598,서울,종로구,2011,1065,557,508,4,2009,1026,528,498,1.059548293,1.074903807,1.043210218,,,
1599,서울,종로구,2012,954,490,464,4,2010,1059,545,514,0.91954063,0.916110596,0.923192621,,,
1600,서울,종로구,2013,988,528,460,4,2011,1056,534,522,0.955017952,1.00749058,0.901207488,,,
1601,서울,종로구,2014,1009,520,489,4,2012,1037,538,499,0.993186754,0.984848429,1.002180103,,,
1602,서울,종로구,2015,976,504,472,4,2013,893,480,413,1.115621481,1.069886303,1.168770953,,,
1603,서울,종로구,2016,876,454,422,4,2014,966,490,476,0.925647193,0.944078487,0.906656879,,,
1604,서울,종로구,2017,926,459,467,4,2015,881,440,441,1.072886022,1.06293899,1.082968324,,,
1605,서울,종로구,2018,862,443,419,4,2016,992,521,471,0.886980562,0.866391797,0.909767836,,,
1606,서울,종로구,2019,946,478,468,4,2017,859,438,421,1.124129854,1.111993157,1.136844906,,,
1607,서울,종로구,2020,764,381,383,4,2018,880,456,424,0.886194796,0.85135063,0.923783881,,,
1608,서울,중구,2010,1138,570,568,4,2008,1007,500,507,1.153536392,1.161590843,1.145718272,,,
1609,서울,중구,2011,1067,541,526,4,2009,843,429,414,1.2919787,1.284956133,1.299340172,,,
1610,서울,중구,2012,976,495,481,4,2010,850,430,420,1.172058803,1.17296505,1.171205893,,,
1611,서울,중구,2013,951,469,482,4,2011,1078,546,532,0.900492842,0.875242763,0.926558552,,,
1612,서울,중구,2014,1089,531,558,4,2012,939,474,465,1.183806708,1.141470016,1.227209501,,,
1613,서울,중구,2015,977,481,496,4,2013,837,432,405,1.191482354,1.134513474,1.252460725,,,
1614,서울,중구,2016,883,443,440,4,2014,883,442,441,1.020747933,1.021244629,1.020355594,,,
1615,서울,중구,2017,868,456,412,4,2015,856,439,417,1.035057483,1.058397124,1.010412299,,,
1616,서울,중구,2018,898,439,459,4,2016,871,444,427,1.052389947,1.007464794,1.099315302,,,
1617,서울,중구,2019,919,459,460,4,2017,824,425,399,1.13843125,1.100454483,1.17902333,,,
1618,서울,중구,2020,907,455,452,4,2018,802,397,405,1.154387001,1.16780201,1.141355338,,,
1619,서울,중랑구,2010,3259,1645,1614,4,2008,3434,1740,1694,0.968729619,0.963307591,0.974378264,,,
1620,서울,중랑구,2011,3043,1525,1518,4,2009,3064,1619,1445,1.013751945,0.959779177,1.074339113,,,
1621,서울,중랑구,2012,2670,1410,1260,4,2010,3170,1703,1467,0.859746681,0.843631512,0.878370808,,,
1622,서울,중랑구,2013,2747,1452,1295,4,2011,3284,1661,1623,0.853835131,0.890728426,0.815997281,,,
1623,서울,중랑구,2014,2883,1481,1402,4,2012,3179,1618,1561,0.92570503,0.932663262,0.918507218,,,
1624,서울,중랑구,2015,2812,1423,1389,4,2013,2926,1449,1477,0.980978533,1.000656091,0.961743397,,,
1625,서울,중랑구,2016,2563,1281,1282,4,2014,3030,1589,1441,0.863424736,0.821435676,0.909832628,,,
1626,서울,중랑구,2017,2652,1358,1294,4,2015,3072,1562,1510,0.881192551,0.885864033,0.87638471,,,
1627,서울,중랑구,2018,2647,1368,1279,4,2016,3172,1634,1538,0.851803209,0.853065491,0.850455652,,,
1628,서울,중랑구,2019,2717,1416,1301,4,2017,2895,1489,1406,0.95798692,0.968984621,0.946301304,,,
1629,서울,중랑구,2020,2369,1218,1151,4,2018,2605,1308,1297,0.928273264,0.948828832,0.9075547,,,
1630,세종,세종시,2014,1504,741,763,4,2012,1290,669,621,1.19008131,1.128600969,1.256522879,,,
1631,세종,세종시,2015,2578,1287,1291,4,2013,1354,667,687,1.943492002,1.966079349,1.921794597,,,
1632,세종,세종시,2016,3248,1649,1599,4,2014,2122,1076,1046,1.562388918,1.561552942,1.563342887,,,
1633,세종,세종시,2017,3839,1968,1871,4,2015,3085,1549,1536,1.27022733,1.294559467,1.245718846,,,
1634,세종,세종시,2018,4442,2310,2132,4,2016,3722,1894,1828,1.218205888,1.242740162,1.192747381,,,
1635,세종,세종시,2019,5004,2576,2428,4,2017,3993,2018,1975,1.279194254,1.300687676,1.257242476,,,
1636,세종,세종시,2020,4879,2489,2390,4,2018,4380,2232,2148,1.137038622,1.136263445,1.137892112,,,
1637,울산,남구,2010,3139,1664,1475,4,2008,3074,1641,1433,1.042331737,1.033220631,1.052648298,,,
1638,울산,남구,2011,2933,1576,1357,4,2009,2817,1497,1320,1.062780861,1.072711018,1.051340463,,,
1639,울산,남구,2012,2648,1402,1246,4,2010,2851,1498,1353,0.948067529,0.953640153,0.94179788,,,
1640,울산,남구,2013,2734,1383,1351,4,2011,3090,1622,1468,0.9031472,0.868799693,0.941167141,,,
1641,울산,남구,2014,2968,1563,1405,4,2012,2976,1553,1423,1.018003986,1.02550044,1.009738433,,,
1642,울산,남구,2015,2840,1482,1358,4,2013,2925,1531,1394,0.991085172,0.986327953,0.99626405,,,
1643,울산,남구,2016,2702,1411,1291,4,2014,2886,1512,1374,0.955669062,0.950875267,0.960897298,,,
1644,울산,남구,2017,2649,1410,1239,4,2015,2927,1513,1414,0.923799547,0.949573341,0.896105947,,,
1645,울산,남구,2018,2678,1414,1264,4,2016,3062,1581,1481,0.892737741,0.911309438,0.872829625,,,
1646,울산,남구,2019,2817,1450,1367,4,2017,2655,1368,1287,1.083030857,1.080016109,1.0862441,,,
1647,울산,남구,2020,2519,1270,1249,4,2018,2734,1419,1315,0.940476972,0.911947116,0.97134643,,,
1648,울산,동구,2010,1672,903,769,4,2008,1714,902,812,0.995735439,1.020068981,0.968518171,,,
1649,울산,동구,2011,1581,825,756,4,2009,1627,873,754,0.991888434,0.96291518,1.025387249,,,
1650,울산,동구,2012,1500,801,699,4,2010,1632,867,765,0.938187438,0.94137302,0.934443836,,,
1651,울산,동구,2013,1650,883,767,4,2011,1913,977,936,0.880415101,0.920904231,0.838025006,,,
1652,울산,동구,2014,1879,950,929,4,2012,1847,994,853,1.038432791,0.973835382,1.113792132,,,
1653,울산,동구,2015,1775,941,834,4,2013,1912,987,925,0.947608567,0.971450776,0.922065517,,,
1654,울산,동구,2016,1772,900,872,4,2014,2006,1050,956,0.901677635,0.873376574,0.932816148,,,
1655,울산,동구,2017,1890,997,893,4,2015,2058,1075,983,0.937421571,0.945006994,0.92904212,,,
1656,울산,동구,2018,1869,975,894,4,2016,2182,1106,1076,0.874325337,0.898251223,0.849694311,,,
1657,울산,동구,2019,1920,981,939,4,2017,1898,958,940,1.032579573,1.043402389,1.021586632,,,
1658,울산,동구,2020,1680,867,813,4,2018,1927,970,957,0.889909978,0.910742685,0.868792515,,,
1659,울산,북구,2010,2132,1161,971,4,2008,2099,1108,991,1.036795899,1.067679214,1.002035339,,,
1660,울산,북구,2011,2142,1117,1025,4,2009,2127,1094,1033,1.027946437,1.040361279,1.014754549,,,
1661,울산,북구,2012,2068,1054,1014,4,2010,2258,1144,1114,0.934856831,0.938778025,0.930872557,,,
1662,울산,북구,2013,2248,1152,1096,4,2011,2656,1339,1317,0.863946292,0.876637876,0.851064043,,,
1663,울산,북구,2014,2526,1284,1242,4,2012,2416,1241,1175,1.067222383,1.054245051,1.080988794,,,
1664,울산,북구,2015,2349,1211,1138,4,2013,2317,1242,1075,1.034845444,0.993506873,1.082608071,,,
1665,울산,북구,2016,2278,1223,1055,4,2014,2491,1255,1236,0.933465994,0.992958413,0.872913986,,,
1666,울산,북구,2017,2446,1225,1221,4,2015,2431,1249,1182,1.027046254,0.999360038,1.056417654,,,
1667,울산,북구,2018,2599,1328,1271,4,2016,2594,1336,1258,1.02271545,1.012837903,1.033242763,,,
1668,울산,북구,2019,2828,1459,1369,4,2017,2516,1286,1230,1.147327167,1.156012824,1.138245127,,,
1669,울산,북구,2020,2713,1396,1317,4,2018,2628,1356,1272,1.053762991,1.048996544,1.058854109,,,
1670,울산,울주군,2010,2381,1248,1133,4,2008,2272,1192,1080,1.069718674,1.06680897,1.072861392,,,
1671,울산,울주군,2011,2323,1228,1095,4,2009,2160,1149,1011,1.097776596,1.088996958,1.107644579,,,
1672,울산,울주군,2012,2213,1157,1056,4,2010,2092,1121,971,1.079787368,1.051661741,1.112198106,,,
1673,울산,울주군,2013,2145,1160,985,4,2011,2402,1230,1172,0.911533853,0.960950919,0.859500397,,,
1674,울산,울주군,2014,2461,1243,1218,4,2012,2279,1185,1094,1.102264441,1.068811473,1.138590168,,,
1675,울산,울주군,2015,2325,1222,1103,4,2013,2110,1076,1034,1.124757793,1.157196904,1.090918826,,,
1676,울산,울주군,2016,2179,1093,1086,4,2014,2283,1170,1113,0.974248684,0.951880936,0.997865767,,,
1677,울산,울주군,2017,2320,1183,1137,4,2015,2259,1166,1093,1.04831129,1.033795227,1.063843552,,,
1678,울산,울주군,2018,2262,1199,1063,4,2016,2279,1121,1158,1.013133753,1.089837881,0.93877641,,,
1679,울산,울주군,2019,2328,1143,1185,4,2017,2020,990,1030,1.176386726,1.176411779,1.176572216,,,
1680,울산,울주군,2020,2032,1016,1016,4,2018,2030,1055,975,1.021753596,0.981272385,1.065679361,,,
1681,울산,중구,2010,2069,1134,935,4,2008,1971,1027,944,1.071500493,1.12509952,1.012924509,,,
1682,울산,중구,2011,1893,1003,890,4,2009,1704,910,794,1.133964693,1.123072697,1.146322897,,,
1683,울산,중구,2012,1696,894,802,4,2010,1786,940,846,0.969310467,0.969076348,0.969485835,,,
1684,울산,중구,2013,1774,949,825,4,2011,1965,1033,932,0.921530195,0.936082701,0.905264519,,,
1685,울산,중구,2014,2023,1048,975,4,2012,1899,987,912,1.087400246,1.081913297,1.093319868,,,
1686,울산,중구,2015,2063,1059,1004,4,2013,1920,997,923,1.096772388,1.082303668,1.112421758,,,
1687,울산,중구,2016,2079,1113,966,4,2014,2140,1134,1006,0.991651847,1.000070089,0.982011579,,,
1688,울산,중구,2017,2179,1146,1033,4,2015,2290,1201,1089,0.971270631,0.972276836,0.970085257,,,
1689,울산,중구,2018,2181,1134,1047,4,2016,2355,1255,1100,0.945329614,0.92069897,0.973400263,,,
1690,울산,중구,2019,2188,1187,1001,4,2017,2176,1132,1044,1.026377057,1.068446106,0.98055293,,,
1691,울산,중구,2020,1911,974,937,4,2018,2043,1033,1010,0.954796524,0.960742414,0.9487585,,,
1692,인천,강화군,2010,430,230,200,4,2008,410,205,205,1.070540515,1.143200231,0.997731302,,,
1693,인천,강화군,2011,381,188,193,4,2009,396,198,198,0.982083238,0.967477754,0.996849468,,,
1694,인천,강화군,2012,411,203,208,4,2010,381,183,198,1.101121785,1.130298827,1.074324816,,,
1695,인천,강화군,2013,377,183,194,4,2011,417,212,205,0.922834462,0.879556125,0.967799363,,,
1696,인천,강화군,2014,422,217,205,4,2012,365,176,189,1.180152404,1.256305886,1.10925021,,,
1697,인천,강화군,2015,382,186,196,4,2013,376,195,181,1.037036463,0.971911367,1.107426621,,,
1698,인천,강화군,2016,394,210,184,4,2014,375,199,176,1.072465828,1.075262616,1.069159792,,,
1699,인천,강화군,2017,402,213,189,4,2015,360,185,175,1.139835191,1.173157182,1.104488551,,,
1700,인천,강화군,2018,386,204,182,4,2016,381,195,186,1.034143575,1.065967306,1.000681582,,,
1701,인천,강화군,2019,353,183,170,4,2017,318,157,161,1.133094403,1.187680883,1.079842729,,,
1702,인천,강화군,2020,334,166,168,4,2018,324,160,164,1.052252498,1.057149561,1.047617867,,,
1703,인천,계양구,2010,3450,1737,1713,4,2008,3452,1787,1665,1.020156537,0.990429562,1.052157095,,,
1704,인천,계양구,2011,3241,1688,1553,4,2009,3071,1548,1523,1.077253028,1.111091473,1.042819192,,,
1705,인천,계양구,2012,2837,1446,1391,4,2010,3221,1644,1577,0.899056779,0.896220365,0.902054754,,,
1706,인천,계양구,2013,2919,1512,1407,4,2011,3470,1777,1693,0.858663751,0.866987212,0.849913254,,,
1707,인천,계양구,2014,3228,1646,1582,4,2012,3127,1593,1534,1.053717405,1.052840017,1.054674832,,,
1708,인천,계양구,2015,2964,1488,1476,4,2013,2998,1563,1435,1.009171739,0.970045894,1.051893858,,,
1709,인천,계양구,2016,2720,1426,1294,4,2014,3116,1591,1525,0.891025153,0.913266809,0.867764532,,,
1710,인천,계양구,2017,2836,1430,1406,4,2015,2983,1523,1460,0.970446241,0.956719141,0.984849634,,,
1711,인천,계양구,2018,2606,1319,1287,4,2016,2928,1476,1452,0.908493549,0.910556223,0.906461563,,,
1712,인천,계양구,2019,2465,1258,1207,4,2017,2400,1250,1150,1.048393189,1.025460548,1.073363672,,,
1713,인천,계양구,2020,2091,1085,1006,4,2018,2292,1174,1118,0.93123208,0.941694361,0.920224179,,,
1714,인천,남동구,2010,4753,2476,2277,4,2008,4405,2260,2145,1.101388178,1.116324689,1.085608405,,,
1715,인천,남동구,2011,4547,2375,2172,4,2009,4399,2237,2162,1.055089986,1.081797463,1.027404809,,,
1716,인천,남동구,2012,4400,2279,2121,4,2010,4640,2428,2212,0.967950626,0.956409698,0.980602528,,,
1717,인천,남동구,2013,4671,2497,2174,4,2011,5385,2749,2636,0.885406424,0.925533475,0.843434957,,,
1718,인천,남동구,2014,5134,2624,2510,4,2012,5221,2626,2595,1.003738725,1.018163297,0.989176573,,,
1719,인천,남동구,2015,4980,2508,2472,4,2013,5116,2656,2460,0.993613116,0.96216109,1.027663241,,,
1720,인천,남동구,2016,5079,2599,2480,4,2014,5270,2713,2557,0.983753083,0.976123603,0.991878361,,,
1721,인천,남동구,2017,5243,2696,2547,4,2015,5602,2898,2704,0.955334061,0.94791596,0.963295919,,,
1722,인천,남동구,2018,5242,2696,2546,4,2016,5745,2952,2793,0.931376965,0.930576033,0.932233975,,,
1723,인천,남동구,2019,5246,2679,2567,4,2017,5126,2596,2530,1.044643709,1.051517135,1.037630695,,,
1724,인천,남동구,2020,4656,2338,2318,4,2018,4968,2545,2423,0.95664299,0.936062935,0.978357279,,,
1725,인천,동구,2010,796,377,419,4,2008,721,378,343,1.126928369,1.01624373,1.249273034,,,
1726,인천,동구,2011,859,429,430,4,2009,658,341,317,1.332556951,1.281891423,1.387224199,,,
1727,인천,동구,2012,742,382,360,4,2010,691,363,328,1.096085334,1.072272249,1.122447714,,,
1728,인천,동구,2013,747,394,353,4,2011,805,404,401,0.947203361,0.993718066,0.900259671,,,
1729,인천,동구,2014,839,415,424,4,2012,695,367,328,1.232241029,1.152206607,1.321993975,,,
1730,인천,동구,2015,754,378,376,4,2013,636,311,325,1.210131983,1.238453599,1.183155827,,,
1731,인천,동구,2016,704,332,372,4,2014,668,347,321,1.0757583,0.974892967,1.185155593,,,
1732,인천,동구,2017,714,361,353,4,2015,677,351,326,1.076534747,1.047968947,1.107374626,,,
1733,인천,동구,2018,663,345,318,4,2016,653,335,318,1.036379601,1.049355436,1.022674584,,,
1734,인천,동구,2019,658,325,333,4,2017,511,258,253,1.314387749,1.283547614,1.346049947,,,
1735,인천,동구,2020,539,286,253,4,2018,486,271,215,1.132064065,1.075338193,1.203426371,,,
1736,인천,미추홀구,2020,2815,1453,1362,4,2018,3234,1611,1623,0.888498896,0.919006118,0.858214901,,,
1737,인천,부평구,2010,5382,2831,2551,4,2008,5466,2856,2610,1.005061356,1.010020049,0.999556653,,,
1738,인천,부평구,2011,4839,2526,2313,4,2009,4984,2613,2371,0.991051213,0.985013687,0.997657661,,,
1739,인천,부평구,2012,4485,2343,2142,4,2010,4856,2528,2328,0.942762454,0.944372969,0.940966048,,,
1740,인천,부평구,2013,4448,2329,2119,4,2011,5433,2796,2637,0.835686877,0.848751686,0.821785151,,,
1741,인천,부평구,2014,5006,2590,2416,4,2012,4943,2594,2349,1.033757667,1.017368111,1.051844102,,,
1742,인천,부평구,2015,4537,2358,2179,4,2013,4723,2403,2320,0.980549094,0.999858075,0.960520655,,,
1743,인천,부평구,2016,4474,2305,2169,4,2014,4839,2464,2375,0.943754133,0.953187975,0.93397102,,,
1744,인천,부평구,2017,4338,2237,2101,4,2015,4797,2442,2355,0.923077868,0.933401841,0.912373376,,,
1745,인천,부평구,2018,4209,2171,2038,4,2016,4773,2418,2355,0.900131583,0.914854135,0.885015203,,,
1746,인천,부평구,2019,4246,2170,2076,4,2017,4257,2165,2092,1.018110341,1.021292545,1.014852981,,,
1747,인천,부평구,2020,3626,1832,1794,4,2018,4104,2089,2015,0.90185965,0.893583946,0.910510275,,,
1748,인천,서구,2010,4697,2443,2254,4,2008,4605,2345,2260,1.041140725,1.061521876,1.019959519,,,
1749,인천,서구,2011,4511,2310,2201,4,2009,4164,2211,1953,1.10581026,1.064563486,1.152538023,,,
1750,인천,서구,2012,4547,2382,2165,4,2010,4468,2329,2139,1.038796072,1.042126878,1.035105411,,,
1751,인천,서구,2013,5127,2642,2485,4,2011,5207,2672,2535,1.00506523,1.007499149,1.002503488,,,
1752,인천,서구,2014,5649,2854,2795,4,2012,5443,2733,2710,1.059379951,1.064051543,1.054751093,,,
1753,인천,서구,2015,5471,2745,2726,4,2013,5405,2849,2556,1.0332122,0.981743938,1.090692847,,,
1754,인천,서구,2016,5111,2657,2454,4,2014,5843,2996,2847,0.89287056,0.903645466,0.881504541,,,
1755,인천,서구,2017,5554,2862,2692,4,2015,5951,3071,2880,0.95265233,0.949594393,0.95591666,,,
1756,인천,서구,2018,5863,3035,2828,4,2016,6008,3134,2874,0.996112704,0.986752038,1.006306097,,,
1757,인천,서구,2019,5921,3095,2826,4,2017,5438,2776,2662,1.111410171,1.136029267,1.085679329,,,
1758,인천,서구,2020,5318,2705,2613,4,2018,5587,2870,2717,0.971601487,0.9603592,0.983529145,,,
1759,인천,연수구,2010,2810,1408,1402,4,2008,2513,1311,1202,1.141385472,1.094329966,1.192836745,,,
1760,인천,연수구,2011,2675,1400,1275,4,2009,2291,1160,1131,1.19183794,1.229754371,1.152882489,,,
1761,인천,연수구,2012,2614,1304,1310,4,2010,2407,1242,1165,1.108531407,1.069804263,1.149960262,,,
1762,인천,연수구,2013,2738,1409,1329,4,2011,2772,1445,1327,1.008227936,0.993553996,1.024215917,,,
1763,인천,연수구,2014,3203,1673,1530,4,2012,2706,1439,1267,1.208224548,1.184632043,1.234958259,,,
1764,인천,연수구,2015,3134,1630,1504,4,2013,2742,1439,1303,1.166675427,1.154184238,1.180431753,,,
1765,인천,연수구,2016,3226,1686,1540,4,2014,3090,1602,1488,1.065674055,1.072366867,1.058413212,,,
1766,인천,연수구,2017,3514,1827,1687,4,2015,3227,1660,1567,1.111530287,1.121447089,1.100990443,,,
1767,인천,연수구,2018,3667,1873,1794,4,2016,3512,1805,1707,1.065798026,1.057325971,1.074796839,,,
1768,인천,연수구,2019,3981,2017,1964,4,2017,3377,1719,1658,1.203315819,1.195579198,1.211419109,,,
1769,인천,연수구,2020,3979,2025,1954,4,2018,3505,1818,1687,1.158789165,1.134957182,1.184532387,,,
1770,인천,옹진군,2010,119,64,55,4,2008,154,74,80,0.788759766,0.881244831,0.703088777,,,
1771,인천,옹진군,2011,114,53,61,4,2009,118,65,53,0.986146308,0.830827459,1.177040559,,,
1772,인천,옹진군,2012,90,51,39,4,2010,151,72,79,0.608392807,0.721748697,0.504864668,,,
1773,인천,옹진군,2013,122,57,65,4,2011,173,74,99,0.719833802,0.784858678,0.67145301,,,
1774,인천,옹진군,2014,118,50,68,4,2012,153,70,83,0.787243504,0.727813812,0.837853876,,,
1775,인천,옹진군,2015,107,55,52,4,2013,127,62,65,0.860000227,0.903897798,0.818139667,,,
1776,인천,옹진군,2016,114,62,52,4,2014,131,66,65,0.88828446,0.957185437,0.818139667,,,
1777,인천,옹진군,2017,111,57,54,4,2015,141,79,62,0.803567521,0.735184078,0.890716573,,,
1778,인천,옹진군,2018,108,63,45,4,2016,119,56,63,0.926393082,1.146306753,0.730481846,,,
1779,인천,옹진군,2019,102,47,55,4,2017,131,71,60,0.794780833,0.674509138,0.937451702,,,
1780,인천,옹진군,2020,97,52,45,4,2018,113,48,65,0.876217252,1.103850948,0.708005481,,,
1781,인천,중구,2010,938,490,448,4,2008,908,464,444,1.054473084,1.076035075,1.031887869,,,
1782,인천,중구,2011,1006,515,491,4,2009,792,425,367,1.296556086,1.234714725,1.368210411,,,
1783,인천,중구,2012,877,477,400,4,2010,841,445,396,1.064442255,1.092211379,1.03300463,,,
1784,인천,중구,2013,1066,572,494,4,2011,972,517,455,1.119462239,1.127337138,1.110332406,,,
1785,인천,중구,2014,1343,668,675,4,2012,1003,491,512,1.366764181,1.386255553,1.348252626,,,
1786,인천,중구,2015,1244,623,621,4,2013,993,489,504,1.27876176,1.298157887,1.260081184,,,
1787,인천,중구,2016,1201,612,589,4,2014,1165,603,562,1.052290358,1.034147386,1.071806637,,,
1788,인천,중구,2017,1244,643,601,4,2015,1284,652,632,0.988948932,1.004874223,0.972511748,,,
1789,인천,중구,2018,1345,690,655,4,2016,1245,635,610,1.102735718,1.107193925,1.098117791,,,
1790,인천,중구,2019,1442,746,696,4,2017,1095,547,548,1.344217825,1.389632075,1.29887137,,,
1791,인천,중구,2020,1391,714,677,4,2018,1113,551,562,1.275705637,1.320367851,1.231940736,,,
1792,전남,강진군,2010,257,130,127,4,2008,287,149,138,0.914049542,0.889007475,0.941157045,,,
1793,전남,강진군,2011,231,119,112,4,2009,273,140,133,0.863709789,0.866098436,0.86119965,,,
1794,전남,강진군,2012,227,122,105,4,2010,306,142,164,0.757221506,0.875426754,0.654761167,,,
1795,전남,강진군,2013,223,117,106,4,2011,337,161,176,0.675450412,0.740471443,0.615929011,,,
1796,전남,강진군,2014,249,119,130,4,2012,303,152,151,0.838832459,0.797722244,0.880448317,,,
1797,전남,강진군,2015,239,128,111,4,2013,257,124,133,0.949255859,1.051808347,0.853510367,,,
1798,전남,강진군,2016,194,96,98,4,2014,291,155,136,0.680498622,0.631085008,0.736927274,,,
1799,전남,강진군,2017,219,117,102,4,2015,302,155,147,0.740211249,0.769134854,0.709610936,,,
1800,전남,강진군,2018,223,118,105,4,2016,247,128,119,0.921565947,0.939334701,0.902359927,,,
1801,전남,강진군,2019,192,98,94,4,2017,225,118,107,0.871038236,0.846237754,0.898424401,,,
1802,전남,강진군,2020,181,95,86,4,2018,204,93,111,0.905663607,1.04085201,0.792342471,,,
1803,전남,고흥군,2010,415,227,188,4,2008,418,227,191,1.01342199,1.018939336,1.006611633,,,
1804,전남,고흥군,2011,371,206,165,4,2009,416,218,198,0.910330488,0.962850933,0.85222882,,,
1805,전남,고흥군,2012,384,203,181,4,2010,366,197,169,1.070948651,1.049973022,1.095290531,,,
1806,전남,고흥군,2013,350,179,171,4,2011,409,221,188,0.873500676,0.825294757,0.930198691,,,
1807,전남,고흥군,2014,388,203,185,4,2012,348,172,176,1.138075281,1.20258538,1.074970444,,,
1808,전남,고흥군,2015,312,157,155,4,2013,350,183,167,0.909923871,0.874171999,0.949188985,,,
1809,전남,고흥군,2016,319,164,155,4,2014,345,182,163,0.943822001,0.918165116,0.972481966,,,
1810,전남,고흥군,2017,326,168,158,4,2015,316,164,152,1.053050082,1.043791515,1.063043318,,,
1811,전남,고흥군,2018,292,157,135,4,2016,332,165,167,0.897766254,0.969536217,0.826712987,,,
1812,전남,고흥군,2019,310,148,162,4,2017,289,154,135,1.094919928,0.979240401,1.227209501,,,
1813,전남,고흥군,2020,260,145,115,4,2018,261,127,134,1.016837021,1.163355935,0.877668486,,,
1814,전남,곡성군,2010,196,98,98,4,2008,211,122,89,0.948182914,0.818492254,1.126091115,,,
1815,전남,곡성군,2011,188,98,90,4,2009,189,98,91,1.01534715,1.018939336,1.011436402,,,
1816,전남,곡성군,2012,160,85,75,4,2010,206,119,87,0.792813928,0.727813812,0.881616021,,,
1817,전남,곡성군,2013,177,102,75,4,2011,179,88,91,1.009342928,1.181043322,0.842863668,,,
1818,전남,곡성군,2014,154,80,74,4,2012,192,111,81,0.818724904,0.734370693,0.934295299,,,
1819,전남,곡성군,2015,177,105,72,4,2013,162,87,75,1.11526163,1.229754371,0.981767601,,,
1820,전남,곡성군,2016,152,84,68,4,2014,167,78,89,0.929063986,1.097319285,0.781369345,,,
1821,전남,곡성군,2017,155,73,82,4,2015,188,91,97,0.841574093,0.817390896,0.86452903,,,
1822,전남,곡성군,2018,169,83,86,4,2016,147,79,68,1.173512929,1.070531201,1.293382562,,,
1823,전남,곡성군,2019,129,70,59,4,2017,137,70,67,0.961142214,1.018939336,0.900564186,,,
1824,전남,곡성군,2020,113,65,48,4,2018,127,71,56,0.908224538,0.932831787,0.876578215,,,
1825,전남,광양시,2010,1497,806,691,4,2008,1521,799,722,1.004641456,1.027866214,0.978764734,,,
1826,전남,광양시,2011,1518,791,727,4,2009,1430,734,696,1.08356319,1.098066778,1.068224745,,,
1827,전남,광양시,2012,1418,726,692,4,2010,1501,752,749,0.964304176,0.983710051,0.944847546,,,
1828,전남,광양시,2013,1462,730,732,4,2011,1689,897,792,0.883560377,0.829237141,0.945199237,,,
1829,전남,광양시,2014,1610,845,765,4,2012,1622,830,792,1.01319616,1.037353903,0.987810678,,,
1830,전남,광양시,2015,1533,785,748,4,2013,1562,792,770,1.001796787,1.009933559,0.99345531,,,
1831,전남,광양시,2016,1459,747,712,4,2014,1716,901,815,0.867873679,0.844781004,0.893428594,,,
1832,전남,광양시,2017,1652,866,786,4,2015,1692,842,850,0.996616776,1.047982738,0.945673204,,,
1833,전남,광양시,2018,1606,802,804,4,2016,1752,901,851,0.935685605,0.906980408,0.966193144,,,
1834,전남,광양시,2019,1648,835,813,4,2017,1587,800,787,1.05998273,1.063517932,1.05646053,,,
1835,전남,광양시,2020,1444,733,711,4,2018,1465,721,744,1.006116051,1.035898105,0.977314018,,,
1836,전남,구례군,2010,180,100,80,4,2008,157,84,73,1.170284254,1.213023019,1.12073927,,,
1837,전남,구례군,2011,151,76,75,4,2009,174,88,86,0.885821482,0.879993063,0.89186737,,,
1838,전남,구례군,2012,171,91,80,4,2010,173,86,87,1.008947378,1.078179995,0.940390422,,,
1839,전남,구례군,2013,162,83,79,4,2011,199,111,88,0.830960628,0.761909594,0.918082865,,,
1840,전남,구례군,2014,184,98,86,4,2012,176,98,78,1.067145566,1.018939336,1.127564285,,,
1841,전남,구례군,2015,170,97,73,4,2013,163,90,73,1.064583733,1.098190174,1.022674584,,,
1842,전남,구례군,2016,170,87,83,4,2014,163,81,82,1.064583733,1.094416324,1.035146225,,,
1843,전남,구례군,2017,155,80,75,4,2015,178,92,86,0.888853537,0.886034206,0.89186737,,,
1844,전남,구례군,2018,158,75,83,4,2016,152,68,84,1.061040614,1.12383015,1.010499887,,,
1845,전남,구례군,2019,136,59,77,4,2017,160,80,80,0.867635743,0.751467761,0.984324287,,,
1846,전남,구례군,2020,139,70,69,4,2018,119,65,54,1.192302207,1.097319285,1.306750857,,,
1847,전남,나주시,2010,670,326,344,4,2008,697,387,310,0.981206764,0.858331327,1.134838893,,,
1848,전남,나주시,2011,576,311,265,4,2009,627,343,284,0.937720589,0.923877941,0.954256214,,,
1849,전남,나주시,2012,551,309,242,4,2010,570,313,257,0.986723001,1.005917747,0.962985406,,,
1850,전남,나주시,2013,552,290,262,4,2011,634,324,310,0.888726907,0.912013604,0.864324971,,,
1851,전남,나주시,2014,597,315,282,4,2012,559,293,266,1.09013688,1.095446727,1.084188845,,,
1852,전남,나주시,2015,630,333,297,4,2013,535,285,250,1.202002238,1.190550172,1.214937406,,,
1853,전남,나주시,2016,728,369,359,4,2014,633,332,301,1.17394075,1.132495829,1.219734803,,,
1854,전남,나주시,2017,914,479,435,4,2015,796,385,411,1.172064837,1.26771933,1.082392808,,,
1855,전남,나주시,2018,1006,475,531,4,2016,1080,568,512,0.950807796,0.852105959,1.060625399,,,
1856,전남,나주시,2019,1145,584,561,4,2017,1039,542,497,1.124885835,1.097897735,1.154367086,,,
1857,전남,나주시,2020,989,520,469,4,2018,1098,575,523,0.919416854,0.921475574,0.917082944,,,
1858,전남,담양군,2010,241,125,116,4,2008,278,156,122,0.884892992,0.816457802,0.972379113,,,
1859,전남,담양군,2011,227,126,101,4,2009,270,130,140,0.858184373,0.987587357,0.737786664,,,
1860,전남,담양군,2012,218,109,109,4,2010,247,130,117,0.900903034,0.854341444,0.952748117,,,
1861,전남,담양군,2013,212,113,99,4,2011,278,136,142,0.778412092,0.846618713,0.712991435,,,
1862,전남,담양군,2014,233,117,116,4,2012,276,156,120,0.861718363,0.764204502,0.988585431,,,
1863,전남,담양군,2015,241,136,105,4,2013,284,145,139,0.86619807,0.955694826,0.772523966,,,
1864,전남,담양군,2016,246,132,114,4,2014,289,128,161,0.868871943,1.050781191,0.72412983,,,
1865,전남,담양군,2017,269,130,139,4,2015,250,142,108,1.098324775,0.932831787,1.316220067,,,
1866,전남,담양군,2018,221,125,96,4,2016,284,150,134,0.794314412,0.849116114,0.732662389,,,
1867,전남,담양군,2019,242,126,116,4,2017,254,131,123,0.972523621,0.980048522,0.964473592,,,
1868,전남,담양군,2020,198,98,100,4,2018,271,137,134,0.745786312,0.728876314,0.763189988,,,
1869,전남,목포시,2010,2887,1481,1406,4,2008,2597,1343,1254,1.134732107,1.123640474,1.14663514,,,
1870,전남,목포시,2011,2736,1421,1315,4,2009,2375,1199,1176,1.175901618,1.207600331,1.143551937,,,
1871,전남,목포시,2012,2501,1261,1240,4,2010,2521,1309,1212,1.012649972,0.981575633,1.04630073,,,
1872,전남,목포시,2013,2638,1350,1288,4,2011,2672,1385,1287,1.007759374,0.993189967,1.023469203,,,
1873,전남,목포시,2014,2741,1424,1317,4,2012,2586,1348,1238,1.081929653,1.076386955,1.087934109,,,
1874,전남,목포시,2015,2631,1358,1273,4,2013,2389,1226,1163,1.124147263,1.128645692,1.119402189,,,
1875,전남,목포시,2016,2538,1292,1246,4,2014,2513,1308,1205,1.030902608,1.006475247,1.057470981,,,
1876,전남,목포시,2017,2756,1430,1326,4,2015,2617,1310,1307,1.074964196,1.112277291,1.037541315,,,
1877,전남,목포시,2018,2756,1360,1396,4,2016,2587,1314,1273,1.087429958,1.054609968,1.121487604,,,
1878,전남,목포시,2019,2762,1389,1373,4,2017,2220,1122,1098,1.269957563,1.261414205,1.278808929,,,
1879,전남,목포시,2020,2389,1210,1179,4,2018,2130,1093,1037,1.144867047,1.128011525,1.162712955,,,
1880,전남,무안군,2010,613,327,286,4,2008,572,300,272,1.093913431,1.110643877,1.075312247,,,
1881,전남,무안군,2011,574,298,276,4,2009,649,316,333,0.902787848,0.960898488,0.847622178,,,
1882,전남,무안군,2012,529,252,277,4,2010,653,328,325,0.826915247,0.782843636,0.871633415,,,
1883,전남,무안군,2013,577,293,284,4,2011,780,402,378,0.75509174,0.742659765,0.768358682,,,
1884,전남,무안군,2014,775,394,381,4,2012,739,396,343,1.070473136,1.013793178,1.135973809,,,
1885,전남,무안군,2015,787,408,379,4,2013,851,427,424,0.943981931,0.973600115,0.914136008,,,
1886,전남,무안군,2016,790,413,377,4,2014,918,462,456,0.878421423,0.910870013,0.845500698,,,
1887,전남,무안군,2017,819,407,412,4,2015,889,435,454,0.94037408,0.953352437,0.928065922,,,
1888,전남,무안군,2018,777,382,395,4,2016,971,501,470,0.816808593,0.776915821,0.859481831,,,
1889,전남,무안군,2019,827,438,389,4,2017,811,412,399,1.040885993,1.083241333,0.997043642,,,
1890,전남,무안군,2020,702,362,340,4,2018,784,396,388,0.913986031,0.931454646,0.896158141,,,
1891,전남,보성군,2010,290,164,126,4,2008,305,152,153,0.970547215,1.099381916,0.842202599,,,
1892,전남,보성군,2011,244,126,118,4,2009,285,139,146,0.873903493,0.923642852,0.826545212,,,
1893,전남,보성군,2012,229,122,107,4,2010,328,172,156,0.712656331,0.722736041,0.701449875,,,
1894,전남,보성군,2013,252,136,116,4,2011,364,192,172,0.706671646,0.721748697,0.689710766,,,
1895,전남,보성군,2014,256,127,129,4,2012,313,146,167,0.834860929,0.886337642,0.789970188,,,
1896,전남,보성군,2015,222,105,117,4,2013,271,136,135,0.836184653,0.786681105,0.886317973,,,
1897,전남,보성군,2016,214,101,113,4,2014,304,141,163,0.718552821,0.729878532,0.708970724,,,
1898,전남,보성군,2017,224,108,116,4,2015,308,160,148,0.742362133,0.687784052,0.801555755,,,
1899,전남,보성군,2018,238,122,116,4,2016,296,167,129,0.820736513,0.744374845,0.919614355,,,
1900,전남,보성군,2019,200,110,90,4,2017,223,116,107,0.915468998,0.966235578,0.860193575,,,
1901,전남,보성군,2020,170,85,85,4,2018,213,110,103,0.814681448,0.787362214,0.843954754,,,
1902,전남,순천시,2010,2966,1552,1414,4,2008,2756,1421,1335,1.098526258,1.112873927,1.083192406,,,
1903,전남,순천시,2011,2832,1440,1392,4,2009,2478,1271,1207,1.166569066,1.154423796,1.179422553,,,
1904,전남,순천시,2012,2519,1275,1244,4,2010,2492,1268,1224,1.031807401,1.024564396,1.039384953,,,
1905,전남,순천시,2013,2593,1314,1279,4,2011,2687,1397,1290,0.98503885,0.958401065,1.013954103,,,
1906,전남,순천시,2014,2872,1524,1348,4,2012,2524,1294,1230,1.161484969,1.20004911,1.120784829,,,
1907,전남,순천시,2015,2710,1400,1310,4,2013,2510,1284,1226,1.102082429,1.110993046,1.092743642,,,
1908,전남,순천시,2016,2712,1397,1315,4,2014,2609,1387,1222,1.061045762,1.026285691,1.100504974,,,
1909,전남,순천시,2017,2761,1474,1287,4,2015,2603,1333,1270,1.082706509,1.126719116,1.036363929,,,
1910,전남,순천시,2018,2747,1408,1339,4,2016,2751,1408,1343,1.019263748,1.018939336,1.019628643,,,
1911,전남,순천시,2019,2857,1467,1390,4,2017,2485,1259,1226,1.17355205,1.187278798,1.159476078,,,
1912,전남,순천시,2020,2627,1330,1297,4,2018,2442,1217,1225,1.098077321,1.113549151,1.082782805,,,
1913,전남,신안군,2010,180,85,95,4,2008,242,126,116,0.759233999,0.687379711,0.83753522,,,
1914,전남,신안군,2011,183,90,93,4,2009,204,96,108,0.915670939,0.955255628,0.880636447,,,
1915,전남,신안군,2012,163,73,90,4,2010,209,94,115,0.796085708,0.791303953,0.800354022,,,
1916,전남,신안군,2013,145,62,83,4,2011,201,114,87,0.736360449,0.55415999,0.975655063,,,
1917,전남,신안군,2014,174,98,76,4,2012,232,122,110,0.765560949,0.818492254,0.706575167,,,
1918,전남,신안군,2015,173,87,86,4,2013,196,98,98,0.900966287,0.904568595,0.897449125,,,
1919,전남,신안군,2016,156,75,81,4,2014,224,125,99,0.710878024,0.611363602,0.836733751,,,
1920,전남,신안군,2017,160,89,71,4,2015,234,106,128,0.697947304,0.855524537,0.567264808,,,
1921,전남,신안군,2018,177,80,97,4,2016,230,105,125,0.785532105,0.776334732,0.793595477,,,
1922,전남,신안군,2019,177,87,90,4,2017,203,112,91,0.890011744,0.79149752,1.011436402,,,
1923,전남,신안군,2020,143,76,67,4,2018,182,93,89,0.802016233,0.832681608,0.76987862,,,
1924,전남,여수시,2010,2940,1518,1422,4,2008,2862,1522,1340,1.048567059,1.016261441,1.085256163,,,
1925,전남,여수시,2011,2771,1469,1302,4,2009,2504,1284,1220,1.129589665,1.165749132,1.091411728,,,
1926,전남,여수시,2012,2413,1240,1173,4,2010,2494,1272,1222,0.987596135,0.993305642,0.981667174,,,
1927,전남,여수시,2013,2482,1276,1206,4,2011,2803,1410,1393,0.903851719,0.922103967,0.885388046,,,
1928,전남,여수시,2014,2677,1339,1338,4,2012,2609,1333,1276,1.047352325,1.02352571,1.072365669,,,
1929,전남,여수시,2015,2485,1292,1193,4,2013,2458,1242,1216,1.031960379,1.059959438,1.003331233,,,
1930,전남,여수시,2016,2367,1182,1185,4,2014,2593,1355,1238,0.931781857,0.888845975,0.978892877,,,
1931,전남,여수시,2017,2477,1287,1190,4,2015,2699,1350,1349,0.936788673,0.971388834,0.902136957,,,
1932,전남,여수시,2018,2614,1311,1303,4,2016,2574,1265,1309,1.036610371,1.055991676,1.017987,,,
1933,전남,여수시,2019,2486,1209,1277,4,2017,2393,1256,1137,1.060417618,0.980810237,1.148597576,,,
1934,전남,여수시,2020,2306,1202,1104,4,2018,2286,1174,1112,1.029678361,1.043241126,1.015317213,,,
1935,전남,영광군,2010,424,226,198,4,2008,433,222,211,0.999531463,1.037298604,0.959666197,,,
1936,전남,영광군,2011,397,207,190,4,2009,392,217,175,1.033767677,0.971983607,1.110332406,,,
1937,전남,영광군,2012,361,191,170,4,2010,390,195,195,0.944846163,0.998038017,0.891562458,,,
1938,전남,영광군,2013,373,183,190,4,2011,457,223,234,0.833126868,0.836169949,0.830376799,,,
1939,전남,영광군,2014,425,219,206,4,2012,393,204,189,1.103862268,1.093861346,1.114661187,,,
1940,전남,영광군,2015,391,199,192,4,2013,412,197,215,0.968719518,1.029283898,0.913272187,,,
1941,전남,영광군,2016,373,184,189,4,2014,429,215,214,0.887503447,0.872022502,0.903203254,,,
1942,전남,영광군,2017,387,200,187,4,2015,433,218,215,0.912308198,0.934806731,0.889489057,,,
1943,전남,영광군,2018,372,186,186,4,2016,447,229,218,0.849481501,0.827610116,0.872557214,,,
1944,전남,영광군,2019,375,193,182,4,2017,352,171,181,1.08744453,1.150030947,1.02832472,,,
1945,전남,영광군,2020,312,152,160,4,2018,355,188,167,0.897108042,0.823823293,0.979807985,,,
1946,전남,영암군,2010,570,300,270,4,2008,570,297,273,1.020747933,1.029231653,1.011436402,,,
1947,전남,영암군,2011,480,246,234,4,2009,518,250,268,0.94586681,1.002636307,0.892932286,,,
1948,전남,영암군,2012,458,227,231,4,2010,513,270,243,0.91131102,0.856663812,0.972172136,,,
1949,전남,영암군,2013,471,252,219,4,2011,610,299,311,0.788151272,0.858771615,0.720147054,,,
1950,전남,영암군,2014,497,239,258,4,2012,548,273,275,0.925751318,0.892038467,0.959454701,,,
1951,전남,영암군,2015,445,243,202,4,2013,548,286,262,0.828892026,0.865742163,0.788474298,,,
1952,전남,영암군,2016,453,235,218,4,2014,566,313,253,0.816959034,0.765018352,0.881197863,,,
1953,전남,영암군,2017,448,244,204,4,2015,541,260,281,0.845277401,0.956235377,0.742439912,,,
1954,전남,영암군,2018,413,196,217,4,2016,505,258,247,0.834789893,0.774077945,0.898463096,,,
1955,전남,영암군,2019,414,212,202,4,2017,483,257,226,0.874926799,0.840525834,0.914071973,,,
1956,전남,영암군,2020,412,204,208,4,2018,381,190,191,1.103800914,1.094019077,1.113697976,,,
1957,전남,완도군,2010,358,180,178,4,2008,393,220,173,0.929841628,0.833677639,1.052231653,,,
1958,전남,완도군,2011,402,220,182,4,2009,363,178,185,1.130415066,1.259363225,1.006090672,,,
1959,전남,완도군,2012,359,177,182,4,2010,367,196,171,0.998497296,0.920164605,1.088460668,,,
1960,전남,완도군,2013,369,200,169,4,2011,392,196,196,0.96085711,1.039734017,0.881795942,,,
1961,전남,완도군,2014,376,186,190,4,2012,321,172,149,1.195642438,1.101876259,1.304081684,,,
1962,전남,완도군,2015,308,170,138,4,2013,337,168,169,0.93290909,1.031069567,0.835083388,,,
1963,전남,완도군,2016,323,150,173,4,2014,406,202,204,0.812072863,0.756638121,0.867268152,,,
1964,전남,완도군,2017,390,198,192,4,2015,382,203,179,1.042124853,0.993842308,1.09694704,,,
1965,전남,완도군,2018,354,186,168,4,2016,416,207,209,0.868617231,0.915568679,0.822054211,,,
1966,전남,완도군,2019,387,191,196,4,2017,358,180,178,1.103434218,1.081207851,1.126091115,,,
1967,전남,완도군,2020,315,162,153,4,2018,381,197,184,0.843925456,0.837909505,0.850376149,,,
1968,전남,장성군,2010,363,195,168,4,2008,347,183,164,1.06781412,1.085755031,1.047617867,,,
1969,전남,장성군,2011,325,172,153,4,2009,326,178,148,1.017616804,0.984593067,1.057224401,,,
1970,전남,장성군,2012,331,177,154,4,2010,337,152,185,1.002574379,1.186528043,0.851307492,,,
1971,전남,장성군,2013,343,175,168,4,2011,346,193,153,1.011897517,0.923908725,1.122936798,,,
1972,전남,장성군,2014,340,184,156,4,2012,344,176,168,1.008878771,1.065254761,0.9496264,,,
1973,전남,장성군,2015,346,181,165,4,2013,311,159,152,1.135623102,1.159924653,1.110140174,,,
1974,전남,장성군,2016,309,154,155,4,2014,344,181,163,0.916892765,0.866942861,0.972481966,,,
1975,전남,장성군,2017,339,187,152,4,2015,383,191,192,0.903481852,0.997600293,0.809617379,,,
1976,전남,장성군,2018,366,191,175,4,2016,338,162,176,1.105306933,1.201342057,1.016863933,,,
1977,전남,장성군,2019,322,157,165,4,2017,308,154,154,1.067145566,1.038788804,1.095722769,,,
1978,전남,장성군,2020,271,138,133,4,2018,328,172,156,0.843361859,0.817521095,0.871895639,,,
1979,전남,장흥군,2010,300,146,154,4,2008,298,156,142,1.02759859,0.953622712,1.109097788,,,
1980,전남,장흥군,2011,275,149,126,4,2009,258,129,129,1.088006517,1.176914427,0.998891454,,,
1981,전남,장흥군,2012,268,135,133,4,2010,252,156,96,1.085557325,0.881774426,1.416830413,,,
1982,전남,장흥군,2013,246,147,99,4,2011,265,136,129,0.947562232,1.101353547,0.784843285,,,
1983,전남,장흥군,2014,258,133,125,4,2012,249,116,133,1.057642436,1.168266653,0.961160323,,,
1984,전남,장흥군,2015,240,116,124,4,2013,265,142,123,0.924450958,0.832372979,1.030989012,,,
1985,전남,장흥군,2016,243,129,114,4,2014,241,120,121,1.02921887,1.095359787,0.963511592,,,
1986,전남,장흥군,2017,230,110,120,4,2015,249,146,103,0.942859536,0.767694021,1.191465535,,,
1987,전남,장흥군,2018,233,129,104,4,2016,254,132,122,0.936355387,0.995781624,0.87178817,,,
1988,전남,장흥군,2019,245,128,117,4,2017,241,115,126,1.037689807,1.134123783,0.9496264,,,
1989,전남,장흥군,2020,221,100,121,4,2018,233,119,114,0.968177224,0.856251543,1.085470392,,,
1990,전남,진도군,2010,229,102,127,4,2008,205,95,110,1.14025013,1.094019077,1.180724293,,,
1991,전남,진도군,2011,210,104,106,4,2009,203,113,90,1.055946137,0.937784876,1.204483399,,,
1992,전남,진도군,2012,197,110,87,4,2010,224,120,104,0.897711351,0.934027725,0.855506623,,,
1993,전남,진도군,2013,201,111,90,4,2011,266,124,142,0.771317047,0.912115051,0.648174032,,,
1994,전남,진도군,2014,241,113,128,4,2012,208,114,94,1.182693518,1.010001272,1.392578157,,,
1995,전남,진도군,2015,183,99,84,4,2013,208,106,102,0.898061883,0.95165089,0.842202599,,,
1996,전남,진도군,2016,208,108,100,4,2014,222,120,102,0.956376441,0.917045403,1.002622141,,,
1997,전남,진도군,2017,185,102,83,4,2015,236,107,129,0.800162574,0.971325349,0.657999926,,,
1998,전남,진도군,2018,202,89,113,4,2016,230,126,104,0.896482967,0.719726992,1.111175269,,,
1999,전남,진도군,2019,199,105,94,4,2017,189,96,93,1.07475576,1.114464899,1.033671085,,,
2000,전남,진도군,2020,171,93,78,4,2018,173,92,81,1.008947378,1.030014764,0.984797748,,,
2001,전남,함평군,2010,209,106,103,4,2008,254,135,119,0.839906763,0.800056072,0.885172119,,,
2002,전남,함평군,2011,204,110,94,4,2009,195,95,100,1.067859376,1.179824495,0.961314109,,,
2003,전남,함평군,2012,167,84,83,4,2010,201,93,108,0.848084103,0.920332304,0.785944356,,,
2004,전남,함평군,2013,165,77,88,4,2011,228,116,112,0.738699162,0.676364904,0.80353003,,,
2005,전남,함평군,2014,192,97,95,4,2012,207,105,102,0.946780691,0.941305863,0.952491034,,,
2006,전남,함평군,2015,162,87,75,4,2013,203,116,87,0.81458702,0.764204502,0.881616021,,,
2007,전남,함평군,2016,166,94,72,4,2014,215,112,103,0.788112357,0.855181229,0.714879321,,,
2008,전남,함평군,2017,167,87,80,4,2015,212,121,91,0.804079739,0.732625804,0.899054579,,,
2009,전남,함평군,2018,164,89,75,4,2016,215,119,96,0.778617028,0.762063873,0.798964519,,,
2010,전남,함평군,2019,162,87,75,4,2017,190,99,91,0.870321921,0.895431538,0.842863668,,,
2011,전남,함평군,2020,152,78,74,4,2018,175,84,91,0.88659249,0.946157955,0.831625486,,,
2012,전남,해남군,2010,557,290,267,4,2008,587,304,283,0.968580236,0.972014498,0.964855526,,,
2013,전남,해남군,2011,537,278,259,4,2009,531,265,266,1.032281807,1.06892504,0.995762095,,,
2014,전남,해남군,2012,493,233,260,4,2010,519,262,257,0.969612198,0.906155975,1.03461242,,,
2015,전남,해남군,2013,495,255,240,4,2011,542,276,266,0.93223289,0.941411343,0.92271391,,,
2016,전남,해남군,2014,499,239,260,4,2012,561,299,262,0.907938001,0.814469904,1.014867908,,,
2017,전남,해남군,2015,517,274,243,4,2013,467,233,234,1.13003572,1.198237675,1.062008222,,,
2018,전남,해남군,2016,441,221,220,4,2014,533,273,260,0.844558796,0.824855653,0.865340033,,,
2019,전남,해남군,2017,479,264,215,4,2015,479,232,247,1.020747933,1.159482693,0.89018233,,,
2020,전남,해남군,2018,415,205,210,4,2016,543,253,290,0.780129635,0.825622782,0.740557457,,,
2021,전남,해남군,2019,455,211,244,4,2017,451,199,252,1.029801129,1.080382914,0.990208724,,,
2022,전남,해남군,2020,376,173,203,4,2018,446,213,233,0.860540858,0.827589226,0.890999745,,,
2023,전남,화순군,2010,659,347,312,4,2008,715,362,353,0.940801241,0.976718093,0.903893683,,,
2024,전남,화순군,2011,635,328,307,4,2009,620,346,274,1.045443447,0.965930932,1.145843421,,,
2025,전남,화순군,2012,561,296,265,4,2010,568,299,269,1.008168293,1.008715865,1.007467527,,,
2026,전남,화순군,2013,513,269,244,4,2011,676,335,341,0.774620842,0.818193079,0.731767151,,,
2027,전남,화순군,2014,611,298,313,4,2012,549,280,269,1.136023655,1.084442579,1.189952211,,,
2028,전남,화순군,2015,484,242,242,4,2013,554,285,269,0.891772562,0.865204629,0.920026949,,,
2029,전남,화순군,2016,491,262,229,4,2014,518,275,243,0.967542924,0.970771295,0.963755061,,,
2030,전남,화순군,2017,450,237,213,4,2015,501,270,231,0.91683946,0.894402306,0.942985655,,,
2031,전남,화순군,2018,470,238,232,4,2016,486,240,246,0.987143062,1.010448175,0.964473592,,,
2032,전남,화순군,2019,450,226,224,4,2017,403,213,190,1.139792977,1.081128122,1.20567951,,,
2033,전남,화순군,2020,378,199,179,4,2018,367,183,184,1.051342557,1.108026929,0.994884514,,,
2034,전북,고창군,2010,366,202,164,4,2008,363,187,176,1.029183866,1.100672438,0.952946772,,,
2035,전북,고창군,2011,343,180,163,4,2009,320,168,152,1.09411419,1.091720718,1.096683929,,,
2036,전북,고창군,2012,321,169,152,4,2010,346,186,160,0.946994469,0.925810472,0.971540855,,,
2037,전북,고창군,2013,335,176,159,4,2011,381,203,178,0.897508025,0.883415385,0.91351269,,,
2038,전북,고창군,2014,394,205,189,4,2012,364,183,181,1.104875509,1.141434776,1.067875671,,,
2039,전북,고창군,2015,351,177,174,4,2013,357,180,177,1.003592505,1.001957014,1.005341117,,,
2040,전북,고창군,2016,346,171,175,4,2014,374,210,164,0.944328301,0.829707745,1.091268611,,,
2041,전북,고창군,2017,348,194,154,4,2015,373,206,167,0.952333192,0.959583647,0.943065185,,,
2042,전북,고창군,2018,362,196,166,4,2016,356,187,169,1.037951549,1.067979197,1.004520597,,,
2043,전북,고창군,2019,324,171,153,4,2017,316,171,145,1.046589652,1.018939336,1.079098009,,,
2044,전북,고창군,2020,273,146,127,4,2018,328,179,149,0.849585932,0.831090185,0.871675652,,,
2045,전북,군산시,2010,2729,1395,1334,4,2008,2605,1343,1262,1.069336318,1.058391939,1.081020519,,,
2046,전북,군산시,2011,2645,1358,1287,4,2009,2485,1264,1221,1.086470133,1.094714888,1.077954291,,,
2047,전북,군산시,2012,2525,1277,1248,4,2010,2519,1307,1212,1.02317925,0.995551287,1.053051057,,,
2048,전북,군산시,2013,2525,1302,1223,4,2011,2820,1438,1382,0.913967564,0.922572334,0.905015207,,,
2049,전북,군산시,2014,2801,1417,1384,4,2012,2658,1408,1250,1.075664018,1.025452443,1.1323053,,,
2050,전북,군산시,2015,2618,1379,1239,4,2013,2670,1353,1317,1.000868198,1.038519841,0.962106158,,,
2051,전북,군산시,2016,2597,1327,1270,4,2014,2797,1416,1381,0.947759164,0.954895833,0.940475541,,,
2052,전북,군산시,2017,2708,1366,1342,4,2015,2831,1450,1381,0.976398941,0.959911127,0.993793839,,,
2053,전북,군산시,2018,2721,1402,1319,4,2016,2791,1457,1334,0.995146945,0.9804756,1.011175245,,,
2054,전북,군산시,2019,2706,1416,1290,4,2017,2622,1342,1280,1.053449239,1.075125261,1.030664229,,,
2055,전북,군산시,2020,2503,1277,1226,4,2018,2535,1300,1235,1.007862752,1.000911948,1.015221895,,,
2056,전북,김제시,2010,640,320,320,4,2008,705,333,372,0.926636421,0.979160924,0.879720072,,,
2057,전북,김제시,2011,632,321,311,4,2009,592,329,263,1.089717387,0.994162696,1.209322417,,,
2058,전북,김제시,2012,552,299,253,4,2010,641,347,294,0.879021621,0.877990956,0.8800567,,,
2059,전북,김제시,2013,645,347,298,4,2011,690,326,364,0.954177415,1.084576533,0.837244577,,,
2060,전북,김제시,2014,669,335,334,4,2012,606,319,287,1.126865292,1.070046012,1.19015091,,,
2061,전북,김제시,2015,606,316,290,4,2013,620,328,292,0.997698786,0.981661068,1.015669964,,,
2062,전북,김제시,2016,591,299,292,4,2014,589,287,302,1.02421397,1.061543072,0.988811187,,,
2063,전북,김제시,2017,602,299,303,4,2015,635,310,325,0.96770119,0.982783424,0.953447381,,,
2064,전북,김제시,2018,658,318,340,4,2016,623,332,291,1.078093322,0.975972015,1.194877521,,,
2065,전북,김제시,2019,607,316,291,4,2017,512,277,235,1.210144522,1.162400109,1.266375762,,,
2066,전북,김제시,2020,490,268,222,4,2018,495,263,232,1.010437347,1.038310807,0.978593783,,,
2067,전북,남원시,2010,783,412,371,4,2008,780,407,373,1.024673886,1.031457019,1.017191074,,,
2068,전북,남원시,2011,780,405,375,4,2009,716,371,345,1.111987971,1.112319222,1.111602809,,,
2069,전북,남원시,2012,729,371,358,4,2010,697,350,347,1.067611539,1.080075697,1.055093663,,,
2070,전북,남원시,2013,697,354,343,4,2011,716,362,354,0.993661046,0.99642134,0.99089656,,,
2071,전북,남원시,2014,729,365,364,4,2012,731,395,336,1.017955189,0.941551539,1.107897466,,,
2072,전북,남원시,2015,729,382,347,4,2013,626,339,287,1.188698471,1.148185329,1.236474149,,,
2073,전북,남원시,2016,616,332,284,4,2014,689,350,339,0.912599022,0.966536742,0.856753929,,,
2074,전북,남원시,2017,686,348,338,4,2015,652,317,335,1.073977119,1.118583246,1.031832864,,,
2075,전북,남원시,2018,638,327,311,4,2016,587,322,265,1.109433017,1.034761376,1.200195455,,,
2076,전북,남원시,2019,572,310,262,4,2017,569,300,269,1.026129732,1.052903981,0.996062234,,,
2077,전북,남원시,2020,531,276,255,4,2018,551,295,256,0.983697191,0.953312735,1.018679762,,,
2078,전북,무주군,2010,161,84,77,4,2008,198,97,101,0.830002107,0.882380456,0.779662802,,,
2079,전북,무주군,2011,177,90,87,4,2009,191,89,102,0.945928712,1.030388093,0.872281263,,,
2080,전북,무주군,2012,183,88,95,4,2010,188,98,90,0.993600381,0.914965935,1.079489839,,,
2081,전북,무주군,2013,170,89,81,4,2011,221,106,115,0.785190717,0.855524537,0.72031862,,,
2082,전북,무주군,2014,210,100,110,4,2012,193,101,92,1.110658372,1.008850828,1.22276309,,,
2083,전북,무주군,2015,167,83,84,4,2013,197,87,110,0.865304085,0.972091551,0.780951501,,,
2084,전북,무주군,2016,178,75,103,4,2014,185,105,80,0.982125038,0.727813812,1.316693527,,,
2085,전북,무주군,2017,164,90,74,4,2015,183,96,87,0.914768639,0.955255628,0.869861141,,,
2086,전북,무주군,2018,165,85,80,4,2016,158,86,72,1.065970942,1.007091205,1.136305093,,,
2087,전북,무주군,2019,155,84,71,4,2017,137,71,66,1.1548608,1.205505694,1.100149931,,,
2088,전북,무주군,2020,123,65,58,4,2018,146,93,53,0.859945176,0.712161902,1.119153318,,,
2089,전북,부안군,2010,399,203,196,4,2008,388,199,189,1.049686663,1.039420529,1.060551421,,,
2090,전북,부안군,2011,395,204,191,4,2009,359,176,183,1.123107057,1.181043322,1.06738167,,,
2091,전북,부안군,2012,330,162,168,4,2010,336,182,154,1.002520291,0.906967981,1.115645001,,,
2092,전북,부안군,2013,313,166,147,4,2011,376,195,181,0.849718359,0.867404768,0.830569966,,,
2093,전북,부안군,2014,353,177,176,4,2012,352,179,173,1.023647785,1.007554539,1.040408825,,,
2094,전북,부안군,2015,335,173,162,4,2013,358,181,177,0.955169155,0.973903344,0.936007246,,,
2095,전북,부안군,2016,317,156,161,4,2014,364,186,178,0.888948062,0.854594282,0.925003416,,,
2096,전북,부안군,2017,341,182,159,4,2015,368,195,173,0.945856101,0.951010047,0.939914791,,,
2097,전북,부안군,2018,328,173,155,4,2016,346,190,156,0.967645439,0.92777108,1.016118978,,,
2098,전북,부안군,2019,306,167,139,4,2017,324,162,162,0.964039714,1.050388081,0.877480044,,,
2099,전북,부안군,2020,279,146,133,4,2018,291,146,145,0.978655234,1.018939336,0.938039446,,,
2100,전북,순창군,2010,211,102,109,4,2008,237,128,109,0.908767147,0.811967284,1.022674584,,,
2101,전북,순창군,2011,201,109,92,4,2009,219,110,109,0.936850842,1.009676251,0.863174878,,,
2102,전북,순창군,2012,188,103,85,4,2010,208,115,93,0.922599093,0.912615232,0.934702577,,,
2103,전북,순창군,2013,177,96,81,4,2011,229,117,112,0.788962376,0.836052789,0.739612869,,,
2104,전북,순창군,2014,208,111,97,4,2012,199,88,111,1.066912412,1.285253027,0.893688601,,,
2105,전북,순창군,2015,187,85,102,4,2013,209,113,96,0.913300782,0.766458793,1.086591746,,,
2106,전북,순창군,2016,181,94,87,4,2014,216,115,101,0.855348962,0.832872153,0.880917711,,,
2107,전북,순창군,2017,192,104,88,4,2015,194,93,101,1.010224758,1.139459043,0.891043202,,,
2108,전북,순창군,2018,160,72,88,4,2016,193,107,86,0.846215903,0.685641423,1.046457714,,,
2109,전북,순창군,2019,153,87,66,4,2017,169,86,83,0.924109075,1.030787468,0.813211115,,,
2110,전북,순창군,2020,133,74,59,4,2018,150,79,71,0.905063167,0.954449505,0.849828176,,,
2111,전북,완주군,2010,854,446,408,4,2008,860,461,399,1.013626435,0.985785128,1.045742432,,,
2112,전북,완주군,2011,843,466,377,4,2009,836,428,408,1.029294865,1.109405913,0.944971368,,,
2113,전북,완주군,2012,876,469,407,4,2010,868,426,442,1.030155748,1.121790021,0.941693565,,,
2114,전북,완주군,2013,871,444,427,4,2011,903,471,432,0.984575248,0.960528801,1.010838073,,,
2115,전북,완주군,2014,916,475,441,4,2012,923,476,447,1.013006616,1.016798707,1.008947408,,,
2116,전북,완주군,2015,904,477,427,4,2013,876,441,435,1.053374579,1.102118058,1.003866776,,,
2117,전북,완주군,2016,848,443,405,4,2014,1008,542,466,0.858724451,0.832823111,0.888805164,,,
2118,전북,완주군,2017,898,504,394,4,2015,1026,556,470,0.893403161,0.923642852,0.857305928,,,
2119,전북,완주군,2018,829,451,378,4,2016,1057,535,522,0.800567678,0.858956338,0.740557457,,,
2120,전북,완주군,2019,822,445,377,4,2017,966,472,494,0.86858675,0.960652552,0.780462183,,,
2121,전북,완주군,2020,702,343,359,4,2018,864,431,433,0.829357695,0.810896038,0.847898789,,,
2122,전북,익산시,2010,3100,1563,1537,4,2008,2959,1500,1459,1.069387831,1.061734788,1.077348071,,,
2123,전북,익산시,2011,2858,1466,1392,4,2009,2759,1475,1284,1.057374988,1.012722079,1.108693942,,,
2124,전북,익산시,2012,2678,1414,1264,4,2010,2659,1356,1303,1.028041731,1.062522287,0.992064984,,,
2125,전북,익산시,2013,2643,1329,1314,4,2011,2950,1496,1454,0.914520944,0.905194103,0.924205229,,,
2126,전북,익산시,2014,2933,1492,1441,4,2012,2704,1375,1329,1.107194411,1.105641811,1.10885935,,,
2127,전북,익산시,2015,2674,1393,1281,4,2013,2545,1264,1281,1.072487219,1.12292919,1.022674584,,,
2128,전북,익산시,2016,2534,1282,1252,4,2014,2692,1384,1308,0.960837764,0.943844096,0.978890351,,,
2129,전북,익산시,2017,2651,1344,1307,4,2015,2694,1351,1343,1.004455371,1.013659858,0.995261118,,,
2130,전북,익산시,2018,2610,1309,1301,4,2016,2782,1439,1343,0.957639146,0.926887833,0.990692207,,,
2131,전북,익산시,2019,2591,1322,1269,4,2017,2339,1232,1107,1.13072163,1.09337484,1.172334279,,,
2132,전북,익산시,2020,2153,1149,1004,4,2018,2202,1151,1051,0.998033741,1.017168808,0.976941277,,,
2133,전북,임실군,2010,214,122,92,4,2008,167,97,70,1.308024297,1.281552567,1.344086596,,,
2134,전북,임실군,2011,173,97,76,4,2009,155,77,78,1.139286402,1.283598904,0.996452159,,,
2135,전북,임실군,2012,149,80,69,4,2010,176,91,85,0.86415592,0.895770845,0.830171133,,,
2136,전북,임실군,2013,166,82,84,4,2011,194,99,95,0.873423489,0.843969955,0.904259632,,,
2137,전북,임실군,2014,163,84,79,4,2012,208,110,98,0.799913043,0.77809913,0.82440094,,,
2138,전북,임실군,2015,203,103,100,4,2013,197,102,95,1.051836702,1.028928938,1.076499562,,,
2139,전북,임실군,2016,163,84,79,4,2014,176,88,88,0.945351778,0.972623912,0.918082865,,,
2140,전북,임실군,2017,164,78,86,4,2015,176,93,83,0.951151483,0.854594282,1.059638726,,,
2141,전북,임실군,2018,158,91,67,4,2016,195,102,93,0.827067556,0.909053722,0.736765561,,,
2142,전북,임실군,2019,144,69,75,4,2017,184,87,97,0.798846208,0.808124301,0.790727771,,,
2143,전북,임실군,2020,139,64,75,4,2018,169,93,76,0.839550075,0.701205565,1.00921834,,,
2144,전북,장수군,2010,150,73,77,4,2008,183,93,90,0.836678633,0.799812597,0.874954922,,,
2145,전북,장수군,2011,162,82,80,4,2009,163,84,79,1.014485675,0.994678876,1.035619832,,,
2146,전북,장수군,2012,156,81,75,4,2010,150,73,77,1.06157785,1.130603921,0.996111608,,,
2147,전북,장수군,2013,134,71,63,4,2011,189,84,105,0.723704883,0.861246344,0.61360475,,,
2148,전북,장수군,2014,179,76,103,4,2012,193,98,95,0.946704041,0.790197853,1.108794549,,,
2149,전북,장수군,2015,187,92,95,4,2013,138,75,63,1.383187416,1.249898919,1.542128341,,,
2150,전북,장수군,2016,146,78,68,4,2014,193,109,84,0.772172011,0.72914925,0.827879425,,,
2151,전북,장수군,2017,165,90,75,4,2015,174,85,89,0.967950626,1.078876944,0.861804425,,,
2152,전북,장수군,2018,161,78,83,4,2016,165,87,78,0.996002528,0.913531819,1.088230647,,,
2153,전북,장수군,2019,150,76,74,4,2017,165,95,70,0.927952666,0.815151469,1.081113132,,,
2154,전북,장수군,2020,136,75,61,4,2018,133,65,68,1.043772322,1.175699234,0.917399259,,,
2155,전북,전주시,2010,6857,3544,3313,4,2008,6479,3331,3148,1.080300752,1.084095169,1.076277286,,,
2156,전북,전주시,2011,6546,3346,3200,4,2009,6024,3226,2798,1.109199198,1.056841606,1.169606386,,,
2157,전북,전주시,2012,5995,3233,2762,4,2010,5942,3102,2840,1.029852551,1.061969979,0.994587043,,,
2158,전북,전주시,2013,5965,3098,2867,4,2011,6621,3525,3096,0.919613566,0.895510373,0.947031018,,,
2159,전북,전주시,2014,6669,3510,3159,4,2012,6215,3215,3000,1.095312625,1.112434548,1.076876337,,,
2160,전북,전주시,2015,6339,3241,3098,4,2013,5925,3061,2864,1.092071079,1.078857363,1.106231097,,,
2161,전북,전주시,2016,6041,3100,2941,4,2014,6358,3292,3066,0.969855027,0.959511526,0.980980415,,,
2162,전북,전주시,2017,6505,3346,3159,4,2015,6290,3199,3091,1.055638363,1.065761494,1.045172763,,,
2163,전북,전주시,2018,6532,3266,3266,4,2016,6423,3289,3134,1.038070294,1.011813886,1.065748306,,,
2164,전북,전주시,2019,6708,3435,3273,4,2017,5783,2963,2820,1.184018179,1.181254344,1.186955289,,,
2165,전북,전주시,2020,6166,3157,3009,4,2018,5791,2990,2801,1.086847134,1.075849995,1.098617574,,,
2166,전북,정읍시,2010,1069,554,515,4,2008,995,517,478,1.096662854,1.091861494,1.101835587,,,
2167,전북,정읍시,2011,982,519,463,4,2009,962,478,484,1.041969303,1.106337899,0.97830234,,,
2168,전북,정읍시,2012,935,468,467,4,2010,884,457,427,1.079637236,1.043465228,1.118475482,,,
2169,전북,정읍시,2013,855,453,402,4,2011,995,504,491,0.877125108,0.91583238,0.837301798,,,
2170,전북,정읍시,2014,963,488,475,4,2012,886,468,418,1.109458532,1.062483752,1.162130209,,,
2171,전북,정읍시,2015,866,453,413,4,2013,820,449,371,1.078009402,1.028016747,1.138449065,,,
2172,전북,정읍시,2016,812,458,354,4,2014,857,435,422,0.967149733,1.07281429,0.857883419,,,
2173,전북,정읍시,2017,829,434,395,4,2015,903,466,437,0.9370986,0.948969253,0.924385494,,,
2174,전북,정읍시,2018,873,455,418,4,2016,864,444,420,1.031380723,1.044183329,1.017804705,,,
2175,전북,정읍시,2019,858,446,412,4,2017,745,385,360,1.175572787,1.180381673,1.170394246,,,
2176,전북,정읍시,2020,698,365,333,4,2018,743,374,369,0.958926052,0.994419406,0.922901454,,,
2177,전북,진안군,2010,159,84,75,4,2008,180,99,81,0.901660674,0.864554588,0.946920911,,,
2178,전북,진안군,2011,156,82,74,4,2009,172,94,78,0.925794636,0.888861974,0.970229734,,,
2179,전북,진안군,2012,140,71,69,4,2010,196,105,91,0.729105666,0.688997075,0.775434575,,,
2180,전북,진안군,2013,169,88,81,4,2011,208,105,103,0.829357695,0.853968206,0.804239236,,,
2181,전북,진안군,2014,163,81,82,4,2012,190,98,92,0.875694279,0.842184554,0.911514303,,,
2182,전북,진안군,2015,135,68,67,4,2013,186,98,88,0.740865435,0.707019131,0.77862724,,,
2183,전북,진안군,2016,152,80,72,4,2014,192,100,92,0.808092113,0.815151469,0.800354022,,,
2184,전북,진안군,2017,166,85,81,4,2015,192,105,87,0.88252165,0.824855653,0.952145302,,,
2185,전북,진안군,2018,146,85,61,4,2016,184,87,97,0.809941294,0.995515444,0.643125254,,,
2186,전북,진안군,2019,148,67,81,4,2017,147,69,78,1.027691796,0.989404863,1.062008222,,,
2187,전북,진안군,2020,116,50,66,4,2018,133,58,75,0.890276392,0.87839598,0.899953634,,,
2188,제주,서귀포시,2010,1382,729,653,4,2008,1455,796,659,0.96953515,0.933174342,1.013363435,,,
2189,제주,서귀포시,2011,1385,763,622,4,2009,1354,746,608,1.044118085,1.042159134,1.046223012,,,
2190,제주,서귀포시,2012,1289,706,583,4,2010,1391,756,635,0.945897976,0.951549169,0.938928004,,,
2191,제주,서귀포시,2013,1314,703,611,4,2011,1469,732,737,0.913044781,0.978571521,0.847834696,,,
2192,제주,서귀포시,2014,1431,720,711,4,2012,1364,688,676,1.07088731,1.066331864,1.075623712,,,
2193,제주,서귀포시,2015,1407,723,684,4,2013,1340,662,678,1.071785329,1.112829517,1.031724802,,,
2194,제주,서귀포시,2016,1412,708,704,4,2014,1387,703,684,1.039146417,1.026186416,1.05257735,,,
2195,제주,서귀포시,2017,1515,769,746,4,2015,1491,785,706,1.037178483,0.998171146,1.080616487,,,
2196,제주,서귀포시,2018,1618,882,736,4,2016,1597,818,779,1.034170416,1.098660751,0.966223997,,,
2197,제주,서귀포시,2019,1624,828,796,4,2017,1507,756,751,1.099996445,1.115981178,1.083953354,,,
2198,제주,서귀포시,2020,1437,706,731,4,2018,1498,743,755,0.979182095,0.968198077,0.990165723,,,
2199,제주,제주시,2010,5083,2663,2420,4,2008,4673,2451,2222,1.110306386,1.107072808,1.113804002,,,
2200,제주,제주시,2011,4633,2438,2195,4,2009,4324,2280,2044,1.093692223,1.089550045,1.098224419,,,
2201,제주,제주시,2012,4458,2348,2110,4,2010,4487,2312,2175,1.014150721,1.034805174,0.992111895,,,
2202,제주,제주시,2013,4623,2403,2220,4,2011,4857,2518,2339,0.971570453,0.972403187,0.970644539,,,
2203,제주,제주시,2014,5147,2655,2492,4,2012,4537,2331,2206,1.157987571,1.16056797,1.155260682,,,
2204,제주,제주시,2015,4796,2467,2329,4,2013,4524,2366,2158,1.082119161,1.062435901,1.103711356,,,
2205,제주,제주시,2016,4774,2502,2272,4,2014,4866,2528,2338,1.001448958,1.008459739,0.993805242,,,
2206,제주,제주시,2017,5048,2629,2419,4,2015,4961,2550,2411,1.038648572,1.050506477,1.026067946,,,
2207,제주,제주시,2018,5182,2667,2515,4,2016,5316,2696,2620,0.995018019,1.007978935,0.981689534,,,
2208,제주,제주시,2019,5533,2821,2712,4,2017,4851,2459,2392,1.164254445,1.168941793,1.159487238,,,
2209,제주,제주시,2020,4989,2567,2422,4,2018,4962,2552,2410,1.026302184,1.0249284,1.02776674,,,
2210,충남,계룡시,2010,579,301,278,4,2008,530,284,246,1.115118968,1.079932184,1.155705424,,,
2211,충남,계룡시,2011,550,290,260,4,2009,526,270,256,1.067321983,1.094416324,1.038653874,,,
2212,충남,계룡시,2012,487,242,245,4,2010,570,304,266,0.872112707,0.81112934,0.941937117,,,
2213,충남,계룡시,2013,532,275,257,4,2011,566,280,286,0.959430919,1.000743991,0.918976812,,,
2214,충남,계룡시,2014,484,243,241,4,2012,482,235,247,1.024983401,1.053626633,0.997832287,,,
2215,충남,계룡시,2015,441,229,212,4,2013,475,266,209,0.94768387,0.877207173,1.037354124,,,
2216,충남,계룡시,2016,455,260,195,4,2014,472,252,220,0.983983706,1.051286617,0.906461563,,,
2217,충남,계룡시,2017,480,249,231,4,2015,475,256,219,1.031492648,0.991077714,1.078711548,,,
2218,충남,계룡시,2018,508,273,235,4,2016,475,234,241,1.091663052,1.188762559,0.997213806,,,
2219,충남,계룡시,2019,475,230,245,4,2017,460,236,224,1.054033191,0.993034099,1.118550326,,,
2220,충남,계룡시,2020,419,194,225,4,2018,421,207,214,1.015898774,0.954947977,1.075241969,,,
2221,충남,공주시,2010,981,496,485,4,2008,924,491,433,1.083716149,1.029315501,1.145490008,,,
2222,충남,공주시,2011,925,503,422,4,2009,858,437,421,1.100456687,1.172829488,1.02510374,,,
2223,충남,공주시,2012,832,413,419,4,2010,928,464,464,0.915153319,0.906943849,0.923492782,,,
2224,충남,공주시,2013,887,436,451,4,2011,970,518,452,0.933405584,0.857640059,1.02041203,,,
2225,충남,공주시,2014,871,466,405,4,2012,864,416,448,1.029017881,1.141408007,0.924516086,,,
2226,충남,공주시,2015,797,395,402,4,2013,827,410,417,0.983719592,0.981661068,0.985887729,,,
2227,충남,공주시,2016,731,380,351,4,2014,787,412,375,0.948115297,0.939798417,0.957223411,,,
2228,충남,공주시,2017,749,390,359,4,2015,781,400,381,0.978924714,0.993465853,0.963622508,,,
2229,충남,공주시,2018,735,364,371,4,2016,764,399,365,0.982002265,0.929558693,1.039485673,,,
2230,충남,공주시,2019,734,389,345,4,2017,685,376,309,1.093764938,1.054168622,1.141821138,,,
2231,충남,공주시,2020,670,353,317,4,2018,629,343,286,1.087283171,1.048646023,1.133523927,,,
2232,충남,금산군,2010,412,206,206,4,2008,378,195,183,1.112561239,1.076417966,1.151207455,,,
2233,충남,금산군,2011,370,191,179,4,2009,379,185,194,0.996508536,1.051986018,0.943601807,,,
2234,충남,금산군,2012,371,183,188,4,2010,404,216,188,0.937370007,0.863268049,1.022674584,,,
2235,충남,금산군,2013,377,201,176,4,2011,462,229,233,0.832947988,0.894352867,0.77249239,,,
2236,충남,금산군,2014,454,221,233,4,2012,406,202,204,1.141427491,1.114780165,1.168054795,,,
2237,충남,금산군,2015,378,200,178,4,2013,396,200,196,0.974350299,1.018939336,0.92875549,,,
2238,충남,금산군,2016,377,190,187,4,2014,417,221,196,0.922834462,0.876011194,0.975715037,,,
2239,충남,금산군,2017,400,218,182,4,2015,384,191,193,1.063279096,1.162977881,0.964387432,,,
2240,충남,금산군,2018,370,187,183,4,2016,345,180,165,1.094715174,1.058564755,1.134239084,,,
2241,충남,금산군,2019,322,179,143,4,2017,310,170,140,1.060260756,1.072883184,1.044589039,,,
2242,충남,금산군,2020,298,167,131,4,2018,270,132,138,1.126603274,1.289112645,0.970799786,,,
2243,충남,논산시,2010,1068,545,523,4,2008,1001,481,520,1.089069722,1.154515464,1.02857463,,,
2244,충남,논산시,2011,985,489,496,4,2009,931,472,459,1.079953505,1.055638423,1.105112405,,,
2245,충남,논산시,2012,939,483,456,4,2010,981,510,471,0.977046186,0.964995489,0.99010533,,,
2246,충남,논산시,2013,999,518,481,4,2011,1049,567,482,0.972094552,0.93088285,1.020552853,,,
2247,충남,논산시,2014,1065,564,501,4,2012,973,482,491,1.117262639,1.192285862,1.043502987,,,
2248,충남,논산시,2015,1009,512,497,4,2013,903,452,451,1.140569949,1.15419677,1.126982857,,,
2249,충남,논산시,2016,919,467,452,4,2014,880,453,427,1.065985625,1.050429735,1.082550145,,,
2250,충남,논산시,2017,918,495,423,4,2015,915,485,430,1.024094647,1.039948395,1.006026393,,,
2251,충남,논산시,2018,909,465,444,4,2016,917,460,457,1.011842825,1.030014764,0.993583185,,,
2252,충남,논산시,2019,905,466,439,4,2017,826,419,407,1.118373945,1.133235634,1.103081431,,,
2253,충남,논산시,2020,794,409,385,4,2018,816,409,407,0.993227768,1.018939336,0.967394877,,,
2254,충남,당진시,2014,1773,923,850,4,2012,1728,921,807,1.04732991,1.021152017,1.077166538,,,
2255,충남,당진시,2015,1734,925,809,4,2013,1732,857,875,1.021926625,1.099788665,0.945535701,,,
2256,충남,당진시,2016,1691,845,846,4,2014,1923,1011,912,0.897599976,0.851635746,0.948665239,,,
2257,충남,당진시,2017,1862,989,873,4,2015,1951,999,952,0.974183829,1.008739743,0.937809781,,,
2258,충남,당진시,2018,1865,967,898,4,2016,1943,1009,934,0.979770918,0.976525608,0.98325672,,,
2259,충남,당진시,2019,1871,975,896,4,2017,1825,923,902,1.046476374,1.076344369,1.015871871,,,
2260,충남,당진시,2020,1703,850,853,4,2018,1786,901,885,0.973311159,0.961263525,0.98569652,,,
2261,충남,보령시,2010,900,435,465,4,2008,920,481,439,0.99855776,0.921493994,1.083243011,,,
2262,충남,보령시,2011,888,471,417,4,2009,815,453,362,1.112176888,1.059426992,1.178053319,,,
2263,충남,보령시,2012,779,426,353,4,2010,876,455,421,0.907719908,0.95399595,0.857491991,,,
2264,충남,보령시,2013,813,434,379,4,2011,879,447,432,0.944104743,0.989305754,0.897207563,,,
2265,충남,보령시,2014,828,422,406,4,2012,859,428,431,0.983910696,1.00465514,0.963354713,,,
2266,충남,보령시,2015,836,424,412,4,2013,796,390,406,1.072041798,1.107769945,1.037788002,,,
2267,충남,보령시,2016,768,388,380,4,2014,812,424,388,0.965436468,0.932425619,1.00158851,,,
2268,충남,보령시,2017,797,412,385,4,2015,838,416,422,0.970806805,1.009141843,0.933008803,,,
2269,충남,보령시,2018,811,401,410,4,2016,766,399,367,1.080713542,1.024046802,1.142497492,,,
2270,충남,보령시,2019,726,374,352,4,2017,684,360,324,1.083425437,1.058564755,1.111053869,,,
2271,충남,보령시,2020,644,341,303,4,2018,732,343,389,0.898035066,1.012997999,0.796582003,,,
2272,충남,부여군,2010,536,279,257,4,2008,490,265,225,1.116573249,1.072770094,1.168121636,,,
2273,충남,부여군,2011,451,248,203,4,2009,481,234,247,0.95708382,1.079901519,0.840497735,,,
2274,충남,부여군,2012,451,220,231,4,2010,460,240,220,1.000776777,0.934027725,1.073808313,,,
2275,충남,부여군,2013,455,243,212,4,2011,456,237,219,1.01850945,1.044735269,0.989986355,,,
2276,충남,부여군,2014,442,230,212,4,2012,429,230,199,1.051679688,1.018939336,1.089482472,,,
2277,충남,부여군,2015,408,210,198,4,2013,412,205,207,1.010837758,1.043791515,0.978210472,,,
2278,충남,부여군,2016,377,200,177,4,2014,409,229,180,0.940885014,0.889903351,1.005630008,,,
2279,충남,부여군,2017,380,212,168,4,2015,385,214,171,1.007491466,1.009416539,1.004732925,,,
2280,충남,부여군,2018,359,198,161,4,2016,403,214,189,0.909301508,0.942756956,0.871167238,,,
2281,충남,부여군,2019,370,190,180,4,2017,337,183,154,1.120702478,1.057915158,1.195333929,,,
2282,충남,부여군,2020,314,176,138,4,2018,352,188,164,0.910553553,0.953900655,0.860543248,,,
2283,충남,서산시,2010,1714,911,803,4,2008,1692,897,795,1.034020069,1.034842514,1.032965649,,,
2284,충남,서산시,2011,1711,912,799,4,2009,1556,798,758,1.122429121,1.164502099,1.077990756,,,
2285,충남,서산시,2012,1492,762,730,4,2010,1620,831,789,0.940096244,0.934334265,0.946200819,,,
2286,충남,서산시,2013,1599,831,768,4,2011,1855,955,900,0.879879215,0.886637265,0.872682312,,,
2287,충남,서산시,2014,1873,967,906,4,2012,1718,914,804,1.112841023,1.07802444,1.152416882,,,
2288,충남,서산시,2015,1724,901,823,4,2013,1665,894,771,1.05691858,1.026917609,1.091648745,,,
2289,충남,서산시,2016,1641,884,757,4,2014,1807,934,873,0.926976955,0.964392263,0.886786552,,,
2290,충남,서산시,2017,1716,889,827,4,2015,1771,927,844,0.989047686,0.977170518,1.002075688,,,
2291,충남,서산시,2018,1716,904,812,4,2016,1838,955,883,0.952994261,0.964524775,0.940443672,,,
2292,충남,서산시,2019,1834,948,886,4,2017,1658,823,835,1.129102357,1.17369926,1.085137343,,,
2293,충남,서산시,2020,1655,816,839,4,2018,1719,903,816,0.982744519,0.920769101,1.051499971,,,
2294,충남,서천군,2010,405,215,190,4,2008,358,176,182,1.154756739,1.24472703,1.067627313,,,
2295,충남,서천군,2011,339,164,175,4,2009,380,192,188,0.910614603,0.870344016,0.951957725,,,
2296,충남,서천군,2012,360,180,180,4,2010,339,181,158,1.083980105,1.013309837,1.165072311,,,
2297,충남,서천군,2013,310,160,150,4,2011,341,166,175,0.927952666,0.982110204,0.876578215,,,
2298,충남,서천군,2014,328,166,162,4,2012,336,160,176,0.99644441,1.057149561,0.941325469,,,
2299,충남,서천군,2015,315,154,161,4,2013,313,162,151,1.027270284,0.968621344,1.090401378,,,
2300,충남,서천군,2016,293,149,144,4,2014,333,167,166,0.898135568,0.90911354,0.887139398,,,
2301,충남,서천군,2017,316,154,162,4,2015,338,173,165,0.954308718,0.907032704,1.004080501,,,
2302,충남,서천군,2018,306,156,150,4,2016,299,152,147,1.044645041,1.045753529,1.043545494,,,
2303,충남,서천군,2019,266,133,133,4,2017,278,133,145,0.976686871,1.018939336,0.938039446,,,
2304,충남,서천군,2020,261,127,134,4,2018,278,138,140,0.958328095,0.937719534,0.978845673,,,
2305,충남,아산시,2010,3124,1649,1475,4,2008,3132,1600,1532,1.018140658,1.050144354,0.984624681,,,
2306,충남,아산시,2011,3259,1634,1625,4,2009,3077,1573,1504,1.081123663,1.058453195,1.10495093,,,
2307,충남,아산시,2012,2953,1548,1405,4,2010,3368,1726,1642,0.894972876,0.913857528,0.875065646,,,
2308,충남,아산시,2013,3235,1662,1573,4,2011,3819,1972,1847,0.864655554,0.858761246,0.870962166,,,
2309,충남,아산시,2014,3701,1934,1767,4,2012,3705,1865,1840,1.01964591,1.05663736,0.982101082,,,
2310,충남,아산시,2015,3494,1782,1712,4,2013,3738,1892,1846,0.954118051,0.959698677,0.948439268,,,
2311,충남,아산시,2016,3564,1817,1747,4,2014,4062,2127,1935,0.895604538,0.870433838,0.923313953,,,
2312,충남,아산시,2017,3824,1990,1834,4,2015,4121,2123,1998,0.947182745,0.955105643,0.938731325,,,
2313,충남,아산시,2018,3957,2034,1923,4,2016,4273,2201,2072,0.94526084,0.941627719,0.949132831,,,
2314,충남,아산시,2019,4141,2111,2030,4,2017,3929,2045,1884,1.075825194,1.05182442,1.101926436,,,
2315,충남,아산시,2020,3646,1895,1751,4,2018,3668,1885,1783,1.014625671,1.02434485,1.004320357,,,
2316,충남,연기군,2010,736,382,354,4,2008,726,372,354,1.034807821,1.046330179,1.022674584,,,
2317,충남,연기군,2011,719,371,348,4,2009,710,348,362,1.033686991,1.086283028,0.983123633,,,
2318,충남,연기군,2012,783,388,395,4,2010,717,346,371,1.114707993,1.142625614,1.088831431,,,
2319,충남,연기군,2013,0,0,0,4,2011,828,416,412,0,0,0,,,
2320,충남,예산군,2010,580,282,298,4,2008,591,315,276,1.00174924,0.912193311,1.104192123,,,
2321,충남,예산군,2011,560,293,267,4,2009,567,299,268,1.008146106,0.998492393,1.018858634,,,
2322,충남,예산군,2012,539,281,258,4,2010,568,280,288,0.968632281,1.022578405,0.916145982,,,
2323,충남,예산군,2013,557,271,286,4,2011,640,355,285,0.888369685,0.777838198,1.026262916,,,
2324,충남,예산군,2014,614,338,276,4,2012,543,280,263,1.154215894,1.230005342,1.073225039,,,
2325,충남,예산군,2015,512,256,256,4,2013,528,278,250,0.989816177,0.938303849,1.047218774,,,
2326,충남,예산군,2016,484,264,220,4,2014,537,273,264,0.920003723,0.98534793,0.85222882,,,
2327,충남,예산군,2017,496,259,237,4,2015,517,263,254,0.979286218,1.00344216,0.95422786,,,
2328,충남,예산군,2018,497,262,235,4,2016,473,256,217,1.072540639,1.042820727,1.107504734,,,
2329,충남,예산군,2019,486,265,221,4,2017,427,216,211,1.161788045,1.250087612,1.071142574,,,
2330,충남,예산군,2020,441,229,212,4,2018,400,191,209,1.125374596,1.221660251,1.037354124,,,
2331,충남,천안시,2010,6122,3184,2938,4,2008,6326,3297,3029,0.98783099,0.984016635,0.991950455,,,
2332,충남,천안시,2011,6315,3307,3008,4,2009,5708,2926,2782,1.129296285,1.151617357,1.105753109,,,
2333,충남,천안시,2012,6027,3089,2938,4,2010,5988,3125,2863,1.02739609,1.007201155,1.049464872,,,
2334,충남,천안시,2013,6104,3190,2914,4,2011,6821,3517,3304,0.91345043,0.924201445,0.901959364,,,
2335,충남,천안시,2014,6797,3506,3291,4,2012,6610,3441,3169,1.04962537,1.038186955,1.062045458,,,
2336,충남,천안시,2015,6599,3425,3174,4,2013,6324,3262,3062,1.065135295,1.069855067,1.060081362,,,
2337,충남,천안시,2016,6326,3273,3053,4,2014,6611,3376,3235,0.976743522,0.987852028,0.96513926,,,
2338,충남,천안시,2017,6857,3517,3340,4,2015,6685,3488,3197,1.047011006,1.027411022,1.068418239,,,
2339,충남,천안시,2018,7076,3700,3376,4,2016,7130,3555,3575,1.013017163,1.06049945,0.965748083,,,
2340,충남,천안시,2019,7491,3751,3740,4,2017,6612,3373,3239,1.156446274,1.13312821,1.180859199,,,
2341,충남,천안시,2020,6790,3458,3332,4,2018,6731,3411,3320,1.029695211,1.032979251,1.026370998,,,
2342,충남,청양군,2010,189,103,86,4,2008,215,112,103,0.897308648,0.937060283,0.853883633,,,
2343,충남,청양군,2011,196,96,100,4,2009,174,87,87,1.149808016,1.124346854,1.175488028,,,
2344,충남,청양군,2012,159,86,73,4,2010,192,106,86,0.845306882,0.826686631,0.86808424,,,
2345,충남,청양군,2013,173,88,85,4,2011,180,84,96,0.98105218,1.067460257,0.905493121,,,
2346,충남,청양군,2014,162,76,86,4,2012,184,110,74,0.898701984,0.703994451,1.188513706,,,
2347,충남,청양군,2015,171,99,72,4,2013,167,72,95,1.045196985,1.401041587,0.775079685,,,
2348,충남,청양군,2016,144,63,81,4,2014,181,92,89,0.812086753,0.697751937,0.930748779,,,
2349,충남,청양군,2017,165,88,77,4,2015,191,105,86,0.881797952,0.853968206,0.9156505,,,
2350,충남,청양군,2018,169,89,80,4,2016,192,97,95,0.898470836,0.934903102,0.86119965,,,
2351,충남,청양군,2019,159,80,79,4,2017,168,84,84,0.966065008,0.970418416,0.961801097,,,
2352,충남,청양군,2020,143,74,69,4,2018,140,66,74,1.042621103,1.142447135,0.95357495,,,
2353,충남,태안군,2010,442,217,225,4,2008,435,215,220,1.037173761,1.028417842,1.045917188,,,
2354,충남,태안군,2011,436,219,217,4,2009,430,215,215,1.034990927,1.037896347,1.032187836,,,
2355,충남,태안군,2012,414,209,205,4,2010,434,218,216,0.973708857,0.976873033,0.970593934,,,
2356,충남,태안군,2013,429,212,217,4,2011,443,240,203,0.988489533,0.90006308,1.093203866,,,
2357,충남,태안군,2014,438,235,203,4,2012,427,216,211,1.047043547,1.108568259,0.983900192,,,
2358,충남,태안군,2015,429,217,212,4,2013,419,234,185,1.045109458,0.944913829,1.171929794,,,
2359,충남,태안군,2016,429,224,205,4,2014,354,193,161,1.237008088,1.182603168,1.30216329,,,
2360,충남,태안군,2017,349,189,160,4,2015,434,220,214,0.820831863,0.875361521,0.764616511,,,
2361,충남,태안군,2018,422,221,201,4,2016,421,206,215,1.023172512,1.093133948,0.95608182,,,
2362,충남,태안군,2019,392,186,206,4,2017,380,190,190,1.052982078,0.997487982,1.108794549,,,
2363,충남,태안군,2020,356,174,182,4,2018,332,157,175,1.09453694,1.129270347,1.063581567,,,
2364,충남,홍성군,2010,749,398,351,4,2008,726,363,363,1.053085677,1.117184176,0.98886716,,,
2365,충남,홍성군,2011,733,365,368,4,2009,678,333,345,1.103551968,1.116855429,1.09085289,,,
2366,충남,홍성군,2012,661,315,346,4,2010,661,334,327,1.020747933,0.960975721,1.082096043,,,
2367,충남,홍성군,2013,716,378,338,4,2011,704,361,343,1.038147045,1.066922629,1.007766791,,,
2368,충남,홍성군,2014,773,396,377,4,2012,706,353,353,1.117617779,1.143059425,1.092204867,,,
2369,충남,홍성군,2015,827,412,415,4,2013,696,339,357,1.212871466,1.238356952,1.188823396,,,
2370,충남,홍성군,2016,849,429,420,4,2014,744,376,368,1.1648051,1.162566424,1.167182949,,,
2371,충남,홍성군,2017,950,478,472,4,2015,794,429,365,1.221297904,1.135321685,1.322472339,,,
2372,충남,홍성군,2018,942,490,452,4,2016,923,485,438,1.041760078,1.029443866,1.055362813,,,
2373,충남,홍성군,2019,943,482,461,4,2017,852,453,399,1.129771479,1.084169448,1.181586424,,,
2374,충남,홍성군,2020,865,462,403,4,2018,836,445,391,1.056156653,1.057865109,1.054061016,,,
2375,충북,괴산군,2010,200,112,88,4,2008,186,83,103,1.097578422,1.374954285,0.873741392,,,
2376,충북,괴산군,2011,177,88,89,4,2009,165,73,92,1.094984146,1.228310433,0.9893265,,,
2377,충북,괴산군,2012,167,79,88,4,2010,160,79,81,1.065405655,1.018939336,1.111053869,,,
2378,충북,괴산군,2013,166,83,83,4,2011,206,94,112,0.82254445,0.899701754,0.757874915,,,
2379,충북,괴산군,2014,191,90,101,4,2012,185,89,96,1.053853271,1.030388093,1.075938885,,,
2380,충북,괴산군,2015,189,79,110,4,2013,199,96,103,0.969454067,0.838502162,1.09217674,,,
2381,충북,괴산군,2016,182,77,105,4,2014,196,110,86,0.947837366,0.713257535,1.248614318,,,
2382,충북,괴산군,2017,190,104,86,4,2015,153,68,85,1.267595472,1.558377809,1.03470605,,,
2383,충북,괴산군,2018,142,61,81,4,2016,187,97,90,0.775113403,0.640776284,0.920407126,,,
2384,충북,괴산군,2019,170,96,74,4,2017,142,68,74,1.222022173,1.438502593,1.022674584,,,
2385,충북,괴산군,2020,143,62,81,4,2018,164,81,83,0.890042405,0.779928875,0.998031823,,,
2386,충북,단양군,2010,203,103,100,4,2008,227,125,102,0.912827446,0.839606013,1.002622141,,,
2387,충북,단양군,2011,205,114,91,4,2009,222,111,111,0.94258255,1.046478237,0.838408893,,,
2388,충북,단양군,2012,200,106,94,4,2010,209,106,103,0.97679228,1.018939336,0.933314669,,,
2389,충북,단양군,2013,184,95,89,4,2011,207,103,104,0.907331496,0.939798417,0.875173442,,,
2390,충북,단양군,2014,211,108,103,4,2012,187,90,97,1.151753015,1.222727204,1.085932806,,,
2391,충북,단양군,2015,182,86,96,4,2013,186,102,84,0.998796364,0.859105715,1.168770953,,,
2392,충북,단양군,2016,175,100,75,4,2014,162,95,67,1.102659804,1.072567722,1.144784982,,,
2393,충북,단양군,2017,152,88,64,4,2015,164,93,71,0.946059059,0.964157652,0.921847512,,,
2394,충북,단양군,2018,164,92,72,4,2016,160,81,79,1.046266631,1.157313814,0.932057849,,,
2395,충북,단양군,2019,155,78,77,4,2017,136,71,65,1.163352423,1.119398144,1.211476046,,,
2396,충북,단양군,2020,117,60,57,4,2018,136,77,59,0.878143442,0.793978704,0.988007649,,,
2397,충북,보은군,2010,209,90,119,4,2008,207,102,105,1.030610231,0.89906412,1.159031195,,,
2398,충북,보은군,2011,210,113,97,4,2009,203,114,89,1.055946137,1.010001272,1.114600389,,,
2399,충북,보은군,2012,199,108,91,4,2010,191,109,82,1.063501773,1.009591269,1.134919356,,,
2400,충북,보은군,2013,188,103,85,4,2011,186,103,83,1.031723717,1.018939336,1.047317345,,,
2401,충북,보은군,2014,191,115,76,4,2012,198,105,93,0.984660884,1.115981178,0.835734069,,,
2402,충북,보은군,2015,180,100,80,4,2013,185,90,95,0.993160151,1.132154818,0.86119965,,,
2403,충북,보은군,2016,196,101,95,4,2014,167,101,66,1.198003562,1.018939336,1.472031598,,,
2404,충북,보은군,2017,185,110,75,4,2015,194,97,97,0.973393647,1.155498216,0.790727771,,,
2405,충북,보은군,2018,202,101,101,4,2016,194,104,90,1.062840631,0.989546856,1.147668144,,,
2406,충북,보은군,2019,184,93,91,4,2017,158,73,85,1.188719111,1.298100798,1.094863378,,,
2407,충북,보은군,2020,146,67,79,4,2018,156,82,74,0.955315373,0.832547994,1.091774218,,,
2408,충북,영동군,2010,339,163,176,4,2008,331,164,167,1.045418577,1.012726292,1.077788783,,,
2409,충북,영동군,2011,320,162,158,4,2009,298,158,140,1.096105162,1.044735269,1.154161316,,,
2410,충북,영동군,2012,295,154,141,4,2010,287,149,138,1.049200837,1.053131932,1.04490664,,,
2411,충북,영동군,2013,296,150,146,4,2011,360,191,169,0.839281633,0.800214139,0.883494019,,,
2412,충북,영동군,2014,343,178,165,4,2012,304,169,135,1.151699148,1.073202378,1.249935603,,,
2413,충북,영동군,2015,294,159,135,4,2013,305,164,141,0.983934073,0.987874113,0.979156517,,,
2414,충북,영동군,2016,272,143,129,4,2014,352,199,153,0.788759766,0.732202639,0.862255042,,,
2415,충북,영동군,2017,298,181,117,4,2015,299,156,143,1.01733406,1.182230897,0.836733751,,,
2416,충북,영동군,2018,279,141,138,4,2016,303,143,160,0.939896611,1.004688437,0.882056829,,,
2417,충북,영동군,2019,266,132,134,4,2017,255,135,120,1.064780196,0.99629624,1.141986619,,,
2418,충북,영동군,2020,224,113,111,4,2018,261,122,139,0.876044203,0.94377168,0.816668193,,,
2419,충북,옥천군,2010,408,221,187,4,2008,421,222,199,0.9892284,1.01434952,0.961005765,,,
2420,충북,옥천군,2011,392,191,201,4,2009,365,175,190,1.096255314,1.112099504,1.08188206,,,
2421,충북,옥천군,2012,354,176,178,4,2010,392,199,193,0.921797878,0.901172478,0.943192103,,,
2422,충북,옥천군,2013,374,198,176,4,2011,438,218,220,0.87159755,0.925458663,0.818139667,,,
2423,충북,옥천군,2014,396,200,196,4,2012,370,188,182,1.092476166,1.083978017,1.10134186,,,
2424,충북,옥천군,2015,357,183,174,4,2013,376,191,185,0.969167585,0.976261249,0.961866906,,,
2425,충북,옥천군,2016,350,179,171,4,2014,350,190,160,1.020747933,0.959948112,1.092983462,,,
2426,충북,옥천군,2017,362,195,167,4,2015,389,220,169,0.949899104,0.903150775,1.010571926,,,
2427,충북,옥천군,2018,379,210,169,4,2016,328,161,167,1.179461788,1.329051308,1.034922184,,,
2428,충북,옥천군,2019,334,163,171,4,2017,288,151,137,1.183784061,1.099914648,1.276477036,,,
2429,충북,옥천군,2020,272,148,124,4,2018,309,148,161,0.898522452,1.018939336,0.78764999,,,
2430,충북,음성군,2010,824,427,397,4,2008,880,467,413,0.955791246,0.931664018,0.98305523,,,
2431,충북,음성군,2011,786,443,343,4,2009,785,399,386,1.022048248,1.131303574,0.908749695,,,
2432,충북,음성군,2012,720,376,344,4,2010,793,394,399,0.926782486,0.972388808,0.881704403,,,
2433,충북,음성군,2013,727,349,378,4,2011,877,461,416,0.846161627,0.771387914,0.929257194,,,
2434,충북,음성군,2014,836,436,400,4,2012,806,414,392,1.058741032,1.073085871,1.043545494,,,
2435,충북,음성군,2015,797,413,384,4,2013,791,420,371,1.028490648,1.001957014,1.058509543,,,
2436,충북,음성군,2016,785,427,358,4,2014,845,457,388,0.948268789,0.95205054,0.943601807,,,
2437,충북,음성군,2017,823,454,369,4,2015,875,477,398,0.960086341,0.96980809,0.948158094,,,
2438,충북,음성군,2018,801,428,373,4,2016,894,493,401,0.914562745,0.884596422,0.951265885,,,
2439,충북,음성군,2019,756,411,345,4,2017,763,395,368,1.011383273,1.060212828,0.958757423,,,
2440,충북,음성군,2020,670,340,330,4,2018,694,352,342,0.985448292,0.984202768,0.986791265,,,
2441,충북,제천시,2010,1162,605,557,4,2008,1130,606,524,1.049654069,1.017257918,1.087079663,,,
2442,충북,제천시,2011,1162,618,544,4,2009,1028,527,501,1.153802624,1.194885218,1.110449049,,,
2443,충북,제천시,2012,1053,536,517,4,2010,1067,551,516,1.007354801,0.991200516,1.024656512,,,
2444,충북,제천시,2013,1082,562,520,4,2011,1134,582,552,0.973941149,0.983924239,0.963389101,,,
2445,충북,제천시,2014,1105,568,537,4,2012,1115,598,517,1.011593243,0.967821978,1.062236464,,,
2446,충북,제천시,2015,1079,572,507,4,2013,1026,517,509,1.073476627,1.127337138,1.018656216,,,
2447,충북,제천시,2016,993,496,497,4,2014,1108,538,570,0.914803878,0.939393886,0.891700471,,,
2448,충북,제천시,2017,1061,511,550,4,2015,1082,553,529,1.000936743,0.941551539,1.063272252,,,
2449,충북,제천시,2018,1057,524,533,4,2016,1116,574,542,0.96678366,0.930181554,1.005692903,,,
2450,충북,제천시,2019,1078,536,542,4,2017,964,476,488,1.141458788,1.147377068,1.135839395,,,
2451,충북,제천시,2020,931,477,454,4,2018,1022,507,515,0.929859418,0.958647068,0.901542255,,,
2452,충북,증평군,2010,311,165,146,4,2008,348,171,177,0.912220135,0.983187079,0.843562086,,,
2453,충북,증평군,2011,332,165,167,4,2009,345,175,170,0.982284967,0.960714231,1.004627386,,,
2454,충북,증평군,2012,319,163,156,4,2010,330,173,157,0.986723001,0.960041109,1.016160733,,,
2455,충북,증평군,2013,323,172,151,4,2011,389,208,181,0.847561908,0.842584451,0.853170509,,,
2456,충북,증평군,2014,367,192,175,4,2012,385,203,182,0.973024653,0.963725875,0.983340946,,,
2457,충북,증평군,2015,352,183,169,4,2013,368,194,174,0.976367588,0.961164426,0.993287383,,,
2458,충북,증평군,2016,341,193,148,4,2014,436,228,208,0.798337259,0.86252321,0.7276723,,,
2459,충북,증평군,2017,397,214,183,4,2015,402,213,189,1.008052063,1.023723089,0.990208724,,,
2460,충북,증평군,2018,381,192,189,4,2016,418,208,210,0.930394647,0.940559387,0.920407126,,,
2461,충북,증평군,2019,369,188,181,4,2017,423,228,195,0.890439686,0.840178049,0.949251793,,,
2462,충북,증평군,2020,355,184,171,4,2018,384,171,213,0.943660198,1.096402561,0.821020441,,,
2463,충북,진천군,2010,632,336,296,4,2008,653,363,290,0.987921429,0.94315046,1.043833369,,,
2464,충북,진천군,2011,644,356,288,4,2009,586,319,267,1.121777591,1.137123523,1.103109664,,,
2465,충북,진천군,2012,598,325,273,4,2010,547,291,256,1.115918215,1.137990668,1.090586568,,,
2466,충북,진천군,2013,564,300,264,4,2011,700,357,343,0.822431191,0.856251543,0.787131458,,,
2467,충북,진천군,2014,698,355,343,4,2012,613,339,274,1.162287205,1.067030868,1.280209425,,,
2468,충북,진천군,2015,670,369,301,4,2013,567,280,287,1.206174806,1.342816483,1.072561149,,,
2469,충북,진천군,2016,681,325,356,4,2014,639,327,312,1.087839346,1.012707291,1.166897923,,,
2470,충북,진천군,2017,767,392,375,4,2015,696,353,343,1.124875954,1.131513371,1.118084458,,,
2471,충북,진천군,2018,852,437,415,4,2016,702,360,342,1.238856465,1.236879139,1.240964773,,,
2472,충북,진천군,2019,904,455,449,4,2017,705,348,357,1.308873945,1.332233902,1.286220976,,,
2473,충북,진천군,2020,837,415,422,4,2018,772,412,360,1.106691735,1.026358798,1.198801874,,,
2474,충북,청원군,2010,1453,777,676,4,2008,1711,864,847,0.86683036,0.916337806,0.816207814,,,
2475,충북,청원군,2011,1558,793,765,4,2009,1534,816,718,1.036717913,0.990219233,1.089618464,,,
2476,충북,청원군,2012,1530,813,717,4,2010,1632,819,813,0.956951187,1.011474579,0.901915962,,,
2477,충북,청원군,2013,1618,825,793,4,2011,1957,1016,941,0.843929563,0.827386764,0.861828847,,,
2478,충북,청원군,2014,1759,922,837,4,2012,1845,943,902,0.973168354,0.996248216,0.948978522,,,
2479,충북,청원군,2015,0,0,0,4,2013,1791,953,838,0,0,0,,,
2480,충북,청주시,2010,7191,3773,3418,4,2008,6759,3537,3222,1.085988812,1.086926241,1.084885701,,,
2481,충북,청주시,2011,6977,3643,3334,4,2009,6334,3250,3084,1.124369802,1.142152616,1.10557622,,,
2482,충북,청주시,2012,6402,3293,3109,4,2010,6568,3346,3222,0.994949492,1.002799532,0.986807971,,,
2483,충북,청주시,2013,6508,3290,3218,4,2011,7227,3742,3485,0.919195731,0.895860614,0.944323332,,,
2484,충북,청주시,2014,7226,3741,3485,4,2012,6803,3458,3345,1.084216458,1.10232853,1.065477108,,,
2485,충북,청주시,2015,8391,4303,4088,4,2013,6697,3508,3189,1.278945185,1.249856318,1.310973252,,,
2486,충북,청주시,2016,8134,4263,3871,4,2014,8843,4553,4290,0.938908027,0.954038742,0.922790983,,,
2487,충북,청주시,2017,8554,4407,4147,4,2015,8785,4415,4370,0.993907549,1.017093014,0.970487758,,,
2488,충북,청주시,2018,8496,4284,4212,4,2016,9141,4671,4470,0.948722726,0.934518544,0.963647729,,,
2489,충북,청주시,2019,8854,4511,4343,4,2017,8228,4219,4009,1.098408142,1.089460855,1.107876208,,,
2490,충북,청주시,2020,8056,4118,3938,4,2018,7938,4005,3933,1.03592156,1.047688436,1.023974704,,,
2491,충북,충주시,2010,1918,977,941,4,2008,1841,955,886,1.063440812,1.042412284,1.086158898,,,
2492,충북,충주시,2011,1818,948,870,4,2009,1643,866,777,1.129470323,1.11542089,1.14507965,,,
2493,충북,충주시,2012,1624,845,779,4,2010,1694,872,822,0.978568266,0.987389609,0.969177009,,,
2494,충북,충주시,2013,1676,865,811,4,2011,1847,982,865,0.926244469,0.897538214,0.958831315,,,
2495,충북,충주시,2014,1837,957,880,4,2012,1730,916,814,1.083880897,1.064546883,1.105594145,,,
2496,충북,충주시,2015,1701,902,799,4,2013,1588,802,786,1.093383018,1.145989129,1.039589049,,,
2497,충북,충주시,2016,1594,789,805,4,2014,1736,860,876,0.937253574,0.9348176,0.939786576,,,
2498,충북,충주시,2017,1738,874,864,4,2015,1731,928,803,1.02487574,0.959647608,1.100362193,,,
2499,충북,충주시,2018,1735,914,821,4,2016,1654,815,839,1.070736193,1.142712335,1.000734009,,,
2500,충북,충주시,2019,1682,828,854,4,2017,1544,774,770,1.111980585,1.090028127,1.134239084,,,
2501,충북,충주시,2020,1598,806,792,4,2018,1565,769,796,1.042271691,1.067965026,1.017535516,,,
