"","prov","distinct","adm.year","adm.total","adm.male","adm.female","pop.age","pop.year","pop.total","pop.male","pop.female","sum.adm.total","sum.pop.total","correction","adm.per.pop.total","corr.adm.per.pop.total","percent.adm","index","zscore"
"1","강원","강릉시",2009,2051,1074,977,"6",2008,2171,1132,1039,462768,488710,0.946917394773997,0.944725932749885,0.997685688280513,0.443202641496387,-0.00102570906732285,-0.0846760642468108
"2","강원","강릉시",2010,2054,1059,995,"6",2009,2089,1080,1009,470657,487028,0.966385916210156,0.98324557204404,1.01744609017069,0.436411229409103,0.00761366965977138,0.299054771636031
"3","강원","강릉시",2011,1935,989,946,"6",2010,2002,1021,981,441332,457372,0.964930078798003,0.966533466533467,1.00166166209417,0.438445433369889,0.000728548156993103,-0.00675812450779377
"4","강원","강릉시",2012,1735,919,816,"6",2011,1786,938,848,407210,420797,0.967711271705834,0.971444568868981,1.00385786264178,0.426070086687458,0.00164371987021293,0.0338905861904457
"5","강원","강릉시",2013,1704,923,781,"6",2012,1747,947,800,422944,435284,0.971650692421499,0.975386376645678,1.00384467818869,0.402890217144587,0.00154898323029257,0.0296827176418238
"6","강원","강릉시",2014,1839,999,840,"6",2013,1893,1018,875,465061,480776,0.967313260229296,0.971473851030111,1.00430118243167,0.395431997092854,0.00170082515881408,0.0364270023866156
"7","강원","강릉시",2015,1627,850,777,"6",2014,1656,855,801,441255,454993,0.969806128885499,0.982487922705314,1.01307662783529,0.368721034322557,0.00482162774087766,0.175042083548056
"8","강원","강릉시",2016,1659,820,839,"6",2015,1689,836,853,422114,435131,0.970084870992873,0.982238010657194,1.01252791382251,0.393021790322046,0.00492374311952347,0.179577689734802
"9","강원","강릉시",2017,1625,869,756,"6",2016,1675,889,786,445571,460063,0.968499966308962,0.970149253731343,1.00170292976743,0.364700575216969,0.000621059465735344,-0.0115323943537188
"10","강원","강릉시",2018,1662,875,787,"6",2017,1699,892,807,447106,462352,0.967025123715265,0.978222483814008,1.01157918219924,0.371723931237783,0.00430425912762084,0.152062388283399
"11","강원","강릉시",2019,1627,824,803,"6",2018,1693,860,833,462528,478982,0.965647978420901,0.961015948021264,0.995203189461224,0.351762487892625,-0.00168733800906937,-0.114063296231959
"12","강원","강릉시",2020,1451,770,681,"6",2019,1494,799,695,417119,431843,0.965904275396382,0.971218206157965,1.00550150868667,0.347862360621309,0.00191376779872285,0.0458851659639376
"13","강원","고성군",2009,221,117,104,"6",2008,250,128,122,462768,488710,0.946917394773997,0.884,0.933555561317982,0.0477561110534868,-0.00317312799258504,-0.180056864789473
"14","강원","고성군",2010,196,99,97,"6",2009,201,104,97,470657,487028,0.966385916210156,0.975124378109453,1.00904241437372,0.0416439147829523,0.00037656153361121,-0.0223921330952772
"15","강원","고성군",2011,175,97,78,"6",2010,181,99,82,441332,457372,0.964930078798003,0.966850828729282,1.00199055866687,0.0396526877724706,7.89310013103589e-05,-0.0356118351770812
"16","강원","고성군",2012,183,102,81,"6",2011,185,99,86,407210,420797,0.967711271705834,0.989189189189189,1.02219455132056,0.0449399572702046,0.000997422187977105,0.00518431486381394
"17","강원","고성군",2013,181,99,82,"6",2012,183,101,82,422944,435284,0.971650692421499,0.989071038251366,1.01792860949489,0.0427952636755693,0.000767259570670222,-0.00503869958179294
"18","강원","고성군",2014,162,91,71,"6",2013,161,84,77,465061,480776,0.967313260229296,1.00621118012422,1.04021232985652,0.0348341400375435,0.00140076192945795,0.0230992484524786
"19","강원","고성군",2015,160,94,66,"6",2014,157,92,65,441255,454993,0.969806128885499,1.01910828025478,1.05083712084387,0.0362602123488686,0.00184336479700381,0.0427581120921606
"20","강원","고성군",2016,144,69,75,"6",2015,129,61,68,422114,435131,0.970084870992873,1.11627906976744,1.15070248299506,0.0341140071165609,0.00514106557737687,0.189230389430287
"21","강원","고성군",2017,154,82,72,"6",2016,153,80,73,445571,460063,0.968499966308962,1.00653594771242,1.03927308490099,0.0345623929744081,0.00135737179366525,0.021172011135681
"22","강원","고성군",2018,163,90,73,"6",2017,156,84,72,447106,462352,0.967025123715265,1.04487179487179,1.08050118786723,0.03645667917675,0.00293480597942275,0.0912360930299685
"23","강원","고성군",2019,155,78,77,"6",2018,144,76,68,462528,478982,0.965647978420901,1.07638888888889,1.11468041454307,0.0335114847101148,0.00384311095850977,0.131579807534407
"24","강원","고성군",2020,150,76,74,"6",2019,126,64,62,417119,431843,0.965904275396382,1.19047619047619,1.23249914178882,0.0359609607809762,0.00836089251947826,0.33224378459675
"25","강원","동해시",2009,947,505,442,"6",2008,969,511,458,462768,488710,0.946917394773997,0.977296181630547,1.03208177083261,0.204638177229195,0.00656515510546978,0.252483440633298
"26","강원","동해시",2010,980,531,449,"6",2009,967,516,451,470657,487028,0.966385916210156,1.0134436401241,1.04869454647941,0.208219573914762,0.0101391577199145,0.411228074247663
"27","강원","동해시",2011,943,507,436,"6",2010,927,501,426,441332,457372,0.964930078798003,1.01725997842503,1.05423180474611,0.213671340396799,0.0115877824122394,0.475570891205444
"28","강원","동해시",2012,845,436,409,"6",2011,855,439,416,407210,420797,0.967711271705834,0.988304093567251,1.02127992353041,0.207509638761327,0.00441578924466431,0.157016164057227
"29","강원","동해시",2013,845,445,400,"6",2012,810,426,384,422944,435284,0.971650692421499,1.04320987654321,1.07364702632319,0.199790043126277,0.0147139425652318,0.614423936835832
"30","강원","동해시",2014,928,484,444,"6",2013,939,487,452,465061,480776,0.967313260229296,0.98828541001065,1.02168082527514,0.199543715770619,0.00432627243637423,0.15304014208206
"31","강원","동해시",2015,836,452,384,"6",2014,825,443,382,441255,454993,0.969806128885499,1.01333333333333,1.04488237715909,0.189459609522838,0.00850339765101753,0.338573361638171
"32","강원","동해시",2016,869,429,440,"6",2015,872,430,442,422114,435131,0.970084870992873,0.996559633027523,1.02729118124227,0.205868556835357,0.00561839609667803,0.210431733294214
"33","강원","동해시",2017,810,426,384,"6",2016,815,438,377,445571,460063,0.968499966308962,0.993865030674847,1.02619005188256,0.181789209800458,0.00476106883636269,0.172352269872357
"34","강원","동해시",2018,829,436,393,"6",2017,838,440,398,447106,462352,0.967025123715265,0.989260143198091,1.02299321800182,0.185414644401999,0.00426327933946587,0.150242210136365
"35","강원","동해시",2019,861,439,422,"6",2018,887,446,441,462528,478982,0.965647978420901,0.970687711386697,1.00521901674152,0.186150892486509,0.000971524624336399,0.00403403611610591
"36","강원","동해시",2020,756,386,370,"6",2019,766,393,373,417119,431843,0.965904275396382,0.986945169712794,1.02178362271745,0.18124324233612,0.00394813441113823,0.136244580145663
"37","강원","삼척시",2009,603,302,301,"6",2008,632,319,313,462768,488710,0.946917394773997,0.954113924050633,1.00759995467013,0.130302873145939,0.000990295929296284,0.00486779150181189
"38","강원","삼척시",2010,522,267,255,"6",2009,560,287,273,470657,487028,0.966385916210156,0.932142857142857,0.964565854600211,0.110908793452557,-0.00392995831331308,-0.213672607398795
"39","강원","삼척시",2011,547,268,279,"6",2010,561,264,297,441332,457372,0.964930078798003,0.975044563279857,1.01048209057226,0.12394297263738,0.00129918146497966,0.0185874012728455
"40","강원","삼척시",2012,473,234,239,"6",2011,481,241,240,407210,420797,0.967711271705834,0.983367983367983,1.01617911470076,0.116156282998944,0.00187930582585411,0.044354486261979
"41","강원","삼척시",2013,464,256,208,"6",2012,499,273,226,422944,435284,0.971650692421499,0.929859719438878,0.95698971522526,0.109707195278808,-0.0047185377107795,-0.248698532399718
"42","강원","삼척시",2014,500,266,234,"6",2013,510,264,246,465061,480776,0.967313260229296,0.980392156862745,1.01352084910978,0.107512777893653,0.00145366404727332,0.0254489745763722
"43","강원","삼척시",2015,447,216,231,"6",2014,466,226,240,441255,454993,0.969806128885499,0.959227467811159,0.98909198368699,0.101301968249652,-0.00110500352220726,-0.0881980452149844
"44","강원","삼척시",2016,461,249,212,"6",2015,488,265,223,422114,435131,0.970084870992873,0.944672131147541,0.973803591206074,0.109212203338435,-0.00286096752393902,-0.166191794007537
"45","강원","삼척시",2017,464,236,228,"6",2016,491,245,246,445571,460063,0.968499966308962,0.945010183299389,0.975746222171701,0.104136041169645,-0.00252569240644722,-0.151300051771215
"46","강원","삼척시",2018,450,233,217,"6",2017,477,241,236,447106,462352,0.967025123715265,0.943396226415094,0.975565373928043,0.100647273800844,-0.00245927850048547,-0.148350179511417
"47","강원","삼척시",2019,486,260,226,"6",2018,492,260,232,462528,478982,0.965647978420901,0.98780487804878,1.02294511056101,0.105074719800747,0.00241095106299486,0.0679682989776267
"48","강원","삼척시",2020,400,199,201,"6",2019,424,216,208,417119,431843,0.965904275396382,0.943396226415094,0.976697433115666,0.0958958954159365,-0.00223462051686293,-0.138371661545435
"49","강원","속초시",2009,898,482,416,"6",2008,935,499,436,462768,488710,0.946917394773997,0.960427807486631,1.0142677838502,0.194049718217336,0.00276865943571805,0.0838564475590613
"50","강원","속초시",2010,847,429,418,"6",2009,850,433,417,470657,487028,0.966385916210156,0.996470588235294,1.03113111596568,0.179961203169187,0.00560239308518317,0.20972093577375
"51","강원","속초시",2011,803,424,379,"6",2010,828,424,404,441332,457372,0.964930078798003,0.969806763285024,1.0050539252472,0.181949190178822,0.000919557605952657,0.0017258438221168
"52","강원","속초시",2012,677,339,338,"6",2011,685,340,345,407210,420797,0.967711271705834,0.988321167883212,1.0212975675493,0.166253284546057,0.00354079055791322,0.118151797987664
"53","강원","속초시",2013,680,340,340,"6",2012,686,338,348,422944,435284,0.971650692421499,0.991253644314869,1.02017489623201,0.160777786184459,0.00324367515268456,0.104954976039749
"54","강원","속초시",2014,712,399,313,"6",2013,732,409,323,465061,480776,0.967313260229296,0.972677595628415,1.005545603084,0.153098195720561,0.000849021826342404,-0.00140710757687734
"55","강원","속초시",2015,644,312,332,"6",2014,654,321,333,441255,454993,0.969806128885499,0.984709480122324,1.01536735105392,0.145947354704196,0.00224282423513008,0.0605006962449725
"56","강원","속초시",2016,597,314,283,"6",2015,627,322,305,422114,435131,0.970084870992873,0.952153110047847,0.981515265848159,0.141430987837409,-0.0026143142110068,-0.155236320826586
"57","강원","속초시",2017,666,316,350,"6",2016,700,344,356,445571,460063,0.968499966308962,0.951428571428571,0.982373365540268,0.149471128058155,-0.00263467293656485,-0.156140583855524
"58","강원","속초시",2018,648,342,306,"6",2017,671,351,320,447106,462352,0.967025123715265,0.965722801788376,0.998653269811765,0.144932074273215,-0.000195184399667264,-0.0477870777805365
"59","강원","속초시",2019,663,324,339,"6",2018,696,338,358,462528,478982,0.965647978420901,0.952586206896552,0.986473568198518,0.143342673308427,-0.00193891489474856,-0.125237457208109
"60","강원","속초시",2020,579,274,305,"6",2019,616,296,320,417119,431843,0.965904275396382,0.939935064935065,0.973114095130534,0.138809308614568,-0.0037320138664076,-0.20488061083645
"61","강원","양구군",2009,205,117,88,"6",2008,210,117,93,462768,488710,0.946917394773997,0.976190476190476,1.0309140813951,0.0442986550496145,0.00136945222789723,0.0217085815618771
"62","강원","양구군",2010,210,106,104,"6",2009,216,106,110,470657,487028,0.966385916210156,0.972222222222222,1.00603931194999,0.0446184801245918,0.000269464920206649,-0.0271489882211059
"63","강원","양구군",2011,222,105,117,"6",2010,233,110,123,441332,457372,0.964930078798003,0.952789699570815,0.987418384508948,0.0503022667742199,-0.000632883778881559,-0.0672281457041548
"64","강원","양구군",2012,192,100,92,"6",2011,189,101,88,407210,420797,0.967711271705834,1.01587301587302,1.04976871260607,0.0471501191031654,0.00234660072698738,0.0651100832418063
"65","강원","양구군",2013,199,110,89,"6",2012,204,108,96,422944,435284,0.971650692421499,0.975490196078431,1.00395152670284,0.0470511462510403,0.000185923860809988,-0.0308595884350174
"66","강원","양구군",2014,209,115,94,"6",2013,213,122,91,465061,480776,0.967313260229296,0.981220657276995,1.01437734560198,0.0449403411595468,0.000646122816321911,-0.0104191684176401
"67","강원","양구군",2015,197,106,91,"6",2014,200,107,93,441255,454993,0.969806128885499,0.985,1.01566691595563,0.0446453864545444,0.000699455517389819,-0.00805031729915681
"68","강원","양구군",2016,166,85,81,"6",2015,165,84,81,422114,435131,0.970084870992873,1.00606060606061,1.03708514187105,0.0393258693149244,0.00145840544274645,0.025659570697416
"69","강원","양구군",2017,197,93,104,"6",2016,200,95,105,445571,460063,0.968499966308962,0.985,1.01703669000002,0.0442129312724571,0.000753242004081153,-0.00566131061832472
"70","강원","양구군",2018,199,110,89,"6",2017,210,115,95,447106,462352,0.967025123715265,0.947619047619048,0.979932190363721,0.0445084610808175,-0.000893187324173572,-0.078789914226342
"71","강원","양구군",2019,195,97,98,"6",2018,203,107,96,462528,478982,0.965647978420901,0.960591133004926,0.994763262048926,0.0421596097965961,-0.000220778828624317,-0.0489238923511066
"72","강원","양구군",2020,166,83,83,"6",2019,177,84,93,417119,431843,0.965904275396382,0.937853107344633,0.970958645938037,0.0397967965976136,-0.0011557528605232,-0.0904521524404732
"73","강원","양양군",2009,183,92,91,"6",2008,197,99,98,462768,488710,0.946917394773997,0.928934010152284,0.981008496917511,0.03954465304429,-0.000751012400186582,-0.0724750038437228
"74","강원","양양군",2010,207,113,94,"6",2009,203,110,93,470657,487028,0.966385916210156,1.01970443349754,1.05517311085873,0.0439810732656691,0.00242657263097279,0.0686621541178315
"75","강원","양양군",2011,180,103,77,"6",2010,195,111,84,441332,457372,0.964930078798003,0.923076923076923,0.956625711395363,0.0407856217088269,-0.0017690473269182,-0.117692536924836
"76","강원","양양군",2012,169,85,84,"6",2011,182,86,96,407210,420797,0.967711271705834,0.928571428571429,0.959554213866485,0.0415019277522654,-0.00167857809399671,-0.113674211595288
"77","강원","양양군",2013,168,82,86,"6",2012,170,87,83,422944,435284,0.971650692421499,0.988235294117647,1.01706848132307,0.0397215707043959,0.000677986887691115,-0.0090038783687401
"78","강원","양양군",2014,175,89,86,"6",2013,177,88,89,465061,480776,0.967313260229296,0.988700564971751,1.022110008848,0.0376294722627784,0.000831987964675517,-0.00216369183857296
"79","강원","양양군",2015,150,87,63,"6",2014,159,91,68,441255,454993,0.969806128885499,0.943396226415094,0.972767853611365,0.0339939490770643,-0.000925728197594404,-0.0802352654434351
"80","강원","양양군",2016,151,70,81,"6",2015,160,71,89,422114,435131,0.970084870992873,0.94375,0.972853023709235,0.0357723269069493,-0.000971110510408452,-0.0822509882610744
"81","강원","양양군",2017,158,85,73,"6",2016,148,83,65,445571,460063,0.968499966308962,1.06756756756757,1.10228973123888,0.0354601174672499,0.00362720588542401,0.121990063088233
"82","강원","양양군",2018,146,74,72,"6",2017,158,81,77,447106,462352,0.967025123715265,0.924050632911392,0.955560109298126,0.0326544488331626,-0.00145116013707567,-0.103573105316616
"83","강원","양양군",2019,154,83,71,"6",2018,153,83,70,462528,478982,0.965647978420901,1.00653594771242,1.04234252046836,0.0332952815829528,0.00140980614192598,0.0235009605801545
"84","강원","양양군",2020,141,76,65,"6",2019,147,78,69,417119,431843,0.965904275396382,0.959183673469388,0.993042165669847,0.0338033031341176,-0.000235197783019142,-0.0495643316231032
"85","강원","영월군",2009,286,136,150,"6",2008,307,152,155,462768,488710,0.946917394773997,0.931596091205212,0.983819809781357,0.0618020260692183,-0.00099996853769748,-0.0835327603980939
"86","강원","영월군",2010,283,144,139,"6",2009,285,145,140,470657,487028,0.966385916210156,0.992982456140351,1.02752165515253,0.0601287136917118,0.00165484172298831,0.0343845797977263
"87","강원","영월군",2011,287,147,140,"6",2010,298,149,149,441332,457372,0.964930078798003,0.963087248322148,0.998090192733809,0.0650304079468518,-0.000124195545620266,-0.0446340024076061
"88","강원","영월군",2012,244,132,112,"6",2011,249,133,116,407210,420797,0.967711271705834,0.979919678714859,1.01261575365088,0.0599199430269394,0.00075593524000291,-0.00554168654532923
"89","강원","영월군",2013,253,137,116,"6",2012,270,147,123,422944,435284,0.971650692421499,0.937037037037037,0.964376441395621,0.0598187939774533,-0.00213095831289907,-0.133767350815109
"90","강원","영월군",2014,254,136,118,"6",2013,268,140,128,465061,480776,0.967313260229296,0.947761194029851,0.979787244728962,0.0546164911699756,-0.00110394976978155,-0.0881512412361446
"91","강원","영월군",2015,232,120,112,"6",2014,239,125,114,441255,454993,0.969806128885499,0.97071129707113,1.00093334962388,0.0525773079058594,4.90730105584826e-05,-0.0369380221762768
"92","강원","영월군",2016,205,113,92,"6",2015,211,112,99,422114,435131,0.970084870992873,0.971563981042654,1.00152472231452,0.0485650795756597,7.40482605354181e-05,-0.0358287093596067
"93","강원","영월군",2017,221,121,100,"6",2016,227,125,102,445571,460063,0.968499966308962,0.973568281938326,1.00523316035692,0.0495992782295078,0.000259560976562384,-0.0275888865856991
"94","강원","영월군",2018,238,115,123,"6",2017,262,127,135,447106,462352,0.967025123715265,0.908396946564885,0.939372643261705,0.053231224810224,-0.00322726845618582,-0.182461593880404
"95","강원","영월군",2019,198,117,81,"6",2018,199,117,82,462528,478982,0.965647978420901,0.994974874371859,1.03037017278172,0.0428082191780822,0.00130009301291596,0.0186278890281101
"96","강원","영월군",2020,168,88,80,"6",2019,177,93,84,417119,431843,0.965904275396382,0.949152542372881,0.98265694287705,0.0402762760746933,-0.000698513756663112,-0.0701431986296744
"97","강원","원주시",2009,3179,1678,1501,"6",2008,3309,1728,1581,462768,488710,0.946917394773997,0.960713206406769,1.01456918175641,0.686953289769388,0.0100083473368169,0.405417936825308
"98","강원","원주시",2010,3262,1724,1538,"6",2009,3353,1769,1584,470657,487028,0.966385916210156,0.97286012526096,1.00669940335657,0.693073724601992,0.00464318043695178,0.167116081544953
"99","강원","원주시",2011,3221,1671,1550,"6",2010,3269,1691,1578,441332,457372,0.964930078798003,0.985316610584277,1.02112747051234,0.72983604180073,0.0154195894519873,0.645766291216432
"100","강원","원주시",2012,3041,1599,1442,"6",2011,3094,1615,1479,407210,420797,0.967711271705834,0.982870071105365,1.01566458905951,0.746789126003782,0.0116981447729623,0.480472799348145
"101","강원","원주시",2013,3061,1576,1485,"6",2012,3069,1576,1493,422944,435284,0.971650692421499,0.997393287715868,1.02649367256685,0.723736475750927,0.0191744372132314,0.812543430585993
"102","강원","원주시",2014,3415,1764,1651,"6",2013,3479,1790,1689,465061,480776,0.967313260229296,0.981603909169302,1.01477354806096,0.734312273013648,0.0108483976571231,0.442730019299919
"103","강원","원주시",2015,3085,1569,1516,"6",2014,3151,1617,1534,441255,454993,0.969806128885499,0.979054268486195,1.00953607048382,0.699142219351622,0.00666706948195335,0.257010119010513
"104","강원","원주시",2016,3173,1655,1518,"6",2015,3204,1688,1516,422114,435131,0.970084870992873,0.990324594257179,1.0208638685846,0.751692670700332,0.0156832170974996,0.657475704586287
"105","강원","원주시",2017,3285,1649,1636,"6",2016,3343,1673,1670,445571,460063,0.968499966308962,0.982650314089141,1.01461058159259,0.737256239746303,0.0107717424454607,0.439325264238801
"106","강원","원주시",2018,3224,1648,1576,"6",2017,3289,1678,1611,447106,462352,0.967025123715265,0.980237154150198,1.0136625513763,0.721081801630933,0.00985181716129792,0.398465416627946
"107","강원","원주시",2019,3303,1634,1669,"6",2018,3360,1672,1688,462528,478982,0.965647978420901,0.983035714285714,1.01800628826795,0.714118929016189,0.0128586312934677,0.532017531511319
"108","강원","원주시",2020,3008,1537,1471,"6",2019,3032,1541,1491,417119,431843,0.965904275396382,0.992084432717678,1.02710429800153,0.721137133527842,0.0195459157671079,0.829043202212454
"109","강원","인제군",2009,322,163,159,"6",2008,317,158,159,462768,488710,0.946917394773997,1.01577287066246,1.07271539869103,0.0695813020779311,0.00505963212203783,0.185613401580445
"110","강원","인제군",2010,305,165,140,"6",2009,322,174,148,470657,487028,0.966385916210156,0.947204968944099,0.980151876238762,0.0648030306571452,-0.00128621857258634,-0.0962469807869875
"111","강원","인제군",2011,323,167,156,"6",2010,328,174,154,441332,457372,0.964930078798003,0.984756097560976,1.02054658591187,0.0731875322886172,0.00150375391984602,0.0276737906515496
"112","강원","인제군",2012,279,146,133,"6",2011,292,161,131,407210,420797,0.967711271705834,0.955479452054795,0.987360052519097,0.0685150168217873,-0.000866026214280594,-0.0775835131954378
"113","강원","인제군",2013,291,140,151,"6",2012,295,145,150,422944,435284,0.971650692421499,0.986440677966102,1.01522150466207,0.0688034349701142,0.00104729180616436,0.00739934801337833
"114","강원","인제군",2014,310,159,151,"6",2013,316,167,149,465061,480776,0.967313260229296,0.981012658227848,1.01416231800162,0.0666579222940646,0.000944030692855888,0.0028128523201421
"115","강원","인제군",2015,282,138,144,"6",2014,288,142,146,441255,454993,0.969806128885499,0.979166666666667,1.0096519680608,0.0639086242648809,0.000616844000214059,-0.0117196305149309
"116","강원","인제군",2016,264,137,127,"6",2015,267,134,133,422114,435131,0.970084870992873,0.98876404494382,1.01925519561173,0.0625423463803617,0.00120426511357038,0.0143715505715667
"117","강원","인제군",2017,300,163,137,"6",2016,306,162,144,445571,460063,0.968499966308962,0.980392156862745,1.01227897879966,0.0673293369631327,0.00082673550116574,-0.00239698780541486
"118","강원","인제군",2018,253,152,101,"6",2017,262,152,110,447106,462352,0.967025123715265,0.965648854961832,0.998576801450468,0.0565861339369188,-8.05333037426457e-05,-0.0426946790949617
"119","강원","인제군",2019,274,140,134,"6",2018,288,146,142,462528,478982,0.965647978420901,0.951388888888889,0.985233656725166,0.0592396568423966,-0.000874753108418174,-0.0779711311582402
"120","강원","인제군",2020,251,123,128,"6",2019,261,130,131,417119,431843,0.965904275396382,0.961685823754789,0.995632640056529,0.0601746743735001,-0.000262804462470211,-0.0507905232876132
"121","강원","정선군",2009,301,156,145,"6",2008,328,173,155,462768,488710,0.946917394773997,0.917682926829268,0.969126696683288,0.0650433910728486,-0.00200810434133959,-0.128310609226712
"122","강원","정선군",2010,251,125,126,"6",2009,256,127,129,470657,487028,0.966385916210156,0.98046875,1.01457268111385,0.0533297071965359,0.000777156816869956,-0.00459909869414441
"123","강원","정선군",2011,256,142,114,"6",2010,263,139,124,441332,457372,0.964930078798003,0.973384030418251,1.00876120643972,0.0580062175414427,0.000508204446668119,-0.0165450176184482
"124","강원","정선군",2012,255,124,131,"6",2011,270,134,136,407210,420797,0.967711271705834,0.944444444444444,0.975956850000955,0.0626212519338916,-0.00150561215337454,-0.105991672483297
"125","강원","정선군",2013,227,112,115,"6",2012,233,113,120,422944,435284,0.971650692421499,0.974248927038627,1.00267404185207,0.0536714080351063,0.000143519591345358,-0.0327430370348147
"126","강원","정선군",2014,289,148,141,"6",2013,288,151,137,465061,480776,0.967313260229296,1.00347222222222,1.03738081909924,0.0621423856225312,0.00232293327535098,0.0640588582305483
"127","강원","정선군",2015,238,114,124,"6",2014,250,118,132,441255,454993,0.969806128885499,0.952,0.981639496436301,0.053937065868942,-0.000990311690102177,-0.0831038371714598
"128","강원","정선군",2016,267,143,124,"6",2015,276,149,127,422114,435131,0.970084870992873,0.967391304347826,0.997223370113699,0.0632530548619567,-0.000175630322529553,-0.0469185544061139
"129","강원","정선군",2017,262,134,128,"6",2016,265,135,130,445571,460063,0.968499966308962,0.988679245283019,1.02083560111103,0.0588009542811359,0.0012251532283495,0.0152993272089159
"130","강원","정선군",2018,218,108,110,"6",2017,220,108,112,447106,462352,0.967025123715265,0.990909090909091,1.02469839366951,0.0487580126412976,0.00120424459075771,0.0143706390203651
"131","강원","정선군",2019,251,136,115,"6",2018,256,141,115,462528,478982,0.965647978420901,0.98046875,1.01534800663419,0.0542669849176699,0.000832890044534042,-0.00212362462204274
"132","강원","정선군",2020,187,95,92,"6",2019,184,93,91,417119,431843,0.965904275396382,1.01630434782609,1.05217915865319,0.0448313311069503,0.00233926113846335,0.0647840845180172
"133","강원","철원군",2009,488,245,243,"6",2008,507,258,249,462768,488710,0.946917394773997,0.962524654832347,1.01648217695069,0.105452408118107,0.00173808525047889,0.0380819646901863
"134","강원","철원군",2010,416,216,200,"6",2009,438,225,213,470657,487028,0.966385916210156,0.949771689497717,0.982807875783626,0.0883870844372866,-0.00151956173476897,-0.106611263856449
"135","강원","철원군",2011,432,241,191,"6",2010,440,243,197,441332,457372,0.964930078798003,0.981818181818182,1.01750189302961,0.0978854921011846,0.00171318141190602,0.0369758237170755
"136","강원","철원군",2012,402,200,202,"6",2011,399,193,206,407210,420797,0.967711271705834,1.00751879699248,1.04113574621951,0.0987205618722526,0.00406094397982406,0.141255184664208
"137","강원","철원군",2013,441,225,216,"6",2012,454,231,223,422944,435284,0.971650692421499,0.97136563876652,0.99970662949432,0.104269123099039,-3.05894853703419e-05,-0.0404763502339892
"138","강원","철원군",2014,427,216,211,"6",2013,437,221,216,465061,480776,0.967313260229296,0.977116704805492,1.01013471538049,0.0918159123211794,0.000930528138774999,0.00221311632896906
"139","강원","철원군",2015,418,221,197,"6",2014,429,226,203,441255,454993,0.969806128885499,0.974358974358974,1.0046945934222,0.0947298047614191,0.000444717918319251,-0.0193648660543327
"140","강원","철원군",2016,361,184,177,"6",2015,367,189,178,422114,435131,0.970084870992873,0.983651226158038,1.01398470955565,0.0855219206186007,0.00119599922049241,0.0140044086554263
"141","강원","철원군",2017,371,200,171,"6",2016,387,207,180,445571,460063,0.968499966308962,0.958656330749354,0.989836204541005,0.0832639467110741,-0.000846277723480038,-0.0767063546494702
"142","강원","철원군",2018,359,200,159,"6",2017,364,199,165,447106,462352,0.967025123715265,0.986263736263736,1.01989463569939,0.0802941584322286,0.00159742303079819,0.0318342433157391
"143","강원","철원군",2019,336,160,176,"6",2018,374,185,189,462528,478982,0.965647978420901,0.898395721925134,0.930355307525478,0.0726442507264425,-0.00505928650188515,-0.263833395978157
"144","강원","철원군",2020,301,141,160,"6",2019,304,149,155,417119,431843,0.965904275396382,0.990131578947368,1.02508250990094,0.0721616613004922,0.00180999558403758,0.0412759689440513
"145","강원","춘천시",2009,2659,1413,1246,"6",2008,2767,1465,1302,462768,488710,0.946917394773997,0.96096855800506,1.01483884793817,0.574585969643536,0.00852619383094846,0.339585887822767
"146","강원","춘천시",2010,2590,1314,1276,"6",2009,2647,1340,1307,470657,487028,0.966385916210156,0.978466188137514,1.01250046355677,0.550294588203299,0.00687893744532128,0.266420549233349
"147","강원","춘천시",2011,2406,1264,1142,"6",2010,2511,1319,1192,441332,457372,0.964930078798003,0.958183990442055,0.993008728296302,0.545167810174653,-0.00381141628504103,-0.208407387174866
"148","강원","춘천시",2012,2418,1265,1153,"6",2011,2451,1284,1167,407210,420797,0.967711271705834,0.986536107711138,1.01945294692302,0.59379681245549,0.0115510978757564,0.473941493039991
"149","강원","춘천시",2013,2271,1199,1072,"6",2012,2304,1211,1093,422944,435284,0.971650692421499,0.985677083333333,1.01443563105675,0.536950518271923,0.00775121957750498,0.305164255497642
"150","강원","춘천시",2014,2517,1289,1228,"6",2013,2593,1326,1267,465061,480776,0.967313260229296,0.970690320092557,1.00349117499171,0.541219323916648,0.00188949136868735,0.0448068922727335
"151","강원","춘천시",2015,2436,1277,1159,"6",2014,2454,1277,1177,441255,454993,0.969806128885499,0.992665036674817,1.02357059530608,0.552061733011524,0.0130124236927885,0.538848449313163
"152","강원","춘천시",2016,2297,1190,1107,"6",2015,2344,1219,1125,422114,435131,0.970084870992873,0.979948805460751,1.01016811493801,0.544165794074586,0.00553314033948228,0.206644972231182
"153","강원","춘천시",2017,2485,1289,1196,"6",2016,2551,1323,1228,445571,460063,0.968499966308962,0.974127793022344,1.00581086929185,0.557711341177949,0.00324078770616714,0.104826725814739
"154","강원","춘천시",2018,2570,1337,1233,"6",2017,2643,1382,1261,447106,462352,0.967025123715265,0.972379871358305,1.00553734076987,0.57480776370704,0.00318290646481471,0.10225584452481
"155","강원","춘천시",2019,2544,1308,1236,"6",2018,2615,1338,1277,462528,478982,0.965647978420901,0.972848948374761,1.00745713770937,0.550020755500208,0.00410158051677712,0.143060116799371
"156","강원","춘천시",2020,2377,1212,1165,"6",2019,2448,1237,1211,417119,431843,0.965904275396382,0.970996732026144,1.00527221667765,0.569861358509202,0.00300443255828239,0.0943286609274357
"157","강원","태백시",2009,472,235,237,"6",2008,498,237,261,462768,488710,0.946917394773997,0.947791164658635,1.0009227519628,0.101994952114234,9.4116042259159e-05,-0.0349373690331299
"158","강원","태백시",2010,437,224,213,"6",2009,463,233,230,470657,487028,0.966385916210156,0.943844492440605,0.976674511298808,0.0928489324497458,-0.00216574672477433,-0.135312529790313
"159","강원","태백시",2011,397,195,202,"6",2010,414,204,210,441332,457372,0.964930078798003,0.958937198067633,0.993789310892003,0.0899549545466905,-0.00055868225641352,-0.0639323748924015
"160","강원","태백시",2012,406,221,185,"6",2011,416,222,194,407210,420797,0.967711271705834,0.975961538461538,1.00852554578719,0.0997028560202353,0.00085002126411373,-0.0013627160640709
"161","강원","태백시",2013,415,196,219,"6",2012,423,206,217,422944,435284,0.971650692421499,0.981087470449173,1.00971210961025,0.0981217371566921,0.000952969066413949,0.00320986345545801
"162","강원","태백시",2014,449,244,205,"6",2013,459,249,210,465061,480776,0.967313260229296,0.978213507625272,1.0112685805562,0.0965464745485001,0.00108794172586708,0.00920487456324191
"163","강원","태백시",2015,399,204,195,"6",2014,416,214,202,441255,454993,0.969806128885499,0.959134615384615,0.988996240399978,0.090423904544991,-0.000995002907708416,-0.0833122045680302
"164","강원","태백시",2016,399,189,210,"6",2015,397,190,207,422114,435131,0.970084870992873,1.00503778337531,1.03603077774697,0.0945242280521376,0.00340578145265039,0.112155168085119
"165","강원","태백시",2017,397,193,204,"6",2016,421,207,214,445571,460063,0.968499966308962,0.942992874109264,0.973663300891059,0.0890991559145456,-0.00234657766018199,-0.143344404325439
"166","강원","태백시",2018,373,181,192,"6",2017,378,182,196,447106,462352,0.967025123715265,0.986772486772487,1.02042073424251,0.0834254069504771,0.00170360806440914,0.0365506092713131
"167","강원","태백시",2019,360,179,181,"6",2018,371,182,189,462528,478982,0.965647978420901,0.970350404312669,1.00486971028455,0.0778331257783312,0.000379024773081108,-0.0222827246562422
"168","강원","태백시",2020,284,152,132,"6",2019,297,158,139,417119,431843,0.965904275396382,0.956228956228956,0.989983149040876,0.0680860857453149,-0.000682008173300962,-0.0694100786333918
"169","강원","평창군",2009,368,189,179,"6",2008,389,199,190,462768,488710,0.946917394773997,0.946015424164524,0.999047466426902,0.0795214880890641,-7.5746887187519e-05,-0.0424820832957034
"170","강원","평창군",2010,336,171,165,"6",2009,356,187,169,470657,487028,0.966385916210156,0.943820224719101,0.976649399466053,0.0713895681993469,-0.00166698928931388,-0.113159477625601
"171","강원","평창군",2011,314,178,136,"6",2010,326,180,146,441332,457372,0.964930078798003,0.96319018404908,0.998196869610397,0.0711482512031758,-0.000128289573911563,-0.0448158447539105
"172","강원","평창군",2012,304,175,129,"6",2011,297,170,127,407210,420797,0.967711271705834,1.02356902356902,1.05772150588339,0.0746543552466786,0.0043091618055917,0.152280148006088
"173","강원","평창군",2013,286,146,140,"6",2012,313,163,150,422944,435284,0.971650692421499,0.913738019169329,0.940397641144223,0.0676212453658167,-0.00403038573256795,-0.218133240362525
"174","강원","평창군",2014,313,163,150,"6",2013,324,166,158,465061,480776,0.967313260229296,0.966049382716049,0.998693414465396,0.0673029989614266,-8.79371248784941e-05,-0.0430235308055918
"175","강원","평창군",2015,312,156,156,"6",2014,323,164,159,441255,454993,0.969806128885499,0.96594427244582,0.996017908812232,0.0707074140802937,-0.000281563370519035,-0.0516237280461047
"176","강원","평창군",2016,258,128,130,"6",2015,270,130,140,422114,435131,0.970084870992873,0.955555555555556,0.985022634749012,0.0611209294171717,-0.000915430484360832,-0.0797778772177739
"177","강원","평창군",2017,278,157,121,"6",2016,284,162,122,445571,460063,0.968499966308962,0.97887323943662,1.01071065925504,0.062391852252503,0.000668257869767657,-0.00943600714767409
"178","강원","평창군",2018,237,116,121,"6",2017,248,123,125,447106,462352,0.967025123715265,0.955645161290323,0.988231988863722,0.0530075642017777,-0.000623793605833503,-0.0668243921690643
"179","강원","평창군",2019,261,132,129,"6",2018,269,141,128,462528,478982,0.965647978420901,0.970260223048327,1.00477632090627,0.0564290161892902,0.000269523089744973,-0.0271464045346778
"180","강원","평창군",2020,213,119,94,"6",2019,224,122,102,417119,431843,0.965904275396382,0.950892857142857,0.984458689503818,0.0510645643089862,-0.000793610249278231,-0.0743670505701252
"181","강원","홍천군",2009,641,321,320,"6",2008,680,344,336,462768,488710,0.946917394773997,0.942647058823529,0.995490276159214,0.138514331155136,-0.000624661381500885,-0.0668629357140022
"182","강원","홍천군",2010,588,324,264,"6",2009,606,333,273,470657,487028,0.966385916210156,0.97029702970297,1.00404715489662,0.124931744348857,0.000505618120884685,-0.0166598931188855
"183","강원","홍천군",2011,530,259,271,"6",2010,549,267,282,441332,457372,0.964930078798003,0.965391621129326,1.00047831686613,0.120090997253768,5.74415494566331e-05,-0.0365663210936012
"184","강원","홍천군",2012,495,250,245,"6",2011,511,258,253,407210,420797,0.967711271705834,0.968688845401174,1.00101019149402,0.121558900812848,0.000122797767622958,-0.0336634276079327
"185","강원","홍천군",2013,456,240,216,"6",2012,458,246,212,422944,435284,0.971650692421499,0.995633187772926,1.02468221917452,0.107815691911932,0.00266113053822334,0.079080391893415
"186","강원","홍천군",2014,569,287,282,"6",2013,572,290,282,465061,480776,0.967313260229296,0.994755244755245,1.02836928392716,0.122349541242977,0.00347096887387941,0.115050564204149
"187","강원","홍천군",2015,494,241,253,"6",2014,509,251,258,441255,454993,0.969806128885499,0.970530451866405,1.00074687399814,0.111953405627132,8.36150876665969e-05,-0.0354037845255697
"188","강원","홍천군",2016,504,274,230,"6",2015,517,282,235,422114,435131,0.970084870992873,0.974854932301741,1.00491715874714,0.119399024907963,0.000587103959725747,-0.0130405785780109
"189","강원","홍천군",2017,495,240,255,"6",2016,509,254,255,445571,460063,0.968499966308962,0.972495088408644,1.00412506168163,0.111093405989169,0.000458267152127829,-0.0187630567137337
"190","강원","홍천군",2018,474,232,242,"6",2017,490,239,251,447106,462352,0.967025123715265,0.96734693877551,1.00033278872736,0.106015128403555,3.52806396622415e-05,-0.0375506308116897
"191","강원","홍천군",2019,443,220,223,"6",2018,468,229,239,462528,478982,0.965647978420901,0.946581196581197,0.980254935270632,0.0957779853327799,-0.00189114252004423,-0.123115576242304
"192","강원","홍천군",2020,384,195,189,"6",2019,392,203,189,417119,431843,0.965904275396382,0.979591836734694,1.01417072238623,0.092060059599299,0.00130455754744114,0.018826187959005
"193","강원","화천군",2009,237,110,127,"6",2008,258,119,139,462768,488710,0.946917394773997,0.918604651162791,0.970100091341163,0.0512135670573592,-0.00153128097710824,-0.10713179140835
"194","강원","화천군",2010,200,95,105,"6",2009,219,104,115,470657,487028,0.966385916210156,0.91324200913242,0.945007572868871,0.0424937905948493,-0.0023368366828127,-0.142911744349958
"195","강원","화천군",2011,221,120,101,"6",2010,226,130,96,441332,457372,0.964930078798003,0.97787610619469,1.01341654455711,0.0500756799869486,0.000671842591772408,-0.00927678639642068
"196","강원","화천군",2012,188,112,76,"6",2011,190,110,80,407210,420797,0.967711271705834,0.989473684210526,1.02248853882453,0.0461678249551828,0.00103824692394873,0.00699760613786802
"197","강원","화천군",2013,190,93,97,"6",2012,209,107,102,422944,435284,0.971650692421499,0.909090909090909,0.935614944940057,0.0449232049633048,-0.0028923830250315,-0.167587160141457
"198","강원","화천군",2014,243,117,126,"6",2013,253,124,129,465061,480776,0.967313260229296,0.960474308300395,0.99292995122668,0.0522512100563152,-0.000369418603563158,-0.0555259486892367
"199","강원","화천군",2015,191,99,92,"6",2014,203,107,96,441255,454993,0.969806128885499,0.940886699507389,0.970180195281562,0.0432856284914619,-0.00129076898873026,-0.0964490942775148
"200","강원","화천군",2016,208,97,111,"6",2015,210,99,111,422114,435131,0.970084870992873,0.990476190476191,1.02102013967339,0.0492757880572547,0.00103578394748008,0.00688820938042373
"201","강원","화천군",2017,197,101,96,"6",2016,204,102,102,445571,460063,0.968499966308962,0.965686274509804,0.997094794117669,0.0442129312724571,-0.000128447668007839,-0.0448228667379708
"202","강원","화천군",2018,190,100,90,"6",2017,199,103,96,447106,462352,0.967025123715265,0.954773869346734,0.987330986477929,0.0424955156048007,-0.000538376261824592,-0.0630304539877646
"203","강원","화천군",2019,191,87,104,"6",2018,201,91,110,462528,478982,0.965647978420901,0.950248756218905,0.984052964904274,0.041294797287948,-0.000658529581621817,-0.0683672421175975
"204","강원","화천군",2020,180,94,86,"6",2019,179,93,86,417119,431843,0.965904275396382,1.00558659217877,1.04108307395793,0.0431531529371714,0.00177286417363559,0.0396267222098642
"205","강원","횡성군",2009,303,156,147,"6",2008,318,170,148,462768,488710,0.946917394773997,0.952830188679245,1.00624425524114,0.0654755730733326,0.000408846190330088,-0.0209581621234904
"206","강원","횡성군",2010,292,152,140,"6",2009,311,163,148,470657,487028,0.966385916210156,0.938906752411576,0.97156502041509,0.06204093426848,-0.001764132699353,-0.117474246443169
"207","강원","횡성군",2011,309,164,145,"6",2010,313,170,143,441332,457372,0.964930078798003,0.987220447284345,1.02310050124472,0.0700153172668195,0.00161738892367174,0.032721058097627
"208","강원","횡성군",2012,291,148,143,"6",2011,295,149,146,407210,420797,0.967711271705834,0.986440677966102,1.01935433306181,0.0714618992657351,0.0013830973996189,0.0223146521273564
"209","강원","횡성군",2013,292,156,136,"6",2012,299,156,143,422944,435284,0.971650692421499,0.976588628762542,1.00508200774163,0.0690398728909737,0.000350861168512806,-0.0235336529768835
"210","강원","횡성군",2014,314,159,155,"6",2013,322,162,160,465061,480776,0.967313260229296,0.975155279503106,1.00810701103379,0.0675180245172139,0.000547369369740709,-0.0148054493991733
"211","강원","횡성군",2015,293,156,137,"6",2014,288,153,135,441255,454993,0.969806128885499,1.01736111111111,1.04903555546742,0.0664015138638656,0.00325603511619244,0.105503962173843
"212","강원","횡성군",2016,260,135,125,"6",2015,270,136,134,422114,435131,0.970084870992873,0.962962962962963,0.992658469126911,0.0615947350715683,-0.000452199649147635,-0.0592027917610384
"213","강원","횡성군",2017,255,126,129,"6",2016,256,126,130,445571,460063,0.968499966308962,0.99609375,1.0284912593195,0.0572299364186628,0.00163055295934275,0.0333057582909159
"214","강원","횡성군",2018,268,143,125,"6",2017,280,148,132,447106,462352,0.967025123715265,0.957142857142857,0.989780755090995,0.0599410430636135,-0.000612552199168305,-0.0663250883982264
"215","강원","횡성군",2019,265,132,133,"6",2018,284,139,145,462528,478982,0.965647978420901,0.933098591549296,0.96629269920408,0.0572938286979383,-0.00193122031767131,-0.124895691140561
"216","강원","횡성군",2020,221,114,107,"6",2019,233,123,110,417119,431843,0.965904275396382,0.948497854077253,0.981979144556549,0.0529824822173049,-0.000954789653073253,-0.081526073145602
"217","경기","가평군",2009,478,254,224,"6",2008,502,276,226,462768,488710,0.946917394773997,0.952191235059761,1.00556948295054,0.103291498115686,0.000575280237691113,-0.0135657467507369
"218","경기","가평군",2010,463,254,209,"6",2009,448,251,197,470657,487028,0.966385916210156,1.03348214285714,1.0694300543101,0.0983731252270762,0.00683005142717013,0.264249204140062
"219","경기","가평군",2011,494,261,233,"6",2010,484,249,235,441332,457372,0.964930078798003,1.02066115702479,1.05775659755183,0.111933872912003,0.00646491965019612,0.248031334034864
"220","경기","가평군",2012,447,236,211,"6",2011,440,229,211,407210,420797,0.967711271705834,1.01590909090909,1.04980599132456,0.109771371037057,0.00546727195355637,0.203719330053888
"221","경기","가평군",2013,440,233,207,"6",2012,438,241,197,422944,435284,0.971650692421499,1.00456621004566,1.03387587523056,0.10403268517818,0.00352419826299664,0.117414826568922
"222","경기","가평군",2014,450,234,216,"6",2013,445,227,218,465061,480776,0.967313260229296,1.01123595505618,1.04540689829526,0.0967615001042874,0.00439363959413174,0.156032354435972
"223","경기","가평군",2015,438,224,214,"6",2014,448,231,217,441255,454993,0.969806128885499,0.977678571428571,1.00811754257742,0.0992623313050277,0.000805766200702668,-0.00332837042547965
"224","경기","가평군",2016,418,217,201,"6",2015,408,210,198,422114,435131,0.970084870992873,1.02450980392157,1.05610326947269,0.099025381768906,0.00555564767801718,0.207644669096236
"225","경기","가평군",2017,459,238,221,"6",2016,453,235,218,445571,460063,0.968499966308962,1.01324503311258,1.0462003803409,0.103013885553593,0.0047592806929697,0.172272846828115
"226","경기","가평군",2018,422,196,226,"6",2017,434,209,225,447106,462352,0.967025123715265,0.972350230414747,1.005506689091,0.0943847767643467,0.000519747620564326,-0.0160323104079122
"227","경기","가평군",2019,436,204,232,"6",2018,451,214,237,462528,478982,0.965647978420901,0.966740576496674,1.00113146622806,0.0942645634426456,0.000106657170037727,-0.0343803362189194
"228","경기","가평군",2020,357,189,168,"6",2019,360,191,169,417119,431843,0.965904275396382,0.991666666666667,1.02667178511008,0.0855870866587233,0.00228276038355964,0.0622745195837683
"229","경기","고양시",2009,9576,4986,4590,"6",2008,10375,5401,4974,462768,488710,0.946917394773997,0.922987951807229,0.974729112487706,2.0692874183176,-0.0522927295789087,-2.36177691322769
"230","경기","고양시",2010,9935,5232,4703,"6",2009,10310,5413,4897,470657,487028,0.966385916210156,0.963627546071775,0.997145684666847,2.11087904779914,-0.00602511443256344,-0.306732077800713
"231","경기","고양시",2011,9446,4811,4635,"6",2010,9817,4987,4830,441332,457372,0.964930078798003,0.962208413975756,0.997179417574342,2.14033879256433,-0.00603700198326023,-0.307260081018256
"232","경기","고양시",2012,8370,4267,4103,"6",2011,8776,4485,4291,407210,420797,0.967711271705834,0.953737465815861,0.985559943034103,2.05545050465362,-0.02968082237778,-1.35743547557518
"233","경기","고양시",2013,8587,4387,4200,"6",2012,8971,4620,4351,422944,435284,0.971650692421499,0.957195407423922,0.985122961255188,2.03029242642052,-0.0302047390911561,-1.38070601443074
"234","경기","고양시",2014,9425,4870,4555,"6",2013,9965,5134,4831,465061,480776,0.967313260229296,0.945810336176618,0.977770464918903,2.02661586329535,-0.0450507284290325,-2.04011267758176
"235","경기","고양시",2015,9234,4715,4519,"6",2014,9748,4969,4779,441255,454993,0.969806128885499,0.947271235125154,0.976763506551312,2.09266750518408,-0.048626254774492,-2.19892498997193
"236","경기","고양시",2016,8646,4490,4156,"6",2015,9217,4803,4414,422114,435131,0.970084870992873,0.938049256808072,0.966976483045228,2.04826184395685,-0.0676408097317224,-3.04348468554304
"237","경기","고양시",2017,9165,4721,4444,"6",2016,9757,5005,4752,445571,460063,0.968499966308962,0.939325612380855,0.969876763094486,2.0569112442237,-0.0619608247033664,-2.79119971557204
"238","경기","고양시",2018,9095,4631,4464,"6",2017,9656,4939,4717,447106,462352,0.967025123715265,0.941901408450704,0.974019583722876,2.03419323381927,-0.0528491870027347,-2.38649279606175
"239","경기","고양시",2019,9283,4787,4496,"6",2018,9900,5128,4772,462528,478982,0.965647978420901,0.937676767676768,0.971033739655445,2.00701362944514,-0.0581356793055784,-2.62130020228143
"240","경기","고양시",2020,8550,4305,4245,"6",2019,9054,4599,4455,417119,431843,0.965904275396382,0.944333996023857,0.977668305315582,2.04977476451564,-0.0457749442129874,-2.0722797971068
"241","경기","과천시",2009,757,390,367,"6",2008,822,413,409,462768,488710,0.946917394773997,0.920924574209246,0.972550065393027,0.163580887183211,-0.0044902846561297,-0.23856033401528
"242","경기","과천시",2010,711,391,320,"6",2009,786,439,347,470657,487028,0.966385916210156,0.904580152671756,0.936044428523149,0.151065425564689,-0.00966147562238338,-0.468246460144599
"243","경기","과천시",2011,677,349,328,"6",2010,786,411,375,441332,457372,0.964930078798003,0.861323155216285,0.892627532441751,0.153399254982643,-0.0164708565290835,-0.77069522523671
"244","경기","과천시",2012,606,312,294,"6",2011,713,365,348,407210,420797,0.967711271705834,0.849929873772791,0.878288698936591,0.148817563419366,-0.0181127792648574,-0.843623661847276
"245","경기","과천시",2013,590,331,259,"6",2012,651,369,282,422944,435284,0.971650692421499,0.906298003072197,0.932740551868044,0.139498373307104,-0.00938258360394141,-0.455859056983054
"246","경기","과천시",2014,578,304,274,"6",2013,660,353,307,465061,480776,0.967313260229296,0.875757575757576,0.905350533032063,0.124284771245062,-0.0117634873505772,-0.561610432598511
"247","경기","과천시",2015,554,278,276,"6",2014,639,323,316,441255,454993,0.969806128885499,0.86697965571205,0.893972135140435,0.125550985257957,-0.0133119028979159,-0.630385608573939
"248","경기","과천시",2016,496,258,238,"6",2015,569,292,277,422114,435131,0.970084870992873,0.87170474516696,0.898586063170718,0.117503802290377,-0.0119165231826767,-0.568407746343702
"249","경기","과천시",2017,440,229,211,"6",2016,525,281,244,445571,460063,0.968499966308962,0.838095238095238,0.865353915591027,0.0987496942125946,-0.0132962596623093,-0.62969079103383
"250","경기","과천시",2018,418,205,213,"6",2017,481,232,249,447106,462352,0.967025123715265,0.869022869022869,0.898655937380535,0.0934901343305614,-0.00947467002789861,-0.459949212254027
"251","경기","과천시",2019,466,242,224,"6",2018,538,284,254,462528,478982,0.965647978420901,0.866171003717472,0.896984225176859,0.100750657257507,-0.0103789070213228,-0.500112241134177
"252","경기","과천시",2020,483,253,230,"6",2019,509,265,244,417119,431843,0.965904275396382,0.948919449901768,0.982415622409742,0.115794293714743,-0.00203617058347726,-0.129557213050411
"253","경기","광명시",2009,3051,1612,1439,"6",2008,3294,1750,1544,462768,488710,0.946917394773997,0.926229508196721,0.978152385106186,0.659293641738409,-0.0144039935866407,-0.678892438298856
"254","경기","광명시",2010,3376,1785,1591,"6",2009,3301,1739,1562,470657,487028,0.966385916210156,1.02272038776128,1.05829396994117,0.717295185241057,0.0418139839673905,1.81811252003186
"255","경기","광명시",2011,3560,1794,1766,"6",2010,3545,1788,1757,441332,457372,0.964930078798003,1.00423131170663,1.04072961738076,0.806648962685688,0.0328545036107728,1.42016389491386
"256","경기","광명시",2012,3308,1765,1543,"6",2011,3404,1801,1603,407210,420797,0.967711271705834,0.971797884841363,1.00422296738192,0.812357260381621,0.00343055821305646,0.113255664692737
"257","경기","광명시",2013,3595,1859,1736,"6",2012,3698,1923,1775,422944,435284,0.971650692421499,0.972147106544078,1.00051089771916,0.849994325489899,0.000434260162191654,-0.0198293628228002
"258","경기","광명시",2014,3800,1877,1923,"6",2013,3932,1948,1984,465061,480776,0.967313260229296,0.966429298067141,0.999086167637209,0.81709711199176,-0.000746689784481287,-0.0722830084479669
"259","경기","광명시",2015,3612,1822,1790,"6",2014,3760,1916,1844,441255,454993,0.969806128885499,0.96063829787234,0.990546738425241,0.818574293775708,-0.00773819691743521,-0.382821180341678
"260","경기","광명시",2016,3274,1735,1539,"6",2015,3400,1792,1608,422114,435131,0.970084870992873,0.962941176470588,0.992636010790506,0.775619856247365,-0.00571165625207513,-0.292809367220163
"261","경기","광명시",2017,3272,1651,1621,"6",2016,3401,1734,1667,445571,460063,0.968499966308962,0.962069979417818,0.993360880624861,0.734338635144567,-0.00487536186050171,-0.255664109897877
"262","경기","광명시",2018,3176,1654,1522,"6",2017,3304,1728,1576,447106,462352,0.967025123715265,0.961259079903148,0.994037338151088,0.71034609242551,-0.00423555354482964,-0.227246073424066
"263","경기","광명시",2019,3071,1575,1496,"6",2018,3212,1636,1576,462528,478982,0.965647978420901,0.956102117061021,0.990114553571075,0.663959803514598,-0.00656353906860333,-0.330647007586063
"264","경기","광명시",2020,2623,1355,1268,"6",2019,2706,1393,1313,417119,431843,0.965904275396382,0.969327420546933,1.00354397970663,0.628837334190003,0.0022285867511395,0.059868317250469
"265","경기","광주시",2009,2634,1357,1277,"6",2008,2877,1492,1385,462768,488710,0.946917394773997,0.915537017726799,0.966860491506033,0.569183694637486,-0.0188624678830666,-0.876922195133594
"266","경기","광주시",2010,2600,1361,1239,"6",2009,2754,1434,1320,470657,487028,0.966385916210156,0.944081336238199,0.976919593303441,0.552419277733041,-0.0127500615970981,-0.605430592848076
"267","경기","광주시",2011,2694,1385,1309,"6",2010,2803,1431,1372,441332,457372,0.964930078798003,0.96111309311452,0.996044287801416,0.610424804908776,-0.0024146648470962,-0.14636859784361
"268","경기","광주시",2012,2576,1312,1264,"6",2011,2727,1385,1342,407210,420797,0.967711271705834,0.944627796112945,0.976146319395248,0.632597431300803,-0.0150897770776362,-0.709352530459079
"269","경기","광주시",2013,2725,1405,1320,"6",2012,2859,1463,1396,422944,435284,0.971650692421499,0.953130465197622,0.98093941848822,0.644293334342135,-0.0122806056167251,-0.584579008324554
"270","경기","광주시",2014,3122,1535,1587,"6",2013,3302,1618,1684,465061,480776,0.967313260229296,0.945487583282859,0.977436805796228,0.671309785167967,-0.015146893053637,-0.711889421351979
"271","경기","광주시",2015,2939,1461,1478,"6",2014,3064,1544,1520,441255,454993,0.969806128885499,0.95920365535248,0.989067429853013,0.66605477558328,-0.00728169055580004,-0.362544772364942
"272","경기","광주시",2016,2816,1424,1392,"6",2015,2993,1530,1463,422114,435131,0.970084870992873,0.94086201135984,0.96987597631213,0.667118361390525,-0.0200962893211413,-0.931724206565013
"273","경기","광주시",2017,3151,1628,1523,"6",2016,3348,1743,1605,445571,460063,0.968499966308962,0.94115890083632,0.971769678447341,0.707182469236104,-0.0199639885029389,-0.925847869254141
"274","경기","광주시",2018,3451,1781,1670,"6",2017,3650,1891,1759,447106,462352,0.967025123715265,0.945479452054795,0.977719636096224,0.771852759748248,-0.0171971603673247,-0.802955088793699
"275","경기","광주시",2019,3728,1931,1797,"6",2018,3982,2045,1937,462528,478982,0.965647978420901,0.936212958312406,0.969517856645204,0.806005258060053,-0.0245687678209062,-1.13037598088768
"276","경기","광주시",2020,3312,1680,1632,"6",2019,3538,1801,1737,417119,431843,0.965904275396382,0.936122102882985,0.96916653826677,0.794018014043954,-0.0244823240515196,-1.12653645249897
"277","경기","구리시",2009,1946,1006,940,"6",2008,2085,1076,1009,462768,488710,0.946917394773997,0.933333333333333,0.985654438797266,0.420513086470975,-0.0060324962185198,-0.307059950786124
"278","경기","구리시",2010,1999,1015,984,"6",2009,2114,1083,1031,470657,487028,0.966385916210156,0.945600756859035,0.978491864375845,0.424725436995519,-0.00913505230192812,-0.44486458661323
"279","경기","구리시",2011,1831,938,893,"6",2010,1971,982,989,441332,457372,0.964930078798003,0.928970065956367,0.96273303772805,0.414880407493678,-0.0154613324934383,-0.72585571602211
"280","경기","구리시",2012,1653,919,734,"6",2011,1718,963,755,407210,420797,0.967711271705834,0.962165308498254,0.994268989759927,0.405933056653815,-0.0023264065044673,-0.142448472489641
"281","경기","구리시",2013,1736,946,790,"6",2012,1845,996,849,422944,435284,0.971650692421499,0.940921409214092,0.96837414572224,0.41045623061209,-0.0129810289367368,-0.615689350231087
"282","경기","구리시",2014,1802,954,848,"6",2013,1920,1021,899,465061,480776,0.967313260229296,0.938541666666667,0.970256177863406,0.387476051528724,-0.0115250187588602,-0.551018495964875
"283","경기","구리시",2015,1607,784,823,"6",2014,1760,858,902,441255,454993,0.969806128885499,0.913068181818182,0.941495577953791,0.364188507778949,-0.0213066381634787,-0.9854836477993
"284","경기","구리시",2016,1524,804,720,"6",2015,1644,873,771,422114,435131,0.970084870992873,0.927007299270073,0.955594017584553,0.36103990865027,-0.0160323318347984,-0.751217499718605
"285","경기","구리시",2017,1598,839,759,"6",2016,1751,895,856,445571,460063,0.968499966308962,0.912621359223301,0.942303965896231,0.358640934890287,-0.0206921596104376,-0.958190670348149
"286","경기","구리시",2018,1693,853,840,"6",2017,1838,923,915,447106,462352,0.967025123715265,0.921109902067465,0.952519101601626,0.378657410099618,-0.0179789940167316,-0.837681391376933
"287","경기","구리시",2019,1806,929,877,"6",2018,2012,1044,968,462528,478982,0.965647978420901,0.897614314115308,0.929546101865354,0.390462847654628,-0.0275096296940229,-1.26099872824427
"288","경기","구리시",2020,1598,845,753,"6",2019,1754,938,816,417119,431843,0.965904275396382,0.911060433295325,0.943220209809558,0.383104102186666,-0.0217525705432566,-1.00529039666918
"289","경기","군포시",2009,2938,1511,1427,"6",2008,3122,1612,1510,462768,488710,0.946917394773997,0.941063420884049,0.993817862125824,0.63487535871106,-0.00392488700046857,-0.213447357507765
"290","경기","군포시",2010,3089,1593,1496,"6",2009,3189,1625,1564,470657,487028,0.966385916210156,0.968642207588586,1.00233477262094,0.656316595737448,0.00153235001839631,0.0289439288346666
"291","경기","군포시",2011,2990,1550,1440,"6",2010,3067,1586,1481,441332,457372,0.964930078798003,0.974894033257255,1.01032608960813,0.677494493941069,0.00699586885345293,0.271614231371927
"292","경기","군포시",2012,2753,1400,1353,"6",2011,2870,1468,1402,407210,420797,0.967711271705834,0.959233449477352,0.991239306106729,0.676063947349034,-0.0059227892950011,-0.302187154860192
"293","경기","군포시",2013,2838,1463,1375,"6",2012,2931,1508,1423,422944,435284,0.971650692421499,0.968270214943705,0.996520892225817,0.671010819399259,-0.00233451895833311,-0.142808799175312
"294","경기","군포시",2014,2995,1551,1444,"6",2013,3075,1588,1487,465061,480776,0.967313260229296,0.973983739837398,1.0068958835595,0.644001539582979,0.00444095962910345,0.158134144060816
"295","경기","군포시",2015,2892,1507,1385,"6",2014,3009,1571,1438,441255,454993,0.969806128885499,0.96111665004985,0.991039983583487,0.655403338205799,-0.00587242466976124,-0.299950135237287
"296","경기","군포시",2016,2679,1361,1318,"6",2015,2757,1408,1349,422114,435131,0.970084870992873,0.97170837867247,1.00167357282661,0.634662674064352,0.00106215420537616,0.00805948354544872
"297","경기","군포시",2017,2682,1415,1267,"6",2016,2790,1450,1340,445571,460063,0.968499966308962,0.961290322580645,0.992555865793374,0.601924272450406,-0.0044808050663467,-0.238139283957612
"298","경기","군포시",2018,2625,1346,1279,"6",2017,2753,1412,1341,447106,462352,0.967025123715265,0.953505266981475,0.986019125664649,0.587109097171588,-0.00820829850869709,-0.403701440631581
"299","경기","군포시",2019,2511,1291,1220,"6",2018,2643,1375,1268,462528,478982,0.965647978420901,0.95005675368899,0.98385413206435,0.542886052303861,-0.00876536650460444,-0.428444442931354
"300","경기","군포시",2020,2338,1185,1153,"6",2019,2411,1216,1195,417119,431843,0.965904275396382,0.96972210700954,1.00395259831684,0.560511508706149,0.00221547684587952,0.0592860213397713
"301","경기","김포시",2009,2447,1271,1176,"6",2008,2584,1344,1240,462768,488710,0.946917394773997,0.946981424148607,1.00006761875425,0.528774677592228,3.57550849764923e-05,-0.0375295576184927
"302","경기","김포시",2010,2576,1335,1241,"6",2009,2604,1340,1264,470657,487028,0.966385916210156,0.989247311827957,1.02365659022376,0.547320022861659,0.0129477255020995,0.535974783095092
"303","경기","김포시",2011,2662,1400,1262,"6",2010,2651,1392,1259,441332,457372,0.964930078798003,1.00414937759336,1.04064470541142,0.603174027716096,0.0245158306683375,1.04978935301315
"304","경기","김포시",2012,2601,1357,1244,"6",2011,2581,1358,1223,407210,420797,0.967711271705834,1.0077489345215,1.04137356253492,0.638736769725694,0.0264268156855993,1.13466859042101
"305","경기","김포시",2013,3302,1719,1583,"6",2012,3250,1708,1542,422944,435284,0.971650692421499,1.016,1.04564326246501,0.780718014678066,0.0356345172551103,1.5436423293251
"306","경기","김포시",2014,3827,1938,1889,"6",2013,3809,1930,1879,465061,480776,0.967313260229296,1.00472564977684,1.03867660155789,0.822902801998017,0.0318270837937454,1.37452951799344
"307","경기","김포시",2015,4265,2158,2107,"6",2014,4329,2186,2143,441255,454993,0.969806128885499,0.985215985215985,1.01588962563909,0.966561285424528,0.0153582969826335,0.643043895169052
"308","경기","김포시",2016,4133,2137,1996,"6",2015,4265,2206,2059,422114,435131,0.970084870992873,0.96905041031653,0.998933638996674,0.979119384810738,-0.00104409472956295,-0.0854926907384275
"309","경기","김포시",2017,4856,2591,2265,"6",2016,4748,2538,2210,445571,460063,0.968499966308962,1.02274641954507,1.05601079517106,1.08983753430991,0.0610426669039651,2.67218302779158
"310","경기","김포시",2018,5362,2712,2650,"6",2017,5378,2707,2671,447106,462352,0.967025123715265,0.997024916325772,1.03102276442958,1.19926818248916,0.0372046143132556,1.61338052180065
"311","경기","김포시",2019,6010,3023,2987,"6",2018,6157,3089,3068,462528,478982,0.965647978420901,0.976124736072763,1.01084945848382,1.29938079424381,0.0140975779818206,0.587047188544982
"312","경기","김포시",2020,5412,2756,2656,"6",2019,5483,2806,2677,417119,431843,0.965904275396382,0.987050884552252,1.02189306921454,1.29747146497762,0.0284056325866414,1.22256068167921
"313","경기","남양주시",2009,5938,3092,2846,"6",2008,6304,3284,3020,462768,488710,0.946917394773997,0.941941624365482,0.994745296225441,1.28314835943713,-0.00674256452765353,-0.338598689207589
"314","경기","남양주시",2010,6436,3320,3116,"6",2009,6503,3369,3134,470657,487028,0.966385916210156,0.989697062894049,1.02412198511265,1.36745018134225,0.0329856129166234,1.4259873094342
"315","경기","남양주시",2011,6648,3403,3245,"6",2010,6846,3511,3335,441332,457372,0.964930078798003,0.971078001752848,1.00637136626781,1.50634896177934,0.0095975009626268,0.387169584997303
"316","경기","남양주시",2012,6176,3235,2941,"6",2011,6387,3340,3047,407210,420797,0.967711271705834,0.966964145921403,0.999227945559511,1.51666216448516,-0.00117094575881209,-0.0911269675798527
"317","경기","남양주시",2013,6846,3544,3302,"6",2012,6973,3633,3340,422944,435284,0.971650692421499,0.981786892298867,1.01043193809918,1.61865400620413,0.016885698396713,0.710885697209195
"318","경기","남양주시",2014,7590,3918,3672,"6",2013,7932,4098,3834,465061,480776,0.967313260229296,0.956883509833585,0.989217815133395,1.63204396842565,-0.0175969997779928,-0.820714549991224
"319","경기","남양주시",2015,7243,3775,3468,"6",2014,7615,3963,3652,441255,454993,0.969806128885499,0.951149047931714,0.980762050890288,1.64145448776784,-0.0315782179015854,-1.4417111154504
"320","경기","남양주시",2016,7049,3628,3421,"6",2015,7460,3821,3639,422114,435131,0.970084870992873,0.944906166219839,0.974044843367917,1.6699280289211,-0.0433432435549529,-1.96427220123674
"321","경기","남양주시",2017,7192,3700,3492,"6",2016,7644,3956,3688,445571,460063,0.968499966308962,0.940868655154369,0.971469992652764,1.6141086381295,-0.0460505313050719,-2.08452040705627
"322","경기","남양주시",2018,7351,3780,3571,"6",2017,7689,3962,3727,447106,462352,0.967025123715265,0.956041097671999,0.988641426397418,1.64412913268889,-0.0186749617657957,-0.86859383248318
"323","경기","남양주시",2019,7734,3947,3787,"6",2018,8152,4138,4014,462528,478982,0.965647978420901,0.948724239450442,0.98247421488094,1.67211498547115,-0.0293051279297275,-1.34074844874817
"324","경기","남양주시",2020,7055,3634,3421,"6",2019,7432,3810,3622,417119,431843,0.965904275396382,0.949273412271259,0.982782079395706,1.69136385539858,-0.0291217685752254,-1.33260427072419
"325","경기","동두천시",2009,900,454,446,"6",2008,979,484,495,462768,488710,0.946917394773997,0.919305413687436,0.970840137440763,0.19448190021782,-0.0056710654806109,-0.291006467827149
"326","경기","동두천시",2010,1015,526,489,"6",2009,1053,547,506,470657,487028,0.966385916210156,0.963912630579297,0.997440685352123,0.21565598726886,-0.000551931527119656,-0.0636325312257928
"327","경기","동두천시",2011,931,459,472,"6",2010,955,480,475,441332,457372,0.964930078798003,0.974869109947644,1.01030026047278,0.210952298949544,0.00217286362651247,0.0573932919197618
"328","경기","동두천시",2012,804,413,391,"6",2011,858,430,428,407210,420797,0.967711271705834,0.937062937062937,0.968329050679681,0.197441123744505,-0.00625314782385915,-0.316860519511074
"329","경기","동두천시",2013,896,460,436,"6",2012,949,494,455,422944,435284,0.971650692421499,0.944151738672287,0.971698724692223,0.211848377090111,-0.00599557924353298,-0.305420228519344
"330","경기","동두천시",2014,983,491,492,"6",2013,1035,523,512,465061,480776,0.967313260229296,0.94975845410628,0.981851994752088,0.211370121338921,-0.00383594607131045,-0.20949691405944
"331","경기","동두천시",2015,866,414,452,"6",2014,910,435,475,441255,454993,0.969806128885499,0.951648351648352,0.981276899891307,0.196258399338251,-0.00367456565798202,-0.202328963347032
"332","경기","동두천시",2016,863,431,432,"6",2015,902,440,462,422114,435131,0.970084870992873,0.956762749445676,0.986267055650953,0.204447139872167,-0.00280766119418622,-0.163824114210176
"333","경기","동두천시",2017,923,482,441,"6",2016,978,516,462,445571,460063,0.968499966308962,0.943762781186094,0.974458248855554,0.207149926723238,-0.00529097187795522,-0.274124046015571
"334","경기","동두천시",2018,835,439,396,"6",2017,879,462,417,447106,462352,0.967025123715265,0.949943117178612,0.982335509059967,0.186756608052677,-0.00329896041093779,-0.18564589851527
"335","경기","동두천시",2019,803,401,402,"6",2018,840,428,412,462528,478982,0.965647978420901,0.955952380952381,0.989959490740741,0.173611111111111,-0.0017431439686214,-0.116542000798872
"336","경기","동두천시",2020,733,377,356,"6",2019,776,407,369,417119,431843,0.965904275396382,0.944587628865979,0.977930891214189,0.175729228349704,-0.00387818745729629,-0.211373127947641
"337","경기","부천시",2009,8209,4289,3920,"6",2008,8581,4479,4102,462768,488710,0.946917394773997,0.956648409276308,1.01027651889808,1.77389102098676,0.0182294246002966,0.770569292012342
"338","경기","부천시",2010,8247,4254,3993,"6",2009,8617,4462,4155,470657,487028,0.966385916210156,0.957061622374376,0.990351376526319,1.75223145517861,-0.0169066215497588,-0.790050375753241
"339","경기","부천시",2011,7620,3898,3722,"6",2010,7962,4044,3918,441332,457372,0.964930078798003,0.957045968349661,0.991829345336439,1.72659131900701,-0.0141073814127092,-0.665717968116317
"340","경기","부천시",2012,6986,3558,3428,"6",2011,7291,3724,3567,407210,420797,0.967711271705834,0.958167603895213,0.99013789743939,1.71557672945163,-0.0169191936564476,-0.790608784541754
"341","경기","부천시",2013,7249,3755,3494,"6",2012,7547,3930,3617,422944,435284,0.971650692421499,0.96051411156751,0.988538493369222,1.71393848831051,-0.0196443173485168,-0.911649200209881
"342","경기","부천시",2014,7777,3979,3798,"6",2013,8104,4164,3940,465061,480776,0.967313260229296,0.959649555774926,0.992077329269162,1.67225374735787,-0.0132487158187261,-0.627579060617147
"343","경기","부천시",2015,7048,3609,3439,"6",2014,7321,3728,3593,441255,454993,0.969806128885499,0.962710012293403,0.992682953447354,1.59726235396766,-0.0116872430007706,-0.558223926576862
"344","경기","부천시",2016,6657,3403,3254,"6",2015,6890,3558,3332,422114,435131,0.970084870992873,0.966182873730044,0.995977674346332,1.57706212065935,-0.00634345742535633,-0.320871754573854
"345","경기","부천시",2017,6934,3528,3406,"6",2016,7176,3649,3527,445571,460063,0.968499966308962,0.966276477146042,0.997704192834003,1.55620540834121,-0.00357274752823265,-0.197806559911445
"346","경기","부천시",2018,7070,3575,3495,"6",2017,7236,3665,3571,447106,462352,0.967025123715265,0.97705914870094,1.01037617817738,1.58128050171548,0.0164076482342207,0.689652389324244
"347","경기","부천시",2019,7059,3638,3421,"6",2018,7334,3803,3531,462528,478982,0.965647978420901,0.96250340878102,0.996743565243078,1.52617787463678,-0.00496989867621213,-0.25986310295747
"348","경기","부천시",2020,6172,3198,2974,"6",2019,6418,3305,3113,417119,431843,0.965904275396382,0.961670302274852,0.99561657067954,1.4796736662679,-0.00648604493343173,-0.327204990491459
"349","경기","성남시",2009,8221,4231,3990,"6",2008,9030,4697,4333,462768,488710,0.946917394773997,0.910409745293466,0.961445792756564,1.77648411298966,-0.0684909366568741,-3.08124433538591
"350","경기","성남시",2010,8852,4638,4214,"6",2009,9275,4800,4475,470657,487028,0.966385916210156,0.954393530997305,0.987590480147018,1.88077517172803,-0.023339516832554,-1.07577697276794
"351","경기","성남시",2011,8517,4411,4106,"6",2010,9037,4683,4354,441332,457372,0.964930078798003,0.942458780568773,0.97671199320761,1.92983966718933,-0.0449421192777295,-2.03528864083901
"352","경기","성남시",2012,7665,3948,3717,"6",2011,8166,4184,3982,407210,420797,0.967711271705834,0.938648052902278,0.969967055615333,1.88232116107168,-0.0565316467445476,-2.55005471405005
"353","경기","성남시",2013,7917,4076,3841,"6",2012,8323,4270,4053,422944,435284,0.971650692421499,0.951219512195122,0.978972710681181,1.87187901944465,-0.0393605417116896,-1.78737458444461
"354","경기","성남시",2014,8606,4427,4179,"6",2013,9094,4669,4425,465061,480776,0.967313260229296,0.946338244996701,0.978316212446397,1.85050993310555,-0.0401260642552922,-1.8213764050411
"355","경기","성남시",2015,7921,4067,3854,"6",2014,8425,4316,4109,441255,454993,0.969806128885499,0.940178041543027,0.969449474013408,1.79510713759617,-0.0548414672558488,-2.47498288209569
"356","경기","성남시",2016,7483,3825,3658,"6",2015,7942,4045,3897,422114,435131,0.970084870992873,0.942205993452531,0.971261403642128,1.77274385592518,-0.0509461701213315,-2.30196747524096
"357","경기","성남시",2017,8106,4157,3949,"6",2016,8629,4405,4224,445571,460063,0.968499966308962,0.939390427627767,0.96994368642868,1.81923868474385,-0.054679608369737,-2.46779367930406
"358","경기","성남시",2018,7902,4071,3831,"6",2017,8486,4397,4089,447106,462352,0.967025123715265,0.931180768324299,0.962933377311591,1.76736612794281,-0.0655102934167307,-2.94885463953639
"359","경기","성남시",2019,7813,4093,3720,"6",2018,8450,4436,4014,462528,478982,0.965647978420901,0.924615384615385,0.957507710136135,1.68919503251695,-0.0717777649583113,-3.22723369542616
"360","경기","성남시",2020,7248,3704,3544,"6",2019,7753,3955,3798,417119,431843,0.965904275396382,0.934863923642461,0.967863946206074,1.73763362493677,-0.0558406876451031,-2.51936473955464
"361","경기","수원시",2009,11217,5832,5385,"6",2008,11752,6080,5672,462768,488710,0.946917394773997,0.954475833900613,1.00798215258092,2.42389274971476,0.0193478817680155,0.820247228056743
"362","경기","수원시",2010,11610,6047,5563,"6",2009,11974,6184,5790,470657,487028,0.966385916210156,0.969600801737097,1.00332670982991,2.466764544031,0.00820620985669568,0.325373324421182
"363","경기","수원시",2011,10941,5633,5308,"6",2010,11227,5791,5436,441332,457372,0.964930078798003,0.974525696980493,1.00994436632595,2.47908603953486,0.0246529397306727,1.05587925562756
"364","경기","수원시",2012,10298,5241,5057,"6",2011,10293,5262,5031,407210,420797,0.967711271705834,1.00048576702613,1.03386805163748,2.52891628398124,0.0856494672927285,3.76513060884505
"365","경기","수원시",2013,11042,5631,5411,"6",2012,10954,5607,5347,422944,435284,0.971650692421499,1.00803359503378,1.03744442616678,2.61074752213059,0.0977579428325247,4.30294653136981
"366","경기","수원시",2014,12350,6416,5934,"6",2013,12398,6430,5968,465061,480776,0.967313260229296,0.996128407807711,1.02978884789772,2.65556561397322,0.0791062401570548,3.47450345873886
"367","경기","수원시",2015,11849,6089,5760,"6",2014,12048,6177,5871,441255,454993,0.969806128885499,0.983482735723772,1.01410241328748,2.6852953507609,0.0378691448353724,1.64289663178687
"368","경기","수원시",2016,11258,5747,5511,"6",2015,11442,5876,5566,422114,435131,0.970084870992873,0.983918895298025,1.01426063298049,2.66705202859891,0.0380338501197096,1.65021226158266
"369","경기","수원시",2017,11580,5984,5596,"6",2016,11873,6150,5723,445571,460063,0.968499966308962,0.975322159521604,1.00704408203404,2.59891240677692,0.0183069521926113,0.774012795155642
"370","경기","수원시",2018,11749,6072,5677,"6",2017,11945,6206,5739,447106,462352,0.967025123715265,0.983591460862285,1.01713123758706,2.6277884886358,0.0450172689273573,1.96039117849651
"371","경기","수원시",2019,12205,6273,5932,"6",2018,12491,6403,6088,462528,478982,0.965647978420901,0.977103514530462,1.01186305606759,2.63875916701259,0.0313037479471342,1.35128477919784
"372","경기","수원시",2020,10731,5521,5210,"6",2019,10961,5663,5298,417119,431843,0.965904275396382,0.979016513091871,1.01357509023356,2.57264713427104,0.034923916986843,1.51207996314874
"373","경기","시흥시",2009,4894,2604,2290,"6",2008,5144,2700,2444,462768,488710,0.946917394773997,0.951399688958009,1.00473356409836,1.05754935518446,0.00500597765994245,0.183230258968103
"374","경기","시흥시",2010,4860,2513,2347,"6",2009,5010,2606,2404,470657,487028,0.966385916210156,0.970059880239521,1.00380175659407,1.03259911145484,0.00392569048100036,0.135247699658726
"375","경기","시흥시",2011,4589,2386,2203,"6",2010,4725,2445,2280,441332,457372,0.964930078798003,0.971216931216931,1.00651534505667,1.03980676678782,0.00677469987788296,0.261790682879874
"376","경기","시흥시",2012,4164,2099,2065,"6",2011,4258,2148,2110,407210,420797,0.967711271705834,0.977923907937999,1.01055339183366,1.0225682080499,0.010791562976198,0.440205622545543
"377","경기","시흥시",2013,4245,2122,2123,"6",2012,4348,2191,2157,422944,435284,0.971650692421499,0.976310947562097,1.00479622479245,1.00367897404857,0.00481386997899746,0.174697511033654
"378","경기","시흥시",2014,4395,2199,2196,"6",2013,4457,2215,2242,465061,480776,0.967313260229296,0.986089297733902,1.01941050358408,0.945037317685207,0.018343650242015,0.775642793517539
"379","경기","시흥시",2015,4152,2179,1973,"6",2014,4210,2219,1991,441255,454993,0.969806128885499,0.986223277909739,1.01692827930785,0.940952510453139,0.0159287069123742,0.66837949927318
"380","경기","시흥시",2016,4069,2106,1963,"6",2015,4099,2121,1978,422114,435131,0.970084870992873,0.992681141741888,1.02329308643468,0.963957603870045,0.0224535477863144,0.958189996260354
"381","경기","시흥시",2017,4248,2165,2083,"6",2016,4159,2112,2047,445571,460063,0.968499966308962,1.02139937484972,1.05461993844188,0.953383411397959,0.0520737432420692,2.27381496424608
"382","경기","시흥시",2018,4662,2422,2240,"6",2017,4381,2283,2098,447106,462352,0.967025123715265,1.06414060716731,1.10042705310379,1.04270575657674,0.104715866387356,4.61199303876866
"383","경기","시흥시",2019,5317,2756,2561,"6",2018,5015,2602,2413,462528,478982,0.965647978420901,1.06021934197408,1.09793565115502,1.14955202712052,0.112582126312618,4.96138465496507
"384","경기","시흥시",2020,4959,2537,2422,"6",2019,4794,2460,2334,417119,431843,0.965904275396382,1.03441802252816,1.07093223301415,1.18886936341907,0.0843291587094231,3.70648714242238
"385","경기","안산시",2009,7976,4140,3836,"6",2008,8444,4359,4085,462768,488710,0.946917394773997,0.944576030317385,0.997527382568391,1.72354181793037,-0.00426165954312108,-0.228405610106317
"386","경기","안산시",2010,7654,3947,3707,"6",2009,7911,4091,3820,470657,487028,0.966385916210156,0.967513588673998,1.00116689662476,1.62623736606488,0.00189765089352078,0.0451693096853327
"387","경기","안산시",2011,7397,3852,3545,"6",2010,7566,3950,3616,441332,457372,0.964930078798003,0.97766323024055,1.01319593172845,1.67606246544551,0.0221172058666385,0.943250870420793
"388","경기","안산시",2012,6600,3390,3210,"6",2011,6808,3498,3310,407210,420797,0.967711271705834,0.969447708578143,1.00179437495778,1.62078534417131,0.0029082966335157,0.0900586410643868
"389","경기","안산시",2013,6424,3298,3126,"6",2012,6574,3348,3226,422944,435284,0.971650692421499,0.977182841496806,1.00569355748774,1.51887720360142,0.00864781467552538,0.344987858245006
"390","경기","안산시",2014,7139,3668,3471,"6",2013,7238,3714,3524,465061,480776,0.967313260229296,0.986322188449848,1.01965126397218,1.53506744276557,0.0301660155328794,1.30075070445427
"391","경기","안산시",2015,6508,3354,3154,"6",2014,6590,3387,3203,441255,454993,0.969806128885499,0.987556904400607,1.01830342682563,1.47488413729023,0.0269954338831809,1.15992461208051
"392","경기","안산시",2016,5900,3037,2863,"6",2015,5946,3063,2883,422114,435131,0.970084870992873,0.992263706693576,1.0228627786742,1.3977266804702,0.0319559157426176,1.38025178032164
"393","경기","안산시",2017,6090,3146,2944,"6",2016,6091,3129,2962,445571,460063,0.968499966308962,0.99983582334592,1.03235504194841,1.36678554035159,0.0442224034925533,1.9250860498123
"394","경기","안산시",2018,5745,2909,2836,"6",2017,5889,2978,2911,447106,462352,0.967025123715265,0.97554763117677,1.0088131189692,1.2849301955241,0.0113242426802682,0.463865382646074
"395","경기","안산시",2019,5611,2815,2796,"6",2018,5498,2771,2727,462528,478982,0.965647978420901,1.02055292833758,1.05685814203895,1.21311574650616,0.0689755074245286,3.02453192000237
"396","경기","안산시",2020,5094,2610,2484,"6",2019,4890,2511,2379,417119,431843,0.965904275396382,1.04171779141104,1.07848967847621,1.22123422812195,0.0958542819094367,4.21839260448116
"397","경기","안성시",2009,1853,990,863,"6",2008,1939,1041,898,462768,488710,0.946917394773997,0.955647240845797,1.00921922664002,0.400416623448467,0.00369153160200347,0.124847185315597
"398","경기","안성시",2010,1798,937,861,"6",2009,1811,951,860,470657,487028,0.966385916210156,0.992821645499724,1.02735525098838,0.382019177447695,0.0104502304814575,0.425044832903345
"399","경기","안성시",2011,1852,948,904,"6",2010,1885,962,923,441332,457372,0.964930078798003,0.982493368700265,1.01820161925529,0.419638730026375,0.00763810438871549,0.300140076408339
"400","경기","안성시",2012,1696,876,820,"6",2011,1722,889,833,407210,420797,0.967711271705834,0.984901277584204,1.01776356892905,0.416492718744628,0.0073983971178697,0.289493122001724
"401","경기","안성시",2013,1813,966,847,"6",2012,1846,978,868,422944,435284,0.971650692421499,0.982123510292524,1.01077837740734,0.428661950518272,0.00462028028285368,0.166098937193316
"402","경기","안성시",2014,2031,1044,987,"6",2013,2057,1058,999,465061,480776,0.967313260229296,0.987360233349538,1.02072438572329,0.436716903804017,0.009050689566314,0.362882144799859
"403","경기","안성시",2015,1926,990,936,"6",2014,1949,1000,949,441255,454993,0.969806128885499,0.988199076449461,1.01896559221078,0.436482306149505,0.00827814542565433,0.328568449542812
"404","경기","안성시",2016,1802,919,883,"6",2015,1833,941,892,422114,435131,0.970084870992873,0.983087834151664,1.01340394386883,0.426898894611408,0.00572212882103728,0.215039176292626
"405","경기","안성시",2017,1809,938,871,"6",2016,1828,946,882,445571,460063,0.968499966308962,0.989606126914661,1.0217926291584,0.40599590188769,0.00884771812967051,0.35386686702308
"406","경기","안성시",2018,1888,984,904,"6",2017,1916,998,918,447106,462352,0.967025123715265,0.985386221294363,1.01898719808701,0.422271228746651,0.00801774746665842,0.317002487495759
"407","경기","안성시",2019,1787,897,890,"6",2018,1782,893,889,462528,478982,0.965647978420901,1.00280583613917,1.03847971367271,0.38635498823855,0.014866829323443,0.62121462924289
"408","경기","안성시",2020,1681,886,795,"6",2019,1657,875,782,417119,431843,0.965904275396382,1.014484007242,1.05029456135877,0.403002500485473,0.0202688339884042,0.8611526885651
"409","경기","안양시",2009,5819,3020,2799,"6",2008,6152,3224,2928,462768,488710,0.946917394773997,0.945871261378413,0.998895222116146,1.25743353040833,-0.00138918475481198,-0.100820376678199
"410","경기","안양시",2010,6023,3126,2897,"6",2009,6215,3241,2974,470657,487028,0.966385916210156,0.969106999195495,1.00281573121017,1.27970050376389,0.00360329264811396,0.120927921141281
"411","경기","안양시",2011,5482,2893,2589,"6",2010,5734,2988,2746,441332,457372,0.964930078798003,0.95605162190443,0.990798859846267,1.24214876782105,-0.0114291849045079,-0.546761893007867
"412","경기","안양시",2012,5104,2628,2476,"6",2011,5262,2722,2540,407210,420797,0.967711271705834,0.969973394146712,1.00233760059123,1.25340733282581,0.00292996572226356,0.0910211058203257
"413","경기","안양시",2013,5291,2688,2603,"6",2012,5424,2780,2644,422944,435284,0.971650692421499,0.975479351032448,1.00394036523702,1.25099303926761,0.00492936948369022,0.179827593054576
"414","경기","안양시",2014,5378,2845,2533,"6",2013,5599,2939,2660,465061,480776,0.967313260229296,0.960528665833185,0.992986145569323,1.15640743902413,-0.00811087343986675,-0.39937416152053
"415","경기","안양시",2015,5127,2626,2501,"6",2014,5290,2717,2573,441255,454993,0.969806128885499,0.969187145557656,0.999361745291758,1.16191317945406,-0.000741596557355336,-0.0720567852015831
"416","경기","안양시",2016,4642,2389,2253,"6",2015,4811,2464,2347,422114,435131,0.970084870992873,0.964872167948451,0.994626549490369,1.09970292385469,-0.00590919923662971,-0.30158353223601
"417","경기","안양시",2017,4978,2583,2395,"6",2016,5158,2699,2459,445571,460063,0.968499966308962,0.965102753005041,0.996492293833661,1.11721813134158,-0.00391887292845285,-0.213180233568121
"418","경기","안양시",2018,4837,2443,2394,"6",2017,5128,2599,2529,447106,462352,0.967025123715265,0.943252730109204,0.975416984499092,1.08184636305485,-0.0265950459125787,-1.22037613140894
"419","경기","안양시",2019,4602,2360,2242,"6",2018,4893,2506,2387,462528,478982,0.965647978420901,0.940527283874923,0.973985660295114,0.994966791199668,-0.0258834041013484,-1.18876750355516
"420","경기","안양시",2020,4147,2145,2002,"6",2019,4326,2228,2098,417119,431843,0.965904275396382,0.958622283865002,0.992460959417131,0.994200695724721,-0.0074953193925854,-0.372033414395559
"421","경기","양주시",2009,2175,1146,1029,"6",2008,2312,1203,1109,462768,488710,0.946917394773997,0.940743944636678,0.99348047657442,0.469997925526398,-0.00306416248544348,-0.175216999972956
"422","경기","양주시",2010,2278,1155,1123,"6",2009,2275,1142,1133,470657,487028,0.966385916210156,1.00131868131868,1.03614784168784,0.484004274875334,0.0174957099044324,0.737980264208699
"423","경기","양주시",2011,2334,1242,1092,"6",2010,2406,1283,1123,441332,457372,0.964930078798003,0.970074812967581,1.00533171706699,0.528853561491122,0.00281969755974018,0.0861233816305457
"424","경기","양주시",2012,2112,1104,1008,"6",2011,2171,1132,1039,407210,420797,0.967711271705834,0.972823583602027,1.00528288968587,0.51865131013482,0.00273997765687287,0.0825825037584094
"425","경기","양주시",2013,2158,1144,1014,"6",2012,2214,1180,1034,422944,435284,0.971650692421499,0.974706413730804,1.00314487637701,0.510233033214799,0.0016046198129288,0.0321538990814925
"426","경기","양주시",2014,2361,1220,1141,"6",2013,2437,1260,1177,465061,480776,0.967313260229296,0.968814115716044,1.00155157129387,0.507675337213828,0.000787694479824979,-0.00413105274527298
"427","경기","양주시",2015,2212,1111,1101,"6",2014,2266,1145,1121,441255,454993,0.969806128885499,0.976169461606355,1.00656144824344,0.501297435723108,0.00328923717906757,0.106978681102434
"428","경기","양주시",2016,2141,1089,1052,"6",2015,2199,1121,1078,422114,435131,0.970084870992873,0.97362437471578,1.00364865366809,0.507208953031645,0.00185062980696676,0.043080798298408
"429","경기","양주시",2017,2136,1074,1062,"6",2016,2179,1086,1093,445571,460063,0.968499966308962,0.98026617714548,1.01214890164773,0.479384879177505,0.00582399974853647,0.219563924818678
"430","경기","양주시",2018,2187,1100,1087,"6",2017,2277,1143,1134,447106,462352,0.967025123715265,0.960474308300395,0.993225806388875,0.4891457506721,-0.00331356801911187,-0.186294717125028
"431","경기","양주시",2019,2359,1179,1180,"6",2018,2401,1198,1203,462528,478982,0.965647978420901,0.982507288629738,1.01745906436464,0.510023176975232,0.00890452747426952,0.35639013842691
"432","경기","양주시",2020,2065,1035,1030,"6",2019,2124,1084,1040,417119,431843,0.965904275396382,0.972222222222222,1.0065409657942,0.495062560084772,0.00323818727150376,0.104711223647447
"433","경기","양평군",2009,628,346,282,"6",2008,679,359,320,462768,488710,0.946917394773997,0.924889543446245,0.97673730417318,0.13570514815199,-0.00315686758359329,-0.179334634576942
"434","경기","양평군",2010,722,380,342,"6",2009,697,367,330,470657,487028,0.966385916210156,1.03586800573888,1.07189890535782,0.153402584047406,0.0110294778720696,0.450772965955949
"435","경기","양평군",2011,790,429,361,"6",2010,804,437,367,441332,457372,0.964930078798003,0.982587064676617,1.018298720567,0.179003561944296,0.00327553616051571,0.106370130017057
"436","경기","양평군",2012,681,361,320,"6",2011,699,369,330,407210,420797,0.967711271705834,0.974248927038627,1.00675579124057,0.16723557869404,0.00112980865765304,0.0110644565120793
"437","경기","양평군",2013,776,390,386,"6",2012,812,414,398,422944,435284,0.971650692421499,0.955665024630542,0.983547927340927,0.183475826586971,-0.00301855763019241,-0.173191392602495
"438","경기","양평군",2014,847,422,425,"6",2013,883,434,449,465061,480776,0.967313260229296,0.959229898074745,0.991643490803967,0.182126645751848,-0.00152194299006795,-0.106717030846783
"439","경기","양평군",2015,816,410,406,"6",2014,859,429,430,441255,454993,0.969806128885499,0.949941792782305,0.97951720914981,0.18492708297923,-0.00378782276319935,-0.207359445865228
"440","경기","양평군",2016,822,431,391,"6",2015,851,440,411,422114,435131,0.970084870992873,0.965922444183314,0.99570921376673,0.194734123957035,-0.000835562498222753,-0.0762304220072587
"441","경기","양평군",2017,831,421,410,"6",2016,871,442,429,445571,460063,0.968499966308962,0.954075774971297,0.985106668209152,0.186502263387878,-0.00277764008837984,-0.162490682213604
"442","경기","양평군",2018,873,444,429,"6",2017,937,476,461,447106,462352,0.967025123715265,0.931696905016009,0.963467113901315,0.195255711173637,-0.00713325465642412,-0.355951771462699
"443","경기","양평군",2019,840,438,402,"6",2018,905,474,431,462528,478982,0.965647978420901,0.92817679558011,0.961195814957262,0.181610626816106,-0.00704725236869984,-0.352131852137624
"444","경기","양평군",2020,746,373,373,"6",2019,799,404,395,417119,431843,0.965904275396382,0.933667083854819,0.966624858836726,0.178845844950722,-0.00596900532169531,-0.304239908317907
"445","경기","여주시",2014,1014,511,503,"6",2013,1036,529,507,465061,480776,0.967313260229296,0.978764478764479,1.01183816970778,0.218035913568328,0.00258114614721326,0.0755277663876453
"446","경기","여주시",2015,884,475,409,"6",2014,932,503,429,441255,454993,0.969806128885499,0.948497854077253,0.978028314965659,0.200337673227499,-0.00440175625666742,-0.234628213686014
"447","경기","여주시",2016,908,481,427,"6",2015,926,492,434,422114,435131,0.970084870992873,0.980561555075594,1.01079976030551,0.215107767096093,0.00232311232449034,0.0640668109639658
"448","경기","여주시",2017,939,463,476,"6",2016,957,474,483,445571,460063,0.968499966308962,0.981191222570533,1.01310403376671,0.210740824694605,0.00276155488282258,0.0835408882917496
"449","경기","여주시",2018,955,494,461,"6",2017,984,509,475,447106,462352,0.967025123715265,0.970528455284553,1.00362279271073,0.213595881066235,0.000773813600968652,-0.00474759259316993
"450","경기","여주시",2019,868,457,411,"6",2018,922,485,437,462528,478982,0.965647978420901,0.941431670281996,0.974922219400795,0.187664314376643,-0.0047062045022377,-0.248150734627175
"451","경기","여주시",2020,804,428,376,"6",2019,827,455,372,417119,431843,0.965904275396382,0.972188633615478,1.00650619153385,0.192750749786032,0.00125407329640147,0.0165838549785535
"452","경기","연천군",2009,377,201,176,"6",2008,401,215,186,462768,488710,0.946917394773997,0.940149625935162,0.992852841360624,0.0814663070912423,-0.000582252620545256,-0.0649792876179623
"453","경기","연천군",2010,333,192,141,"6",2009,352,196,156,470657,487028,0.966385916210156,0.946022727272727,0.978928512309775,0.0707521613404241,-0.00149085329674156,-0.105336135948628
"454","경기","연천군",2011,334,159,175,"6",2010,354,174,180,441332,457372,0.964930078798003,0.943502824858757,0.97779398278688,0.075679986948601,-0.00168055109286931,-0.113761845270173
"455","경기","연천군",2012,329,186,143,"6",2011,341,191,150,407210,420797,0.967711271705834,0.964809384164223,0.997001287856763,0.08079369367157,-0.000242277030309898,-0.0498787669044022
"456","경기","연천군",2013,281,147,134,"6",2012,289,156,133,422944,435284,0.971650692421499,0.972318339100346,1.00068712623174,0.0664390557615193,4.56520180254555e-05,-0.0370899706399008
"457","경기","연천군",2014,312,170,142,"6",2013,314,175,139,465061,480776,0.967313260229296,0.993630573248408,1.02720660834617,0.0670879734056393,0.00182523621718524,0.0419529042980708
"458","경기","연천군",2015,300,157,143,"6",2014,306,161,145,441255,454993,0.969806128885499,0.980392156862745,1.01091561257652,0.0679878981541286,0.000742129556142168,-0.00615488649583061
"459","경기","연천군",2016,271,147,124,"6",2015,283,155,128,422114,435131,0.970084870992873,0.957597173144876,0.987127211008645,0.0642006661707501,-0.000826441628720483,-0.0758253050435692
"460","경기","연천군",2017,334,165,169,"6",2016,338,166,172,445571,460063,0.968499966308962,0.988165680473373,1.02030533283275,0.0749599951522877,0.00152208765070853,0.0284881105339111
"461","경기","연천군",2018,300,166,134,"6",2017,315,171,144,447106,462352,0.967025123715265,0.952380952380952,0.984856472727358,0.0670981825338958,-0.00101610315714677,-0.084249403481295
"462","경기","연천군",2019,286,156,130,"6",2018,321,175,146,462528,478982,0.965647978420901,0.890965732087227,0.922661002764383,0.0618340943683409,-0.00478218685342003,-0.251525603590854
"463","경기","연천군",2020,284,143,141,"6",2019,294,146,148,417119,431843,0.965904275396382,0.965986394557823,1.00008501790864,0.0680860857453149,5.78853661755155e-06,-0.0388605663650172
"464","경기","오산시",2009,1986,995,991,"6",2008,2092,1045,1047,462768,488710,0.946917394773997,0.949330783938815,1.00254867972448,0.429156726480656,0.00109378304740537,0.00946432553389079
"465","경기","오산시",2010,2310,1200,1110,"6",2009,2297,1207,1090,470657,487028,0.966385916210156,1.00565955594253,1.04063970622254,0.49080328137051,0.0199461011679543,0.84681803107756
"466","경기","오산시",2011,2447,1243,1204,"6",2010,2499,1267,1232,441332,457372,0.964930078798003,0.979191676670668,1.01477992881145,0.554457868452775,0.00819484782468282,0.324868662896396
"467","경기","오산시",2012,2479,1264,1215,"6",2011,2503,1273,1230,407210,420797,0.967711271705834,0.990411506192569,1.02345765224654,0.608776798212225,0.0142804744282257,0.595170805818404
"468","경기","오산시",2013,2583,1276,1307,"6",2012,2643,1309,1334,422944,435284,0.971650692421499,0.977298524404086,1.00581261561036,0.610719149580086,0.00354987566239523,0.118555326394867
"469","경기","오산시",2014,2993,1554,1439,"6",2013,3060,1589,1471,465061,480776,0.967313260229296,0.978104575163399,1.01115596712852,0.643571488471405,0.0071796623702418,0.279777693358615
"470","경기","오산시",2015,2971,1600,1371,"6",2014,3047,1644,1403,441255,454993,0.969806128885499,0.975057433541188,1.00541479838009,0.673306818053053,0.00364582066769593,0.122816866286312
"471","경기","오산시",2016,2728,1427,1301,"6",2015,2756,1440,1316,422114,435131,0.970084870992873,0.989840348330914,1.0203646896563,0.646270912597071,0.0131611065689326,0.545452420055334
"472","경기","오산시",2017,2839,1439,1400,"6",2016,2863,1457,1406,445571,460063,0.968499966308962,0.991617184771219,1.02386909578362,0.637159958794446,0.0152084320859491,0.636387423229251
"473","경기","오산시",2018,2943,1502,1441,"6",2017,2980,1518,1462,447106,462352,0.967025123715265,0.98758389261745,1.02125980845585,0.658233170657517,0.0139939111274682,0.582442671260747
"474","경기","오산시",2019,2979,1555,1424,"6",2018,3048,1598,1450,462528,478982,0.965647978420901,0.977362204724409,1.01213094892268,0.644069115815691,0.00781316954663265,0.307915855373884
"475","경기","오산시",2020,2677,1378,1299,"6",2019,2719,1392,1327,417119,431843,0.965904275396382,0.984553144538433,1.01930716077884,0.641783280071155,0.0123910129735076,0.511247569404014
"476","경기","용인시",2009,10494,5502,4992,"6",2008,11360,5893,5467,462768,488710,0.946917394773997,0.923767605633803,0.975552472403658,2.26765895653978,-0.0554386549190992,-2.50150785899934
"477","경기","용인시",2010,11092,5717,5375,"6",2009,11702,5999,5703,470657,487028,0.966385916210156,0.947872158605367,0.980842272953031,2.35670562639034,-0.0451491231204435,-2.04448302391964
"478","경기","용인시",2011,11162,5763,5399,"6",2010,11750,6052,5698,441332,457372,0.964930078798003,0.949957446808511,0.984483194877557,2.52916171952181,-0.039244509524962,-1.78222084256006
"479","경기","용인시",2012,10455,5449,5006,"6",2011,11047,5727,5320,407210,420797,0.967711271705834,0.946410790259799,0.977988805061154,2.56747132928956,-0.0565131119288895,-2.54923146268787
"480","경기","용인시",2013,11055,5738,5317,"6",2012,11544,5990,5554,422944,435284,0.971650692421499,0.957640332640333,0.985580867805229,2.61382121510176,-0.0376890336340504,-1.71313207094004
"481","경기","용인시",2014,12253,6241,6012,"6",2013,12950,6608,6342,465061,480776,0.967313260229296,0.946177606177606,0.978150145438222,2.63470813506185,-0.0575679895638357,-2.59608541936679
"482","경기","용인시",2015,11757,6077,5680,"6",2014,12457,6434,6023,441255,454993,0.969806128885499,0.943806695030906,0.973191101726206,2.6644457286603,-0.0714308544956982,-3.21182515205746
"483","경기","용인시",2016,10993,5693,5300,"6",2015,11634,5996,5638,422114,435131,0.970084870992873,0.944902870895651,0.974041446423704,2.60427277939135,-0.0676031544711201,-3.04181217122428
"484","경기","용인시",2017,11437,5882,5555,"6",2016,12059,6196,5863,445571,460063,0.968499966308962,0.948420267020483,0.979267217359847,2.56681875615783,-0.053217295348089,-2.40284287487185
"485","경기","용인시",2018,11495,5866,5629,"6",2017,12004,6146,5858,447106,462352,0.967025123715265,0.95759746751083,0.990250867352635,2.57097869409044,-0.0250648123222375,-1.15240853405427
"486","경기","용인시",2019,11990,6091,5899,"6",2018,12683,6495,6188,462528,478982,0.965647978420901,0.945359930615785,0.978990223913384,2.59227549467276,-0.0544631276978952,-2.45817836878436
"487","경기","용인시",2020,10958,5579,5379,"6",2019,11405,5812,5593,417119,431843,0.965904275396382,0.960806663743972,0.994722446331114,2.62706805491958,-0.0138644926516533,-0.654929703097419
"488","경기","의왕시",2009,1291,644,647,"6",2008,1452,725,727,462768,488710,0.946917394773997,0.889118457300275,0.93896095077278,0.27897348131245,-0.0170282760589197,-0.79545384143797
"489","경기","의왕시",2010,1394,727,667,"6",2009,1504,785,719,470657,487028,0.966385916210156,0.92686170212766,0.959101003626483,0.2961817204461,-0.0121135351104269,-0.577158323682949
"490","경기","의왕시",2011,1331,657,674,"6",2010,1463,720,743,441332,457372,0.964930078798003,0.909774436090226,0.942839751895305,0.301587013858048,-0.0172387885372802,-0.804804065781267
"491","경기","의왕시",2012,1198,606,592,"6",2011,1313,667,646,407210,420797,0.967711271705834,0.912414318354912,0.942858004274925,0.294197097320793,-0.0168110092774343,-0.785803614691051
"492","경기","의왕시",2013,1407,721,686,"6",2012,1512,774,738,422944,435284,0.971650692421499,0.930555555555556,0.957705853362252,0.332668154649315,-0.014069915714447,-0.664053873490395
"493","경기","의왕시",2014,1503,767,736,"6",2013,1639,838,801,465061,480776,0.967313260229296,0.917022574740696,0.948009928576106,0.32318341034832,-0.0168023285870267,-0.785418048935528
"494","경기","의왕시",2015,1397,729,668,"6",2014,1520,785,735,441255,454993,0.969806128885499,0.919078947368421,0.94769348222683,0.316596979071059,-0.0165600855127122,-0.774658463052113
"495","경기","의왕시",2016,1368,701,667,"6",2015,1461,743,718,422114,435131,0.970084870992873,0.936344969199179,0.965219639226862,0.324083067607329,-0.011271726011848,-0.53976812245952
"496","경기","의왕시",2017,1326,708,618,"6",2016,1465,769,696,445571,460063,0.968499966308962,0.905119453924915,0.934558064441039,0.297595669377047,-0.0194752366179987,-0.904139228474307
"497","경기","의왕시",2018,1237,647,590,"6",2017,1429,750,679,447106,462352,0.967025123715265,0.865640307907628,0.895158033311357,0.276668172648097,-0.0290064353405796,-1.32748157383431
"498","경기","의왕시",2019,1313,686,627,"6",2018,1428,745,683,462528,478982,0.965647978420901,0.919467787114846,0.952176991680164,0.283874705963747,-0.0135757424250951,-0.64210443298268
"499","경기","의왕시",2020,1257,590,667,"6",2019,1402,680,722,417119,431843,0.965904275396382,0.896576319543509,0.928224817283863,0.30135285134458,-0.0216296559672861,-0.999830963245875
"500","경기","의정부시",2009,4514,2375,2139,"6",2008,4814,2529,2285,462768,488710,0.946917394773997,0.937681761528874,0.990246632603758,0.975434775092487,-0.00951377373254727,-0.461686061366093
"501","경기","의정부시",2010,4414,2261,2153,"6",2009,4728,2423,2305,470657,487028,0.966385916210156,0.933587140439932,0.96606037482536,0.937837958428325,-0.0318298687836073,-1.45288856308399
"502","경기","의정부시",2011,4024,2034,1990,"6",2010,4236,2151,2085,441332,457372,0.964930078798003,0.949952785646837,0.984478364308196,0.911785231979553,-0.0141523981999532,-0.667717455572948
"503","경기","의정부시",2012,3709,1908,1801,"6",2011,3902,1999,1903,407210,420797,0.967711271705834,0.950538185545874,0.982253915333973,0.910832248716878,-0.0161637062022776,-0.757052687344802
"504","경기","의정부시",2013,3720,1873,1847,"6",2012,3877,1951,1926,422944,435284,0.971650692421499,0.95950477173072,0.987499704589815,0.879549065597337,-0.0109946231477191,-0.527460187243734
"505","경기","의정부시",2014,4073,2144,1929,"6",2013,4347,2273,2074,465061,480776,0.967313260229296,0.936968023924546,0.968629359740652,0.875799088721695,-0.0274743781517532,-1.25943297864483
"506","경기","의정부시",2015,3574,1856,1718,"6",2014,3864,1979,1885,441255,454993,0.969806128885499,0.924948240165631,0.953745509144783,0.809962493342852,-0.0374644027413958,-1.70315475625963
"507","경기","의정부시",2016,3466,1731,1735,"6",2015,3689,1858,1831,422114,435131,0.970084870992873,0.939550013553809,0.968523519588742,0.821105199069446,-0.0258455017140914,-1.18708401273903
"508","경기","의정부시",2017,3749,1897,1852,"6",2016,3986,2038,1948,445571,460063,0.968499966308962,0.940541896638234,0.971132606460196,0.841392280915948,-0.0242888020945544,-1.11794088739484
"509","경기","의정부시",2018,3683,1884,1799,"6",2017,3901,2003,1898,447106,462352,0.967025123715265,0.944116893104332,0.976310614844297,0.823742020907794,-0.0195139420022219,-0.90585838559316
"510","경기","의정부시",2019,3868,1967,1901,"6",2018,4158,2127,2031,462528,478982,0.965647978420901,0.93025493025493,0.963347877324977,0.836273695862737,-0.0306512060906559,-1.4005365092295
"511","경기","의정부시",2020,3502,1812,1690,"6",2019,3745,1955,1790,417119,431843,0.965904275396382,0.935113484646195,0.968122316533332,0.839568564366524,-0.0267635009434412,-1.22785831176512
"512","경기","이천시",2009,2333,1233,1100,"6",2008,2390,1258,1132,462768,488710,0.946917394773997,0.976150627615063,1.0308719989752,0.504140303564637,0.0155638189350066,0.652172457889549
"513","경기","이천시",2010,2251,1164,1087,"6",2009,2295,1185,1110,470657,487028,0.966385916210156,0.98082788671024,1.01494430978125,0.478267613145029,0.00714737936917923,0.278343795925262
"514","경기","이천시",2011,2187,1158,1029,"6",2010,2252,1184,1068,441332,457372,0.964930078798003,0.97113676731794,1.00643226763919,0.495545303762247,0.00318748002114431,0.102458985821048
"515","경기","이천시",2012,2124,1116,1008,"6",2011,2176,1145,1031,407210,420797,0.967711271705834,0.976102941176471,1.00867166655592,0.521598192578768,0.0045231256022124,0.161783667775217
"516","경기","이천시",2013,2165,1142,1023,"6",2012,2215,1162,1053,422944,435284,0.971650692421499,0.977426636568849,1.00594446563194,0.511888098660816,0.0030429012098878,0.0960373032155127
"517","경기","이천시",2014,2377,1210,1167,"6",2013,2464,1246,1218,465061,480776,0.967313260229296,0.964691558441558,0.997289707589539,0.511115746106425,-0.00138527312753927,-0.100646635944005
"518","경기","이천시",2015,2168,1141,1027,"6",2014,2241,1166,1075,441255,454993,0.969806128885499,0.967425256581883,0.997545001797058,0.491325877327169,-0.00120620414589717,-0.0926930212019275
"519","경기","이천시",2016,2032,1064,968,"6",2015,2044,1067,977,422114,435131,0.970084870992873,0.99412915851272,1.02478575662688,0.481386544867026,0.0119315297445283,0.490838939443454
"520","경기","이천시",2017,2274,1203,1071,"6",2016,2298,1222,1076,445571,460063,0.968499966308962,0.989556135770235,1.02174101207408,0.510356374180546,0.0110956640931448,0.453712725253397
"521","경기","이천시",2018,2274,1181,1093,"6",2017,2345,1213,1132,447106,462352,0.967025123715265,0.969722814498934,1.0027896801412,0.50860422360693,0.00141884310232634,0.023902350596475
"522","경기","이천시",2019,2291,1163,1128,"6",2018,2352,1194,1158,462528,478982,0.965647978420901,0.97406462585034,1.0087160617715,0.495321364328214,0.00431725160822753,0.152639468603742
"523","경기","이천시",2020,2035,1016,1019,"6",2019,2082,1041,1041,417119,431843,0.965904275396382,0.977425552353506,1.01192796972805,0.487870367928577,0.00581930297986549,0.219355310863324
"524","경기","파주시",2009,3543,1852,1691,"6",2008,3767,1952,1815,462768,488710,0.946917394773997,0.940536235731351,0.993261123855298,0.765610413857484,-0.00515935375407948,-0.268278031587036
"525","경기","파주시",2010,3766,1961,1805,"6",2009,3924,2058,1866,470657,487028,0.966385916210156,0.95973496432212,0.993117706108426,0.800158076901013,-0.00550692304494928,-0.283715837791132
"526","경기","파주시",2011,4048,2133,1915,"6",2010,4161,2166,1995,441332,457372,0.964930078798003,0.972843066570536,1.00820058152026,0.917223314874063,0.00752176456590739,0.294972670410428
"527","경기","파주시",2012,4011,2075,1936,"6",2011,4102,2115,1987,407210,420797,0.967711271705834,0.977815699658703,1.01044157306865,0.984995456889566,0.0102849020353965,0.417701524454183
"528","경기","파주시",2013,4441,2243,2198,"6",2012,4497,2292,2205,422944,435284,0.971650692421499,0.987547253724705,1.01636036636128,1.05002080653704,0.0171787250819111,0.723900912585091
"529","경기","파주시",2014,4943,2512,2431,"6",2013,5068,2572,2496,465061,480776,0.967313260229296,0.97533543804262,1.00829325735845,1.06287132225665,0.00881466541439209,0.352398781589783
"530","경기","파주시",2015,4757,2456,2301,"6",2014,4896,2535,2361,441255,454993,0.969806128885499,0.971609477124183,1.00185949354719,1.0780614383973,0.00200464828816942,0.0499217578627748
"531","경기","파주시",2016,4591,2396,2195,"6",2015,4710,2451,2259,422114,435131,0.970084870992873,0.974734607218684,1.00479312312236,1.08762087966758,0.00521310078669923,0.192429940226639
"532","경기","파주시",2017,4992,2492,2500,"6",2016,5190,2590,2600,445571,460063,0.968499966308962,0.961849710982659,0.993133448056124,1.12036016706653,-0.00769301128301238,-0.380814193286857
"533","경기","파주시",2018,4847,2483,2364,"6",2017,5005,2555,2450,447106,462352,0.967025123715265,0.968431568431568,1.0014544034915,1.08408296913931,0.00157669405539653,0.0309135350901663
"534","경기","파주시",2019,5245,2689,2556,"6",2018,5428,2783,2645,462528,478982,0.965647978420901,0.966285924834193,1.0006606407589,1.13398540196485,0.000749156976533115,-0.00584275318325095
"535","경기","파주시",2020,4595,2333,2262,"6",2019,4791,2415,2376,417119,431843,0.965904275396382,0.959089960342309,0.992945144536939,1.10160409859057,-0.00777165769307189,-0.384307390381768
"536","경기","평택시",2009,4718,2460,2258,"6",2008,4917,2555,2362,462768,488710,0.946917394773997,0.959528167581859,1.01331771163721,1.01951733914186,0.0135776379318311,0.563953279099187
"537","경기","평택시",2010,4672,2350,2322,"6",2009,4787,2394,2393,470657,487028,0.966385916210156,0.975976603300606,1.00992428276279,0.99265494829568,0.00985138839277112,0.398446372237095
"538","경기","평택시",2011,4523,2376,2147,"6",2010,4613,2440,2173,441332,457372,0.964930078798003,0.980489919791892,1.01612535595664,1.02485203882791,0.0165261039289921,0.694913774917533
"539","경기","평택시",2012,4190,2142,2048,"6",2011,4223,2140,2083,407210,420797,0.967711271705834,0.99218565001184,1.02529099228416,1.02895312001179,0.0260232454189791,1.11674341771594
"540","경기","평택시",2013,4508,2318,2190,"6",2012,4585,2347,2238,422944,435284,0.971650692421499,0.983206106870229,1.01189256029853,1.06586214723462,0.0126758298559068,0.523898134196805
"541","경기","평택시",2014,4946,2541,2405,"6",2013,5075,2612,2463,465061,480776,0.967313260229296,0.974581280788177,1.00751361617555,1.06351639892401,0.00799085401791651,0.315807975032364
"542","경기","평택시",2015,4718,2401,2317,"6",2014,4773,2435,2338,441255,454993,0.969806128885499,0.988476848941965,1.01925201285119,1.06922301163726,0.0205846951608279,0.87518213160097
"543","경기","평택시",2016,4704,2401,2303,"6",2015,4747,2416,2331,422114,435131,0.970084870992873,0.990941647356225,1.0214999501456,1.11439089914099,0.0239593487742463,1.02507238329591
"544","경기","평택시",2017,4918,2572,2346,"6",2016,4953,2585,2368,445571,460063,0.968499966308962,0.992933575610741,1.02522830165384,1.10375226394896,0.0278457950660159,1.19769466682627
"545","경기","평택시",2018,5043,2593,2450,"6",2017,5079,2615,2464,447106,462352,0.967025123715265,0.992911990549321,1.02676959077816,1.12792044839479,0.0301939688338459,1.30199229182813
"546","경기","평택시",2019,5410,2767,2643,"6",2018,5445,2796,2649,462528,478982,0.965647978420901,0.993572084481175,1.02891747995573,1.16965891794659,0.0338235883147573,1.46320723115922
"547","경기","평택시",2020,5066,2515,2551,"6",2019,5054,2537,2517,417119,431843,0.965904275396382,1.00237435694499,1.03775744913609,1.21452151544284,0.0458572343440208,1.99769948984975
"548","경기","포천시",2009,1530,792,738,"6",2008,1605,847,758,462768,488710,0.946917394773997,0.953271028037383,1.0067098073163,0.330619230370294,0.00221839133084803,0.0594154725177395
"549","경기","포천시",2010,1571,773,798,"6",2009,1624,796,828,470657,487028,0.966385916210156,0.967364532019704,1.00101265528929,0.333788725122541,0.000338012918001582,-0.0241043271033508
"550","경기","포천시",2011,1273,642,631,"6",2010,1331,672,659,441332,457372,0.964930078798003,0.956423741547708,0.991184503999616,0.288444980196315,-0.00254278556925146,-0.15205926998099
"551","경기","포천시",2012,1263,683,580,"6",2011,1278,688,590,407210,420797,0.967711271705834,0.988262910798122,1.02123736665386,0.31015937722551,0.00658696841527031,0.253452311181463
"552","경기","포천시",2013,1322,689,633,"6",2012,1372,719,653,422944,435284,0.971650692421499,0.963556851311953,0.991670009425532,0.312570931376258,-0.00260371291221685,-0.154765448397606
"553","경기","포천시",2014,1335,733,602,"6",2013,1356,740,616,465061,480776,0.967313260229296,0.984513274336283,1.01778122436046,0.287059116976053,0.00510426256366737,0.187595728922875
"554","경기","포천시",2015,1240,653,587,"6",2014,1261,664,597,441255,454993,0.969806128885499,0.98334655035686,1.01396198793559,0.281016645703731,0.00392355101701538,0.135152672188669
"555","경기","포천시",2016,1192,603,589,"6",2015,1221,607,614,422114,435131,0.970084870992873,0.976248976248976,1.00635419172118,0.282388170020421,0.00179434857210231,0.0405809836726958
"556","경기","포천시",2017,1171,605,566,"6",2016,1210,623,587,445571,460063,0.968499966308962,0.967768595041322,0.999244841204872,0.262808845279428,-0.000198462410950281,-0.0479326755196101
"557","경기","포천시",2018,1110,606,504,"6",2017,1150,632,518,447106,462352,0.967025123715265,0.965217391304348,0.998130625185857,0.248263275375414,-0.000464097114263464,-0.0597312353422262
"558","경기","포천시",2019,1127,553,574,"6",2018,1173,572,601,462528,478982,0.965647978420901,0.96078431372549,0.994963314992525,0.243660924311609,-0.0012272433243877,-0.0936275075583526
"559","경기","포천시",2020,922,486,436,"6",2019,951,501,450,417119,431843,0.965904275396382,0.96950578338591,1.00372863862524,0.221040038933734,0.000824178426892818,-0.00251056405657347
"560","경기","하남시",2009,1294,666,628,"6",2008,1417,725,692,462768,488710,0.946917394773997,0.913196894848271,0.964389185253299,0.279621754313176,-0.00995755849199417,-0.481397420489702
"561","경기","하남시",2010,1286,666,620,"6",2009,1385,710,675,470657,487028,0.966385916210156,0.928519855595668,0.960816833131233,0.273235073524881,-0.0107062154803251,-0.514650132402981
"562","경기","하남시",2011,1320,676,644,"6",2010,1425,725,700,441332,457372,0.964930078798003,0.926315789473684,0.959982292838856,0.299094559198064,-0.0119690784834796,-0.570742068074954
"563","경기","하남시",2012,1109,598,511,"6",2011,1183,641,542,407210,420797,0.967711271705834,0.937447168216399,0.968726102119192,0.27234105252818,-0.00851716626551812,-0.417420260728041
"564","경기","하남시",2013,1189,624,565,"6",2012,1285,681,604,422944,435284,0.971650692421499,0.925291828793774,0.952288549795409,0.281124687901945,-0.0134128665481149,-0.634870059031373
"565","경기","하남시",2014,1328,699,629,"6",2013,1424,752,672,465061,480776,0.967313260229296,0.932584269662921,0.964097472872291,0.285553938085541,-0.0102521080085402,-0.494480274681359
"566","경기","하남시",2015,1390,709,681,"6",2014,1415,721,694,441255,454993,0.969806128885499,0.982332155477032,1.01291601096183,0.315010594780796,0.00406868029528052,0.141598804603851
"567","경기","하남시",2016,1652,836,816,"6",2015,1621,817,804,422114,435131,0.970084870992873,1.01912399753239,1.0505513775195,0.391363470531657,0.0197839625461866,0.839616403411359
"568","경기","하남시",2017,2477,1269,1208,"6",2016,2513,1293,1220,445571,460063,0.968499966308962,0.985674492638281,1.01773312021349,0.555915892192266,0.00985812334483552,0.398745515134627
"569","경기","하남시",2018,2735,1333,1402,"6",2017,2772,1361,1411,447106,462352,0.967025123715265,0.986652236652237,1.02029638367777,0.611711764100683,0.0124155366643956,0.51233682555317
"570","경기","하남시",2019,3089,1646,1443,"6",2018,3202,1681,1521,462528,478982,0.965647978420901,0.96470955652717,0.99902819462713,0.667851459803515,-0.000649021636916132,-0.0679449326339308
"571","경기","하남시",2020,3027,1522,1505,"6",2019,3183,1610,1573,417119,431843,0.965904275396382,0.950989632422243,0.984558880880801,0.725692188560099,-0.0112054995274289,-0.536826574805861
"572","경기","화성시",2009,6561,3411,3150,"6",2008,6543,3396,3147,462768,488710,0.946917394773997,1.00275103163686,1.05896357715151,1.41777305258791,0.0835969707696042,3.67396592775576
"573","경기","화성시",2010,7266,3772,3494,"6",2009,7492,3857,3635,470657,487028,0.966385916210156,0.969834490122798,1.00356852666703,1.54379941231088,0.00550908937138175,0.205576712766637
"574","경기","화성시",2011,7373,3783,3590,"6",2010,7605,3890,3715,441332,457372,0.964930078798003,0.969493754109139,1.00472953990285,1.670624382551,0.00790128467995055,0.311829619873635
"575","경기","화성시",2012,6814,3475,3339,"6",2011,7024,3567,3457,407210,420797,0.967711271705834,0.970102505694761,1.00247102008506,1.67333808108838,0.00413485200746915,0.144537919467552
"576","경기","화성시",2013,7351,3762,3589,"6",2012,7600,3886,3714,422944,435284,0.971650692421499,0.967236842105263,0.995457369247341,1.73805515623818,-0.00789534280254516,-0.389801048194869
"577","경기","화성시",2014,8041,4064,3977,"6",2013,8231,4157,4074,465061,480776,0.967313260229296,0.976916535050419,1.00992778163596,1.72902049408572,0.0171653379093796,0.723306301436778
"578","경기","화성시",2015,8225,4211,4014,"6",2014,8089,4141,3948,441255,454993,0.969806128885499,1.01681295586599,1.04847033399811,1.86400154105902,0.0903487772681174,3.97385744000864
"579","경기","화성시",2016,8751,4483,4268,"6",2015,8685,4472,4213,422114,435131,0.970084870992873,1.00759930915371,1.03867129493778,2.07313664081267,0.0801708784831772,3.52179095101127
"580","경기","화성시",2017,9716,4984,4732,"6",2016,9694,4971,4723,445571,460063,0.968499966308962,1.00226944501754,1.03486781609015,2.18057279311266,0.0760318111214303,3.33794812750853
"581","경기","화성시",2018,10549,5378,5171,"6",2017,10301,5250,5051,447106,462352,0.967025123715265,1.02407533249199,1.05899558075342,2.35939575850022,0.139193922999868,6.14338712409138
"582","경기","화성시",2019,11743,5921,5822,"6",2018,11551,5843,5708,462528,478982,0.965647978420901,1.01662193749459,1.05278730988185,2.53887332226373,0.134020292813103,5.91359265636074
"583","경기","화성시",2020,11118,5741,5377,"6",2019,11134,5755,5379,417119,431843,0.965904275396382,0.998562960301778,1.033811512939,2.66542641308595,0.0901220996539962,3.96378921715486
"584","경남","거제시",2009,2728,1474,1254,"6",2008,2792,1511,1281,462768,488710,0.946917394773997,0.977077363896848,1.03185068654278,0.589496248660236,0.0187758602342212,0.794840042165295
"585","경남","거제시",2010,2755,1388,1367,"6",2009,2829,1410,1419,470657,487028,0.966385916210156,0.973842347119123,1.00771579012472,0.585351965444049,0.00451645291446112,0.161487290439616
"586","경남","거제시",2011,2706,1429,1277,"6",2010,2778,1452,1326,441332,457372,0.964930078798003,0.974082073434125,1.00948461949442,0.613143846356031,0.005815436078034,0.219183556676021
"587","경남","거제시",2012,2467,1272,1195,"6",2011,2516,1303,1213,407210,420797,0.967711271705834,0.980524642289348,1.01324090248626,0.605829915768277,0.00802173483794826,0.317179592512955
"588","경남","거제시",2013,2643,1349,1294,"6",2012,2681,1358,1323,422944,435284,0.971650692421499,0.985826184259605,1.01458908221717,0.624905424831656,0.00911679662082314,0.365818387796707
"589","경남","거제시",2014,3060,1594,1466,"6",2013,3101,1626,1475,465061,480776,0.967313260229296,0.986778458561754,1.02012295202884,0.657978200709154,0.0132404637688951,0.548977187939327
"590","경남","거제시",2015,3028,1546,1482,"6",2014,3041,1555,1486,441255,454993,0.969806128885499,0.995725090430779,1.02672592054565,0.686224518702338,0.0183399819633168,0.775479861471661
"591","경남","거제시",2016,3054,1595,1459,"6",2015,3085,1619,1466,422114,435131,0.970084870992873,0.989951377633712,1.02047914284088,0.72350123426373,0.0148166851220387,0.61898740007198
"592","경남","거제시",2017,3305,1674,1631,"6",2016,3356,1712,1644,445571,460063,0.968499966308962,0.984803337306317,1.01683363093908,0.741744862210512,0.0124862592614093,0.515478074724568
"593","경남","거제시",2018,3396,1731,1665,"6",2017,3461,1758,1703,447106,462352,0.967025123715265,0.981219300780121,1.01467818851523,0.7595514262837,0.0111488390220044,0.456074568684948
"594","경남","거제시",2019,3412,1791,1621,"6",2018,3512,1853,1659,462528,478982,0.965647978420901,0.971526195899772,1.00608732955511,0.737685069876851,0.00449053212822281,0.160335980225749
"595","경남","거제시",2020,3038,1573,1465,"6",2019,3114,1604,1510,417119,431843,0.965904275396382,0.975594091201028,1.01003185931719,0.728329325684037,0.00730649733184335,0.285411256531612
"596","경남","거창군",2009,520,264,256,"6",2008,542,275,267,462768,488710,0.946917394773997,0.959409594095941,1.01319249112002,0.112367320125851,0.00148240487294022,0.0267255410292973
"597","경남","거창군",2010,473,280,193,"6",2009,478,279,199,470657,487028,0.966385916210156,0.989539748953975,1.02395919927581,0.100497814756819,0.00240784717054238,0.0678304349849828
"598","경남","거창군",2011,484,249,235,"6",2010,496,262,234,441332,457372,0.964930078798003,0.975806451612903,1.01127166937158,0.10966800503929,0.0012361414934433,0.0157873873209379
"599","경남","거창군",2012,453,239,214,"6",2011,462,245,217,407210,420797,0.967711271705834,0.980519480519481,1.01323556848839,0.111244812259031,0.0014723883316321,0.026280641472253
"600","경남","거창군",2013,428,216,212,"6",2012,435,222,213,422944,435284,0.971650692421499,0.983908045977012,1.01261497948915,0.101195430127866,0.00127657827545837,0.0175834470438889
"601","경남","거창군",2014,495,246,249,"6",2013,515,265,250,465061,480776,0.967313260229296,0.961165048543689,0.993644032457335,0.106437650114716,-0.000676514249446644,-0.0691660578467717
"602","경남","거창군",2015,483,252,231,"6",2014,493,253,240,441255,454993,0.969806128885499,0.979716024340771,1.01021842939543,0.109460516028147,0.00111851455462092,0.0105628121538491
"603","경남","거창군",2016,490,260,230,"6",2015,494,263,231,422114,435131,0.970084870992873,0.991902834008097,1.0224907775264,0.116082385327186,0.00261078310312718,0.0768441357962704
"604","경남","거창군",2017,454,240,214,"6",2016,464,247,217,445571,460063,0.968499966308962,0.978448275862069,1.01027187392791,0.101891729937541,0.00104661900421468,0.00736946451565354
"605","경남","거창군",2018,519,269,250,"6",2017,526,276,250,447106,462352,0.967025123715265,0.986692015209126,1.02033751865546,0.11607985578364,0.00236077623252326,0.0657397093712045
"606","경남","거창군",2019,482,255,227,"6",2018,499,261,238,462528,478982,0.965647978420901,0.965931863727455,1.0002939842602,0.104209907292099,3.06360725012293e-05,-0.0377569261594582
"607","경남","거창군",2020,427,219,208,"6",2019,440,224,216,417119,431843,0.965904275396382,0.970454545454545,1.00471089131094,0.102368868356512,0.000482248612451288,-0.0176978845403282
"608","경남","고성군",2009,336,180,156,"6",2008,371,196,175,462768,488710,0.946917394773997,0.905660377358491,0.956430183199504,0.0726065760813194,-0.00316345521837437,-0.179627234158566
"609","경남","고성군",2010,356,176,180,"6",2009,359,177,182,470657,487028,0.966385916210156,0.991643454038997,1.0261360781497,0.0756389472588318,0.00197690543671808,0.0486895179166534
"610","경남","고성군",2011,339,165,174,"6",2010,355,174,181,441332,457372,0.964930078798003,0.954929577464789,0.989636035239288,0.0768129208849574,-0.000796086405219074,-0.0744770327133985
"611","경남","고성군",2012,333,155,178,"6",2011,342,158,184,407210,420797,0.967711271705834,0.973684210526316,1.00617223235393,0.0817759878195526,0.000504740397794096,-0.0166988784933973
"612","경남","고성군",2013,374,193,181,"6",2012,376,191,185,422944,435284,0.971650692421499,0.99468085106383,1.02370209667112,0.0884277824014527,0.00209592384689155,0.0539758973501748
"613","경남","고성군",2014,382,210,172,"6",2013,391,218,173,465061,480776,0.967313260229296,0.976982097186701,1.00999555919983,0.0821397623107506,0.000821032856837271,-0.00265027922185006
"614","경남","고성군",2015,397,207,190,"6",2014,402,207,195,441255,454993,0.969806128885499,0.987562189054726,1.01830887601178,0.0899706518906301,0.00164726151016439,0.0340478933883238
"615","경남","고성군",2016,364,187,177,"6",2015,364,194,170,422114,435131,0.970084870992873,1,1.03083764101641,0.0862326291001957,0.00265921086009289,0.0789951265384752
"616","경남","고성군",2017,397,214,183,"6",2016,413,221,192,445571,460063,0.968499966308962,0.961259079903148,0.992523606961588,0.0890991559145456,-0.000666140309007871,-0.068705283876592
"617","경남","고성군",2018,368,194,174,"6",2017,378,199,179,447106,462352,0.967025123715265,0.973544973544973,1.0067421721213,0.0823071039082455,0.000554928661355052,-0.0144696922363629
"618","경남","고성군",2019,382,197,185,"6",2018,395,200,195,462528,478982,0.965647978420901,0.967088607594937,1.00149187820637,0.0825895945758959,0.000123213616221096,-0.0336449570748996
"619","경남","고성군",2020,309,142,167,"6",2019,322,147,175,417119,431843,0.965904275396382,0.959627329192547,0.993501482120203,0.0740795792088109,-0.000481407470016299,-0.0605001004993507
"620","경남","김해시",2009,6162,3238,2924,"6",2008,6401,3347,3054,462768,488710,0.946917394773997,0.962662084049367,1.01662731021973,1.33155274349134,0.0221401405399697,0.944269547995429
"621","경남","김해시",2010,6399,3400,2999,"6",2009,6478,3434,3044,470657,487028,0.966385916210156,0.98780487804878,1.02216398384884,1.3595888300822,0.0301339048709994,1.29932446172164
"622","경남","김해시",2011,6059,3190,2869,"6",2010,6249,3278,2971,441332,457372,0.964930078798003,0.969595135221635,1.00483460566329,1.37288934407657,0.00663737859793907,0.255691354305226
"623","경남","김해시",2012,5594,2977,2617,"6",2011,5642,3013,2629,407210,420797,0.967711271705834,0.991492378589153,1.02457458911417,1.37373836595368,0.0337590558936785,1.46034092784455
"624","경남","김해시",2013,5830,3015,2815,"6",2012,5913,3063,2850,422944,435284,0.971650692421499,0.985963132081853,1.01473002568926,1.37843307861088,0.0203043546588612,0.862730391892638
"625","경남","김해시",2014,6507,3312,3195,"6",2013,6596,3339,3257,465061,480776,0.967313260229296,0.98650697392359,1.01984229358103,1.399171291508,0.0277627675362522,1.19400687579361
"626","경남","김해시",2015,6072,3127,2945,"6",2014,6182,3185,2997,441255,454993,0.969806128885499,0.98220640569395,1.01278634609445,1.37607505863956,0.017594971951709,0.742389135445403
"627","경남","김해시",2016,5671,2930,2741,"6",2015,5760,2965,2795,422114,435131,0.970084870992873,0.984548611111111,1.01490976774376,1.34347593304178,0.0200309141309821,0.85058512478006
"628","경남","김해시",2017,5886,3038,2848,"6",2016,5987,3102,2885,445571,460063,0.968499966308962,0.983130115249708,1.01510598807401,1.32100159121666,0.019955034282672,0.847214808633668
"629","경남","김해시",2018,5838,2909,2929,"6",2017,5924,2953,2971,447106,462352,0.967025123715265,0.985482781904119,1.01908705134562,1.30573063210961,0.0249225476186202,1.06785429034599
"630","경남","김해시",2019,6171,3071,3100,"6",2018,6108,3028,3080,462528,478982,0.965647978420901,1.01031434184676,1.04625532743195,1.3341894977169,0.0617133720731611,2.70197339389735
"631","경남","김해시",2020,5602,2829,2773,"6",2019,5611,2834,2777,417119,431843,0.965904275396382,0.998396007841739,1.03363866717747,1.34302201530019,0.0451774705847017,1.9675067730114
"632","경남","남해군",2009,296,183,113,"6",2008,307,187,120,462768,488710,0.946917394773997,0.964169381107492,1.01821910382966,0.0639629360716385,0.00116534737353884,0.012642961354134
"633","경남","남해군",2010,259,128,131,"6",2009,265,125,140,470657,487028,0.966385916210156,0.977358490566038,1.01135423661689,0.0550294588203299,0.0006248174963455,-0.0113654758433882
"634","경남","남해군",2011,244,129,115,"6",2010,262,141,121,441332,457372,0.964930078798003,0.931297709923664,0.965145278799648,0.0552871760941876,-0.00192701910871769,-0.124709088205973
"635","경남","남해군",2012,218,118,100,"6",2011,230,122,108,407210,420797,0.967711271705834,0.947826086956522,0.97945132465569,0.0535350310650524,-0.00110007397290332,-0.0879790919621311
"636","경남","남해군",2013,218,120,98,"6",2012,225,120,105,422944,435284,0.971650692421499,0.968888888888889,0.997157616873891,0.0515434667473708,-0.000146506280143868,-0.0456249668135364
"637","경남","남해군",2014,245,121,124,"6",2013,258,130,128,465061,480776,0.967313260229296,0.949612403100775,0.981701008498193,0.0526812611678898,-0.000964013950415669,-0.0819357840104049
"638","경남","남해군",2015,237,131,106,"6",2014,235,128,107,441255,454993,0.969806128885499,1.00851063829787,1.03990953269892,0.0537104395417616,0.00214355854316553,0.0560916631240391
"639","경남","남해군",2016,226,132,94,"6",2015,223,127,96,422114,435131,0.970084870992873,1.01345291479821,1.04470541197179,0.0535400389468248,0.00239352949810325,0.0671944943014547
"640","경남","남해군",2017,221,114,107,"6",2016,230,118,112,445571,460063,0.968499966308962,0.960869565217391,0.992121423482697,0.0495992782295078,-0.000390771708734192,-0.0564743785653663
"641","경남","남해군",2018,197,119,78,"6",2017,214,126,88,447106,462352,0.967025123715265,0.920560747663551,0.951951221418944,0.0440611398639249,-0.00211708395335067,-0.133151100531955
"642","경남","남해군",2019,183,91,92,"6",2018,193,95,98,462528,478982,0.965647978420901,0.948186528497409,0.981917375364834,0.0395651722706517,-0.000715442158795859,-0.0708950987495508
"643","경남","남해군",2020,152,71,81,"6",2019,155,75,80,417119,431843,0.965904275396382,0.980645161290323,1.01526122853933,0.0364404402580559,0.000556125886851995,-0.0144165156880028
"644","경남","마산시",2009,3452,1774,1678,"6",2008,3604,1847,1757,462768,488710,0.946917394773997,0.957824639289678,1.01151868639849,0.74594613283546,0.00859231957430164,0.342522960912377
"645","경남","마산시",2010,3481,1875,1606,"6",2009,3505,1898,1607,470657,487028,0.966385916210156,0.993152639087019,1.02769775762237,0.739604425303353,0.0204853841084855,0.870771083731496
"646","경남","밀양시",2009,762,426,336,"6",2008,830,449,381,462768,488710,0.946917394773997,0.918072289156627,0.969537886011425,0.164661342184421,-0.00501593257513363,-0.261907766939695
"647","경남","밀양시",2010,774,394,380,"6",2009,801,407,394,470657,487028,0.966385916210156,0.966292134831461,0.999902956596198,0.164450969602067,-1.59588818487803e-05,-0.0398265102517238
"648","경남","밀양시",2011,728,391,337,"6",2010,737,393,344,441332,457372,0.964930078798003,0.987788331071913,1.02368902449635,0.164955181133478,0.00390762732667075,0.134445397834887
"649","경남","밀양시",2012,681,348,333,"6",2011,709,367,342,407210,420797,0.967711271705834,0.960507757404795,0.992556132689928,0.16723557869404,-0.00124487945732146,-0.0944108425927557
"650","경남","밀양시",2013,667,344,323,"6",2012,676,344,332,422944,435284,0.971650692421499,0.986686390532544,1.01547438624633,0.157704093213286,0.00244037405100969,0.0692751646842651
"651","경남","밀양시",2014,782,402,380,"6",2013,807,424,383,465061,480776,0.967313260229296,0.969021065675341,1.00176551435431,0.168149984625673,0.000296871211532855,-0.0259316970927436
"652","경남","밀양시",2015,739,364,375,"6",2014,753,360,393,441255,454993,0.969806128885499,0.98140770252324,1.01196277615927,0.167476855786337,0.00200348813762954,0.04987022805369
"653","경남","밀양시",2016,635,330,305,"6",2015,651,352,299,422114,435131,0.970084870992873,0.97542242703533,1.0055021536796,0.150433295270946,0.000827707109109262,-0.00235383239573838
"654","경남","밀양시",2017,692,359,333,"6",2016,718,370,348,445571,460063,0.968499966308962,0.963788300835655,0.995135089687959,0.155306337261626,-0.000755551401669343,-0.0726766103351237
"655","경남","밀양시",2018,648,333,315,"6",2017,676,345,331,447106,462352,0.967025123715265,0.958579881656805,0.991266781129725,0.144932074273215,-0.00126572352595089,-0.0953366628549567
"656","경남","밀양시",2019,673,359,314,"6",2018,682,361,321,462528,478982,0.965647978420901,0.986803519061584,1.02190812916657,0.145504704580047,0.0031877358622833,0.102470349385167
"657","경남","밀양시",2020,607,298,309,"6",2019,630,304,326,417119,431843,0.965904275396382,0.963492063492064,0.997502638754416,0.145522021293684,-0.000363421056357907,-0.0552595587235902
"658","경남","사천시",2009,1041,526,515,"6",2008,1089,542,547,462768,488710,0.946917394773997,0.955922865013774,1.00951030183781,0.224950731251945,0.00213934935284302,0.0559047056850996
"659","경남","사천시",2010,1083,564,519,"6",2009,1129,587,542,470657,487028,0.966385916210156,0.95925597874225,0.992622059833128,0.230103876071109,-0.00169769262981802,-0.114523212089412
"660","경남","사천시",2011,1052,555,497,"6",2010,1077,570,507,441332,457372,0.964930078798003,0.976787372330548,1.01228824118253,0.238369300209366,0.00292913945148307,0.0909844057765749
"661","경남","사천시",2012,972,497,475,"6",2011,1008,517,491,407210,420797,0.967711271705834,0.964285714285714,0.996460145169042,0.238697477959775,-0.000844954420493316,-0.0766475781821729
"662","경남","사천시",2013,1065,555,510,"6",2012,1078,563,515,422944,435284,0.971650692421499,0.987940630797774,1.01676522077669,0.251806385715367,0.00422158964949953,0.148390500646155
"663","경남","사천시",2014,1172,587,585,"6",2013,1205,603,602,465061,480776,0.967313260229296,0.972614107883817,1.00547997000813,0.252009951382722,0.00138100697532724,0.0222218028281036
"664","경남","사천시",2015,1166,602,564,"6",2014,1200,624,576,441255,454993,0.969806128885499,0.971666666666667,1.00191846362459,0.26424629749238,0.00050694690967064,-0.0166008729916688
"665","경남","사천시",2016,1121,546,575,"6",2015,1145,556,589,422114,435131,0.970084870992873,0.979039301310044,1.0092305638248,0.265568069289339,0.00245134301340351,0.0697623674382025
"666","경남","사천시",2017,1167,619,548,"6",2016,1192,632,560,445571,460063,0.968499966308962,0.979026845637584,1.01086926142986,0.261911120786586,0.00284678044321681,0.0873263081189993
"667","경남","사천시",2018,1061,554,507,"6",2017,1099,580,519,447106,462352,0.967025123715265,0.965423111919927,0.998343360729675,0.237303905561545,-0.000393126968954697,-0.0565789909456874
"668","경남","사천시",2019,1068,551,517,"6",2018,1122,580,542,462528,478982,0.965647978420901,0.951871657754011,0.98573359964009,0.230904939809049,-0.00329418231639685,-0.18543367235063
"669","경남","사천시",2020,904,481,423,"6",2019,941,496,445,417119,431843,0.965904275396382,0.960680127523911,0.994591443473705,0.216724723640016,-0.00117216791845277,-0.0911812516152347
"670","경남","산청군",2009,204,111,93,"6",2008,223,115,108,462768,488710,0.946917394773997,0.914798206278027,0.966080263523265,0.0440825640493725,-0.00149526895577349,-0.105532264001908
"671","경남","산청군",2010,187,98,89,"6",2009,208,107,101,470657,487028,0.966385916210156,0.899038461538462,0.930309979127377,0.0397316942061841,-0.00276890259853365,-0.162102593626669
"672","경남","산청군",2011,184,99,85,"6",2010,187,100,87,441332,457372,0.964930078798003,0.983957219251337,1.01971867275299,0.041691968857912,0.000822110290337002,-0.00260242341294065
"673","경남","산청군",2012,181,86,95,"6",2011,193,92,101,407210,420797,0.967711271705834,0.937823834196891,0.969115335965593,0.0444488101962133,-0.00137278656963916,-0.100092026931984
"674","경남","산청군",2013,181,92,89,"6",2012,193,92,101,422944,435284,0.971650692421499,0.937823834196891,0.965186194495157,0.0427952636755693,-0.00148986598612975,-0.105292283081621
"675","경남","산청군",2014,215,110,105,"6",2013,226,120,106,465061,480776,0.967313260229296,0.951327433628319,0.983473992078649,0.0462304944942706,-0.000764005518220298,-0.0730521124763338
"676","경남","산청군",2015,175,107,68,"6",2014,178,109,69,441255,454993,0.969806128885499,0.98314606741573,1.01375526317364,0.039659607256575,0.000545528335177469,-0.0148872216832875
"677","경남","산청군",2016,159,77,82,"6",2015,160,85,75,422114,435131,0.970084870992873,0.99375,1.02439490576006,0.037667549524536,0.000918896320863269,0.00169647186284478
"678","경남","산청군",2017,194,108,86,"6",2016,200,116,84,445571,460063,0.968499966308962,0.97,1.00154882162439,0.0435396379028258,6.74351327018991e-05,-0.0361224412530122
"679","경남","산청군",2018,149,88,61,"6",2017,156,93,63,447106,462352,0.967025123715265,0.955128205128205,0.987697404860225,0.0333254306585016,-0.000409989281250181,-0.0573279555872965
"680","경남","산청군",2019,159,90,69,"6",2018,165,89,76,462528,478982,0.965647978420901,0.963636363636364,0.997916823905305,0.034376297218763,-7.16118805902723e-05,-0.0422984208370862
"681","경남","산청군",2020,139,77,62,"6",2019,150,79,71,417119,431843,0.965904275396382,0.926666666666667,0.959377331968415,0.0333238236570379,-0.00135370262596292,-0.0992443852334143
"682","경남","양산시",2009,2864,1481,1383,"6",2008,2975,1556,1419,462768,488710,0.946917394773997,0.962689075630252,1.01665581490349,0.618884624693151,0.0103080277555081,0.418728687655278
"683","경남","양산시",2010,2902,1539,1363,"6",2009,2930,1553,1377,470657,487028,0.966385916210156,0.990443686006826,1.02489457823539,0.616584901531264,0.0153496210699282,0.642658541622274
"684","경남","양산시",2011,2830,1462,1368,"6",2010,2880,1481,1399,441332,457372,0.964930078798003,0.982638888888889,1.01835242830542,0.641240607977668,0.0117683222844359,0.483589837735809
"685","경남","양산시",2012,2683,1385,1298,"6",2011,2744,1425,1319,407210,420797,0.967711271705834,0.977769679300292,1.01039401719144,0.658873799759338,0.00684834560168551,0.265061767068523
"686","경남","양산시",2013,2741,1394,1347,"6",2012,2773,1429,1344,422944,435284,0.971650692421499,0.988460151460512,1.01729989920258,0.648076341075887,0.0112116553761921,0.458864650340238
"687","경남","양산시",2014,3194,1612,1582,"6",2013,3229,1650,1579,465061,480776,0.967313260229296,0.989160730876432,1.02258572434121,0.686791625184653,0.0155116863262723,0.649856910654235
"688","경남","양산시",2015,3213,1671,1542,"6",2014,3232,1687,1545,441255,454993,0.969806128885499,0.994121287128713,1.02507218455214,0.728150389230717,0.0182563209405049,0.771763932904513
"689","경남","양산시",2016,3092,1584,1508,"6",2015,3094,1590,1504,422114,435131,0.970084870992873,0.999353587588882,1.03017129477141,0.732503541697267,0.0221005802776477,0.942512420196303
"690","경남","양산시",2017,3559,1800,1759,"6",2016,3560,1817,1743,445571,460063,0.968499966308962,0.999719101123596,1.03223452338735,0.798750367505964,0.0257473374020251,1.10448855341181
"691","경남","양산시",2018,3935,1987,1948,"6",2017,3988,2014,1974,447106,462352,0.967025123715265,0.986710130391174,1.02035625155247,0.880104494236266,0.0179156284771352,0.756631571206111
"692","경남","양산시",2019,4026,2088,1938,"6",2018,4109,2126,1983,462528,478982,0.965647978420901,0.979800438062789,1.01465592012633,0.870433789954338,0.0127570081008288,0.527503786496979
"693","경남","양산시",2020,3713,1862,1851,"6",2019,3775,1881,1894,417119,431843,0.965904275396382,0.983576158940397,1.0182956882935,0.89015364919843,0.0162859736990593,0.684248034154965
"694","경남","의령군",2009,156,77,79,"6",2008,174,89,85,462768,488710,0.946917394773997,0.896551724137931,0.946810914115601,0.0337101960377554,-0.00179301451223211,-0.118757075052494
"695","경남","의령군",2010,156,93,63,"6",2009,171,95,76,470657,487028,0.966385916210156,0.912280701754386,0.944012828055325,0.0331451566639825,-0.00185570358527958,-0.121541503326923
"696","경남","의령군",2011,161,85,76,"6",2010,164,83,81,441332,457372,0.964930078798003,0.981707317073171,1.01738699895859,0.036480472750673,0.000634285941724643,-0.0109449207809675
"697","경남","의령군",2012,130,70,60,"6",2011,140,76,64,407210,420797,0.967711271705834,0.928571428571429,0.959554213866485,0.0319245598094349,-0.00129121391845901,-0.0964688564921502
"698","경남","의령군",2013,129,66,63,"6",2012,135,70,65,422944,435284,0.971650692421499,0.955555555555556,0.983435264348104,0.0305004917908754,-0.000505232583768681,-0.0615583283076227
"699","경남","의령군",2014,142,69,73,"6",2013,149,73,76,465061,480776,0.967313260229296,0.953020134228188,0.985223891174902,0.0305336289217974,-0.000451168223773626,-0.0591569794713562
"700","경남","의령군",2015,131,65,66,"6",2014,138,71,67,441255,454993,0.969806128885499,0.949275362318841,0.978830030090393,0.0296880488606361,-0.000628495101054621,-0.0670332160611622
"701","경남","의령군",2016,143,80,63,"6",2015,157,88,69,422114,435131,0.970084870992873,0.910828025477707,0.938915813155072,0.0338771042893626,-0.00206935536817653,-0.131031164543162
"702","경남","의령군",2017,127,66,61,"6",2016,133,66,67,445571,460063,0.968499966308962,0.954887218045113,0.98594450311059,0.0285027526477262,-0.000400620351179735,-0.0569118206450945
"703","경남","의령군",2018,120,54,66,"6",2017,129,57,72,447106,462352,0.967025123715265,0.930232558139535,0.961952833826722,0.0268392730135583,-0.00102115828031684,-0.0844739342838928
"704","경남","의령군",2019,129,79,50,"6",2018,141,83,58,462528,478982,0.965647978420901,0.914893617021277,0.947440099773603,0.027890203403902,-0.00146590630820301,-0.104228078405713
"705","경남","의령군",2020,96,52,44,"6",2019,108,60,48,417119,431843,0.965904275396382,0.888888888888889,0.920266025868983,0.0230150148998247,-0.00183507860264759,-0.120625414094648
"706","경남","진주시",2009,3336,1825,1511,"6",2008,3453,1890,1563,462768,488710,0.946917394773997,0.96611642050391,1.02027529099779,0.720879576807385,0.014616043194134,0.610075590885219
"707","경남","진주시",2010,3296,1769,1527,"6",2009,3349,1803,1546,470657,487028,0.966385916210156,0.984174380412063,1.01840720555166,0.700297669003117,0.0128905231406869,0.533434055265842
"708","경남","진주시",2011,3165,1765,1400,"6",2010,3223,1785,1438,441332,457372,0.964930078798003,0.982004343779088,1.01769482095776,0.71714718171354,0.0126897909807814,0.524518238290773
"709","경남","진주시",2012,2845,1478,1367,"6",2011,2843,1495,1348,407210,420797,0.967711271705834,1.00070348223707,1.03409303115079,0.698656712752634,0.0238193250715851,1.0188530226031
"710","경남","진주시",2013,3054,1594,1460,"6",2012,3081,1605,1476,422944,435284,0.971650692421499,0.991236611489776,1.02015736644973,0.72208141030491,0.0145552595940558,0.607375797022398
"711","경남","진주시",2014,3364,1716,1648,"6",2013,3392,1732,1660,465061,480776,0.967313260229296,0.991745283018868,1.02525761177282,0.723345969668495,0.0182699916793206,0.77237113907044
"712","경남","진주시",2015,3261,1679,1582,"6",2014,3261,1692,1569,441255,454993,0.969806128885499,1,1.03113392482805,0.739028452935377,0.0230088562994782,0.982854848521189
"713","경남","진주시",2016,3086,1650,1436,"6",2015,3079,1643,1436,422114,435131,0.970084870992873,1.00227346541085,1.03318121473746,0.731082124734077,0.0242581929715189,1.03834599210977
"714","경남","진주시",2017,3352,1776,1576,"6",2016,3394,1788,1606,445571,460063,0.968499966308962,0.987625220978197,1.01974729513117,0.752293125001403,0.0148557543645556,0.620722718497286
"715","경남","진주시",2018,3368,1789,1579,"6",2017,3428,1830,1598,447106,462352,0.967025123715265,0.982497082847141,1.01599954205164,0.753288929247203,0.0120522779005269,0.496202148106521
"716","경남","진주시",2019,3444,1791,1653,"6",2018,3460,1791,1669,462528,478982,0.965647978420901,0.995375722543353,1.03078528075113,0.744603569946036,0.0229228299490847,0.979033860416926
"717","경남","진주시",2020,3121,1670,1451,"6",2019,3168,1705,1463,417119,431843,0.965904275396382,0.985164141414141,1.0199397254038,0.748227723982844,0.0149194553557272,0.623552092617925
"718","경남","진해시",2009,2047,1080,967,"6",2008,2183,1149,1034,462768,488710,0.946917394773997,0.937700412276683,0.990266328881293,0.442338277495419,-0.00430557531635598,-0.230356194390696
"719","경남","진해시",2010,2224,1190,1034,"6",2009,2255,1219,1036,470657,487028,0.966385916210156,0.986252771618625,1.02055789004705,0.472530951414725,0.0097142393430132,0.392354693521924
"720","경남","창녕군",2009,395,200,195,"6",2008,405,209,196,462768,488710,0.946917394773997,0.975308641975309,1.02998281302889,0.0853559450955987,0.00255921134270547,0.074553499471634
"721","경남","창녕군",2010,345,168,177,"6",2009,364,179,185,470657,487028,0.966385916210156,0.947802197802198,0.980769878682796,0.0733017887761151,-0.00140960229093275,-0.101727251865615
"722","경남","창녕군",2011,331,192,139,"6",2010,341,198,143,441332,457372,0.964930078798003,0.970674486803519,1.00595318576106,0.0750002265867873,0.000446490280992566,-0.0192861439341893
"723","경남","창녕군",2012,322,171,151,"6",2011,318,172,146,407210,420797,0.967711271705834,1.0125786163522,1.04636439189892,0.0790746789126004,0.00366624940238469,0.123724238874756
"724","경남","창녕군",2013,369,197,172,"6",2012,355,188,167,422944,435284,0.971650692421499,1.03943661971831,1.06976367929907,0.0872455927971552,0.00608657355615776,0.231226530413623
"725","경남","창녕군",2014,399,220,179,"6",2013,411,228,183,465061,480776,0.967313260229296,0.970802919708029,1.00360757949075,0.0857951967591348,0.000309512992233075,-0.0253701936295456
"726","경남","창녕군",2015,379,201,178,"6",2014,379,199,180,441255,454993,0.969806128885499,1,1.03113392482805,0.0858913780013824,0.00267413570607244,0.0796580357364704
"727","경남","창녕군",2016,355,192,163,"6",2015,364,199,165,422114,435131,0.970084870992873,0.975274725274725,1.00534989714512,0.0841005036554106,0.000449929044409498,-0.0191334061503664
"728","경남","창녕군",2017,382,203,179,"6",2016,390,209,181,445571,460063,0.968499966308962,0.979487179487179,1.01134456743462,0.085732689066389,0.000972600272464785,0.00408181262509573
"729","경남","창녕군",2018,391,200,191,"6",2017,411,208,203,447106,462352,0.967025123715265,0.951338199513382,0.983778162720722,0.0874512979025108,-0.00141862072443618,-0.102127818982295
"730","경남","창녕군",2019,392,186,206,"6",2018,388,195,193,462528,478982,0.965647978420901,1.01030927835052,1.04625008380657,0.0847516258475163,0.00391976979819094,0.134984723739366
"731","경남","창녕군",2020,354,193,161,"6",2019,369,204,165,417119,431843,0.965904275396382,0.959349593495935,0.99321394255372,0.0848678674431038,-0.000575918223812199,-0.0646979359803073
"732","경남","창원시",2009,4927,2621,2306,"6",2008,5238,2805,2433,462768,488710,0.946917394773997,0.940626193203513,0.993356124192876,1.06468035819244,-0.007073604074115,-0.353302302266657
"733","경남","창원시",2010,4988,2665,2323,"6",2009,5128,2739,2389,470657,487028,0.966385916210156,0.972698907956318,1.0065325783833,1.05979513743554,0.00692319480553989,0.268386305610876
"734","경남","통영시",2009,1312,692,620,"6",2008,1337,697,640,462768,488710,0.946917394773997,0.981301421091997,1.03631153731863,0.283511392317533,0.0102947345023961,0.418138248077457
"735","경남","통영시",2010,1290,680,610,"6",2009,1339,706,633,470657,487028,0.966385916210156,0.963405526512323,0.996915942536164,0.274084949336778,-0.000845293733727111,-0.0766626492833416
"736","경남","통영시",2011,1279,684,595,"6",2010,1309,708,601,441332,457372,0.964930078798003,0.977081741787624,1.01259330935642,0.289804500919942,0.00364959773296887,0.122984630249457
"737","경남","통영시",2012,1235,651,584,"6",2011,1251,652,599,407210,420797,0.967711271705834,0.987210231814548,1.02014956390282,0.303283318189632,0.00611102660052066,0.232312648692456
"738","경남","통영시",2013,1254,637,617,"6",2012,1270,648,622,422944,435284,0.971650692421499,0.98740157480315,1.01621043704749,0.296493152757812,0.00480628358779275,0.174360550202294
"739","경남","통영시",2014,1483,754,729,"6",2013,1520,775,745,465061,480776,0.967313260229296,0.975657894736842,1.00862661027263,0.318882899232574,0.00275087849428604,0.0830666806401638
"740","경남","통영시",2015,1439,714,725,"6",2014,1483,732,751,441255,454993,0.969806128885499,0.970330411328388,1.00054060541305,0.326115284812637,0.000176299688249614,-0.0312870603514518
"741","경남","통영시",2016,1411,756,655,"6",2015,1412,756,656,422114,435131,0.970084870992873,0.99929178470255,1.03010758602985,0.334269889176857,0.0100640594455814,0.407892472870125
"742","경남","통영시",2017,1522,789,733,"6",2016,1561,803,758,445571,460063,0.968499966308962,0.97501601537476,1.00672798068402,0.341584169526293,0.00229817169453882,0.0629590358471366
"743","경남","통영시",2018,1455,732,723,"6",2017,1497,755,742,447106,462352,0.967025123715265,0.971943887775551,1.00508649045372,0.325426185289394,0.00165527718486546,0.0344039214836729
"744","경남","통영시",2019,1427,742,685,"6",2018,1442,750,692,462528,478982,0.965647978420901,0.989597780859917,1.02480179420888,0.308521862460219,0.00765189574167861,0.300752639830741
"745","경남","통영시",2020,1103,569,534,"6",2019,1152,595,557,417119,431843,0.965904275396382,0.957465277777778,0.99126311184911,0.264432931609445,-0.0023103209468837,-0.141734008562063
"746","경남","하동군",2009,289,150,139,"6",2008,324,172,152,462768,488710,0.946917394773997,0.891975308641975,0.941977952421991,0.0624502990699443,-0.00362349422389723,-0.200060549759649
"747","경남","하동군",2010,304,169,135,"6",2009,318,175,143,470657,487028,0.966385916210156,0.955974842767296,0.989226795146509,0.064590561704171,-0.000695847352841091,-0.0700247663442351
"748","경남","하동군",2011,281,151,130,"6",2010,298,161,137,441332,457372,0.964930078798003,0.942953020134228,0.977224195673172,0.0636708872232242,-0.0014501556687117,-0.103528490362567
"749","경남","하동군",2012,294,158,136,"6",2011,309,167,142,407210,420797,0.967711271705834,0.951456310679612,0.983202674701133,0.0721986198767221,-0.00121274370419851,-0.0929834853953084
"750","경남","하동군",2013,261,130,131,"6",2012,254,126,128,422944,435284,0.971650692421499,1.02755905511811,1.05753956965469,0.0617102973443293,0.00355078395245542,0.118595669446726
"751","경남","하동군",2014,296,163,133,"6",2013,308,168,140,465061,480776,0.967313260229296,0.961038961038961,0.993513684296184,0.0636475645130424,-0.000412838197210601,-0.0574544944203984
"752","경남","하동군",2015,268,138,130,"6",2014,284,147,137,441255,454993,0.969806128885499,0.943661971830986,0.973041872725059,0.0607358556843548,-0.0016373249276913,-0.111841890951728
"753","경남","하동군",2016,217,91,126,"6",2015,233,103,130,422114,435131,0.970084870992873,0.931330472103004,0.960050506869358,0.0514079135020397,-0.00205372008731036,-0.130336700324662
"754","경남","하동군",2017,266,150,116,"6",2016,286,164,122,445571,460063,0.968499966308962,0.93006993006993,0.960320043803933,0.0596986787739777,-0.00236884095871451,-0.144333261791382
"755","경남","하동군",2018,226,131,95,"6",2017,239,133,106,447106,462352,0.967025123715265,0.945606694560669,0.977851217482017,0.0505472975088681,-0.00111956109939572,-0.0888446416242188
"756","경남","하동군",2019,214,113,101,"6",2018,240,128,112,462528,478982,0.965647978420901,0.891666666666667,0.92338687243439,0.0462674692126747,-0.0035446955209286,-0.19656058834902
"757","경남","하동군",2020,171,96,75,"6",2019,182,101,81,417119,431843,0.965904275396382,0.93956043956044,0.972726245750251,0.0409954952903128,-0.00111810106389474,-0.0887797919792493
"758","경남","함안군",2009,565,309,256,"6",2008,587,315,272,462768,488710,0.946917394773997,0.96252129471891,1.01647862847491,0.122091415136742,0.00201189907001469,0.0502438121060461
"759","경남","함안군",2010,599,325,274,"6",2009,617,334,283,470657,487028,0.966385916210156,0.970826580226904,1.00459512493121,0.127268902831574,0.000584816508369186,-0.0131421791269417
"760","경남","함안군",2011,543,295,248,"6",2010,564,309,255,441332,457372,0.964930078798003,0.962765957446808,0.997757224695607,0.123036625488295,-0.000275943505180968,-0.0513741133814573
"761","경남","함안군",2012,554,306,248,"6",2011,578,309,269,407210,420797,0.967711271705834,0.958477508650519,0.99045814250046,0.136047739495592,-0.00129814814340143,-0.0967768503904857
"762","경남","함안군",2013,547,293,254,"6",2012,568,307,261,422944,435284,0.971650692421499,0.963028169014085,0.99112590206062,0.129331542710146,-0.00114770077666098,-0.0900945071781631
"763","경남","함안군",2014,630,325,305,"6",2013,628,316,312,465061,480776,0.967313260229296,1.0031847133758,1.03708359496488,0.135466100146002,0.00502356998928613,0.184011648401003
"764","경남","함안군",2015,686,360,326,"6",2014,677,360,317,441255,454993,0.969806128885499,1.01329394387001,1.04484176134718,0.155465660445774,0.00697135404339103,0.270525369677849
"765","경남","함안군",2016,646,329,317,"6",2015,660,331,329,422114,435131,0.970084870992873,0.978787878787879,1.00897138802515,0.153039226370128,0.0013729742828353,0.0218650188623011
"766","경남","함안군",2017,628,337,291,"6",2016,639,342,297,445571,460063,0.968499966308962,0.982785602503912,1.01475027020331,0.140942745376158,0.00207894357749415,0.0532216934687141
"767","경남","함안군",2018,598,290,308,"6",2017,594,288,306,447106,462352,0.967025123715265,1.00673400673401,1.04106292798907,0.133749043850899,0.00549212735625654,0.204823319675784
"768","경남","함안군",2019,592,304,288,"6",2018,601,305,296,462528,478982,0.965647978420901,0.985024958402662,1.02006629787953,0.127992251279923,0.00256833064045476,0.0749585466235807
"769","경남","함안군",2020,502,245,257,"6",2019,514,252,262,417119,431843,0.965904275396382,0.976653696498054,1.01112886791733,0.120349348747,0.00133935200614221,0.020371635512957
"770","경남","함양군",2009,274,143,131,"6",2008,299,159,140,462768,488710,0.946917394773997,0.916387959866221,0.967759136038405,0.059208934066314,-0.00190894718854306,-0.12390639703411
"771","경남","함양군",2010,267,127,140,"6",2009,268,132,136,470657,487028,0.966385916210156,0.996268656716418,1.03092216060376,0.0567292104441239,0.00175418975627766,0.0387972702308797
"772","경남","함양군",2011,270,148,122,"6",2010,276,149,127,441332,457372,0.964930078798003,0.978260869565217,1.01381529196791,0.0611784325632404,0.00084519790800038,-0.00157695258866402
"773","경남","함양군",2012,266,136,130,"6",2011,279,145,134,407210,420797,0.967711271705834,0.953405017921147,0.985216402657511,0.0653225608408438,-0.000965702436851304,-0.0820107806428932
"774","경남","함양군",2013,283,149,134,"6",2012,292,150,142,422944,435284,0.971650692421499,0.969178082191781,0.99745524780767,0.0669119316032383,-0.000170274284640388,-0.0466806580294006
"775","경남","함양군",2014,283,155,128,"6",2013,295,159,136,465061,480776,0.967313260229296,0.959322033898305,0.991738740013657,0.0608522322878074,-0.000502716111678884,-0.061446555462723
"776","경남","함양군",2015,283,143,140,"6",2014,297,148,149,441255,454993,0.969806128885499,0.952861952861953,0.982528285273863,0.0641352505920613,-0.00112055280223379,-0.0888886895784781
"777","경남","함양군",2016,241,115,126,"6",2015,256,125,131,422114,435131,0.970084870992873,0.94140625,0.970436997988103,0.0570935813547999,-0.00168785766045837,-0.114086377320098
"778","경남","함양군",2017,253,142,111,"6",2016,266,146,120,445571,460063,0.968499966308962,0.951127819548872,0.982062831838501,0.0567810741722419,-0.00101849167581804,-0.0843554930850965
"779","경남","함양군",2018,191,93,98,"6",2017,198,100,98,447106,462352,0.967025123715265,0.964646464646465,0.997540230330665,0.042719176213247,-0.000105079333948333,-0.0437849274780884
"780","경남","함양군",2019,222,132,90,"6",2018,239,138,101,462528,478982,0.965647978420901,0.928870292887029,0.961913982780751,0.0479970942299709,-0.00182801815731661,-0.120311813930313
"781","경남","함양군",2020,216,105,111,"6",2019,219,108,111,417119,431843,0.965904275396382,0.986301369863014,1.02111709719709,0.0517837835246057,0.00109352318992222,0.00945278357788103
"782","경남","합천군",2009,270,149,121,"6",2008,317,169,148,462768,488710,0.946917394773997,0.851735015772871,0.899481856045275,0.0583445700653459,-0.00586468789280501,-0.299606494799446
"783","경남","합천군",2010,258,142,116,"6",2009,289,162,127,470657,487028,0.966385916210156,0.892733564013841,0.92378577650929,0.0548169898673556,-0.00417783431683863,-0.224682388198178
"784","경남","합천군",2011,244,112,132,"6",2010,248,112,136,441332,457372,0.964930078798003,0.983870967741935,1.01962928647382,0.0552871760941876,0.00108524781788141,0.00908522063952944
"785","경남","합천군",2012,214,105,109,"6",2011,239,118,121,407210,420797,0.967711271705834,0.895397489539749,0.92527339064821,0.0525527369170698,-0.00392708784196925,-0.213545111151328
"786","경남","합천군",2013,205,107,98,"6",2012,223,117,106,422944,435284,0.971650692421499,0.919282511210762,0.946103901721896,0.0484697737761973,-0.00261233169095941,-0.155148264254584
"787","경남","합천군",2014,273,146,127,"6",2013,290,151,139,465061,480776,0.967313260229296,0.941379310344828,0.97318970911417,0.0587019767299344,-0.00157381707170278,-0.109021095217056
"788","경남","합천군",2015,226,120,106,"6",2014,261,138,123,441255,454993,0.969806128885499,0.865900383141762,0.892859260579075,0.0512175499427769,-0.00548748617219725,-0.282852520223551
"789","경남","합천군",2016,210,101,109,"6",2015,221,105,116,422114,435131,0.970084870992873,0.950226244343891,0.979528980151338,0.0497495937116514,-0.00101842492033409,-0.0843525280411433
"790","경남","합천군",2017,165,85,80,"6",2016,189,98,91,445571,460063,0.968499966308962,0.873015873015873,0.901410328740653,0.037031135329723,-0.00365088745851777,-0.20127726095504
"791","경남","합천군",2018,212,109,103,"6",2017,225,117,108,447106,462352,0.967025123715265,0.942222222222222,0.974351337018266,0.0474160489906197,-0.00121615826048579,-0.0931351479835191
"792","경남","합천군",2019,177,97,80,"6",2018,194,103,91,462528,478982,0.965647978420901,0.912371134020619,0.944827881804915,0.0382679535076795,-0.0021113240540097,-0.132895266049114
"793","경남","합천군",2020,183,95,88,"6",2019,201,101,100,417119,431843,0.965904275396382,0.91044776119403,0.942585910824761,0.0438723721527909,-0.00251889228710961,-0.150998014372468
"794","경북","경산시",2009,2407,1323,1084,"6",2008,2554,1422,1132,462768,488710,0.946917394773997,0.942443226311668,0.995275017137692,0.520131037582547,-0.00245761023873227,-0.148276081188233
"795","경북","경산시",2010,2359,1274,1085,"6",2009,2459,1321,1138,470657,487028,0.966385916210156,0.959333062220415,0.992701824528445,0.501214260066248,-0.00365794961880924,-0.20159093729189
"796","경북","경산시",2011,2320,1193,1127,"6",2010,2408,1241,1167,441332,457372,0.964930078798003,0.963455149501661,0.998471465105349,0.525681346469325,-0.000803522281545655,-0.0748073082029279
"797","경북","경산시",2012,2048,1052,996,"6",2011,2122,1102,1020,407210,420797,0.967711271705834,0.965127238454288,0.997329747697378,0.502934603767098,-0.00134296228377747,-0.0987673369855391
"798","경북","경산시",2013,2128,1139,989,"6",2012,2144,1143,1001,422944,435284,0.971650692421499,0.992537313432836,1.02149601824426,0.503139895589014,0.0108155043749944,0.441269015326732
"799","경북","경산시",2014,2386,1227,1159,"6",2013,2486,1277,1209,465061,480776,0.967313260229296,0.959774738535801,0.992206742114019,0.51305097610851,-0.00399833856546765,-0.216709817844826
"800","경북","경산시",2015,2156,1132,1024,"6",2014,2230,1162,1068,441255,454993,0.969806128885499,0.966816143497758,0.99691692463196,0.488606361401004,-0.00150641023750324,-0.10602712057505
"801","경북","경산시",2016,2155,1109,1046,"6",2015,2209,1131,1078,422114,435131,0.970084870992873,0.975554549569941,1.0056383505615,0.510525592612422,0.00287852226176766,0.0887361681274232
"802","경북","경산시",2017,2164,1102,1062,"6",2016,2257,1155,1102,445571,460063,0.968499966308962,0.958794860434205,0.989979239842677,0.485668950627397,-0.00486677207009579,-0.255282581600919
"803","경북","경산시",2018,2342,1220,1122,"6",2017,2417,1247,1170,447106,462352,0.967025123715265,0.968969797269342,1.00201098555393,0.52381314498128,0.00105338066751534,0.00766979383241137
"804","경북","경산시",2019,2437,1241,1196,"6",2018,2518,1281,1237,462528,478982,0.965647978420901,0.967831612390786,1.0022613147013,0.52688702089387,0.00119145736627228,0.0138026754554586
"805","경북","경산시",2020,2228,1130,1098,"6",2019,2282,1157,1125,417119,431843,0.965904275396382,0.976336546888694,1.01080052315539,0.534140137466766,0.00576899292293457,0.217120714972896
"806","경북","경주시",2009,2379,1249,1130,"6",2008,2478,1304,1174,462768,488710,0.946917394773997,0.960048426150121,1.01386713503057,0.51408048957577,0.00712882356552744,0.277519612350181
"807","경북","경주시",2010,2304,1208,1096,"6",2009,2380,1235,1145,470657,487028,0.966385916210156,0.968067226890756,1.00173979220144,0.489528467652664,0.000851677810402992,-0.00128913810061576
"808","경북","경주시",2011,2130,1134,996,"6",2010,2177,1163,1014,441332,457372,0.964930078798003,0.978410656867248,1.01397052321764,0.482629856887785,0.00674259162117671,0.260364546976607
"809","경북","경주시",2012,1947,1026,921,"6",2011,2022,1048,974,407210,420797,0.967711271705834,0.962908011869436,0.995036474228588,0.478131676530537,-0.00237321889858797,-0.144527714492224
"810","경북","경주시",2013,2046,1061,985,"6",2012,2099,1091,1008,422944,435284,0.971650692421499,0.974749880895665,1.00318961175898,0.483751986078535,0.00154298102322432,0.0294161207014421
"811","경북","경주시",2014,2153,1109,1044,"6",2013,2258,1164,1094,465061,480776,0.967313260229296,0.953498671390611,0.985718598713916,0.462950021610068,-0.0066115750340147,-0.332780596324561
"812","경북","경주시",2015,1973,1007,966,"6",2014,2027,1043,984,441255,454993,0.969806128885499,0.973359644795264,1.00366415080697,0.447133743526986,0.00163836546716997,0.0336527624278541
"813","경북","경주시",2016,1909,990,919,"6",2015,1898,983,915,422114,435131,0.970084870992873,1.00579557428873,1.03681193714453,0.452247497121631,0.0166481064378135,0.700332697523975
"814","경북","경주시",2017,1946,992,954,"6",2016,1992,1006,986,445571,460063,0.968499966308962,0.976907630522088,1.00868111977863,0.436742965767521,0.00379141799830149,0.129283787941265
"815","경북","경주시",2018,1939,993,946,"6",2017,1975,1008,967,447106,462352,0.967025123715265,0.981772151898734,1.01524989146798,0.433677919777413,0.00661354120866573,0.254632581261461
"816","경북","경주시",2019,1984,1010,974,"6",2018,2012,1019,993,462528,478982,0.965647978420901,0.986083499005964,1.02116249507246,0.42894700428947,0.00907758886462231,0.364076917080432
"817","경북","경주시",2020,1768,941,827,"6",2019,1819,961,858,417119,431843,0.965904275396382,0.97196261682243,1.00627219651094,0.423859857738439,0.00265853232083645,0.0789649882097509
"818","경북","고령군",2009,233,112,121,"6",2008,250,124,126,462768,488710,0.946917394773997,0.932,0.984246361027556,0.0503492030563911,-0.000793183167500664,-0.0743480810987462
"819","경북","고령군",2010,209,106,103,"6",2009,220,109,111,470657,487028,0.966385916210156,0.95,0.983044127676843,0.0444060111716175,-0.00075294265580662,-0.0725607390135703
"820","경북","고령군",2011,205,117,88,"6",2010,211,127,84,441332,457372,0.964930078798003,0.971563981042654,1.00687500824196,0.0464502913906084,0.000319346136151885,-0.024933439939898
"821","경북","고령군",2012,193,115,78,"6",2011,204,124,80,407210,420797,0.967711271705834,0.946078431372549,0.977645356661856,0.0473956926401611,-0.00105951380473508,-0.0861775518599552
"822","경북","고령군",2013,230,112,118,"6",2012,229,112,117,422944,435284,0.971650692421499,1.00436681222707,1.0336706596936,0.0543807217976848,0.00183103477754216,0.0422104559673477
"823","경북","고령군",2014,247,128,119,"6",2013,260,138,122,465061,480776,0.967313260229296,0.95,0.982101702787376,0.0531113122794644,-0.000950602052530325,-0.081340074648784
"824","경북","고령군",2015,230,131,99,"6",2014,233,130,103,441255,454993,0.969806128885499,0.987124463519313,1.01785752236245,0.0521240552514986,0.000930806482275225,0.00222547936887951
"825","경북","고령군",2016,213,114,99,"6",2015,218,118,100,422114,435131,0.970084870992873,0.977064220183486,1.00719457585548,0.0504603021932464,0.000363040471819805,-0.0229926911338972
"826","경북","고령군",2017,191,99,92,"6",2016,208,104,104,445571,460063,0.968499966308962,0.918269230769231,0.948135531969954,0.0428663445331945,-0.00222324015560678,-0.137866185900089
"827","경북","고령군",2018,160,76,84,"6",2017,166,78,88,447106,462352,0.967025123715265,0.963855421686747,0.996722213362627,0.0357856973514111,-0.000117297880587521,-0.0443276323719514
"828","경북","고령군",2019,188,100,88,"6",2018,190,99,91,462528,478982,0.965647978420901,0.989473684210526,1.02467328293752,0.0406461879064619,0.00100287489454783,0.00542650492357432
"829","경북","고령군",2020,153,76,77,"6",2019,157,79,78,417119,431843,0.965904275396382,0.974522292993631,1.00892222740572,0.0366801799965957,0.000327268907212536,-0.0245815382977026
"830","경북","구미시",2009,4854,2498,2356,"6",2008,4924,2533,2391,462768,488710,0.946917394773997,0.985783915515841,1.04104531288193,1.04890571517477,0.0430526632629968,1.8731303004196
"831","경북","구미시",2010,4998,2687,2311,"6",2009,5116,2730,2386,470657,487028,0.966385916210156,0.976935105551212,1.01091612487734,1.06191982696528,0.0115920494408796,0.475760417619155
"832","경북","구미시",2011,4722,2489,2233,"6",2010,4704,2496,2208,441332,457372,0.964930078798003,1.00382653061224,1.04031012471152,1.06994280949489,0.0431295280849309,1.87654436563221
"833","경북","구미시",2012,4463,2284,2179,"6",2011,4473,2279,2194,407210,420797,0.967711271705834,0.997764363961547,1.03105584603012,1.0959946956116,0.0340370425167472,1.47268811652606
"834","경북","구미시",2013,4506,2346,2160,"6",2012,4512,2340,2172,422944,435284,0.971650692421499,0.998670212765957,1.02780785374333,1.0653892713929,0.029626189038602,1.2767735090535
"835","경북","구미시",2014,4962,2582,2380,"6",2013,5026,2614,2412,465061,480776,0.967313260229296,0.987266215678472,1.02062719107608,1.06695680781661,0.0220083219447581,0.938414629334806
"836","경북","구미시",2015,4723,2422,2301,"6",2014,4737,2424,2313,441255,454993,0.969806128885499,0.997044542959679,1.0280864528104,1.07035614327316,0.0300625073083641,1.29615323294981
"837","경북","구미시",2016,4405,2311,2094,"6",2015,4434,2315,2119,422114,435131,0.970084870992873,0.993459630130807,1.02409558156907,1.04355695380869,0.0251451117024723,1.07773980464417
"838","경북","구미시",2017,4667,2411,2256,"6",2016,4709,2448,2261,445571,460063,0.968499966308962,0.991080908897855,1.0233153777743,1.04742005202313,0.0244209942012994,1.04557705049484
"839","경북","구미시",2018,4998,2616,2382,"6",2017,5018,2629,2389,447106,462352,0.967025123715265,0.996014348345955,1.02997773679273,1.1178557210147,0.0335107845768223,1.44931358861654
"840","경북","구미시",2019,5161,2660,2501,"6",2018,5210,2683,2527,462528,478982,0.965647978420901,0.990595009596929,1.02583449842335,1.11582433928324,0.0288267621339511,1.24126577591213
"841","경북","구미시",2020,4552,2362,2190,"6",2019,4619,2402,2217,417119,431843,0.965904275396382,0.985494695821606,1.02028194814355,1.09129528983336,0.0221335944777021,0.943978794918729
"842","경북","군위군",2009,111,61,50,"6",2008,123,67,56,462768,488710,0.946917394773997,0.902439024390244,0.95302824657227,0.0239861010268644,-0.0011266692231265,-0.0891603594954842
"843","경북","군위군",2010,77,43,34,"6",2009,77,44,33,470657,487028,0.966385916210156,1,1.03478329229141,0.016360109379017,0.000569058466449847,-0.013842095959922
"844","경북","군위군",2011,68,36,32,"6",2010,72,34,38,441332,457372,0.964930078798003,0.944444444444444,0.978769825085071,0.0154079015344457,-0.00032711244464829,-0.0536468578152041
"845","경북","군위군",2012,77,42,35,"6",2011,83,47,36,407210,420797,0.967711271705834,0.927710843373494,0.958664914317026,0.0189091623486653,-0.000781611845875348,-0.0738341236650216
"846","경북","군위군",2013,77,37,40,"6",2012,75,40,35,422944,435284,0.971650692421499,1.02666666666667,1.05662114448564,0.0182057199061814,0.00103082869727294,0.00666811458378878
"847","경북","군위군",2014,80,43,37,"6",2013,87,46,41,465061,480776,0.967313260229296,0.919540229885057,0.950612658475379,0.0172020444629844,-0.000849563244815122,-0.0768522859586589
"848","경북","군위군",2015,93,52,41,"6",2014,93,52,41,441255,454993,0.969806128885499,1,1.03113392482805,0.0210762484277799,0.000656186334207749,-0.00997218232613522
"849","경북","군위군",2016,70,39,31,"6",2015,74,42,32,422114,435131,0.970084870992873,0.945945945945946,0.975116687447953,0.0165831979038838,-0.000412644896554784,-0.0574459086847134
"850","경북","군위군",2017,78,38,40,"6",2016,84,39,45,445571,460063,0.968499966308962,0.928571428571429,0.958772804205967,0.0175056276104145,-0.000721707936991981,-0.0711734025929874
"851","경북","군위군",2018,79,43,36,"6",2017,84,45,39,447106,462352,0.967025123715265,0.94047619047619,0.972545766818266,0.0176691880672592,-0.000485094009330447,-0.0606638436176025
"852","경북","군위군",2019,87,50,37,"6",2018,96,50,46,462528,478982,0.965647978420901,0.90625,0.938488994179812,0.0188096720630967,-0.00115700184774897,-0.0905076280628868
"853","경북","군위군",2020,66,44,22,"6",2019,63,41,22,417119,431843,0.965904275396382,1.04761904761905,1.08459924477416,0.0158228227436295,0.00133859885430644,0.0203381831557197
"854","경북","김천시",2009,1097,604,493,"6",2008,1137,620,517,462768,488710,0.946917394773997,0.964819700967458,1.01890587953317,0.237051827265498,0.00448167328939955,0.159942501743791
"855","경북","김천시",2010,1026,547,479,"6",2009,1053,565,488,470657,487028,0.966385916210156,0.974358974358974,1.00825038736086,0.217993145751577,0.00179852789446397,0.0407666144817997
"856","경북","김천시",2011,1002,513,489,"6",2010,1050,543,507,441332,457372,0.964930078798003,0.954285714285714,0.988968771161587,0.227039960845803,-0.00250452976355428,-0.150360081560009
"857","경북","김천시",2012,913,452,461,"6",2011,922,454,468,407210,420797,0.967711271705834,0.990238611713666,1.02327898895723,0.224208639277031,0.00521935043784658,0.192707527763255
"858","경북","김천시",2013,884,503,381,"6",2012,915,520,395,422944,435284,0.971650692421499,0.966120218579235,0.994308166622635,0.209011122039797,-0.00118965648066663,-0.0919580320769673
"859","경북","김천시",2014,1028,538,490,"6",2013,1060,553,507,465061,480776,0.967313260229296,0.969811320754717,1.00258247315335,0.22104627134935,0.000570846061407699,-0.0137626972752405
"860","경북","김천시",2015,1077,577,500,"6",2014,1081,579,502,441255,454993,0.969806128885499,0.996299722479186,1.02731844314506,0.244076554373322,0.00666779147368906,0.257042187345633
"861","경북","김천시",2016,1021,528,493,"6",2015,1029,532,497,422114,435131,0.970084870992873,0.992225461613217,1.02282335420578,0.241877786569505,0.00552046239738701,0.206081862605922
"862","경북","김천시",2017,1130,568,562,"6",2016,1164,589,575,445571,460063,0.968499966308962,0.970790378006873,1.00236490632688,0.2536071692278,0.000599757199049914,-0.0124785661630138
"863","경북","김천시",2018,1131,605,526,"6",2017,1158,621,537,447106,462352,0.967025123715265,0.976683937823834,1.00998817287338,0.252960148152787,0.00252660968982584,0.073105448644619
"864","경북","김천시",2019,1228,630,598,"6",2018,1253,633,620,462528,478982,0.965647978420901,0.980047885075818,1.01491216983488,0.265497440154974,0.0039591429183158,0.136733539339896
"865","경북","김천시",2020,1118,602,516,"6",2019,1149,620,529,417119,431843,0.965904275396382,0.97302001740644,1.00736692257329,0.268029027687542,0.00197454909436915,0.0485848574719914
"866","경북","문경시",2009,574,301,273,"6",2008,592,300,292,462768,488710,0.946917394773997,0.969594594594595,1.02394844571,0.124036234138921,0.00297047501934853,0.0928203864077932
"867","경북","문경시",2010,518,283,235,"6",2009,528,285,243,470657,487028,0.966385916210156,0.981060606060606,1.0151851238768,0.11005891764066,0.00167125829812036,0.0351137463612892
"868","경북","문경시",2011,485,259,226,"6",2010,499,271,228,441332,457372,0.964930078798003,0.971943887775551,1.00726872250297,0.109894591826561,0.000798793292564083,-0.00363808249541846
"869","경북","문경시",2012,485,256,229,"6",2011,499,259,240,407210,420797,0.967711271705834,0.971943887775551,1.00437384186117,0.119103165442892,0.000520938410812434,-0.0159794196906856
"870","경북","문경시",2013,464,257,207,"6",2012,470,259,211,422944,435284,0.971650692421499,0.987234042553191,1.01603801680299,0.109707195278808,0.00175948584129031,0.0390325037115511
"871","경북","문경시",2014,507,279,228,"6",2013,518,290,228,465061,480776,0.967313260229296,0.978764478764479,1.01183816970778,0.109017956784164,0.00129057307360663,0.0182050467863104
"872","경북","문경시",2015,484,256,228,"6",2014,493,259,234,441255,454993,0.969806128885499,0.981744421906694,1.01230997893869,0.109687142355327,0.00135024641223932,0.0208555267382576
"873","경북","문경시",2016,456,249,207,"6",2015,472,257,215,422114,435131,0.970084870992873,0.966101694915254,0.995893992168394,0.108027689202443,-0.000443562537895527,-0.0588191616384243
"874","경북","문경시",2017,464,238,226,"6",2016,487,252,235,445571,460063,0.968499966308962,0.952772073921971,0.983760564858942,0.104136041169645,-0.00169111048642096,-0.114230856415764
"875","경북","문경시",2018,513,278,235,"6",2017,532,295,237,447106,462352,0.967025123715265,0.964285714285714,0.99716717863645,0.114737892132962,-0.000325031952042976,-0.0535544496465494
"876","경북","문경시",2019,486,256,230,"6",2018,501,265,236,462528,478982,0.965647978420901,0.970059880239521,1.00456885108985,0.105074719800747,0.000480070748077356,-0.0177946176206859
"877","경북","문경시",2020,415,223,192,"6",2019,442,239,203,417119,431843,0.965904275396382,0.938914027149321,0.972057015447017,0.0994919914940341,-0.00278010318146329,-0.162600084150668
"878","경북","봉화군",2009,177,103,74,"6",2008,201,115,86,462768,488710,0.946917394773997,0.880597014925373,0.929961810592304,0.0382481070428379,-0.00267882816555213,-0.158101803922743
"879","경북","봉화군",2010,192,99,93,"6",2009,186,91,95,470657,487028,0.966385916210156,1.03225806451613,1.06816339849436,0.0407940389710554,0.00278066033457861,0.0843894853036238
"880","경북","봉화군",2011,186,98,88,"6",2010,194,101,93,441332,457372,0.964930078798003,0.958762886597938,0.993608664155493,0.0421451424324545,-0.000269363759500386,-0.0510818642059479
"881","경북","봉화군",2012,140,69,71,"6",2011,148,77,71,407210,420797,0.967711271705834,0.945945945945946,0.977508450716378,0.0343802951793915,-0.000773266103412757,-0.0734634351198848
"882","경북","봉화군",2013,171,88,83,"6",2012,182,87,95,422944,435284,0.971650692421499,0.93956043956044,0.966973467819916,0.0404308844669744,-0.0013352919069178,-0.0984266458065927
"883","경북","봉화군",2014,186,80,106,"6",2013,184,83,101,465061,480776,0.967313260229296,1.01086956521739,1.04502812767993,0.0399947533764388,0.00180088886156164,0.0408714803415449
"884","경북","봉화군",2015,175,102,73,"6",2014,187,109,78,441255,454993,0.969806128885499,0.935828877005348,0.964964902913948,0.039659607256575,-0.0013894781906288,-0.100833410065763
"885","경북","봉화군",2016,157,91,66,"6",2015,158,94,64,422114,435131,0.970084870992873,0.993670886075949,1.02431335214922,0.0371937438701393,0.000904304592462419,0.00104835857679638
"886","경북","봉화군",2017,177,89,88,"6",2016,187,96,91,445571,460063,0.968499966308962,0.946524064171123,0.977309341350221,0.0397243088082483,-0.000901370731266368,-0.0791533924049569
"887","경북","봉화군",2018,160,82,78,"6",2017,167,83,84,447106,462352,0.967025123715265,0.958083832335329,0.990753816875426,0.0357856973514111,-0.000330881110951735,-0.0538142487256464
"888","경북","봉화군",2019,141,78,63,"6",2018,153,82,71,462528,478982,0.965647978420901,0.92156862745098,0.95435256744181,0.0304846409298464,-0.0013915455909058,-0.100925236719213
"889","경북","봉화군",2020,132,69,63,"6",2019,137,71,66,417119,431843,0.965904275396382,0.963503649635037,0.997514633879883,0.031645645487259,-7.86510151432553e-05,-0.0426110744515686
"890","경북","상주시",2009,721,415,306,"6",2008,766,435,331,462768,488710,0.946917394773997,0.941253263707572,0.994018347220481,0.155801611174498,-0.000931951140535527,-0.0805116666954093
"891","경북","상주시",2010,696,359,337,"6",2009,727,371,356,470657,487028,0.966385916210156,0.957359009628611,0.990659107888341,0.147878391270076,-0.00138131609849944,-0.100470878622903
"892","경북","상주시",2011,634,336,298,"6",2010,647,348,299,441332,457372,0.964930078798003,0.979907264296754,1.01552152412681,0.143656023129979,0.00222976042897413,0.0599204478944388
"893","경북","상주시",2012,650,329,321,"6",2011,666,329,337,407210,420797,0.967711271705834,0.975975975975976,1.00854046502483,0.159622799047175,0.00136325293242857,0.0214332306475091
"894","경북","상주시",2013,619,331,288,"6",2012,638,347,291,422944,435284,0.971650692421499,0.970219435736677,0.998526984341198,0.14635507301203,-0.000215583314291778,-0.0486931258665429
"895","경북","상주시",2014,703,379,324,"6",2013,703,385,318,465061,480776,0.967313260229296,1,1.03379126609198,0.151162965718476,0.00510798799784511,0.187761199614253
"896","경북","상주시",2015,712,372,340,"6",2014,728,383,345,441255,454993,0.969806128885499,0.978021978021978,1.00847164076589,0.161357944952465,0.00136696654435994,0.0215981762362584
"897","경북","상주시",2016,658,339,319,"6",2015,681,345,336,422114,435131,0.970084870992873,0.966226138032305,0.996022272817616,0.155882060296508,-0.000620056308487472,-0.0666583945574493
"898","경북","상주시",2017,637,348,289,"6",2016,659,357,302,445571,460063,0.968499966308962,0.966616084977238,0.99805484625993,0.142962625485052,-0.000278084285652504,-0.0514691993252194
"899","경북","상주시",2018,609,305,304,"6",2017,645,324,321,447106,462352,0.967025123715265,0.944186046511628,0.976382126334122,0.136209310543808,-0.00321697428853995,-0.182004363137286
"900","경북","상주시",2019,606,320,286,"6",2018,629,340,289,462528,478982,0.965647978420901,0.963434022257552,0.997707284421628,0.131019095060191,-0.00030038952030874,-0.0524599194463732
"901","경북","상주시",2020,564,288,276,"6",2019,582,293,289,417119,431843,0.965904275396382,0.969072164948454,1.00327971376954,0.13521321253647,0.000443460634979053,-0.0194207101609885
"902","경북","성주군",2009,240,128,112,"6",2008,259,134,125,462768,488710,0.946917394773997,0.926640926640927,0.978586866980187,0.0518618400580853,-0.00111052447981603,-0.0884432667459544
"903","경북","성주군",2010,227,131,96,"6",2009,242,138,104,470657,487028,0.966385916210156,0.93801652892562,0.970643832025417,0.048230452325154,-0.00141586125994733,-0.102005253269141
"904","경북","성주군",2011,214,141,73,"6",2010,211,140,71,441332,457372,0.964930078798003,1.01421800947867,1.05107927689649,0.0484895724760498,0.00247681229909633,0.0708936235848505
"905","경북","성주군",2012,196,100,96,"6",2011,210,111,99,407210,420797,0.967711271705834,0.933333333333333,0.964475004706826,0.0481324132511481,-0.00170990375419613,-0.115065587312527
"906","경북","성주군",2013,207,118,89,"6",2012,208,117,91,422944,435284,0.971650692421499,0.995192307692308,1.02422847578294,0.0489426496179163,0.00118580580102045,0.0135516527920665
"907","경북","성주군",2014,203,107,96,"6",2013,209,109,100,465061,480776,0.967313260229296,0.971291866028708,1.00411304792666,0.043650187824823,0.000179535314530995,-0.0311433452051688
"908","경북","성주군",2015,207,114,93,"6",2014,222,126,96,441255,454993,0.969806128885499,0.932432432432432,0.961462713691017,0.0469116497263487,-0.00180784767673102,-0.119415912081377
"909","경북","성주군",2016,218,126,92,"6",2015,222,122,100,422114,435131,0.970084870992873,0.981981981981982,1.01226398982692,0.0516448163292381,0.000633371502075083,-0.0109855369759712
"910","경북","성주군",2017,178,84,94,"6",2016,191,92,99,445571,460063,0.968499966308962,0.931937172774869,0.96224801775323,0.0399487399314587,-0.00150814412067324,-0.106104133570911
"911","경북","성주군",2018,192,92,100,"6",2017,206,96,110,447106,462352,0.967025123715265,0.932038834951456,0.963820703406968,0.0429428368216933,-0.00155364162991823,-0.1081249730091
"912","경북","성주군",2019,193,94,99,"6",2018,197,96,101,462528,478982,0.965647978420901,0.979695431472081,1.0145471780246,0.041727203542272,0.000607013058397986,-0.0121562863949152
"913","경북","성주군",2020,162,80,82,"6",2019,168,84,84,417119,431843,0.965904275396382,0.964285714285714,0.998324304848942,0.0388378376434543,-6.5080376216724e-05,-0.0420083143708685
"914","경북","안동시",2009,1404,761,643,"6",2008,1473,780,693,462768,488710,0.946917394773997,0.953156822810591,1.00658919993553,0.303391764339799,0.00199910899402708,0.0496757218874361
"915","경북","안동시",2010,1370,700,670,"6",2009,1406,710,696,470657,487028,0.966385916210156,0.974395448079659,1.00828812975764,0.291082465574718,0.00241252924485602,0.0680383962686341
"916","경북","안동시",2011,1374,718,656,"6",2010,1379,724,655,441332,457372,0.964930078798003,0.996374184191443,1.03258692633212,0.311330245710712,0.0101452957819369,0.411500705387582
"917","경북","안동시",2012,1267,669,598,"6",2011,1285,679,606,407210,420797,0.967711271705834,0.985992217898833,1.01889090964165,0.311141671373493,0.00587774919966767,0.221951286510108
"918","경북","안동시",2013,1244,635,609,"6",2012,1281,652,629,422944,435284,0.971650692421499,0.97111631537861,0.999450031737684,0.294128773549217,-0.000161761490485938,-0.0463025496352933
"919","경북","안동시",2014,1391,726,665,"6",2013,1418,728,690,465061,480776,0.967313260229296,0.980959097320169,1.01410694720306,0.299100548100142,0.00421939564045459,0.148293050476259
"920","경북","안동시",2015,1318,674,644,"6",2014,1343,679,664,441255,454993,0.969806128885499,0.98138495904691,1.01193932458925,0.298693499223805,0.00356619863993265,0.119280335682269
"921","경북","안동시",2016,1302,665,637,"6",2015,1305,665,640,422114,435131,0.970084870992873,0.997701149425287,1.02846789931292,0.308447481012238,0.0087808518327808,0.350896901148403
"922","경북","안동시",2017,1407,743,664,"6",2016,1380,730,650,445571,460063,0.968499966308962,1.0195652173913,1.05272612582214,0.315774590357092,0.016649570782602,0.700397738572346
"923","경북","안동시",2018,1473,776,697,"6",2017,1329,707,622,447106,462352,0.967025123715265,1.10835214446953,1.14614617271916,0.329452076241428,0.0481481600370667,2.09945435659509
"924","경북","안동시",2019,1424,759,665,"6",2018,1326,699,627,462528,478982,0.965647978420901,1.07390648567119,1.11210970215805,0.307873253078733,0.0345155787050868,1.49394301197078
"925","경북","안동시",2020,1315,686,629,"6",2019,1235,656,579,417119,431843,0.965904275396382,1.06477732793522,1.10236320001614,0.315257756179891,0.0322707927524802,1.39423751031586
"926","경북","영덕군",2009,259,139,120,"6",2008,275,147,128,462768,488710,0.946917394773997,0.941818181818182,0.994614933695423,0.0559675690626837,-0.000301389070308521,-0.0525043159439731
"927","경북","영덕군",2010,245,125,120,"6",2009,254,128,126,470657,487028,0.966385916210156,0.964566929133858,0.998117742564553,0.0520548934786904,-9.79807103016787e-05,-0.0434696315671677
"928","경북","영덕군",2011,212,109,103,"6",2010,221,118,103,441332,457372,0.964930078798003,0.959276018099548,0.994140445175574,0.0480363989015073,-0.000281471912931395,-0.0516196658215326
"929","경북","영덕군",2012,200,99,101,"6",2011,210,108,102,407210,420797,0.967711271705834,0.952380952380952,0.98415816806819,0.0491147073991307,-0.000778066939997058,-0.0736766714061531
"930","경북","영덕군",2013,205,99,106,"6",2012,218,106,112,422944,435284,0.971650692421499,0.940366972477064,0.967803532495334,0.0484697737761973,-0.00156055549634386,-0.10843206265368
"931","경북","영덕군",2014,216,118,98,"6",2013,228,126,102,465061,480776,0.967313260229296,0.947368421052632,0.979381199455555,0.0464455200500579,-0.000957650914095155,-0.0816531603029424
"932","경북","영덕군",2015,168,86,82,"6",2014,165,86,79,441255,454993,0.969806128885499,1.01818181818182,1.04988181437038,0.038073222966312,0.00189916144048749,0.0452364028720636
"933","경북","영덕군",2016,191,98,93,"6",2015,207,106,101,422114,435131,0.970084870992873,0.922705314009662,0.951159369247024,0.0452484399948829,-0.00220996234993828,-0.137276432443409
"934","경북","영덕군",2017,203,106,97,"6",2016,198,98,100,445571,460063,0.968499966308962,1.02525252525253,1.05859841085989,0.0455595180117198,0.00266971535502936,0.0794616992805471
"935","경북","영덕군",2018,186,94,92,"6",2017,193,98,95,447106,462352,0.967025123715265,0.963730569948187,0.996593104267632,0.0416008731710154,-0.000141729837269113,-0.045412814010103
"936","경북","영덕군",2019,174,87,87,"6",2018,187,93,94,462528,478982,0.965647978420901,0.93048128342246,0.963582282794245,0.0376193441261934,-0.00137001063585368,-0.0999687297105631
"937","경북","영덕군",2020,169,88,81,"6",2019,185,99,86,417119,431843,0.965904275396382,0.913513513513514,0.945759881991029,0.0405160158132332,-0.00219759347896308,-0.136727050670927
"938","경북","영양군",2009,109,51,58,"6",2008,114,57,57,462768,488710,0.946917394773997,0.956140350877193,1.00973997959494,0.0235539190263804,0.000229414690697903,-0.0289278786404474
"939","경북","영양군",2010,104,52,52,"6",2009,109,54,55,470657,487028,0.966385916210156,0.954128440366973,0.987316168791808,0.0220967711093217,-0.000280271714996695,-0.0515663572479354
"940","경북","영양군",2011,75,34,41,"6",2010,80,35,45,441332,457372,0.964930078798003,0.9375,0.971572988135916,0.0169940090453445,-0.000483088896750363,-0.0605747835647098
"941","경북","영양군",2012,95,51,44,"6",2011,103,55,48,407210,420797,0.967711271705834,0.922330097087379,0.953104633638854,0.0233294860145871,-0.00109404479367129,-0.0877112970130412
"942","경북","영양군",2013,87,45,42,"6",2012,86,46,40,422944,435284,0.971650692421499,1.01162790697674,1.04114360733446,0.0205700991147764,0.000846328080809252,-0.00152675428501972
"943","경북","영양군",2014,107,56,51,"6",2013,113,55,58,465061,480776,0.967313260229296,0.946902654867257,0.978899694441074,0.0230077344692417,-0.00048547022751964,-0.06068055390717
"944","경북","영양군",2015,105,54,51,"6",2014,102,54,48,441255,454993,0.969806128885499,1.02941176470588,1.06146139320534,0.023795764353945,0.00146252082957949,0.02584236171507
"945","경북","영양군",2016,81,45,36,"6",2015,81,47,34,422114,435131,0.970084870992873,1,1.03083764101641,0.0191891290030655,0.000591747471614077,-0.0128343301017457
"946","경북","영양군",2017,93,46,47,"6",2016,95,48,47,445571,460063,0.968499966308962,0.978947368421053,1.01078719925196,0.0208720944585711,0.000225151441730321,-0.0291172371743865
"947","경북","영양군",2018,71,45,26,"6",2017,72,46,26,447106,462352,0.967025123715265,0.986111111111111,1.01973680613645,0.0158799031996887,0.000313418570917876,-0.0251967215523666
"948","경북","영양군",2019,70,42,28,"6",2018,72,42,30,462528,478982,0.965647978420901,0.972222222222222,1.00680811636148,0.0151342189013422,0.000103035523320507,-0.0345411970361113
"949","경북","영양군",2020,77,46,31,"6",2019,81,47,34,417119,431843,0.965904275396382,0.950617283950617,0.984173388776552,0.0184599598675678,-0.000292158608024453,-0.0520943312541317
"950","경북","영주시",2009,973,516,457,"6",2008,1004,534,470,462768,488710,0.946917394773997,0.969123505976096,1.02345094865154,0.210256543235487,0.00493071539906655,0.179887373884738
"951","경북","영주시",2010,937,471,466,"6",2009,969,482,487,470657,487028,0.966385916210156,0.966976264189886,1.00061088222606,0.199083408936869,0.000121616516023495,-0.0337158946519145
"952","경북","영주시",2011,874,463,411,"6",2010,890,470,420,441332,457372,0.964930078798003,0.982022471910112,1.01771360794701,0.198036852075082,0.00350794715671892,0.11669300955025
"953","경북","영주시",2012,836,461,375,"6",2011,860,477,383,407210,420797,0.967711271705834,0.972093023255814,1.00452795340728,0.205299476928366,0.000929586466069723,0.00217129053735397
"954","경북","영주시",2013,826,440,386,"6",2012,847,456,391,422944,435284,0.971650692421499,0.975206611570248,1.00365966820842,0.195297722629946,0.000714724866686467,-0.00737210647473559
"955","경북","영주시",2014,840,419,421,"6",2013,869,420,449,465061,480776,0.967313260229296,0.96662830840046,0.999291902781656,0.180621466861336,-0.00012789755825774,-0.0447984327964918
"956","경북","영주시",2015,816,402,414,"6",2014,846,418,428,441255,454993,0.969806128885499,0.964539007092199,0.994568892032726,0.18492708297923,-0.00100435895373315,-0.0837277672462086
"957","경북","영주시",2016,787,396,391,"6",2015,786,398,388,422114,435131,0.970084870992873,1.00127226463104,1.03214913928742,0.186442525005093,0.00599396670548725,0.22711325961733
"958","경북","영주시",2017,830,427,403,"6",2016,844,435,409,445571,460063,0.968499966308962,0.983412322274882,1.01539737375805,0.186277832264667,0.00286818940621871,0.088277219003637
"959","경북","영주시",2018,809,403,406,"6",2017,846,415,431,447106,462352,0.967025123715265,0.956264775413712,0.988872731392735,0.180941432233072,-0.00201338391864055,-0.128545109492854
"960","경북","영주시",2019,845,445,400,"6",2018,878,456,422,462528,478982,0.965647978420901,0.962414578587699,0.996651574998905,0.182691642451916,-0.000611729263077167,-0.0662885364696554
"961","경북","영주시",2020,666,333,333,"6",2019,695,355,340,417119,431843,0.965904275396382,0.958273381294964,0.992099740837893,0.159666665867534,-0.00126140803990303,-0.0951449841335236
"962","경북","영천시",2009,651,357,294,"6",2008,707,378,329,462768,488710,0.946917394773997,0.920792079207921,0.972410142943555,0.140675241157556,-0.00388120979491794,-0.211507369561362
"963","경북","영천시",2010,728,393,335,"6",2009,736,398,338,470657,487028,0.966385916210156,0.989130434782609,1.02353564780999,0.154677397765252,0.00364043275796797,0.122577554274548
"964","경북","영천시",2011,648,352,296,"6",2010,683,368,315,441332,457372,0.964930078798003,0.948755490483163,0.983237554025688,0.146828238151777,-0.00246120040952257,-0.148435543955388
"965","경북","영천시",2012,579,279,300,"6",2011,592,284,308,407210,420797,0.967711271705834,0.978040540540541,1.01067391600854,0.142187077920483,0.00151769292722307,0.0282929123640173
"966","경북","영천시",2013,568,292,276,"6",2012,601,315,286,422944,435284,0.971650692421499,0.945091514143095,0.972665919465137,0.134296739048196,-0.00367087788071285,-0.20216516524317
"967","경북","영천시",2014,644,348,296,"6",2013,648,348,300,465061,480776,0.967313260229296,0.993827160493827,1.02740983852351,0.138476457927025,0.00379561735108681,0.129470308431381
"968","경북","영천시",2015,578,313,265,"6",2014,591,317,274,441255,454993,0.969806128885499,0.978003384094755,1.00845246793674,0.130990017110288,0.00110718891965729,0.0100597672580545
"969","경북","영천시",2016,577,325,252,"6",2015,592,329,263,422114,435131,0.970084870992873,0.974662162162162,1.00471844403119,0.136692931293442,0.00064497794576808,-0.0104700195434533
"970","경북","영천시",2017,615,324,291,"6",2016,621,316,305,445571,460063,0.968499966308962,0.990338164251208,1.02254847568604,0.138025140774422,0.00311225653081395,0.0991178227890386
"971","경북","영천시",2018,552,274,278,"6",2017,575,290,285,447106,462352,0.967025123715265,0.96,0.992735324509177,0.123460655862368,-0.000896901600724319,-0.078954889335148
"972","경북","영천시",2019,610,291,319,"6",2018,639,313,326,462528,478982,0.965647978420901,0.954616588419405,0.988576178640652,0.131883907568839,-0.00150661820023916,-0.106036357548796
"973","경북","영천시",2020,542,271,271,"6",2019,563,280,283,417119,431843,0.965904275396382,0.962699822380107,0.996682432102331,0.129938938288594,-0.000431081250323391,-0.0582647867158469
"974","경북","예천군",2009,255,151,104,"6",2008,271,162,109,462768,488710,0.946917394773997,0.940959409594096,0.993708020136938,0.0551032050617156,-0.000346708256638476,-0.0545172349050768
"975","경북","예천군",2010,233,124,109,"6",2009,242,129,113,470657,487028,0.966385916210156,0.962809917355372,0.996299616131816,0.0495052660429995,-0.000183188487855681,-0.0472542615431606
"976","경북","예천군",2011,232,129,103,"6",2010,246,132,114,441332,457372,0.964930078798003,0.943089430894309,0.977365564216943,0.0525681346469325,-0.00118985006790109,-0.0919666305414682
"977","경북","예천군",2012,211,104,107,"6",2011,224,114,110,407210,420797,0.967711271705834,0.941964285714286,0.973393938104944,0.0518160163060829,-0.00137862013699486,-0.100351133489099
"978","경북","예천군",2013,253,139,114,"6",2012,254,139,115,422944,435284,0.971650692421499,0.996062992125984,1.02512456368826,0.0598187939774533,0.00150292109904136,0.0276367996787487
"979","경북","예천군",2014,248,141,107,"6",2013,262,148,114,465061,480776,0.967313260229296,0.946564885496183,0.978550511415305,0.0533263378352517,-0.00114382267466084,-0.0899222555187367
"980","경북","예천군",2015,243,144,99,"6",2014,258,150,108,441255,454993,0.969806128885499,0.941860465116279,0.971184278035719,0.0550701975048441,-0.00158688749981763,-0.109601637691728
"981","경북","예천군",2016,243,138,105,"6",2015,254,140,114,422114,435131,0.970084870992873,0.956692913385827,0.98619506601176,0.0575673870091966,-0.000794713977537405,-0.0744160742998237
"982","경북","예천군",2017,208,108,100,"6",2016,282,150,132,445571,460063,0.968499966308962,0.737588652482269,0.761578397667151,0.046681673627772,-0.0111299194259125,-0.533469572358447
"983","경북","예천군",2018,219,108,111,"6",2017,394,198,196,447106,462352,0.967025123715265,0.555837563451777,0.57479123325801,0.0489816732497439,-0.0208274368754827,-0.964199210965648
"984","경북","예천군",2019,367,210,157,"6",2018,496,273,223,462528,478982,0.965647978420901,0.73991935483871,0.766241292244696,0.0793465476684655,-0.0185479464478251,-0.862952258514219
"985","경북","예천군",2020,394,204,190,"6",2019,501,254,247,417119,431843,0.965904275396382,0.786427145708583,0.814187457018816,0.0944574569846974,-0.0175513802858624,-0.818688292502033
"986","경북","울릉군",2009,47,22,25,"6",2008,57,28,29,462768,488710,0.946917394773997,0.824561403508772,0.870784936531419,0.010156277011375,-0.00131234397862931,-0.0974073794933444
"987","경북","울릉군",2010,58,31,27,"6",2009,63,32,31,470657,487028,0.966385916210156,0.920634920634921,0.952657634173048,0.0123231992725063,-0.000583409408117426,-0.0650306680558421
"988","경북","울릉군",2011,48,29,19,"6",2010,50,33,17,441332,457372,0.964930078798003,0.96,0.994890739851178,0.0108761657890205,-5.55691604378257e-05,-0.0415858595976274
"989","경북","울릉군",2012,57,27,30,"6",2011,57,30,27,407210,420797,0.967711271705834,1,1.0333660764716,0.0139976916087522,0.000467048048643494,-0.0183730401551136
"990","경북","울릉군",2013,51,25,26,"6",2012,52,26,26,422944,435284,0.971650692421499,0.980769230769231,1.00938458482956,0.0120583339638345,0.000113162457986782,-0.0340913941941276
"991","경북","울릉군",2014,54,19,35,"6",2013,60,22,38,465061,480776,0.967313260229296,0.9,0.930412139482778,0.0116113800125145,-0.000808011092723323,-0.0750066854173941
"992","경북","울릉군",2015,57,32,25,"6",2014,53,30,23,441255,454993,0.969806128885499,1.07547169811321,1.10895535311696,0.0129177006492844,0.00140745263570192,0.0233964261061903
"993","경북","울릉군",2016,41,21,20,"6",2015,45,21,24,422114,435131,0.970084870992873,0.911111111111111,0.939207628481616,0.00971301591513193,-0.000590477272076677,-0.0653445977295678
"994","경북","울릉군",2017,40,22,18,"6",2016,41,21,20,445571,460063,0.968499966308962,0.975609756097561,1.00734103256162,0.00897724492841769,6.59022473331254e-05,-0.0361905266330439
"995","경북","울릉군",2018,50,29,21,"6",2017,56,35,21,447106,462352,0.967025123715265,0.892857142857143,0.923302943181898,0.011183030422316,-0.000857705519698931,-0.0772139371891291
"996","경북","울릉군",2019,50,20,30,"6",2018,50,21,29,462528,478982,0.965647978420901,1,1.03557406254324,0.0108101563581016,0.000384561178385315,-0.0220368169929392
"997","경북","울릉군",2020,50,22,28,"6",2019,57,23,34,417119,431843,0.965904275396382,0.87719298245614,0.908157262370707,0.0119869869269921,-0.00110091769530149,-0.0880165671453976
"998","경북","울진군",2009,457,232,225,"6",2008,484,250,234,462768,488710,0.946917394773997,0.944214876033058,0.997145982578994,0.098753587110604,-0.000281844458000541,-0.0516362129640185
"999","경북","울진군",2010,396,186,210,"6",2009,402,187,215,470657,487028,0.966385916210156,0.985074626865672,1.0193387655408,0.0841377053778017,0.00162711935744185,0.0331532497634926
"1000","경북","울진군",2011,413,205,208,"6",2010,427,209,218,441332,457372,0.964930078798003,0.967213114754098,1.00236601180361,0.0935803431430306,0.000221412196462426,-0.0292833213058438
"1001","경북","울진군",2012,397,191,206,"6",2011,394,191,203,407210,420797,0.967711271705834,1.00761421319797,1.0412343460894,0.0974926941872744,0.00402004749330646,0.139438706483103
"1002","경북","울진군",2013,362,196,166,"6",2012,364,198,166,422944,435284,0.971650692421499,0.994505494505495,1.02352162383278,0.0855905273511387,0.00201322818800243,0.0503028468552489
"1003","경북","울진군",2014,400,220,180,"6",2013,410,226,184,465061,480776,0.967313260229296,0.975609756097561,1.00857684496778,0.0860102223149221,0.000737696342439426,-0.00635179426588417
"1004","경북","울진군",2015,368,189,179,"6",2014,385,192,193,441255,454993,0.969806128885499,0.955844155844156,0.985603335939536,0.0833984884023977,-0.00120066002067982,-0.0924467706472175
"1005","경북","울진군",2016,332,169,163,"6",2015,356,188,168,422114,435131,0.970084870992873,0.932584269662921,0.961342968588335,0.0786517386298488,-0.0030404427307961,-0.174163451845794
"1006","경북","울진군",2017,335,181,154,"6",2016,352,188,164,445571,460063,0.968499966308962,0.951704545454545,0.98265831549956,0.0751844262754982,-0.00130382459981627,-0.0970289786318473
"1007","경북","울진군",2018,343,166,177,"6",2017,357,168,189,447106,462352,0.967025123715265,0.96078431372549,0.993546382780835,0.0767155886970875,-0.000495093044193933,-0.0611079655999105
"1008","경북","울진군",2019,330,185,145,"6",2018,350,198,152,462528,478982,0.965647978420901,0.942857142857143,0.976398401826484,0.0713470319634703,-0.00168390397927482,-0.113910768699004
"1009","경북","울진군",2020,299,148,151,"6",2019,309,150,159,417119,431843,0.965904275396382,0.967637540453074,1.00179444806369,0.0716821818234125,0.00012862995237389,-0.0334043824612626
"1010","경북","의성군",2009,257,135,122,"6",2008,273,143,130,462768,488710,0.946917394773997,0.941391941391941,0.994164798943867,0.0555353870621996,-0.000324060149238078,-0.0535112855818155
"1011","경북","의성군",2010,231,123,108,"6",2009,239,131,108,470657,487028,0.966385916210156,0.96652719665272,1.00014619464149,0.049080328137051,7.1752809763066e-06,-0.038798972054969
"1012","경북","의성군",2011,223,123,100,"6",2010,239,133,106,441332,457372,0.964930078798003,0.933054393305439,0.966965807996917,0.0505288535614911,-0.00166917985024596,-0.113256774642444
"1013","경북","의성군",2012,214,115,99,"6",2011,230,125,105,407210,420797,0.967711271705834,0.930434782608696,0.961479740717053,0.0525527369170698,-0.00202434505207401,-0.129031964511891
"1014","경북","의성군",2013,217,110,107,"6",2012,219,111,108,422944,435284,0.971650692421499,0.990867579908676,1.01977756784106,0.0513070288265113,0.00101472824333941,0.00595298901270657
"1015","경북","의성군",2014,225,105,120,"6",2013,231,110,121,465061,480776,0.967313260229296,0.974025974025974,1.00693954489478,0.0483807500521437,0.000335740387030024,-0.0242052649412245
"1016","경북","의성군",2015,220,135,85,"6",2014,229,138,91,441255,454993,0.969806128885499,0.960698689956332,0.990609010751836,0.0498577919796943,-0.000468213988418515,-0.059914092421496
"1017","경북","의성군",2016,193,95,98,"6",2015,208,103,105,422114,435131,0.970084870992873,0.927884615384615,0.956498388058494,0.0457222456492796,-0.00198899138732918,-0.127461678991069
"1018","경북","의성군",2017,192,104,88,"6",2016,204,112,92,445571,460063,0.968499966308962,0.941176470588235,0.971787819647677,0.0430907756564049,-0.00121568473433997,-0.0931141156165531
"1019","경북","의성군",2018,183,88,95,"6",2017,204,96,108,447106,462352,0.967025123715265,0.897058823529412,0.927647898208636,0.0409298913456764,-0.00296136366495183,-0.170651037701697
"1020","경북","의성군",2019,177,90,87,"6",2018,183,91,92,462528,478982,0.965647978420901,0.967213114754098,1.001620814591,0.0382679535076795,6.20252574130818e-05,-0.0363627288977811
"1021","경북","의성군",2020,162,83,79,"6",2019,178,93,85,417119,431843,0.965904275396382,0.910112359550562,0.942238669745069,0.0388378376434543,-0.00224332516651097,-0.138758291486201
"1022","경북","청도군",2009,229,121,108,"6",2008,236,126,110,462768,488710,0.946917394773997,0.970338983050847,1.02473456333796,0.049484839055423,0.00122398588588497,0.0152474779598174
"1023","경북","청도군",2010,181,90,91,"6",2009,191,97,94,470657,487028,0.966385916210156,0.947643979057592,0.98060615656935,0.0384568804883386,-0.000745826719022045,-0.0722446741139183
"1024","경북","청도군",2011,198,110,88,"6",2010,208,115,93,441332,457372,0.964930078798003,0.951923076923077,0.986520264876468,0.0448641838797096,-0.000604757315231908,-0.0659788670525707
"1025","경북","청도군",2012,163,80,83,"6",2011,169,83,86,407210,420797,0.967711271705834,0.964497041420118,0.996678523460773,0.0400284865302915,-0.000132953678911113,-0.0450230079037919
"1026","경북","청도군",2013,184,98,86,"6",2012,194,106,88,422944,435284,0.971650692421499,0.948453608247423,0.976126107504471,0.0435045774381478,-0.00103862360482174,-0.0852496826082734
"1027","경북","청도군",2014,216,102,114,"6",2013,226,101,125,465061,480776,0.967313260229296,0.955752212389381,0.988048289716224,0.0464455200500579,-0.000555103399617605,-0.0637734146531085
"1028","경북","청도군",2015,176,92,84,"6",2014,185,99,86,441255,454993,0.969806128885499,0.951351351351351,0.980970652809385,0.0398862335837554,-0.000759008986991232,-0.0728301841218063
"1029","경북","청도군",2016,175,82,93,"6",2015,186,87,99,422114,435131,0.970084870992873,0.940860215053763,0.969874124612212,0.0414579947597095,-0.00124895838395859,-0.094592014176664
"1030","경북","청도군",2017,182,97,85,"6",2016,181,98,83,445571,460063,0.968499966308962,1.00552486187845,1.03822911394679,0.0408464644243005,0.00156152414280023,0.0302397408944571
"1031","경북","청도군",2018,174,83,91,"6",2017,197,96,101,447106,462352,0.967025123715265,0.883248730964467,0.913366891204509,0.0389169458696595,-0.00337149600551445,-0.188867674665778
"1032","경북","청도군",2019,183,98,85,"6",2018,182,95,87,462528,478982,0.965647978420901,1.00549450549451,1.04126402991985,0.0395651722706517,0.00163261845236027,0.0333975002306036
"1033","경북","청도군",2020,145,74,71,"6",2019,154,80,74,417119,431843,0.965904275396382,0.941558441558442,0.974794775778428,0.034762262088277,-0.000876190610384073,-0.0780349799427862
"1034","경북","청송군",2009,130,70,60,"6",2008,158,84,74,462768,488710,0.946917394773997,0.822784810126582,0.868908750295963,0.0280918300314628,-0.00368259310529787,-0.20268551434055
"1035","경북","청송군",2010,151,85,66,"6",2009,160,89,71,470657,487028,0.966385916210156,0.94375,0.976576732100022,0.0320828118991112,-0.000751484298097487,-0.0724959638902172
"1036","경북","청송군",2011,121,61,60,"6",2010,134,71,63,441332,457372,0.964930078798003,0.902985074626866,0.935803634343847,0.0274170012598225,-0.00176007183807077,-0.117293877258826
"1037","경북","청송군",2012,120,62,58,"6",2011,130,65,65,407210,420797,0.967711271705834,0.923076923076923,0.953876378281476,0.0294688244394784,-0.00135920891093609,-0.0994889550574846
"1038","경북","청송군",2013,118,58,60,"6",2012,131,66,65,422944,435284,0.971650692421499,0.900763358778626,0.927044426360453,0.0278996746614209,-0.00203543676928069,-0.129524619603136
"1039","경북","청송군",2014,125,63,62,"6",2013,131,62,69,465061,480776,0.967313260229296,0.954198473282443,0.986442047797686,0.0268781944734132,-0.000364413275955031,-0.0553036296304703
"1040","경북","청송군",2015,123,74,49,"6",2014,122,74,48,441255,454993,0.969806128885499,1.00819672131148,1.03958584224467,0.0278750382431927,0.00110345686645919,0.00989400257305774
"1041","경북","청송군",2016,106,49,57,"6",2015,116,53,63,422114,435131,0.970084870992873,0.913793103448276,0.941972327135683,0.025111699683024,-0.00145717349427349,-0.10384019750656
"1042","경북","청송군",2017,98,50,48,"6",2016,104,54,50,445571,460063,0.968499966308962,0.942307692307692,0.972955833853985,0.0219942500746233,-0.000594816153275124,-0.0655373155813567
"1043","경북","청송군",2018,116,64,52,"6",2017,119,66,53,447106,462352,0.967025123715265,0.974789915966387,1.0080295662033,0.025944630579773,0.000208324128860336,-0.0298646472645369
"1044","경북","청송군",2019,115,59,56,"6",2018,125,64,61,462528,478982,0.965647978420901,0.92,0.952728137539781,0.0248633596236336,-0.00117533731642736,-0.0913220251329209
"1045","경북","청송군",2020,104,45,59,"6",2019,116,51,65,417119,431843,0.965904275396382,0.896551724137931,0.928199353678199,0.0249329328081435,-0.00179020069032275,-0.118632094973785
"1046","경북","칠곡군",2009,1220,670,550,"6",2008,1375,742,633,462768,488710,0.946917394773997,0.887272727272727,0.937011752207271,0.263631020295267,-0.0166056560322082,-0.776682545349022
"1047","경북","칠곡군",2010,1282,655,627,"6",2009,1363,695,668,470657,487028,0.966385916210156,0.94057226705796,0.973288467144235,0.272385197712984,-0.00727582615813436,-0.362284296433826
"1048","경북","칠곡군",2011,1207,666,541,"6",2010,1277,683,594,441332,457372,0.964930078798003,0.945184025058731,0.979536285402287,0.273490252236412,-0.0055966264670225,-0.287700148494604
"1049","경북","칠곡군",2012,1153,616,537,"6",2011,1234,657,577,407210,420797,0.967711271705834,0.934359805510535,0.965535726233188,0.283146288155988,-0.00975843119106457,-0.472552885709304
"1050","경북","칠곡군",2013,1214,633,581,"6",2012,1270,658,612,422944,435284,0.971650692421499,0.955905511811024,0.983795431081064,0.287035635923432,-0.0046512887445118,-0.245711569696343
"1051","경북","칠곡군",2014,1316,709,607,"6",2013,1393,737,656,465061,480776,0.967313260229296,0.944723618090452,0.97664702525272,0.282973631416094,-0.00660827606860614,-0.332634067876883
"1052","경북","칠곡군",2015,1235,635,600,"6",2014,1313,687,626,441255,454993,0.969806128885499,0.940594059405941,0.969878444145193,0.279883514067829,-0.00843052690183376,-0.413572044728123
"1053","경북","칠곡군",2016,1212,623,589,"6",2015,1261,644,617,422114,435131,0.970084870992873,0.961141950832673,0.99078130127826,0.287126226564388,-0.00264693017780705,-0.156685007427642
"1054","경북","칠곡군",2017,1223,651,572,"6",2016,1286,681,605,445571,460063,0.968499966308962,0.951010886469673,0.981942095562542,0.274479263686371,-0.00495652031371236,-0.2592688831198
"1055","경북","칠곡군",2018,1206,591,615,"6",2017,1285,634,651,447106,462352,0.967025123715265,0.93852140077821,0.970524320167045,0.269734693786261,-0.00795061347388388,-0.392255977140871
"1056","경북","칠곡군",2019,1244,649,595,"6",2018,1303,680,623,462528,478982,0.965647978420901,0.954719877206447,0.988683141829464,0.268956690189567,-0.0030437447168922,-0.174310114461794
"1057","경북","칠곡군",2020,1123,600,523,"6",2019,1166,625,541,417119,431843,0.965904275396382,0.963121783876501,0.997119288535357,0.269227726380242,-0.000775567397983233,-0.0735656505357193
"1058","경북","포항시",2009,4508,2382,2126,"6",2008,4671,2469,2202,462768,488710,0.946917394773997,0.965103832155855,1.01920593864072,0.974138229091035,0.0187092390555005,0.791880963578104
"1059","경북","포항시",2010,4670,2451,2219,"6",2009,4751,2490,2261,470657,487028,0.966385916210156,0.982950957693117,1.01714122816268,0.992230010389732,0.0170080409979509,0.71631972552536
"1060","경북","포항시",2011,4461,2357,2104,"6",2010,4550,2425,2125,441332,457372,0.964930078798003,0.98043956043956,1.01607316631779,1.01080365801709,0.0162468153099388,0.682508756150875
"1061","경북","포항시",2012,4263,2245,2018,"6",2011,4372,2297,2075,407210,420797,0.967711271705834,0.975068618481244,1.00760283257055,1.04687998821247,0.00795925327183476,0.314404380967152
"1062","경북","포항시",2013,4337,2271,2066,"6",2012,4385,2276,2109,422944,435284,0.971650692421499,0.989053591790194,1.0179106540081,1.02543126276765,0.0183661445565227,0.776641911901081
"1063","경북","포항시",2014,4684,2428,2256,"6",2013,4756,2464,2292,465061,480776,0.967313260229296,0.984861227922624,1.01814093573903,1.00717970330774,0.0182711822753577,0.772424021161497
"1064","경북","포항시",2015,4423,2262,2161,"6",2014,4560,2317,2243,441255,454993,0.969806128885499,0.969956140350877,1.00015468191106,1.00236824511904,0.00015504823574515,-0.0322309751734387
"1065","경북","포항시",2016,4355,2275,2080,"6",2015,4465,2331,2134,422114,435131,0.970084870992873,0.975363941769317,1.00544186486595,1.03171181244877,0.00561443626394803,0.210255851443049
"1066","경북","포항시",2017,4712,2432,2280,"6",2016,4862,2515,2347,445571,460063,0.968499966308962,0.969148498560263,1.00066962547637,1.0575194525676,0.000708141967193136,-0.00766449573152168
"1067","경북","포항시",2018,4691,2485,2206,"6",2017,4831,2563,2268,447106,462352,0.967025123715265,0.971020492651625,1.0041316082058,1.04919191422168,0.00433484992226133,0.153421123855542
"1068","경북","포항시",2019,4866,2559,2307,"6",2018,5006,2625,2381,462528,478982,0.965647978420901,0.972033559728326,1.00661274237623,1.05204441677044,0.00695689869645444,0.269883313977066
"1069","경북","포항시",2020,4488,2298,2190,"6",2019,4641,2385,2256,417119,431843,0.965904275396382,0.967032967032967,1.00116853363769,1.07595194656681,0.00125728604209619,0.0167265538496019
"1070","광주","광산구",2009,4689,2432,2257,"6",2008,4765,2464,2301,462768,488710,0.946917394773997,0.98405036726128,1.03921458481196,1.01325070013484,0.0397342055162136,1.72573607159369
"1071","광주","광산구",2010,5399,2796,2603,"6",2009,5447,2841,2606,470657,487028,0.966385916210156,0.991187809803562,1.02566458510765,1.14711987710796,0.0294403557147089,1.26851944600511
"1072","광주","광산구",2011,5118,2683,2435,"6",2010,5184,2708,2476,441332,457372,0.964930078798003,0.987268518518518,1.02315031960486,1.15967117725431,0.026846758389981,1.15332096926278
"1073","광주","광산구",2012,4901,2544,2357,"6",2011,4995,2598,2397,407210,420797,0.967711271705834,0.981181181181181,1.01391934750497,1.2035559048157,0.0167527128807842,0.704978948032009
"1074","광주","광산구",2013,5131,2682,2449,"6",2012,5229,2726,2503,422944,435284,0.971650692421499,0.981258366800535,1.00988799210866,1.21316297193009,0.0119957458929609,0.493691195038866
"1075","광주","광산구",2014,5817,3039,2778,"6",2013,5890,3071,2819,465061,480776,0.967313260229296,0.987606112054329,1.02097857298082,1.25080365801476,0.0262400758243367,1.12637426216912
"1076","광주","광산구",2015,5397,2739,2658,"6",2014,5509,2800,2709,441255,454993,0.969806128885499,0.979669631512071,1.01017059217589,1.22310228779277,0.0124396745585368,0.5134089459669
"1077","광주","광산구",2016,5163,2606,2557,"6",2015,5281,2663,2618,422114,435131,0.970084870992873,0.97765574701761,1.00780434398177,1.22312929682503,0.00954572176659985,0.384869735112212
"1078","광주","광산구",2017,5323,2737,2586,"6",2016,5451,2808,2643,445571,460063,0.968499966308962,0.976518070078885,1.00827888905405,1.19464686884918,0.00989034888597002,0.400176860399946
"1079","광주","광산구",2018,5100,2664,2436,"6",2017,5226,2730,2496,447106,462352,0.967025123715265,0.975889781859931,1.0091669367499,1.14066910307623,0.0104564415204704,0.425320705424669
"1080","광주","광산구",2019,5395,2820,2575,"6",2018,5430,2838,2592,462528,478982,0.965647978420901,0.993554327808471,1.02889909160604,1.16641587103916,0.0337083591078966,1.4580891548179
"1081","광주","광산구",2020,4616,2337,2279,"6",2019,4692,2382,2310,417119,431843,0.965904275396382,0.983802216538789,1.01852972556215,1.10663863309991,0.0205057101678194,0.871673895841577
"1082","광주","남구",2009,1999,1036,963,"6",2008,1888,986,902,462768,488710,0.946917394773997,1.05879237288136,1.11814650224486,0.431965909483802,0.0510352612945293,2.22768924637137
"1083","광주","남구",2010,1931,1029,902,"6",2009,1825,944,881,470657,487028,0.966385916210156,1.05808219178082,1.09488577392587,0.41027754819327,0.0389295026847286,1.68999400032708
"1084","광주","남구",2011,1908,1008,900,"6",2010,1784,943,841,441332,457372,0.964930078798003,1.0695067264574,1.10837743579272,0.432327590113565,0.0468545556389551,2.04199699621426
"1085","광주","남구",2012,1764,923,841,"6",2011,1697,875,822,407210,420797,0.967711271705834,1.03948143783147,1.07416485497696,0.433191719260333,0.0321276010361626,1.38787743759191
"1086","광주","남구",2013,1941,990,951,"6",2012,1866,944,922,422944,435284,0.971650692421499,1.04019292604502,1.07054205195151,0.458926004388288,0.0323735820434567,1.39880304931955
"1087","광주","남구",2014,2074,1054,1020,"6",2013,1944,992,952,465061,480776,0.967313260229296,1.06687242798354,1.10292339808372,0.445963002702871,0.0459000276577997,1.99960021843051
"1088","광주","남구",2015,2076,1076,1000,"6",2014,2005,1047,958,441255,454993,0.969806128885499,1.0354114713217,1.06764789423592,0.47047625522657,0.0318267279540803,1.37451371284628
"1089","광주","남구",2016,1985,1030,955,"6",2015,1950,1004,946,422114,435131,0.970084870992873,1.01794871794872,1.04933985508593,0.470252111988704,0.0232021710593767,0.991441210659906
"1090","광주","남구",2017,2240,1143,1097,"6",2016,2147,1101,1046,445571,460063,0.968499966308962,1.04331625523987,1.07724965568769,0.502725715991391,0.0388353884656828,1.68581377752592
"1091","광주","남구",2018,2195,1123,1072,"6",2017,2101,1068,1033,447106,462352,0.967025123715265,1.04474059971442,1.0803655190473,0.490935035539671,0.0394542489496505,1.71330138494647
"1092","광주","남구",2019,2317,1205,1112,"6",2018,2212,1168,1044,462528,478982,0.965647978420901,1.04746835443038,1.08473105918295,0.500942645634426,0.0424454009545148,1.84615784318687
"1093","광주","남구",2020,2173,1101,1072,"6",2019,2082,1066,1016,417119,431843,0.965904275396382,1.04370797310279,1.08055011214696,0.520954451847075,0.0419629395197381,1.82472860209254
"1094","광주","동구",2009,803,416,387,"6",2008,773,394,379,462768,488710,0.946917394773997,1.03880983182406,1.09704377336103,0.173521073194344,0.0168391397004347,0.708817723573029
"1095","광주","동구",2010,810,460,350,"6",2009,787,436,351,470657,487028,0.966385916210156,1.0292249047014,1.06502473539523,0.17209985190914,0.0111907473319499,0.457935988506191
"1096","광주","동구",2011,742,361,381,"6",2010,707,366,341,441332,457372,0.964930078798003,1.04950495049505,1.08764870487031,0.168127396155275,0.0147361485262267,0.615410247569892
"1097","광주","동구",2012,619,331,288,"6",2011,588,315,273,407210,420797,0.967711271705834,1.05272108843537,1.08784626077537,0.152010019400309,0.0133535118047093,0.553998384329509
"1098","광주","동구",2013,673,350,323,"6",2012,642,348,294,422944,435284,0.971650692421499,1.04828660436137,1.07887187498306,0.159122720738443,0.0125503073370466,0.518322865117182
"1099","광주","동구",2014,608,303,305,"6",2013,693,347,346,465061,480776,0.967313260229296,0.877344877344877,0.906991471549669,0.130735537918682,-0.012159519997979,-0.579200810752417
"1100","광주","동구",2015,530,270,260,"6",2014,596,305,291,441255,454993,0.969806128885499,0.889261744966443,0.916947953286686,0.120111953405627,-0.0099755435650715,-0.482196254218768
"1101","광주","동구",2016,496,263,233,"6",2015,553,286,267,422114,435131,0.970084870992873,0.896925858951175,0.924584936607845,0.117503802290377,-0.00886155669854799,-0.432716873240484
"1102","광주","동구",2017,560,300,260,"6",2016,616,328,288,445571,460063,0.968499966308962,0.909090909090909,0.938658689432416,0.125681428997848,-0.00770946356873478,-0.381544945989322
"1103","광주","동구",2018,578,276,302,"6",2017,661,329,332,447106,462352,0.967025123715265,0.874432677760968,0.904250216790066,0.129275831681973,-0.0123781328578328,-0.588910825569033
"1104","광주","동구",2019,587,292,295,"6",2018,674,339,335,462528,478982,0.965647978420901,0.870919881305638,0.901902039633356,0.126911235644112,-0.0124497333642979,-0.592091068392434
"1105","광주","동구",2020,571,295,276,"6",2019,658,335,323,417119,431843,0.965904275396382,0.867781155015198,0.898413204206061,0.136891390706249,-0.0139063577536241,-0.656789203772298
"1106","광주","북구",2009,4955,2583,2372,"6",2008,5235,2727,2508,462768,488710,0.946917394773997,0.946513849092646,0.99957383222277,1.07073090619922,-0.000456311010306185,-0.0593854039723816
"1107","광주","북구",2010,4979,2630,2349,"6",2009,5206,2756,2450,470657,487028,0.966385916210156,0.956396465616596,0.989663083426613,1.05788291685877,-0.01093524745598,-0.524822927720576
"1108","광주","북구",2011,4554,2408,2146,"6",2010,4693,2444,2249,441332,457372,0.964930078798003,0.970381419134882,1.00564946668848,1.03187622923332,0.00582955038368535,0.219810464521664
"1109","광주","북구",2012,3765,1960,1805,"6",2011,3874,2004,1870,407210,420797,0.967711271705834,0.971863706763036,1.00429098552286,0.924584366788635,0.00396737813255569,0.137099318609884
"1110","광주","북구",2013,3856,2003,1853,"6",2012,3934,2049,1885,422944,435284,0.971650692421499,0.980172852058973,1.00877080591198,0.911704622834229,0.00799638429593738,0.316053610543278
"1111","광주","북구",2014,4308,2305,2003,"6",2013,4394,2336,2058,465061,480776,0.967313260229296,0.980427856167501,1.01355775473924,0.926330094331711,0.0125589562265281,0.518707018387342
"1112","광주","북구",2015,3986,2051,1935,"6",2014,4078,2093,1985,441255,454993,0.969806128885499,0.977439921530162,1.00787146257101,0.903332540141188,0.00711054827890067,0.276707888355341
"1113","광주","북구",2016,3883,2076,1807,"6",2015,3967,2121,1846,422114,435131,0.970084870992873,0.97882530879758,1.00900997228805,0.919893678011153,0.00828821654683687,0.329015773346031
"1114","광주","북구",2017,3957,2018,1939,"6",2016,4038,2053,1985,445571,460063,0.968499966308962,0.979940564635958,1.01181269873514,0.88807395454372,0.0104905500795452,0.426835687728139
"1115","광주","북구",2018,3978,2058,1920,"6",2017,4028,2085,1943,447106,462352,0.967025123715265,0.987586891757696,1.02126290986467,0.889721900399458,0.0189180765728189,0.801156792039353
"1116","광주","북구",2019,4081,2110,1971,"6",2018,4217,2183,2034,462528,478982,0.965647978420901,0.967749585013042,1.00217636927649,0.88232496194825,0.00192026493906576,0.0461737461007028
"1117","광주","북구",2020,3635,1904,1731,"6",2019,3733,1946,1787,417119,431843,0.965904275396382,0.973747656040718,1.00812024632681,0.871453949592323,0.00707642073315935,0.275192062730881
"1118","광주","서구",2009,3423,1863,1560,"6",2008,3710,1988,1722,462768,488710,0.946917394773997,0.922641509433962,0.974363249134494,0.739679493828441,-0.018962978903603,-0.881386541372394
"1119","광주","서구",2010,3339,1788,1551,"6",2009,3554,1882,1672,470657,487028,0.966385916210156,0.939504783342712,0.972183852830903,0.70943383398101,-0.0197337159327522,-0.915619971088091
"1120","광주","서구",2011,3064,1571,1493,"6",2010,3278,1682,1596,441332,457372,0.964930078798003,0.934716290420988,0.968688105966547,0.694261916199143,-0.0217386555514893,-1.00467234164569
"1121","광주","서구",2012,2893,1482,1411,"6",2011,3139,1636,1503,407210,420797,0.967711271705834,0.921631092704683,0.952382306222471,0.710444242528425,-0.0338297163867269,-1.54171476420615
"1122","광주","서구",2013,2924,1520,1404,"6",2012,3143,1632,1511,422944,435284,0.971650692421499,0.93032134902959,0.957464813523766,0.691344480593175,-0.0294064664013455,-1.34524954745555
"1123","광주","서구",2014,3174,1665,1509,"6",2013,3381,1758,1623,465061,480776,0.967313260229296,0.938775510204082,0.970497923270017,0.682491114068907,-0.0201349052147923,-0.933439388827204
"1124","광주","서구",2015,2852,1455,1397,"6",2014,2997,1512,1485,441255,454993,0.969806128885499,0.951618284951618,0.981245897100297,0.646338285118582,-0.0121214947071313,-0.577511860990799
"1125","광주","서구",2016,2724,1387,1337,"6",2015,2822,1440,1382,422114,435131,0.970084870992873,0.965272856130404,0.995039593950636,0.645323301288278,-0.00320106560750584,-0.18129775544432
"1126","광주","서구",2017,2820,1472,1348,"6",2016,2925,1527,1398,445571,460063,0.968499966308962,0.964102564102564,0.995459574228839,0.632895767453447,-0.00287361625300448,-0.166753606092695
"1127","광주","서구",2018,2794,1445,1349,"6",2017,2908,1495,1413,447106,462352,0.967025123715265,0.960797799174691,0.993560328074364,0.624907739999016,-0.00402420082938444,-0.217858528702875
"1128","광주","서구",2019,2803,1472,1331,"6",2018,2943,1532,1411,462528,478982,0.965647978420901,0.952429493713897,0.986311280091303,0.606017365435174,-0.00829560197524878,-0.407579153746563
"1129","광주","서구",2020,2547,1313,1234,"6",2019,2648,1369,1279,417119,431843,0.965904275396382,0.961858006042296,0.995810900254659,0.610617114060975,-0.00255793599701341,-0.152732198728846
"1130","대구","남구",2009,1079,576,503,"6",2008,1231,649,582,462768,488710,0.946917394773997,0.876523151909017,0.925659573629671,0.233162189261142,-0.0173333765631125,-0.809005333414473
"1131","대구","남구",2010,1102,568,534,"6",2009,1234,642,592,470657,487028,0.966385916210156,0.893030794165316,0.924093345304002,0.23414078617762,-0.0177728438066342,-0.828524923656631
"1132","대구","남구",2011,954,497,457,"6",2010,1069,556,513,441332,457372,0.964930078798003,0.892422825070159,0.924857504889718,0.216163795056783,-0.0162430869130744,-0.760578499497417
"1133","대구","남구",2012,894,476,418,"6",2011,1007,530,477,407210,420797,0.967711271705834,0.887785501489573,0.917407420422651,0.219542742074114,-0.0181326013953856,-0.844504091211103
"1134","대구","남구",2013,857,475,382,"6",2012,975,529,446,422944,435284,0.971650692421499,0.878974358974359,0.904619701123068,0.202627298176591,-0.0193266522607084,-0.897539633593335
"1135","대구","남구",2014,938,495,443,"6",2013,1057,557,500,465061,480776,0.967313260229296,0.887417218543046,0.917404169909435,0.201693971328492,-0.0166590809861395,-0.779055494015433
"1136","대구","남구",2015,832,445,387,"6",2014,930,504,426,441255,454993,0.969806128885499,0.894623655913979,0.922476801566597,0.188553104214117,-0.014617239713225,-0.688364081687561
"1137","대구","남구",2016,779,382,397,"6",2015,876,439,437,422114,435131,0.970084870992873,0.889269406392694,0.916692377113906,0.184547302387507,-0.0153741970719444,-0.72198546687792
"1138","대구","남구",2017,731,386,345,"6",2016,833,449,384,445571,460063,0.968499966308962,0.877551020408163,0.906092979799046,0.164059151066833,-0.0154063060133845,-0.723411633194658
"1139","대구","남구",2018,732,389,343,"6",2017,857,464,393,447106,462352,0.967025123715265,0.85414235705951,0.883268010429693,0.163719565382706,-0.0191113105987091,-0.887974913887248
"1140","대구","남구",2019,737,371,366,"6",2018,850,419,431,462528,478982,0.965647978420901,0.867058823529412,0.897903628346316,0.159341704718417,-0.0162682099048631,-0.761694374486059
"1141","대구","남구",2020,720,353,367,"6",2019,809,407,402,417119,431843,0.965904275396382,0.889987639060569,0.921403561129637,0.172612611748686,-0.0135667365875592,-0.641704425334602
"1142","대구","달서구",2009,5990,3171,2819,"6",2008,5932,3156,2776,462768,488710,0.946917394773997,1.00977747808496,1.06638391443424,1.29438509144971,0.0859263491557475,3.77742872796834
"1143","대구","달서구",2010,6108,3217,2891,"6",2009,6021,3168,2853,470657,487028,0.966385916210156,1.01444942700548,1.04973531793987,1.2977603647667,0.0645445243514329,2.82772322667708
"1144","대구","달서구",2011,5784,3043,2741,"6",2010,5620,2956,2664,441332,457372,0.964930078798003,1.02918149466192,1.0665866027764,1.31057797757697,0.0872669352004104,3.83697284794981
"1145","대구","달서구",2012,5386,2812,2574,"6",2011,5259,2745,2514,407210,420797,0.967711271705834,1.02414907777144,1.05832091421868,1.32265907025859,0.0771386861771094,3.38711162684692
"1146","대구","달서구",2013,5330,2746,2584,"6",2012,5225,2695,2530,422944,435284,0.971650692421499,1.0200956937799,1.04985845400642,1.26021411818113,0.0628323276495767,2.75167346750416
"1147","대구","달서구",2014,5906,2978,2928,"6",2013,5900,2987,2913,465061,480776,0.967313260229296,1.00101694915254,1.03484257924393,1.26994093247983,0.0442480175750423,1.92622373732367
"1148","대구","달서구",2015,5526,2906,2620,"6",2014,5391,2841,2550,441255,454993,0.969806128885499,1.02504173622704,1.05695530858835,1.25233708399905,0.0713272450757989,3.1289878401797
"1149","대구","달서구",2016,5193,2742,2451,"6",2015,5212,2759,2453,422114,435131,0.970084870992873,0.996354566385265,1.02707979082851,1.23023638164098,0.0333145438844635,1.44059726684251
"1150","대구","달서구",2017,5415,2796,2619,"6",2016,5437,2778,2659,445571,460063,0.968499966308962,0.995953650910429,1.02834660356891,1.21529453218455,0.0344494723233038,1.49100679885406
"1151","대구","달서구",2018,5249,2636,2613,"6",2017,5200,2623,2577,447106,462352,0.967025123715265,1.00942307692308,1.04384369357946,1.17399453373473,0.0514722566010275,2.24709904185974
"1152","대구","달서구",2019,5343,2677,2666,"6",2018,5304,2667,2637,462528,478982,0.965647978420901,1.00735294117647,1.043188577709,1.15517330842673,0.0498902921983503,2.17683374365346
"1153","대구","달서구",2020,4632,2364,2268,"6",2019,4665,2393,2272,417119,431843,0.965904275396382,0.992926045016077,1.02797561860735,1.11047446891654,0.0310662102156052,1.34073418810181
"1154","대구","달성군",2009,1877,1045,832,"6",2008,1971,1087,884,462768,488710,0.946917394773997,0.952308472856418,1.00569329290197,0.405602807454275,0.00230921558469959,0.0634495666291128
"1155","대구","달성군",2010,1945,1021,924,"6",2009,2060,1068,992,470657,487028,0.966385916210156,0.944174757281553,0.977016263838252,0.41325211353491,-0.0094980775457709,-0.460988891921144
"1156","대구","달성군",2011,1797,935,862,"6",2010,1915,988,927,441332,457372,0.964930078798003,0.938381201044386,0.972486216009882,0.407176456726455,-0.0112029650762334,-0.536714003392286
"1157","대구","달성군",2012,1772,930,842,"6",2011,1868,994,874,407210,420797,0.967711271705834,0.948608137044968,0.980259468687192,0.435156307556298,-0.00859021671528108,-0.420664904936223
"1158","대구","달성군",2013,1761,917,844,"6",2012,1863,958,905,422944,435284,0.971650692421499,0.94524959742351,0.972828615052809,0.416367178633578,-0.0113132728900287,-0.541613488752189
"1159","대구","달성군",2014,1921,986,935,"6",2013,2039,1044,995,465061,480776,0.967313260229296,0.94212849435998,0.97396420900573,0.413064092667414,-0.0107544503839264,-0.516792557276612
"1160","대구","달성군",2015,1896,986,910,"6",2014,2021,1045,976,441255,454993,0.969806128885499,0.938149430974765,0.967357704836209,0.429683516334093,-0.0140258561671932,-0.662096903269457
"1161","대구","달성군",2016,1916,955,961,"6",2015,1889,954,935,422114,435131,0.970084870992873,1.01429327686607,1.04557168882342,0.453905816912019,0.0206852546434541,0.879648630355459
"1162","대구","달성군",2017,2687,1377,1310,"6",2016,2632,1368,1264,445571,460063,0.968499966308962,1.02089665653495,1.05410086943594,0.603046428066459,0.0326253360686328,1.40998507820951
"1163","대구","달성군",2018,2910,1510,1400,"6",2017,2987,1531,1456,447106,462352,0.967025123715265,0.974221627050552,1.0074418990353,0.650852370578789,0.00484357762873331,0.176017020413362
"1164","대구","달성군",2019,3044,1569,1475,"6",2018,3162,1630,1532,462528,478982,0.965647978420901,0.962681846932321,0.996928351164334,0.658122319081223,-0.00202152065513159,-0.128906514727385
"1165","대구","달성군",2020,2880,1481,1399,"6",2019,2987,1533,1454,417119,431843,0.965904275396382,0.964178105122196,0.998212897159527,0.690450446994743,-0.00123390595503047,-0.0939234381925438
"1166","대구","동구",2009,2902,1576,1326,"6",2008,2992,1622,1370,462768,488710,0.946917394773997,0.969919786096257,1.02429186690329,0.627096082702348,0.0152333345765799,0.637493504331514
"1167","대구","동구",2010,2923,1465,1458,"6",2009,2976,1512,1464,470657,487028,0.966385916210156,0.982190860215054,1.01635469199187,0.621046749543723,0.0101570283013392,0.412021822659956
"1168","대구","동구",2011,2814,1469,1345,"6",2010,2864,1482,1382,441332,457372,0.964930078798003,0.982541899441341,1.01825191382289,0.637615219381327,0.0116376980363128,0.477787967774762
"1169","대구","동구",2012,2567,1364,1203,"6",2011,2597,1385,1212,407210,420797,0.967711271705834,0.988448209472468,1.02142884801794,0.630387269467842,0.0135084729898719,0.560881215490199
"1170","대구","동구",2013,2592,1385,1207,"6",2012,2627,1393,1234,422944,435284,0.971650692421499,0.986676817662733,1.01546453407426,0.612847090867822,0.00947739471903849,0.381834887827199
"1171","대구","동구",2014,3072,1524,1548,"6",2013,2993,1481,1512,465061,480776,0.967313260229296,1.02639492148346,1.06107810539076,0.660558507378602,0.0403456621304339,1.75289482514445
"1172","대구","동구",2015,2929,1485,1444,"6",2014,2905,1463,1442,441255,454993,0.969806128885499,1.00826161790017,1.03965275931888,0.663788512311475,0.0263210461173252,1.12997067797535
"1173","대구","동구",2016,2890,1518,1372,"6",2015,2856,1491,1365,422114,435131,0.970084870992873,1.01190476190476,1.04310951769517,0.684649170603202,0.0295148955351053,1.27183024282173
"1174","대구","동구",2017,3072,1578,1494,"6",2016,3123,1633,1490,445571,460063,0.968499966308962,0.983669548511047,1.01566296616395,0.689452410502479,0.0107988697773547,0.440530164969722
"1175","대구","동구",2018,3015,1579,1436,"6",2017,3029,1574,1455,447106,462352,0.967025123715265,0.995378012545394,1.02931970238912,0.674336734465652,0.0197713523645815,0.839056303468895
"1176","대구","동구",2019,3154,1644,1510,"6",2018,3210,1689,1521,462528,478982,0.965647978420901,0.982554517133956,1.01750797297862,0.681904663069047,0.0119387684150102,0.491160455742534
"1177","대구","동구",2020,2723,1361,1362,"6",2019,2785,1419,1366,417119,431843,0.965904275396382,0.977737881508079,1.01225132387662,0.652811308043987,0.00799780276516914,0.316116613960674
"1178","대구","북구",2009,4987,2708,2279,"6",2008,5421,2916,2505,462768,488710,0.946917394773997,0.919940970300683,0.971511322294641,1.07764581820696,-0.0307007043954258,-1.40273504994223
"1179","대구","북구",2010,5034,2655,2379,"6",2009,5328,2818,2510,470657,487028,0.966385916210156,0.94481981981982,0.977683763775334,1.06956870927236,-0.0238687479746336,-1.09928355986644
"1180","대구","북구",2011,4559,2390,2169,"6",2010,4875,2565,2310,441332,457372,0.964930078798003,0.935179487179487,0.969168137389213,1.03300916316968,-0.031849596594531,-1.45376480310252
"1181","대구","북구",2012,4205,2215,1990,"6",2011,4408,2304,2104,407210,420797,0.967711271705834,0.953947368421053,0.98577684926567,1.03263672306672,-0.0146873477659821,-0.691478034963185
"1182","대구","북구",2013,4109,2121,1988,"6",2012,4326,2236,2090,422944,435284,0.971650692421499,0.949838187702265,0.97755108405792,0.971523416811682,-0.0218096475197679,-1.00782555534184
"1183","대구","북구",2014,4452,2303,2149,"6",2013,4715,2441,2274,465061,480776,0.967313260229296,0.944220572640509,0.976126981260122,0.957293774365083,-0.0228534922149866,-1.05418946761854
"1184","대구","북구",2015,4014,2085,1929,"6",2014,4258,2225,2033,441255,454993,0.969806128885499,0.942696101456083,0.97204593101451,0.90967807730224,-0.0254292037274951,-1.16859351945021
"1185","대구","북구",2016,3662,1862,1800,"6",2015,3947,2011,1936,422114,435131,0.970084870992873,0.927793260704332,0.956404216215375,0.86753815320032,-0.037821005751834,-1.71899380853368
"1186","대구","북구",2017,3816,1988,1828,"6",2016,4063,2126,1937,445571,460063,0.968499966308962,0.939207482156042,0.969754790736281,0.856429166171048,-0.0259028793503961,-1.1896325256629
"1187","대구","북구",2018,3807,1943,1864,"6",2017,4089,2118,1971,447106,462352,0.967025123715265,0.931034482758621,0.962782103511055,0.851475936355137,-0.031690143262093,-1.44668244654963
"1188","대구","북구",2019,3864,1967,1897,"6",2018,4182,2136,2046,462528,478982,0.965647978420901,0.923959827833572,0.956828832536366,0.835408883354089,-0.0360655768038871,-1.64102382494955
"1189","대구","북구",2020,3458,1754,1704,"6",2019,3731,1879,1852,417119,431843,0.965904275396382,0.926829268292683,0.959545673314611,0.829020015870771,-0.0335374465507629,-1.52873316541293
"1190","대구","서구",2009,1606,856,750,"6",2008,1643,873,770,462768,488710,0.946917394773997,0.977480219111382,1.03227612514678,0.347042146388687,0.0112011757480471,0.458399182093639
"1191","대구","서구",2010,1514,794,720,"6",2009,1617,843,774,470657,487028,0.966385916210156,0.936301793444651,0.968869452399011,0.321677994803009,-0.0100140121294058,-0.48390489263057
"1192","대구","서구",2011,1332,693,639,"6",2010,1382,728,654,441332,457372,0.964930078798003,0.963820549927641,0.998850145834667,0.301813600645319,-0.000347041625856297,-0.054532041993949
"1193","대구","서구",2012,1158,609,549,"6",2011,1226,644,582,407210,420797,0.967711271705834,0.944535073409462,0.97605050289895,0.284374155840967,-0.00681061802092689,-0.341621386172666
"1194","대구","서구",2013,1136,570,566,"6",2012,1227,624,603,422944,435284,0.971650692421499,0.925835370823146,0.95284795044588,0.268593478096391,-0.0126647329891145,-0.601640596009116
"1195","대구","서구",2014,1204,600,604,"6",2013,1268,636,632,465061,480776,0.967313260229296,0.949526813880126,0.981612527109415,0.258890769167916,-0.00476034699969779,-0.250555554054987
"1196","대구","서구",2015,1080,548,532,"6",2014,1160,586,574,441255,454993,0.969806128885499,0.931034482758621,0.960021240357147,0.244756433354863,-0.00978505862013593,-0.473735582513985
"1197","대구","서구",2016,1028,498,530,"6",2015,1070,522,548,422114,435131,0.970084870992873,0.960747663551402,0.990374855107353,0.243536106359893,-0.00234407031030517,-0.143233036657175
"1198","대구","서구",2017,991,509,482,"6",2016,1053,543,510,445571,460063,0.968499966308962,0.941120607787274,0.971730139933786,0.222411243101548,-0.00628753471963353,-0.318387864552395
"1199","대구","서구",2018,1018,531,487,"6",2017,1080,550,530,447106,462352,0.967025123715265,0.942592592592593,0.97473433675766,0.227686499398353,-0.00575265041862602,-0.294630184005004
"1200","대구","서구",2019,1024,509,515,"6",2018,1079,546,533,462528,478982,0.965647978420901,0.94902687673772,0.982787618206004,0.22139200221392,-0.00381068366824319,-0.208374846911833
"1201","대구","서구",2020,869,424,445,"6",2019,904,456,448,417119,431843,0.965904275396382,0.961283185840708,0.995215789314342,0.208333832791122,-0.000996712949023451,-0.0833881585924967
"1202","대구","수성구",2009,3890,2075,1815,"6",2008,4337,2290,2047,462768,488710,0.946917394773997,0.896933364076551,0.947213948150804,0.840593990941465,-0.0443716379899591,-2.00994986726202
"1203","대구","수성구",2010,4270,2302,1968,"6",2009,4530,2463,2067,470657,487028,0.966385916210156,0.942604856512141,0.975391756751509,0.907242429200033,-0.0223256423831061,-1.0307442334638
"1204","대구","수성구",2011,3937,2079,1858,"6",2010,4277,2243,2034,441332,457372,0.964930078798003,0.920505026888006,0.953960340872225,0.892072181486953,-0.0410706991530298,-1.86333376683335
"1205","대구","수성구",2012,3731,1986,1745,"6",2011,4052,2166,1886,407210,420797,0.967711271705834,0.920779861796644,0.951502673078859,0.916234866530783,-0.0444349418586911,-2.01276160259977
"1206","대구","수성구",2013,3735,1982,1753,"6",2012,4031,2130,1901,422944,435284,0.971650692421499,0.926569089555941,0.953603076478845,0.883095634410229,-0.0409729206115976,-1.85899078771177
"1207","대구","수성구",2014,4119,2146,1973,"6",2013,4478,2312,2166,465061,480776,0.967313260229296,0.919830281375614,0.950912511173034,0.885690264287911,-0.0434763109523857,-1.97018258730252
"1208","대구","수성구",2015,3821,1990,1831,"6",2014,4151,2174,1977,441255,454993,0.969806128885499,0.920501084076126,0.949159895631888,0.865939196156417,-0.0440244391090309,-1.99452851336555
"1209","대구","수성구",2016,3558,1874,1684,"6",2015,3869,2021,1848,422114,435131,0.970084870992873,0.919617472215043,0.947976305695627,0.842900259171693,-0.0438507854122253,-1.98681542654134
"1210","대구","수성구",2017,3571,1852,1719,"6",2016,3838,1972,1866,445571,460063,0.968499966308962,0.930432516935904,0.960694423647596,0.80144354098449,-0.0315012002923072,-1.438290263961
"1211","대구","수성구",2018,3553,1778,1775,"6",2017,3887,1961,1926,447106,462352,0.967025123715265,0.914072549524055,0.945241780288222,0.794666141809772,-0.0435145031907307,-1.97187895228515
"1212","대구","수성구",2019,3675,1919,1756,"6",2018,4015,2076,1939,462528,478982,0.965647978420901,0.915317559153176,0.947879123249417,0.794546492320465,-0.0414124597988431,-1.87851357344126
"1213","대구","수성구",2020,3323,1689,1634,"6",2019,3629,1842,1787,417119,431843,0.965904275396382,0.915679250482227,0.948002067913464,0.796655151167892,-0.0414244204468171,-1.87904482338292
"1214","대구","중구",2009,754,401,353,"6",2008,505,272,233,462768,488710,0.946917394773997,1.49306930693069,1.5767682747945,0.162932614182485,0.0939743627897887,4.13489320504954
"1215","대구","중구",2010,760,405,355,"6",2009,538,285,253,470657,487028,0.966385916210156,1.41263940520446,1.46177565453806,0.161476404260427,0.0745658722698107,3.27283627645367
"1216","대구","중구",2011,717,359,358,"6",2010,473,239,234,441332,457372,0.964930078798003,1.51585623678647,1.5709493051297,0.162462726473494,0.092757980789518,4.08086579214624
"1217","대구","중구",2012,626,330,296,"6",2011,430,227,203,407210,420797,0.967711271705834,1.45581395348837,1.50438875318889,0.153729034159279,0.0775391958685305,3.40490085955948
"1218","대구","중구",2013,701,346,355,"6",2012,476,240,236,422944,435284,0.971650692421499,1.47268907563025,1.51565689925058,0.165742982522509,0.0854665124401005,3.75700439737251
"1219","대구","중구",2014,735,391,344,"6",2013,518,285,233,465061,480776,0.967313260229296,1.41891891891892,1.46686598567105,0.158043783503669,0.073785266764622,3.23816452371971
"1220","대구","중구",2015,725,380,345,"6",2014,507,255,252,441255,454993,0.969806128885499,1.42998027613412,1.47450117455687,0.164304087205811,0.077962482363652,3.42370175783258
"1221","대구","중구",2016,686,370,316,"6",2015,478,266,212,422114,435131,0.970084870992873,1.43514644351464,1.47940297434572,0.162515339458061,0.0779103371129994,3.42138564908769
"1222","대구","중구",2017,735,385,350,"6",2016,540,271,269,445571,460063,0.968499966308962,1.36111111111111,1.4053806489002,0.164956875559675,0.0668703252549307,2.9310271276853
"1223","대구","중구",2018,797,416,381,"6",2017,584,292,292,447106,462352,0.967025123715265,1.36472602739726,1.41126222466077,0.178257504931716,0.0733105780406958,3.2170805191205
"1224","대구","중구",2019,787,436,351,"6",2018,611,350,261,462528,478982,0.965647978420901,1.28805237315876,1.33387362884048,0.170151861076519,0.0568092193115777,2.48414816618766
"1225","대구","중구",2020,717,361,356,"6",2019,537,260,277,417119,431843,0.965904275396382,1.33519553072626,1.38232697042192,0.171893392533066,0.0657194800027123,2.87991062677064
"1226","대전","대덕구",2009,2186,1140,1046,"6",2008,2319,1192,1127,462768,488710,0.946917394773997,0.942647692971108,0.995490945856045,0.47237492652906,-0.00212996411996623,-0.133723192259593
"1227","대전","대덕구",2010,2264,1141,1123,"6",2009,2321,1137,1184,470657,487028,0.966385916210156,0.975441619991383,1.00937069097275,0.481029709533694,0.00450758075675366,0.161093220379637
"1228","대전","대덕구",2011,2074,1093,981,"6",2010,2125,1116,1009,441332,457372,0.964930078798003,0.976,1.01147225218203,0.469940996800595,0.00539128162597132,0.200344106806437
"1229","대전","대덕구",2012,1747,916,831,"6",2011,1767,941,826,407210,420797,0.967711271705834,0.988681380871534,1.02166979943174,0.429016969131406,0.00929671167389051,0.373809582057577
"1230","대전","대덕구",2013,1763,927,836,"6",2012,1783,930,853,422944,435284,0.971650692421499,0.988782950084128,1.01763211594069,0.416840054475297,0.00734977216923235,0.287333372698588
"1231","대전","대덕구",2014,1929,997,932,"6",2013,1976,1021,955,465061,480776,0.967313260229296,0.976214574898785,1.00920210136205,0.414784297113712,0.00381688714542898,0.130415037933328
"1232","대전","대덕구",2015,1721,849,872,"6",2014,1786,884,902,441255,454993,0.969806128885499,0.963605823068309,0.993606654327586,0.390023909077518,-0.00249355767123857,-0.149872739785943
"1233","대전","대덕구",2016,1575,834,741,"6",2015,1610,854,756,422114,435131,0.970084870992873,0.978260869565217,1.00842812708127,0.373121952837385,0.00314471923532455,0.100559702017901
"1234","대전","대덕구",2017,1553,831,722,"6",2016,1600,841,759,445571,460063,0.968499966308962,0.970625,1.00219414947337,0.348541534345817,0.000764752224033274,-0.00515006710615283
"1235","대전","대덕구",2018,1510,792,718,"6",2017,1556,804,752,447106,462352,0.967025123715265,0.970437017994859,1.0035282374738,0.337727518753942,0.00119158288759963,0.0138082506716156
"1236","대전","대덕구",2019,1376,716,660,"6",2018,1464,754,710,462528,478982,0.965647978420901,0.939890710382514,0.973326441297472,0.297495502974955,-0.00793526376234051,-0.391574196907921
"1237","대전","대덕구",2020,1269,661,608,"6",2019,1307,683,624,417119,431843,0.965904275396382,0.970925784238715,1.00519876448447,0.304229728207058,0.00158161870612396,0.031132270765469
"1238","대전","동구",2009,2150,1142,1008,"6",2008,2305,1244,1061,462768,488710,0.946917394773997,0.932754880694143,0.985043559070711,0.464595650520347,-0.00694869740301219,-0.347754386979728
"1239","대전","동구",2010,2165,1116,1049,"6",2009,2286,1196,1090,470657,487028,0.966385916210156,0.947069116360455,0.980011298254992,0.459995283189244,-0.00919470851978044,-0.447514306120292
"1240","대전","동구",2011,2111,1076,1035,"6",2010,2305,1191,1114,441332,457372,0.964930078798003,0.915835140997831,0.94912073021775,0.478324707929631,-0.0243368118582678,-1.12007331234601
"1241","대전","동구",2012,2070,1077,993,"6",2011,2147,1097,1050,407210,420797,0.967711271705834,0.96413600372613,0.996305439355478,0.508337221581002,-0.00187808269299895,-0.12253550462988
"1242","대전","동구",2013,2170,1115,1055,"6",2012,2260,1173,1087,422944,435284,0.971650692421499,0.960176991150443,0.988191536978723,0.513070288265113,-0.00605857152629431,-0.308218124303489
"1243","대전","동구",2014,2378,1224,1154,"6",2013,2481,1274,1207,465061,480776,0.967313260229296,0.958484482063684,0.990872886242127,0.511330771662212,-0.00466697412086211,-0.246408258980165
"1244","대전","동구",2015,2140,1105,1035,"6",2014,2266,1153,1113,441255,454993,0.969806128885499,0.944395410414828,0.973798146130636,0.484980340166117,-0.0127073840025471,-0.603535004108672
"1245","대전","동구",2016,1971,1035,936,"6",2015,2065,1078,987,422114,435131,0.970084870992873,0.954479418886199,0.983913312563361,0.466935472407928,-0.00751144499770586,-0.372749657093958
"1246","대전","동구",2017,1953,999,954,"6",2016,2068,1054,1014,445571,460063,0.968499966308962,0.944390715667311,0.975106606628462,0.438313983629994,-0.0109111224147474,-0.523751378187873
"1247","대전","동구",2018,1931,960,971,"6",2017,2051,1034,1017,447106,462352,0.967025123715265,0.941491955143832,0.973596168346345,0.431888634909842,-0.0114035148092862,-0.545621717607785
"1248","대전","동구",2019,1869,929,940,"6",2018,1940,978,962,462528,478982,0.965647978420901,0.96340206185567,0.997674187058411,0.404083644665836,-0.00093982297024837,-0.0808613057019924
"1249","대전","동구",2020,1637,803,834,"6",2019,1766,880,886,417119,431843,0.965904275396382,0.926953567383918,0.95967436007416,0.39245395198972,-0.0158259567554104,-0.742051044094825
"1250","대전","서구",2009,5098,2655,2443,"6",2008,5271,2737,2534,462768,488710,0.946917394773997,0.967178903433883,1.02139733494359,1.10163191923383,0.0235719871603911,1.00786714197371
"1251","대전","서구",2010,5198,2641,2557,"6",2009,5336,2725,2611,470657,487028,0.966385916210156,0.974137931034483,1.00802165542181,1.10441361756013,0.00885922548322008,0.354377983219726
"1252","대전","서구",2011,5017,2593,2424,"6",2010,5114,2650,2464,441332,457372,0.964930078798003,0.981032459913962,1.0166876144394,1.13678591173991,0.0189702449952554,0.803473929993435
"1253","대전","서구",2012,4427,2265,2162,"6",2011,4583,2350,2233,407210,420797,0.967711271705834,0.965961160811695,0.998191494771933,1.08715404827976,-0.00196612378002775,-0.12644598025374
"1254","대전","서구",2013,4487,2332,2155,"6",2012,4632,2416,2216,422944,435284,0.971650692421499,0.968696027633851,0.996959128614127,1.06089695089657,-0.00322605118134101,-0.182407526810484
"1255","대전","서구",2014,4873,2428,2445,"6",2013,5072,2537,2535,465061,480776,0.967313260229296,0.960764984227129,0.993230449461,1.04781953335154,-0.00709326728677414,-0.354175673057334
"1256","대전","서구",2015,4476,2316,2160,"6",2014,4642,2389,2253,441255,454993,0.969806128885499,0.964239551917277,0.9942601136429,1.0143794404596,-0.00582242271121722,-0.297729223994248
"1257","대전","서구",2016,4253,2210,2043,"6",2015,4370,2274,2096,422114,435131,0.970084870992873,0.973226544622426,1.00323855543313,1.00754772407454,0.00326299915594027,0.105813280341037
"1258","대전","서구",2017,4454,2299,2155,"6",2016,4640,2373,2267,445571,460063,0.968499966308962,0.959913793103448,0.99113456530284,0.99961622277931,-0.00886203234527177,-0.43273799979607
"1259","대전","서구",2018,4459,2294,2165,"6",2017,4693,2409,2284,447106,462352,0.967025123715265,0.950138504155125,0.982537558594897,0.997302653062137,-0.017415339142251,-0.812645823083631
"1260","대전","서구",2019,4556,2339,2217,"6",2018,4777,2446,2331,462528,478982,0.965647978420901,0.953736654804271,0.987664942212059,0.985021447350214,-0.0121502964754265,-0.578791134301058
"1261","대전","서구",2020,4192,2171,2021,"6",2019,4357,2242,2115,417119,431843,0.965904275396382,0.962129905898554,0.996092397979831,1.00498898395901,-0.00392709698396543,-0.213545517206665
"1262","대전","유성구",2009,3563,1859,1704,"6",2008,3713,1941,1772,462768,488710,0.946917394773997,0.959601400484783,1.01339504985418,0.769932233862324,0.0103132806569248,0.418962003072405
"1263","대전","유성구",2010,3738,1989,1749,"6",2009,3787,2007,1780,470657,487028,0.966385916210156,0.987060998151571,1.02139422935973,0.794208946217734,0.0169914883549333,0.715584515304595
"1264","대전","유성구",2011,3743,1921,1822,"6",2010,3791,1957,1834,441332,457372,0.964930078798003,0.9873384331311,1.02322277523052,0.848114344756329,0.019695568798059,0.835690263821086
"1265","대전","유성구",2012,3627,1932,1695,"6",2011,3667,1973,1694,407210,420797,0.967711271705834,0.989091900736297,1.0220940167337,0.890695218683235,0.0196790350662172,0.834955893568275
"1266","대전","유성구",2013,3957,2087,1870,"6",2012,3977,2075,1902,422944,435284,0.971650692421499,0.994971083731456,1.02400079729459,0.935584852841038,0.0224547824049265,0.958244833679453
"1267","대전","유성구",2014,4268,2193,2075,"6",2013,4317,2196,2121,465061,480776,0.967313260229296,0.988649525133194,1.02205724430867,0.917729072100219,0.020242574352488,0.85998632783959
"1268","대전","유성구",2015,4122,2124,1998,"6",2014,4211,2205,2006,441255,454993,0.969806128885499,0.978864877701259,1.00934078322043,0.934153720637727,0.00872572739903075,0.348448467562069
"1269","대전","유성구",2016,3830,1930,1900,"6",2015,3926,1973,1953,422114,435131,0.970084870992873,0.97554763117677,1.00563121882141,0.907337828169641,0.00510941785536297,0.187824708859287
"1270","대전","유성구",2017,4067,2108,1959,"6",2016,4147,2157,1990,445571,460063,0.968499966308962,0.980708946226188,1.01260607159725,0.912761378096869,0.0115063352834941,0.47195329603096
"1271","대전","유성구",2018,4099,2141,1958,"6",2017,4225,2219,2006,447106,462352,0.967025123715265,0.970177514792899,1.00325988539525,0.916784834021462,0.0029886134910091,0.0936260335627353
"1272","대전","유성구",2019,4129,2141,1988,"6",2018,4258,2225,2033,462528,478982,0.965647978420901,0.969704086425552,1.00420040024449,0.892702712052027,0.0037497086899606,0.127431207071815
"1273","대전","유성구",2020,3737,1874,1863,"6",2019,3912,1967,1945,417119,431843,0.965904275396382,0.955265848670757,0.988986044480174,0.895907402923386,-0.00986748428568129,-0.4773966408536
"1274","대전","중구",2009,2614,1388,1226,"6",2008,2641,1386,1255,462768,488710,0.946917394773997,0.989776599772813,1.04526182033972,0.564861874632645,0.0255666766863803,1.09646423944024
"1275","대전","중구",2010,2627,1357,1270,"6",2009,2585,1334,1251,470657,487028,0.966385916210156,1.01624758220503,1.05159601889731,0.558155939463346,0.0287986244001962,1.24001599668208
"1276","대전","중구",2011,2421,1246,1175,"6",2010,2447,1257,1190,441332,457372,0.964930078798003,0.989374744585206,1.02533309544838,0.548566611983722,0.0138968903411788,0.578133348959118
"1277","대전","중구",2012,2314,1204,1110,"6",2011,2314,1203,1111,407210,420797,0.967711271705834,1,1.0333660764716,0.568257164607942,0.0189605120098429,0.803041624992584
"1278","대전","중구",2013,2339,1191,1148,"6",2012,2297,1163,1134,422944,435284,0.971650692421499,1.01828471919896,1.04799464163529,0.553028296890368,0.0265423949234305,1.13980221390768
"1279","대전","중구",2014,2546,1329,1217,"6",2013,2572,1339,1233,465061,480776,0.967313260229296,0.989891135303266,1.02334081005839,0.547455065034479,0.0127780446884711,0.528438157777031
"1280","대전","중구",2015,2374,1255,1119,"6",2014,2415,1270,1145,441255,454993,0.969806128885499,0.983022774327122,1.01362813148728,0.538010900726337,0.00733208329668915,0.286547695156112
"1281","대전","중구",2016,2067,1053,1014,"6",2015,2133,1090,1043,422114,435131,0.970084870992873,0.969057665260197,0.998941117665689,0.489678143818968,-0.000518511535987974,-0.0621481326900579
"1282","대전","중구",2017,2166,1086,1080,"6",2016,2184,1109,1075,445571,460063,0.968499966308962,0.991758241758242,1.02401474058685,0.486117812873818,0.01167399317081,0.479400070072746
"1283","대전","중구",2018,2057,1067,990,"6",2017,2109,1089,1020,447106,462352,0.967025123715265,0.975343764817449,1.00860230091047,0.460069871574079,0.00395765947512207,0.136667650007492
"1284","대전","중구",2019,2024,1038,986,"6",2018,2060,1058,1002,462528,478982,0.965647978420901,0.98252427184466,1.01747665174151,0.437595129375951,0.00764769767988632,0.300566176681997
"1285","대전","중구",2020,1788,920,868,"6",2019,1801,919,882,417119,431843,0.965904275396382,0.992781787895614,1.02782626931453,0.428654652509236,0.0119278598036462,0.490675933569213
"1286","부산","강서구",2009,336,170,166,"6",2008,277,142,135,462768,488710,0.946917394773997,1.2129963898917,1.28099493850908,0.0726065760813194,0.0204020803813254,0.867071024981313
"1287","부산","강서구",2010,437,235,202,"6",2009,440,232,208,470657,487028,0.966385916210156,0.993181818181818,1.02772795166215,0.0928489324497458,0.00257451071084918,0.075233043627726
"1288","부산","강서구",2011,430,232,198,"6",2010,444,240,204,441332,457372,0.964930078798003,0.968468468468468,1.00366699074701,0.0974323185266421,0.000357283410497137,-0.0232483995619405
"1289","부산","강서구",2012,467,243,224,"6",2011,466,243,223,407210,420797,0.967711271705834,1.00214592274678,1.03558360024085,0.11468284177697,0.00408082839627657,0.14213838054986
"1290","부산","강서구",2013,474,233,241,"6",2012,484,252,232,422944,435284,0.971650692421499,0.979338842975207,1.0079124634127,0.112071574487403,0.000886762232734947,0.000269188618606092
"1291","부산","강서구",2014,692,356,336,"6",2013,675,342,333,465061,480776,0.967313260229296,1.02518518518519,1.05982749057133,0.148797684604815,0.00890219207273007,0.356286408099399
"1292","부산","강서구",2015,898,438,460,"6",2014,859,417,442,441255,454993,0.969806128885499,1.0454016298021,1.07794908555947,0.203510441808025,0.0158634528407397,0.66548114277741
"1293","부산","강서구",2016,1191,623,568,"6",2015,1142,590,552,422114,435131,0.970084870992873,1.04290718038529,1.07506797762744,0.282151267193223,0.021180525013216,0.90164679931878
"1294","부산","강서구",2017,1561,789,772,"6",2016,1531,777,754,445571,460063,0.968499966308962,1.01959503592423,1.05275691418968,0.3503369833315,0.0184826981670916,0.781818813599868
"1295","부산","강서구",2018,1750,887,863,"6",2017,1738,882,856,447106,462352,0.967025123715265,1.00690448791715,1.0412392224606,0.391406064781059,0.0161412817779335,0.677821327606612
"1296","부산","강서구",2019,1958,1033,925,"6",2018,1954,1038,916,462528,478982,0.965647978420901,1.00204708290686,1.03769396850546,0.423325722983257,0.0159568264696811,0.669628471169295
"1297","부산","강서구",2020,1956,1014,942,"6",2019,1996,1028,968,417119,431843,0.965904275396382,0.979959919839679,1.01455179855947,0.468930928583929,0.00682378841105755,0.263971022978668
"1298","부산","금정구",2009,1785,921,864,"6",2008,1888,969,919,462768,488710,0.946917394773997,0.945444915254237,0.998444975741405,0.385722435432009,-0.000599807744181244,-0.0657590245041041
"1299","부산","금정구",2010,1820,948,872,"6",2009,1833,975,858,470657,487028,0.966385916210156,0.99290780141844,1.0274444036936,0.386693494413129,0.0106125723663637,0.432255488803691
"1300","부산","금정구",2011,1724,870,854,"6",2010,1700,860,840,441332,457372,0.964930078798003,1.01411764705882,1.05097526685259,0.390635621255653,0.0199127550356351,0.845336913090661
"1301","부산","금정구",2012,1583,825,758,"6",2011,1560,815,745,407210,420797,0.967711271705834,1.01474358974359,1.04860160195804,0.388742909064119,0.0188935281303448,0.800066436511741
"1302","부산","금정구",2013,1625,866,759,"6",2012,1623,874,749,422944,435284,0.971650692421499,1.00123228589033,1.03044467903903,0.384211621396686,0.0116971994964887,0.480430813489807
"1303","부산","금정구",2014,1782,923,859,"6",2013,1812,938,874,465061,480776,0.967313260229296,0.983443708609272,1.01667551665337,0.383175540412978,0.00638965010531917,0.244688125421776
"1304","부산","금정구",2015,1612,854,758,"6",2014,1629,862,767,441255,454993,0.969806128885499,0.989564149785144,1.02037316563709,0.365321639414851,0.00744275827061032,0.291463488478251
"1305","부산","금정구",2016,1534,806,728,"6",2015,1532,797,735,422114,435131,0.970084870992873,1.00130548302872,1.03218338206212,0.363408936922253,0.0116957286617582,0.480365484181018
"1306","부산","금정구",2017,1656,874,782,"6",2016,1658,879,779,445571,460063,0.968499966308962,0.998793727382388,1.03127905227388,0.371657940036492,0.011625108134403,0.477228768585081
"1307","부산","금정구",2018,1709,859,850,"6",2017,1715,864,851,447106,462352,0.967025123715265,0.996501457725948,1.03048145625983,0.38223597983476,0.0116511093002663,0.478383648979357
"1308","부산","금정구",2019,1702,890,812,"6",2018,1720,897,823,462528,478982,0.965647978420901,0.98953488372093,1.02473665956314,0.367977722429777,0.00910253964656387,0.365185143112976
"1309","부산","금정구",2020,1527,765,762,"6",2019,1543,784,759,417119,431843,0.965904275396382,0.989630589760207,1.02456383615663,0.366082580750337,0.0089923925333475,0.360292795507928
"1310","부산","기장군",2009,742,405,337,"6",2008,746,412,334,462768,488710,0.946917394773997,0.994638069705094,1.05039581614454,0.16033952217958,0.00808044108046551,0.31978711745477
"1311","부산","기장군",2010,927,497,430,"6",2009,875,465,410,470657,487028,0.966385916210156,1.05942857142857,1.09627898509045,0.196958719407127,0.0189629856092322,0.803151493582823
"1312","부산","기장군",2011,970,501,469,"6",2010,974,506,468,441332,457372,0.964930078798003,0.995893223819302,1.03208848568579,0.219789183653123,0.00705270207354503,0.274138563241238
"1313","부산","기장군",2012,1036,556,480,"6",2011,1034,561,473,407210,420797,0.967711271705834,1.00193423597679,1.0353648503139,0.254414184327497,0.008997319546476,0.360511636112782
"1314","부산","기장군",2013,1207,628,579,"6",2012,1144,588,556,422944,435284,0.971650692421499,1.05506993006993,1.08585311398332,0.285380570477415,0.0245008106458212,1.04912221640793
"1315","부산","기장군",2014,1702,888,814,"6",2013,1676,867,809,465061,480776,0.967313260229296,1.01551312649165,1.04982860076882,0.365973495949994,0.0182359472216614,0.770859003926537
"1316","부산","기장군",2015,1720,880,840,"6",2014,1736,885,851,441255,454993,0.969806128885499,0.990783410138249,1.02163038635037,0.389797282750337,0.00843146582421402,0.335378402729919
"1317","부산","기장군",2016,1799,919,880,"6",2015,1811,918,893,422114,435131,0.970084870992873,0.99337382661513,1.02400713207538,0.426188186129813,0.0102315560733861,0.415332084331246
"1318","부산","기장군",2017,1987,990,997,"6",2016,2071,1036,1035,445571,460063,0.968499966308962,0.959439884113955,0.990645242632753,0.445944641819149,-0.00417170392344211,-0.224410097671665
"1319","부산","기장군",2018,2106,1074,1032,"6",2017,2168,1105,1063,447106,462352,0.967025123715265,0.97140221402214,1.00452634600646,0.471029241387948,0.00213204132568241,0.0555801088061366
"1320","부산","기장군",2019,2166,1100,1066,"6",2018,2270,1163,1107,462528,478982,0.965647978420901,0.954185022026432,0.988129259677824,0.46829597343296,-0.00555901989454353,-0.286029796731139
"1321","부산","기장군",2020,2038,1061,977,"6",2019,2058,1072,986,417119,431843,0.965904275396382,0.990281827016521,1.02523806161862,0.488589587144196,0.0123310541065593,0.50858440728791
"1322","부산","남구",2009,2199,1095,1104,"6",2008,2459,1239,1220,462768,488710,0.946917394773997,0.894265961773078,0.944397015736009,0.475184109532206,-0.0264216545648181,-1.21267469720715
"1323","부산","남구",2010,2289,1215,1074,"6",2009,2509,1315,1194,470657,487028,0.966385916210156,0.912315663611,0.944049006000417,0.486341433358051,-0.0272112866195648,-1.24774737754441
"1324","부산","남구",2011,2110,1104,1006,"6",2010,2347,1221,1126,441332,457372,0.964930078798003,0.899020025564551,0.931694477473896,0.47809812114236,-0.0326567419833773,-1.4896153641816
"1325","부산","남구",2012,1950,1045,905,"6",2011,2107,1135,972,407210,420797,0.967711271705834,0.925486473659231,0.956366326112776,0.478868397141524,-0.020894787475771,-0.967190687894974
"1326","부산","남구",2013,1895,968,927,"6",2012,2069,1038,1031,422944,435284,0.971650692421499,0.915901401643306,0.942624143415925,0.448049860028751,-0.0257072445115247,-1.18094311377122
"1327","부산","남구",2014,2222,1183,1039,"6",2013,2382,1261,1121,465061,480776,0.967313260229296,0.932829554995802,0.964351046707124,0.477786784959392,-0.0170325987809709,-0.795645841557239
"1328","부산","남구",2015,2073,1041,1032,"6",2014,2197,1106,1091,441255,454993,0.969806128885499,0.943559399180701,0.97293610658559,0.469796376245028,-0.0127145190531713,-0.603851917977898
"1329","부산","남구",2016,1932,971,961,"6",2015,2118,1058,1060,422114,435131,0.970084870992873,0.912181303116147,0.940310822683522,0.457696262147192,-0.0273195133483929,-1.25255442842502
"1330","부산","남구",2017,2120,1069,1051,"6",2016,2298,1153,1145,445571,460063,0.968499966308962,0.92254134029591,0.952546589972321,0.475793981206138,-0.0225780468788768,-1.04195515397119
"1331","부산","남구",2018,2139,1093,1046,"6",2017,2181,1091,1090,447106,462352,0.967025123715265,0.980742778541953,1.01418541720404,0.478410041466677,0.00678644603280651,0.262312405794172
"1332","부산","남구",2019,2214,1116,1098,"6",2018,2379,1199,1180,462528,478982,0.965647978420901,0.930643127364439,0.963749884182738,0.478673723536737,-0.0173519779168866,-0.809831540165878
"1333","부산","남구",2020,2013,1034,979,"6",2019,2185,1124,1061,417119,431843,0.965904275396382,0.921281464530892,0.953802036079426,0.4825960936807,-0.0222949569240709,-1.02938129323199
"1334","부산","동구",2009,594,313,281,"6",2008,629,334,295,462768,488710,0.946917394773997,0.944356120826709,0.997295145319514,0.128358054143761,-0.000347189883528782,-0.0545386270786392
"1335","부산","동구",2010,591,314,277,"6",2009,611,330,281,470657,487028,0.966385916210156,0.967266775777414,1.00091149876305,0.12556915120778,0.000114456126003558,-0.0340339340080294
"1336","부산","동구",2011,517,281,236,"6",2010,544,291,253,441332,457372,0.964930078798003,0.950367647058823,0.98490830365935,0.117145369019242,-0.0017679223369518,-0.117642568824837
"1337","부산","동구",2012,448,225,223,"6",2011,476,238,238,407210,420797,0.967711271705834,0.941176470588235,0.972579836679152,0.110016944574053,-0.00301668258828115,-0.173108109831517
"1338","부산","동구",2013,454,216,238,"6",2012,487,236,251,422944,435284,0.971650692421499,0.932238193018481,0.959437584195204,0.107342816070213,-0.00435408393909773,-0.232510776906432
"1339","부산","동구",2014,507,256,251,"6",2013,549,279,270,465061,480776,0.967313260229296,0.923497267759563,0.954703409669638,0.109017956784164,-0.00493814172710537,-0.258452570902936
"1340","부산","동구",2015,428,219,209,"6",2014,462,236,226,441255,454993,0.969806128885499,0.926406926406926,0.955249610013862,0.0969960680332234,-0.00434061187160872,-0.231912395022511
"1341","부산","동구",2016,388,192,196,"6",2015,445,231,214,422114,435131,0.970084870992873,0.871910112359551,0.89879776340307,0.0919182969529558,-0.00930233723581988,-0.452294795374836
"1342","부산","동구",2017,403,203,200,"6",2016,435,221,214,445571,460063,0.968499966308962,0.926436781609195,0.956568728794,0.0904457426538083,-0.00392817357862566,-0.213593335757272
"1343","부산","동구",2018,435,223,212,"6",2017,477,251,226,447106,462352,0.967025123715265,0.911949685534591,0.943046528130442,0.0972923646741489,-0.00554113795459194,-0.285235543813008
"1344","부산","동구",2019,404,206,198,"6",2018,450,234,216,462528,478982,0.965647978420901,0.897777777777778,0.929715380594376,0.0873460633734606,-0.0061390848207832,-0.311794241842707
"1345","부산","동구",2020,422,224,198,"6",2019,438,230,208,417119,431843,0.965904275396382,0.963470319634703,0.997480127354566,0.101170169663813,-0.000254935943069778,-0.0504410313134717
"1346","부산","동래구",2009,1995,1035,960,"6",2008,2172,1107,1065,462768,488710,0.946917394773997,0.918508287292818,0.969998325473829,0.431101545482834,-0.0129337682553053,-0.613590196881872
"1347","부산","동래구",2010,2088,1101,987,"6",2009,2246,1181,1065,470657,487028,0.966385916210156,0.929652715939448,0.961989098087477,0.443635173810227,-0.0168629730766458,-0.788111664000726
"1348","부산","동래구",2011,2018,1032,986,"6",2010,2111,1096,1015,441332,457372,0.964930078798003,0.95594504973946,0.990688414367044,0.457252136713404,-0.00425774242685895,-0.228231625570508
"1349","부산","동래구",2012,1738,904,834,"6",2011,1904,976,928,407210,420797,0.967711271705834,0.91281512605042,0.943272185350651,0.426806807298446,-0.0242118174555066,-1.11452150032719
"1350","부산","동래구",2013,1857,950,907,"6",2012,1944,989,955,422944,435284,0.971650692421499,0.955246913580247,0.983117617298896,0.43906521903609,-0.00741246705851136,-0.368353404939628
"1351","부산","동래구",2014,2140,1139,1001,"6",2013,2185,1167,1018,465061,480776,0.967313260229296,0.979405034324943,1.01250037045164,0.460154689384833,0.00575210408236832,0.216370572038745
"1352","부산","동래구",2015,2021,1054,967,"6",2014,2123,1107,1016,441255,454993,0.969806128885499,0.951954780970325,0.981592869560755,0.458011807231646,-0.00843068307842705,-0.41357898154344
"1353","부산","동래구",2016,1856,970,886,"6",2015,1924,994,930,422114,435131,0.970084870992873,0.964656964656965,0.994404709837034,0.439691647280119,-0.00246020234876486,-0.148391213604687
"1354","부산","동래구",2017,2214,1167,1047,"6",2016,2242,1169,1073,445571,460063,0.968499966308962,0.987511150758252,1.0196295148277,0.496890506787919,0.00975371957073723,0.394108266465529
"1355","부산","동래구",2018,2004,1032,972,"6",2017,2138,1094,1044,447106,462352,0.967025123715265,0.93732460243218,0.969286711839526,0.448215859326424,-0.0137661828455869,-0.650563127068172
"1356","부산","동래구",2019,2225,1167,1058,"6",2018,2354,1232,1122,462528,478982,0.965647978420901,0.945199660152931,0.978824251979061,0.48105195793552,-0.0101866350462218,-0.491572195830808
"1357","부산","동래구",2020,2036,1080,956,"6",2019,2143,1114,1029,417119,431843,0.965904275396382,0.950069995333644,0.983606781265939,0.488110107667117,-0.00800169576129331,-0.394524872794785
"1358","부산","부산진구",2009,3048,1568,1480,"6",2008,3046,1561,1485,462768,488710,0.946917394773997,1.00065659881812,1.05675173393235,0.658645368737683,0.0373792667223738,1.62113796791535
"1359","부산","부산진구",2010,3108,1602,1506,"6",2009,2997,1555,1442,470657,487028,0.966385916210156,1.03703703703704,1.07310859941332,0.660353505843959,0.0482775199299261,2.10520006833949
"1360","부산","부산진구",2011,2917,1540,1377,"6",2010,2833,1484,1349,441332,457372,0.964930078798003,1.02965054712319,1.06707270272454,0.660953658470267,0.0443319482492755,1.92995164285914
"1361","부산","부산진구",2012,2661,1350,1311,"6",2011,2562,1295,1267,407210,420797,0.967711271705834,1.03864168618267,1.07329708411043,0.653471181945434,0.0478975321867978,2.08832234843603
"1362","부산","부산진구",2013,2738,1404,1334,"6",2012,2661,1347,1314,422944,435284,0.971650692421499,1.02893649004134,1.05895719322453,0.647367027313309,0.0381669429164974,1.65612377579852
"1363","부산","부산진구",2014,2900,1454,1446,"6",2013,2848,1427,1421,465061,480776,0.967313260229296,1.01825842696629,1.05266666842231,0.623574111783185,0.032841570982019,1.41958947300245
"1364","부산","부산진구",2015,2724,1421,1303,"6",2014,2646,1377,1269,441255,454993,0.969806128885499,1.02947845804989,1.06153016297491,0.617330115239487,0.0379844226000031,1.64801686489365
"1365","부산","부산진구",2016,2550,1288,1262,"6",2015,2462,1255,1207,422114,435131,0.970084870992873,1.0357432981316,1.06768317814453,0.604102209355766,0.0408875574533322,1.77696391064069
"1366","부산","부산진구",2017,2673,1395,1278,"6",2016,2617,1338,1279,445571,460063,0.968499966308962,1.02139854795567,1.05461908465347,0.599904392341512,0.0327662287892898,1.41624303762712
"1367","부산","부산진구",2018,2659,1292,1367,"6",2017,2612,1269,1343,447106,462352,0.967025123715265,1.01799387442573,1.05270674924623,0.594713557858763,0.0313454183673937,1.3531356327954
"1368","부산","부산진구",2019,2739,1386,1353,"6",2018,2636,1334,1302,462528,478982,0.965647978420901,1.03907435508346,1.07603845117828,0.592180365296804,0.0450284777953547,1.9608890370141
"1369","부산","부산진구",2020,2372,1180,1192,"6",2019,2250,1128,1122,417119,431843,0.965904275396382,1.05422222222222,1.09143550668061,0.568662659816503,0.0519959584306678,2.27036003633507
"1370","부산","북구",2009,2717,1421,1296,"6",2008,2861,1494,1367,462768,488710,0.946917394773997,0.949667948269836,1.00290474492392,0.587119247657574,0.00170543165436757,0.0366316067273988
"1371","부산","북구",2010,2638,1369,1269,"6",2009,2749,1429,1320,470657,487028,0.966385916210156,0.959621680611131,0.993000482017006,0.560493097946063,-0.00392318151841744,-0.213371605989775
"1372","부산","북구",2011,2472,1262,1210,"6",2010,2560,1314,1246,441332,457372,0.964930078798003,0.965625,1.00072017777999,0.560122538134556,0.00040338780603804,-0.021200604367675
"1373","부산","북구",2012,2240,1200,1040,"6",2011,2317,1242,1075,407210,420797,0.967711271705834,0.966767371601209,0.999024605652302,0.550084722870263,-0.00053654952944292,-0.0629493169562839
"1374","부산","북구",2013,2273,1219,1054,"6",2012,2305,1238,1067,422944,435284,0.971650692421499,0.986117136659436,1.01488852357207,0.537423394113641,0.00800144087144338,0.316278205853533
"1375","부산","북구",2014,2304,1184,1120,"6",2013,2396,1232,1164,465061,480776,0.967313260229296,0.961602671118531,0.994096442853051,0.495418880533951,-0.00292473367290963,-0.16902406220858
"1376","부산","북구",2015,2252,1165,1087,"6",2014,2313,1210,1103,441255,454993,0.969806128885499,0.973627323821876,1.00394016373228,0.510362488810325,0.00201091176872638,0.0501999596531557
"1377","부산","북구",2016,2203,1096,1107,"6",2015,2264,1134,1130,422114,435131,0.970084870992873,0.973056537102474,1.00306330528231,0.521896928317943,0.00159872961733698,0.0318922772971767
"1378","부산","북구",2017,2235,1186,1049,"6",2016,2346,1238,1108,445571,460063,0.968499966308962,0.952685421994885,0.983671094616195,0.501603560375339,-0.00819063707754854,-0.402916981939398
"1379","부산","북구",2018,2224,1141,1083,"6",2017,2337,1196,1141,447106,462352,0.967025123715265,0.951647411210954,0.984097918319609,0.497421193184614,-0.00791003244357927,-0.390453510415927
"1380","부산","북구",2019,2275,1195,1080,"6",2018,2399,1268,1131,462528,478982,0.965647978420901,0.948311796581909,0.982047099744007,0.491862114293621,-0.00883035147761529,-0.431330847012133
"1381","부산","북구",2020,2038,1029,1009,"6",2019,2179,1107,1072,417119,431843,0.965904275396382,0.935291418081689,0.968306530890827,0.488589587144196,-0.0154850989872183,-0.726911340137257
"1382","부산","사상구",2009,1905,1015,890,"6",2008,2110,1115,995,462768,488710,0.946917394773997,0.902843601895735,0.953455504015974,0.411653355461052,-0.0191601979500676,-0.890146318196916
"1383","부산","사상구",2010,1826,956,870,"6",2009,2013,1062,951,470657,487028,0.966385916210156,0.907103825136612,0.938655882624998,0.387968308130974,-0.0237995734317673,-1.09621106981891
"1384","부산","사상구",2011,1732,886,846,"6",2010,1923,982,941,441332,457372,0.964930078798003,0.900676027041082,0.933410665530334,0.392448315553823,-0.0261328721464704,-1.19984799724627
"1385","부산","사상구",2012,1510,748,762,"6",2011,1634,805,829,407210,420797,0.967711271705834,0.924112607099143,0.954946619015982,0.370816040863437,-0.0167065163640055,-0.781162406766212
"1386","부산","사상구",2013,1526,784,742,"6",2012,1667,863,804,422944,435284,0.971650692421499,0.915416916616677,0.942125522841259,0.360804267231596,-0.0208813583226712,-0.966594212117381
"1387","부산","사상구",2014,1660,877,783,"6",2013,1810,952,858,465061,480776,0.967313260229296,0.917127071823204,0.948117956747336,0.356942422606927,-0.0185189022084032,-0.861662215488786
"1388","부산","사상구",2015,1562,791,771,"6",2014,1718,868,850,441255,454993,0.969806128885499,0.909196740395809,0.937503603365198,0.353990323055829,-0.0221231196345789,-1.02174888483603
"1389","부산","사상구",2016,1394,726,668,"6",2015,1526,794,732,422114,435131,0.970084870992873,0.913499344692005,0.941669509552341,0.330242541114486,-0.0192632093898891,-0.894721724271458
"1390","부산","사상구",2017,1462,746,716,"6",2016,1633,846,787,445571,460063,0.968499966308962,0.895284751990202,0.924403493169143,0.328118302133667,-0.0248045974685768,-1.1408507049026
"1391","부산","사상구",2018,1434,748,686,"6",2017,1612,831,781,447106,462352,0.967025123715265,0.889578163771712,0.919912153216863,0.320729312512022,-0.0256865200393238,-1.180022605562
"1392","부산","사상구",2019,1489,750,739,"6",2018,1700,855,845,462528,478982,0.965647978420901,0.875882352941176,0.907041046545227,0.321926456344265,-0.0299259464711666,-1.36832302619908
"1393","부산","사상구",2020,1280,628,652,"6",2019,1448,725,723,417119,431843,0.965904275396382,0.883977900552486,0.915181683184624,0.306866865330997,-0.0260279310037857,-1.1951868805534
"1394","부산","사하구",2009,3102,1634,1468,"6",2008,3284,1722,1562,462768,488710,0.946917394773997,0.944579780755177,0.997531343249452,0.670314282750752,-0.00165477587910144,-0.11261700087376
"1395","부산","사하구",2010,2915,1522,1393,"6",2009,3098,1626,1472,470657,487028,0.966385916210156,0.940929632020658,0.973658262436885,0.619346997919929,-0.0163146760797096,-0.763758238645434
"1396","부산","사하구",2011,2765,1411,1354,"6",2010,2894,1470,1424,441332,457372,0.964930078798003,0.955425017277125,0.990149481574129,0.626512466805036,-0.0061714725983012,-0.313232793077924
"1397","부산","사하구",2012,2478,1230,1248,"6",2011,2573,1275,1298,407210,420797,0.967711271705834,0.963078118927322,0.995212257091575,0.608531224675229,-0.0029134910554938,-0.168524704660455
"1398","부산","사하구",2013,2520,1280,1240,"6",2012,2578,1303,1275,422944,435284,0.971650692421499,0.977501939487975,1.00602196562212,0.595823560565938,0.00358802899857991,0.12024996348028
"1399","부산","사하구",2014,2714,1420,1294,"6",2013,2875,1504,1371,465061,480776,0.967313260229296,0.944,0.975898955190824,0.583579358406747,-0.014064872266671,-0.66382986126776
"1400","부산","사하구",2015,2545,1285,1260,"6",2014,2646,1338,1308,441255,454993,0.969806128885499,0.96182917611489,0.991774693381474,0.576764002674191,-0.00474406076852353,-0.249832176911874
"1401","부산","사하구",2016,2413,1253,1160,"6",2015,2533,1310,1223,422114,435131,0.970084870992873,0.95262534544019,0.982002063866006,0.571646522029594,-0.0102884575947086,-0.496094795531183
"1402","부산","사하구",2017,2498,1250,1248,"6",2016,2637,1311,1326,445571,460063,0.968499966308962,0.947288585513842,0.97809872841198,0.560628945779685,-0.0122784868016261,-0.584484898005433
"1403","부산","사하구",2018,2577,1310,1267,"6",2017,2725,1373,1352,447106,462352,0.967025123715265,0.945688073394495,0.977935371276815,0.576373387966165,-0.0127174648113976,-0.603982758204051
"1404","부산","사하구",2019,2572,1290,1282,"6",2018,2714,1374,1340,462528,478982,0.965647978420901,0.947678703021371,0.98139148447355,0.556074443060744,-0.0103477199075579,-0.498727019162573
"1405","부산","사하구",2020,2145,1094,1051,"6",2019,2265,1145,1120,417119,431843,0.965904275396382,0.947019867549669,0.980448986170018,0.514241739167959,-0.0100539473544268,-0.485678674954804
"1406","부산","서구",2009,740,392,348,"6",2008,860,454,406,462768,488710,0.946917394773997,0.86046511627907,0.908701351382862,0.159907340179096,-0.0145993240623125,-0.687568331447037
"1407","부산","서구",2010,761,415,346,"6",2009,871,480,391,470657,487028,0.966385916210156,0.873708381171068,0.904098835170799,0.161688873213402,-0.0155061512810862,-0.727846409032645
"1408","부산","서구",2011,711,342,369,"6",2010,778,385,393,441332,457372,0.964930078798003,0.913881748071979,0.947096342162312,0.161103205749866,-0.00852294887354563,-0.417677103850917
"1409","부산","서구",2012,589,303,286,"6",2011,646,326,320,407210,420797,0.967711271705834,0.911764705882353,0.942186716782929,0.14464281329044,-0.00836227593007414,-0.410540576462818
"1410","부산","서구",2013,626,316,310,"6",2012,668,343,325,422944,435284,0.971650692421499,0.937125748502994,0.964467741146292,0.148010138458046,-0.00525913455266449,-0.272709943933464
"1411","부산","서구",2014,688,354,334,"6",2013,711,369,342,465061,480776,0.967313260229296,0.967651195499297,1.00034935453063,0.147937582381666,5.16826646556658e-05,-0.0368221105141411
"1412","부산","서구",2015,599,283,316,"6",2014,639,303,336,441255,454993,0.969806128885499,0.937402190923318,0.966587200269171,0.135749169981077,-0.00453575983020396,-0.240580181403693
"1413","부산","서구",2016,572,304,268,"6",2015,610,336,274,422114,435131,0.970084870992873,0.937704918032787,0.966621525674402,0.13550841715745,-0.00452306422299237,-0.240016287156059
"1414","부산","서구",2017,644,317,327,"6",2016,666,326,340,445571,460063,0.968499966308962,0.966966966966967,0.998417140531416,0.144533643347525,-0.000228776445901532,-0.0492791183991594
"1415","부산","서구",2018,615,323,292,"6",2017,651,337,314,447106,462352,0.967025123715265,0.944700460829493,0.976914081818266,0.137551274194486,-0.00317549746184712,-0.180162108285477
"1416","부산","서구",2019,655,336,319,"6",2018,702,358,344,462528,478982,0.965647978420901,0.933048433048433,0.966240756361571,0.14161304829113,-0.00478074939964094,-0.251461756946597
"1417","부산","서구",2020,561,322,239,"6",2019,606,347,259,417119,431843,0.965904275396382,0.925742574257426,0.958420619763304,0.134493993320851,-0.00559217688783933,-0.287502513827434
"1418","부산","수영구",2009,1237,630,607,"6",2008,1285,643,642,462768,488710,0.946917394773997,0.962645914396887,1.01661023412358,0.267304567299381,0.004439991445146,0.158091140732565
"1419","부산","수영구",2010,1273,657,616,"6",2009,1315,676,639,470657,487028,0.966385916210156,0.968060836501901,1.00173317953382,0.270472977136216,0.000468778228423138,-0.0182961916508354
"1420","부산","수영구",2011,1172,616,556,"6",2010,1256,656,600,441332,457372,0.964930078798003,0.93312101910828,0.967034855282627,0.265559714681917,-0.00875421442559369,-0.427949106780943
"1421","부산","수영구",2012,1058,565,493,"6",2011,1117,592,525,407210,420797,0.967711271705834,0.947179946284691,0.978783624804792,0.259816802141401,-0.00551237075625115,-0.283957805978609
"1422","부산","수영구",2013,1010,545,465,"6",2012,1048,573,475,422944,435284,0.971650692421499,0.963740458015267,0.991858973118705,0.238802300068094,-0.00194409594416944,-0.125467581212141
"1423","부산","수영구",2014,1098,550,548,"6",2013,1200,598,602,465061,480776,0.967313260229296,0.915,0.945919008474157,0.236098060254461,-0.0127684171958895,-0.606245884026973
"1424","부산","수영구",2015,1102,557,545,"6",2014,1154,580,574,441255,454993,0.969806128885499,0.954939341421144,0.984670351092295,0.249742212552832,-0.00382846043586842,-0.209164428444905
"1425","부산","수영구",2016,1017,532,485,"6",2015,1101,581,520,422114,435131,0.970084870992873,0.923705722070845,0.952190627532867,0.240930175260712,-0.0115187204876109,-0.550738748894231
"1426","부산","수영구",2017,992,528,464,"6",2016,1088,578,510,445571,460063,0.968499966308962,0.911764705882353,0.941419450283687,0.222635674224759,-0.0130421201825482,-0.61840280863601
"1427","부산","수영구",2018,1089,555,534,"6",2017,1197,607,590,447106,462352,0.967025123715265,0.909774436090226,0.940797104210608,0.243566402598042,-0.0144198363508091,-0.679596118196343
"1428","부산","수영구",2019,1042,535,507,"6",2018,1144,586,558,462528,478982,0.965647978420901,0.910839160839161,0.943241410113686,0.225283658502837,-0.0127867827810509,-0.607061618765326
"1429","부산","수영구",2020,970,518,452,"6",2019,1061,561,500,417119,431843,0.965904275396382,0.914231856738926,0.946503582214447,0.232547546383646,-0.0124404606963448,-0.591679209075127
"1430","부산","연제구",2009,1698,905,793,"6",2008,1705,910,795,462768,488710,0.946917394773997,0.995894428152493,1.05172260394497,0.366922518410953,0.0189781880982598,0.803826734709104
"1431","부산","연제구",2010,1765,879,886,"6",2009,1794,890,904,470657,487028,0.966385916210156,0.983835005574136,1.01805602613955,0.375007701999545,0.00677114886983484,0.261632959584071
"1432","부산","연제구",2011,1596,820,776,"6",2010,1604,827,777,441332,457372,0.964930078798003,0.99501246882793,1.03117572007642,0.361632512484932,0.0112741539797639,0.461640618630054
"1433","부산","연제구",2012,1576,844,732,"6",2011,1579,843,736,407210,420797,0.967711271705834,0.998100063331222,1.03140274637064,0.38702389430515,0.012153613192242,0.500703105573789
"1434","부산","연제구",2013,1552,818,734,"6",2012,1544,811,733,422944,435284,0.971650692421499,1.00518134715026,1.03450895984564,0.366951653173943,0.0126631198646699,0.523333601061328
"1435","부산","연제구",2014,1657,882,775,"6",2013,1671,872,799,465061,480776,0.967313260229296,0.991621783363256,1.02512993890748,0.356297345939565,0.0089537305363593,0.358575565497551
"1436","부산","연제구",2015,1570,806,764,"6",2014,1538,799,739,441255,454993,0.969806128885499,1.02080624187256,1.05258794667102,0.355803333673273,0.0187109667365825,0.791957701099014
"1437","부산","연제구",2016,1472,783,689,"6",2015,1483,790,693,422114,435131,0.970084870992873,0.992582602832097,1.02319150881737,0.348720961635956,0.00808736525658031,0.320094665019504
"1438","부산","연제구",2017,1650,824,826,"6",2016,1637,832,805,445571,460063,0.968499966308962,1.00794135613928,1.04072420361627,0.37031135329723,0.015080634953093,0.630711123791133
"1439","부산","연제구",2018,1675,885,790,"6",2017,1681,888,793,447106,462352,0.967025123715265,0.996430696014277,1.03040828162358,0.374631519147585,0.0113919007393099,0.466870515812522
"1440","부산","연제구",2019,1654,829,825,"6",2018,1710,850,860,462528,478982,0.965647978420901,0.967251461988304,1.00166052599212,0.357599972326,0.000593804048827631,-0.012742984170731
"1441","부산","연제구",2020,1564,764,800,"6",2019,1587,768,819,417119,431843,0.965904275396382,0.985507246376812,1.02029494172431,0.374952951076312,0.00760964829145085,0.29887615659023
"1442","부산","영도구",2009,983,498,485,"6",2008,1072,541,531,462768,488710,0.946917394773997,0.916977611940298,0.968381843021435,0.212417453237908,-0.00671624838146321,-0.337429818494334
"1443","부산","영도구",2010,965,522,443,"6",2009,1021,544,477,470657,487028,0.966385916210156,0.945151811949069,0.978027303683853,0.205032539620148,-0.00450511772800179,-0.239219166930005
"1444","부산","영도구",2011,832,416,416,"6",2010,878,428,450,441332,457372,0.964930078798003,0.947608200455581,0.982048566291975,0.188520207009689,-0.00338420799875758,-0.189432296723337
"1445","부산","영도구",2012,716,357,359,"6",2011,747,376,371,407210,420797,0.967711271705834,0.958500669344043,0.990482075975455,0.175830652488888,-0.00167354279157535,-0.113450561160678
"1446","부산","영도구",2013,746,377,369,"6",2012,819,431,388,422944,435284,0.971650692421499,0.910866910866911,0.937442764124311,0.176382688961186,-0.0110340134777333,-0.529209767247054
"1447","부산","영도구",2014,776,404,372,"6",2013,835,428,407,465061,480776,0.967313260229296,0.929341317365269,0.960744937110626,0.166859831290949,-0.00655009317103657,-0.330049788078101
"1448","부산","영도구",2015,731,371,360,"6",2014,805,406,399,441255,454993,0.969806128885499,0.908074534161491,0.936346458446339,0.165663845168893,-0.0105450904523975,-0.507493525012402
"1449","부산","영도구",2016,617,316,301,"6",2015,668,343,325,422114,435131,0.970084870992873,0.923652694610778,0.952135964831023,0.146169044381376,-0.00699624028088587,-0.34986607450299
"1450","부산","영도구",2017,708,359,349,"6",2016,781,383,398,445571,460063,0.968499966308962,0.906530089628681,0.936014580448099,0.158897235232993,-0.0101671062620202,-0.490704795879704
"1451","부산","영도구",2018,686,321,365,"6",2017,734,345,389,447106,462352,0.967025123715265,0.934604904632153,0.966474274258196,0.153431177394175,-0.00514389157355919,-0.267591255877457
"1452","부산","영도구",2019,645,348,297,"6",2018,695,375,320,462528,478982,0.965647978420901,0.928057553956835,0.961072331425022,0.13945101701951,-0.00542850297297912,-0.280232693838578
"1453","부산","영도구",2020,589,302,287,"6",2019,621,316,305,417119,431843,0.965904275396382,0.948470209339775,0.981950523979767,0.141206705999966,-0.00254870705384253,-0.152322281512673
"1454","부산","중구",2009,389,194,195,"6",2008,300,161,139,462768,488710,0.946917394773997,1.29666666666667,1.36935563104335,0.0840593990941465,0.0310478123975429,1.33991702169129
"1455","부산","중구",2010,365,208,157,"6",2009,280,150,130,470657,487028,0.966385916210156,1.30357142857143,1.34891393459416,0.0775511678356,0.0270586831018916,1.16273392005641
"1456","부산","중구",2011,341,161,180,"6",2010,254,118,136,441332,457372,0.964930078798003,1.34251968503937,1.39131291949332,0.0772660944594999,0.0302352210007937,1.30382456808374
"1457","부산","중구",2012,316,162,154,"6",2011,235,120,115,407210,420797,0.967711271705834,1.34468085106383,1.38954757517032,0.0776012376906265,0.0302293739725992,1.30356486364348
"1458","부산","중구",2013,275,142,133,"6",2012,220,108,112,422944,435284,0.971650692421499,1.25,1.28647054929258,0.0650204282363623,0.0186264377921093,0.788203222502395
"1459","부산","중구",2014,280,135,145,"6",2013,232,106,126,465061,480776,0.967313260229296,1.20689655172414,1.24767911424894,0.0602071556204455,0.0149120549755198,0.623223393741238
"1460","부산","중구",2015,250,138,112,"6",2014,193,104,89,441255,454993,0.969806128885499,1.29533678756477,1.33566570573581,0.0566565817951071,0.0190176715128334,0.805580449201369
"1461","부산","중구",2016,245,135,110,"6",2015,210,113,97,422114,435131,0.970084870992873,1.16666666666667,1.20264391451914,0.0580411926635932,0.0117616944847103,0.483295454168528
"1462","부산","중구",2017,270,129,141,"6",2016,218,108,110,445571,460063,0.968499966308962,1.23853211009174,1.27881482000655,0.0605964032668194,0.0168951752698825,0.71130662660444
"1463","부산","중구",2018,229,115,114,"6",2017,194,100,94,447106,462352,0.967025123715265,1.18041237113402,1.22066360240873,0.0512182793342071,0.0113020100270626,0.462877886337837
"1464","부산","중구",2019,229,125,104,"6",2018,164,82,82,462528,478982,0.965647978420901,1.39634146341463,1.44601500196587,0.0495105161201052,0.0220824329446398,0.941706379451459
"1465","부산","중구",2020,209,114,95,"6",2019,157,77,80,417119,431843,0.965904275396382,1.3312101910828,1.37820095116207,0.0501056053548268,0.0189499876037467,0.802574167866785
"1466","부산","해운대구",2009,3918,2064,1854,"6",2008,4218,2205,2013,462768,488710,0.946917394773997,0.928876244665718,0.980947493194394,0.846644538948242,-0.0161307008402407,-0.755586705176049
"1467","부산","해운대구",2010,3965,2094,1871,"6",2009,4174,2195,1979,470657,487028,0.966385916210156,0.949928126497365,0.982969754177158,0.842439398542888,-0.0143469500480329,-0.676358764820342
"1468","부산","해운대구",2011,3703,1915,1788,"6",2010,3845,1944,1901,441332,457372,0.964930078798003,0.963068920676203,0.998071198978357,0.839050873265478,-0.00161836218156495,-0.110999632422318
"1469","부산","해운대구",2012,3386,1774,1612,"6",2011,3538,1852,1686,407210,420797,0.967711271705834,0.95703787450537,0.988970473412333,0.831511996267282,-0.00917118367079367,-0.446469415017486
"1470","부산","해운대구",2013,3499,1789,1710,"6",2012,3689,1880,1809,422944,435284,0.971650692421499,0.948495527243155,0.976169249547244,0.827296285087388,-0.0197150913204095,-0.914792731272821
"1471","부산","해운대구",2014,3694,1874,1820,"6",2013,3983,2025,1958,465061,480776,0.967313260229296,0.927441626914386,0.958781053714224,0.794304403078306,-0.0327403905250397,-1.49333073837996
"1472","부산","해운대구",2015,3424,1774,1650,"6",2014,3631,1871,1760,441255,454993,0.969806128885499,0.942990911594602,0.97234991974972,0.775968544265787,-0.0214555925206418,-0.992099676774084
"1473","부산","해운대구",2016,3149,1615,1534,"6",2015,3385,1753,1632,422114,435131,0.970084870992873,0.930280649926145,0.958968310653078,0.746007002847572,-0.03060992759147,-1.39870306338844
"1474","부산","해운대구",2017,3285,1711,1574,"6",2016,3536,1849,1687,445571,460063,0.968499966308962,0.929015837104072,0.959231666929874,0.737256239746303,-0.0300567079400061,-1.37413099102202
"1475","부산","해운대구",2018,3294,1710,1584,"6",2017,3588,1873,1715,447106,462352,0.967025123715265,0.918060200668896,0.949365407531247,0.736738044222175,-0.0373044306254162,-1.69604935716533
"1476","부산","해운대구",2019,3398,1793,1605,"6",2018,3651,1919,1732,462528,478982,0.965647978420901,0.930703916735141,0.963812836078316,0.734658226096582,-0.0265851976541706,-1.2199387063868
"1477","부산","해운대구",2020,3075,1598,1477,"6",2019,3327,1742,1585,417119,431843,0.965904275396382,0.924256086564472,0.956881660126394,0.737199696010012,-0.0317868270472784,-1.45097680044676
"1478","서울","강남구",2009,3378,1746,1632,"6",2008,3969,2039,1930,462768,488710,0.946917394773997,0.851095993953137,0.898807011731229,0.72995539881755,-0.0738663681092702,-3.32000210601007
"1479","서울","강남구",2010,3545,1848,1697,"6",2009,4122,2122,2000,470657,487028,0.966385916210156,0.860019408054343,0.889933714500985,0.753202438293704,-0.0829021946117887,-3.72134175857442
"1480","서울","강남구",2011,3548,1876,1672,"6",2010,4187,2177,2010,441332,457372,0.964930078798003,0.847384762359685,0.878182555377751,0.803929921238433,-0.0979326886606316,-4.38894347245766
"1481","서울","강남구",2012,3132,1645,1487,"6",2011,3734,1927,1807,407210,420797,0.967711271705834,0.838778789501875,0.86676554673515,0.769136317870386,-0.102475456797601,-4.59071726539884
"1482","서울","강남구",2013,3320,1698,1622,"6",2012,3948,2002,1946,422944,435284,0.971650692421499,0.840932117527862,0.865467522523072,0.784973897253537,-0.105604483152238,-4.72969761763168
"1483","서울","강남구",2014,3846,2003,1843,"6",2013,4488,2308,2180,465061,480776,0.967313260229296,0.856951871657754,0.885909360380957,0.826988287557976,-0.0943516226849465,-4.22988510916451
"1484","서울","강남구",2015,3970,2089,1881,"6",2014,4540,2368,2172,441255,454993,0.969806128885499,0.874449339207048,0.901674379199856,0.899706518906301,-0.0884642020093982,-3.96838657687573
"1485","서울","강남구",2016,3703,1896,1807,"6",2015,4317,2185,2132,422114,435131,0.970084870992873,0.857771600648599,0.88422325334347,0.877251169115452,-0.101565286360825,-4.55029069382089
"1486","서울","강남구",2017,3957,2060,1897,"6",2016,4566,2366,2200,445571,460063,0.968499966308962,0.866622864651774,0.89480939060282,0.88807395454372,-0.0934170404682174,-4.18837425212777
"1487","서울","강남구",2018,3938,2056,1882,"6",2017,4590,2398,2192,447106,462352,0.967025123715265,0.857952069716776,0.88720763160792,0.880775476061605,-0.0993447519666504,-4.45166236114797
"1488","서울","강남구",2019,4096,2116,1980,"6",2018,4689,2421,2268,462528,478982,0.965647978420901,0.873533802516528,0.904608948640886,0.88556800885568,-0.0844752634147406,-3.79121194550867
"1489","서울","강남구",2020,3913,2064,1849,"6",2019,4425,2309,2116,417119,431843,0.965904275396382,0.884293785310734,0.915508718447118,0.938101596906398,-0.0792614061494266,-3.55963073234595
"1490","서울","강동구",2009,3747,1975,1772,"6",2008,4022,2138,1884,462768,488710,0.946917394773997,0.931626056688215,0.983851455079213,0.809692977906856,-0.0130753634257743,-0.619879356651041
"1491","서울","강동구",2010,3930,2025,1905,"6",2009,4151,2160,1991,470657,487028,0.966385916210156,0.946759816911588,0.979691240352989,0.835002985188789,-0.016957874930736,-0.792326870782046
"1492","서울","강동구",2011,3823,1997,1826,"6",2010,4035,2080,1955,441332,457372,0.964930078798003,0.947459727385378,0.981894697039202,0.866241287738029,-0.0156835609516489,-0.735726323009006
"1493","서울","강동구",2012,3433,1774,1659,"6",2011,3684,1904,1780,407210,420797,0.967711271705834,0.931867535287731,0.962960298731542,0.843053952506078,-0.0312264665540179,-1.4260875569876
"1494","서울","강동구",2013,3587,1873,1714,"6",2012,3878,2019,1859,422944,435284,0.971650692421499,0.924961320268179,0.951948398207834,0.848102822123023,-0.0407526990874675,-1.84920932168241
"1495","서울","강동구",2014,3845,2032,1813,"6",2013,4134,2174,1960,465061,480776,0.967313260229296,0.930091920657958,0.961520904238908,0.826773262002189,-0.031813487521293,-1.45216096499167
"1496","서울","강동구",2015,3665,1924,1741,"6",2014,3960,2071,1889,441255,454993,0.969806128885499,0.92550505050505,0.954319655175453,0.830585489116271,-0.0379414315490964,-1.72434269915477
"1497","서울","강동구",2016,3229,1646,1583,"6",2015,3541,1811,1730,422114,435131,0.970084870992873,0.911889296808811,0.940009811590506,0.764959229023439,-0.0458900482746976,-2.07739231494041
"1498","서울","강동구",2017,3470,1806,1664,"6",2016,3620,1895,1725,445571,460063,0.968499966308962,0.958563535911602,0.989740391592136,0.778775997540235,-0.00798993677220681,-0.394002579832081
"1499","서울","강동구",2018,3210,1697,1513,"6",2017,3476,1819,1657,447106,462352,0.967025123715265,0.923475258918297,0.95496511545672,0.717950553112685,-0.0323328202672136,-1.47522790012538
"1500","서울","강동구",2019,3292,1711,1581,"6",2018,3576,1861,1715,462528,478982,0.965647978420901,0.920581655480984,0.953330484869225,0.711740694617407,-0.0332165931166355,-1.51448198365985
"1501","서울","강동구",2020,3404,1798,1606,"6",2019,3326,1770,1556,417119,431843,0.965904275396382,1.02345159350571,1.05957869695288,0.816074069989619,0.0486206297070131,2.12043979861642
"1502","서울","강북구",2009,2349,1214,1135,"6",2008,2808,1461,1347,462768,488710,0.946917394773997,0.836538461538462,0.883433408400022,0.507597759568509,-0.0591689407366861,-2.66719404316619
"1503","서울","강북구",2010,2358,1207,1151,"6",2009,2779,1436,1343,470657,487028,0.966385916210156,0.848506657070889,0.878020512134996,0.501001791113274,-0.0611119418994468,-2.75349532522126
"1504","서울","강북구",2011,2155,1050,1105,"6",2010,2603,1279,1324,441332,457372,0.964930078798003,0.827890895121014,0.857980192878125,0.488294526569567,-0.0693474944820773,-3.11928962320462
"1505","서울","강북구",2012,1945,990,955,"6",2011,2302,1187,1115,407210,420797,0.967711271705834,0.844917463075586,0.873109043760756,0.477640529456546,-0.0606082635213598,-2.73112370208205
"1506","서울","강북구",2013,1972,1012,960,"6",2012,2365,1242,1123,422944,435284,0.971650692421499,0.833826638477801,0.858154730893857,0.466255579934932,-0.0661361482081115,-2.97665290950743
"1507","서울","강북구",2014,2041,1062,979,"6",2013,2478,1295,1183,465061,480776,0.967313260229296,0.82364810330912,0.851480215534189,0.43886715936189,-0.0651804559175506,-2.9342044171924
"1508","서울","강북구",2015,1855,928,927,"6",2014,2284,1138,1146,441255,454993,0.969806128885499,0.812171628721541,0.83745771915763,0.420391836919695,-0.0683314480204407,-3.07416041075363
"1509","서울","강북구",2016,1778,898,880,"6",2015,2203,1127,1076,422114,435131,0.970084870992873,0.80708125283704,0.831969734783102,0.421213226758648,-0.0707765702051212,-3.18276414366102
"1510","서울","강북구",2017,1791,911,880,"6",2016,2244,1148,1096,445571,460063,0.968499966308962,0.798128342245989,0.824087114104636,0.401956141669902,-0.0707092648845185,-3.17977467789617
"1511","서울","강북구",2018,1753,897,856,"6",2017,2134,1093,1041,447106,462352,0.967025123715265,0.821462043111528,0.849473320771139,0.392077046606398,-0.0590180558275203,-2.66049226585728
"1512","서울","강북구",2019,1706,892,814,"6",2018,2112,1095,1017,462528,478982,0.965647978420901,0.807765151515151,0.836500639535402,0.368842534938425,-0.0603055185745738,-2.71767683568584
"1513","서울","강북구",2020,1528,810,718,"6",2019,1842,976,866,417119,431843,0.965904275396382,0.829533116178067,0.858815037170892,0.366322320488877,-0.0517192032016949,-2.33630288748103
"1514","서울","강서구",2009,5290,2774,2516,"6",2008,5419,2845,2574,462768,488710,0.946917394773997,0.976194869902196,1.03091872141095,1.1431213912803,0.0353438518358921,1.53073199308425
"1515","서울","강서구",2010,5328,2743,2585,"6",2009,5449,2780,2669,470657,487028,0.966385916210156,0.977794090658836,1.01180498831504,1.13203458144679,0.0133636550062007,0.554448909686688
"1516","서울","강서구",2011,4919,2540,2379,"6",2010,5120,2653,2467,441332,457372,0.964930078798003,0.9607421875,0.995659901800119,1.11458040658733,-0.00483738841625257,-0.253977462979925
"1517","서울","강서구",2012,4386,2224,2162,"6",2011,4508,2270,2238,407210,420797,0.967711271705834,0.972937000887311,1.00540009126097,1.07708553326294,0.00581636017548629,0.219224601836675
"1518","서울","강서구",2013,4427,2324,2103,"6",2012,4549,2374,2175,422944,435284,0.971650692421499,0.973180918883271,1.00157487302145,1.046710675645,0.00164843640434095,0.0341000780579267
"1519","서울","강서구",2014,4807,2442,2365,"6",2013,4962,2515,2447,465061,480776,0.967313260229296,0.968762595727529,1.00149831037971,1.03362784666958,0.00154869533142294,0.0296699301859914
"1520","서울","강서구",2015,4757,2433,2324,"6",2014,4905,2490,2415,441255,454993,0.969806128885499,0.969826707441386,1.0000212192471,1.0780614383973,2.28756520492224e-05,-0.0381016167582754
"1521","서울","강서구",2016,4413,2289,2124,"6",2015,4519,2337,2182,422114,435131,0.970084870992873,0.976543483071476,1.00665778043935,1.04545217642627,0.00696039105048342,0.270038432067507
"1522","서울","강서구",2017,4529,2353,2176,"6",2016,4713,2434,2279,445571,460063,0.968499966308962,0.960959049437725,0.992213818137779,1.01644855702009,-0.0079142533185508,-0.390640986845905
"1523","서울","강서구",2018,4816,2460,2356,"6",2017,5036,2557,2479,447106,462352,0.967025123715265,0.956314535345512,0.988924188103198,1.07714949027747,-0.0119303051390498,-0.569019892402601
"1524","서울","강서구",2019,4946,2556,2390,"6",2018,5180,2665,2515,462528,478982,0.965647978420901,0.954826254826255,0.988793303733372,1.06934066694341,-0.0119837760599879,-0.571394882761881
"1525","서울","강서구",2020,4277,2180,2097,"6",2019,4576,2329,2247,417119,431843,0.965904275396382,0.934659090909091,0.967651883024879,1.0253668617349,-0.0331686871858132,-1.51235417060073
"1526","서울","관악구",2009,3626,1916,1710,"6",2008,4110,2124,1986,462768,488710,0.946917394773997,0.882238442822384,0.931695254191577,0.783545966877571,-0.0535199080967878,-2.4162838694937
"1527","서울","관악구",2010,3663,1895,1768,"6",2009,4049,2068,1981,470657,487028,0.966385916210156,0.904667819214621,0.936135144396999,0.778273774744665,-0.0497043422436705,-2.24680984590553
"1528","서울","관악구",2011,3379,1767,1612,"6",2010,3737,1928,1809,441332,457372,0.964930078798003,0.904201230933904,0.937063991268935,0.76563675418959,-0.0481861214465003,-2.17937581459888
"1529","서울","관악구",2012,3148,1594,1554,"6",2011,3506,1795,1711,407210,420797,0.967711271705834,0.897889332572733,0.927848376706388,0.773065494462317,-0.0557779303377352,-2.51657728055154
"1530","서울","관악구",2013,3029,1606,1423,"6",2012,3389,1808,1581,422944,435284,0.971650692421499,0.893773974623783,0.919851116862135,0.716170462283423,-0.057400262688345,-2.58863558111277
"1531","서울","관악구",2014,3225,1623,1602,"6",2013,3579,1789,1790,465061,480776,0.967313260229296,0.901089689857502,0.931538651340212,0.69345741741406,-0.0474750300343,-2.14779163353537
"1532","서울","관악구",2015,3014,1560,1454,"6",2014,3242,1681,1561,441255,454993,0.969806128885499,0.929673041332511,0.958617411916019,0.683051750121812,-0.028266449215333,-1.2946139911814
"1533","서울","관악구",2016,2732,1422,1310,"6",2015,2982,1558,1424,422114,435131,0.970084870992873,0.916163648558015,0.944415974264529,0.647218523905864,-0.035975011089257,-1.63700121424164
"1534","서울","관악구",2017,2769,1411,1358,"6",2016,3055,1565,1490,445571,460063,0.968499966308962,0.906382978723404,0.935862684825596,0.621449780169715,-0.0398581204158093,-1.80947528150637
"1535","서울","관악구",2018,2687,1393,1294,"6",2017,3035,1557,1478,447106,462352,0.967025123715265,0.885337726523888,0.915527120042613,0.60097605489526,-0.0507661781424311,-2.29397286420498
"1536","서울","관악구",2019,2581,1318,1263,"6",2018,2875,1471,1404,462528,478982,0.965647978420901,0.897739130434783,0.929675358408384,0.558020271205203,-0.0392425755733622,-1.78213494322778
"1537","서울","관악구",2020,2302,1169,1133,"6",2019,2538,1291,1247,417119,431843,0.965904275396382,0.907013396375098,0.939030315403546,0.551880878118714,-0.0336480030737122,-1.53364369755925
"1538","서울","광진구",2009,3003,1547,1456,"6",2008,3075,1587,1488,462768,488710,0.946917394773997,0.976585365853659,1.03133110791226,0.648921273726792,0.0203314224536963,0.863932648196672
"1539","서울","광진구",2010,2935,1539,1396,"6",2009,3098,1620,1478,470657,487028,0.966385916210156,0.947385409941898,0.980338593568528,0.623596376979414,-0.0122607818169857,-0.583698504820233
"1540","서울","광진구",2011,2839,1442,1397,"6",2010,2922,1496,1426,441332,457372,0.964930078798003,0.971594798083504,1.00690694531339,0.643279889063109,0.00444309901496182,0.158229168060763
"1541","서울","광진구",2012,2528,1266,1262,"6",2011,2560,1292,1268,407210,420797,0.967711271705834,0.9875,1.0204490005157,0.620809901525012,0.0126949419964393,0.52474702830062
"1542","서울","광진구",2013,2689,1341,1348,"6",2012,2702,1341,1361,422944,435284,0.971650692421499,0.995188749074759,1.0242248133376,0.635781569191193,0.0154016898371426,0.644971253241677
"1543","서울","광진구",2014,2817,1416,1401,"6",2013,2847,1443,1404,465061,480776,0.967313260229296,0.989462592202318,1.02289778594348,0.605726990652839,0.0138698069721584,0.576930400904518
"1544","서울","광진구",2015,2601,1364,1237,"6",2014,2591,1345,1246,441255,454993,0.969806128885499,1.00385951370127,1.03511360033877,0.589455076996295,0.0206978899913063,0.880209848094156
"1545","서울","광진구",2016,2407,1246,1161,"6",2015,2378,1224,1154,422114,435131,0.970084870992873,1.01219512195122,1.04340883176051,0.570225105066404,0.0247528056514469,1.06031494880242
"1546","서울","광진구",2017,2550,1366,1184,"6",2016,2539,1338,1201,445571,460063,0.968499966308962,1.00433241433635,1.036997882575,0.572299364186628,0.0211738646739242,0.901350970458344
"1547","서울","광진구",2018,2480,1248,1232,"6",2017,2429,1205,1224,447106,462352,0.967025123715265,1.02099629477151,1.05581155001319,0.554678308946872,0.0309574561810203,1.33590371615294
"1548","서울","광진구",2019,2599,1350,1249,"6",2018,2568,1327,1241,462528,478982,0.965647978420901,1.01207165109034,1.04807515130447,0.561911927494119,0.0270140009340669,1.16074929521821
"1549","서울","광진구",2020,2244,1124,1120,"6",2019,2248,1144,1104,417119,431843,0.965904275396382,0.998220640569395,1.03345710956684,0.537975973283404,0.0179991210824683,0.760340019260833
"1550","서울","구로구",2009,3478,1790,1688,"6",2008,3842,1955,1887,462768,488710,0.946917394773997,0.905257678292556,0.956004909497534,0.751564498841752,-0.033065148144983,-1.50775533034388
"1551","서울","구로구",2010,3539,1820,1719,"6",2009,3780,1958,1822,470657,487028,0.966385916210156,0.936243386243386,0.968809013602993,0.751927624575859,-0.0234533643096794,-1.08083367753115
"1552","서울","구로구",2011,3447,1795,1652,"6",2010,3723,1941,1782,441332,457372,0.964930078798003,0.925866236905721,0.95951640149829,0.781044655724035,-0.0316194982542378,-1.44354464361593
"1553","서울","구로구",2012,3288,1778,1510,"6",2011,3512,1917,1595,407210,420797,0.967711271705834,0.93621867881549,0.967456622846987,0.807445789641708,-0.0262770128629224,-1.20625022122048
"1554","서울","구로구",2013,3371,1726,1645,"6",2012,3613,1868,1745,422944,435284,0.971650692421499,0.933019651259341,0.960241842605099,0.797032231217372,-0.0316885328975492,-1.44661091981698
"1555","서울","구로구",2014,3665,1867,1798,"6",2013,3865,1966,1899,465061,480776,0.967313260229296,0.948253557567917,0.980296245854357,0.788068661960474,-0.0155279111651553,-0.728812906597612
"1556","서울","구로구",2015,3516,1788,1728,"6",2014,3718,1903,1815,441255,454993,0.969806128885499,0.945669714900484,0.975112124716357,0.796818166366387,-0.0198311111482679,-0.919945924219841
"1557","서울","구로구",2016,3329,1689,1640,"6",2015,3536,1801,1735,422114,435131,0.970084870992873,0.9414592760181,0.970491659203513,0.788649511743273,-0.0232717385615036,-1.07276650020661
"1558","서울","구로구",2017,3464,1761,1703,"6",2016,3660,1859,1801,445571,460063,0.968499966308962,0.946448087431694,0.977230893500895,0.777429410800972,-0.0177013730500635,-0.825350443867475
"1559","서울","구로구",2018,3320,1684,1636,"6",2017,3531,1795,1736,447106,462352,0.967025123715265,0.940243557065987,0.972305200772464,0.74255322004178,-0.0205648623448176,-0.952536573255639
"1560","서울","구로구",2019,3305,1615,1690,"6",2018,3379,1651,1728,462528,478982,0.965647978420901,0.978100029594555,1.0128950212209,0.714551335270513,0.0092141546317335,0.370142688430658
"1561","서울","구로구",2020,3014,1551,1463,"6",2019,3206,1650,1556,417119,431843,0.965904275396382,0.940112289457268,0.97329757555061,0.722575571959081,-0.0192945196192123,-0.896112414603412
"1562","서울","금천구",2009,1970,1005,965,"6",2008,2052,1035,1017,462768,488710,0.946917394773997,0.960038986354776,1.01385716605609,0.425699270476783,0.00589898548095117,0.222894527479786
"1563","서울","금천구",2010,1994,1025,969,"6",2009,2019,1037,982,470657,487028,0.966385916210156,0.987617632491332,1.02197022527443,0.423663092230648,0.00930797357677,0.374309796198211
"1564","서울","금천구",2011,1799,926,873,"6",2010,1885,950,935,441332,457372,0.964930078798003,0.954376657824934,0.989063020000149,0.407629630300998,-0.00445823711394885,-0.237136894837821
"1565","서울","금천구",2012,1645,842,803,"6",2011,1652,840,812,407210,420797,0.967711271705834,0.995762711864407,1.02898740665604,0.40396846835785,0.0117099982685074,0.480999289955549
"1566","서울","금천구",2013,1661,850,811,"6",2012,1671,839,832,422944,435284,0.971650692421499,0.994015559545183,1.02301739431477,0.392723386547628,0.00903946904479781,0.362383768673929
"1567","서울","금천구",2014,1715,860,855,"6",2013,1732,879,853,465061,480776,0.967313260229296,0.990184757505774,1.02364435412687,0.368768828175229,0.00871930076432567,0.348163019037911
"1568","서울","금천구",2015,1550,797,753,"6",2014,1550,791,759,441255,454993,0.969806128885499,1,1.03113392482805,0.351270807129664,0.0109364389034625,0.446640501999796
"1569","서울","금천구",2016,1510,776,734,"6",2015,1484,764,720,422114,435131,0.970084870992873,1.01752021563342,1.04889813877006,0.357723269069493,0.0174920020522412,0.737815574447363
"1570","서울","금천구",2017,1610,828,782,"6",2016,1536,806,730,445571,460063,0.968499966308962,1.04817708333333,1.08226858006823,0.361334108368812,0.0297264440257238,1.28122648318797
"1571","서울","금천구",2018,1561,786,775,"6",2017,1510,756,754,447106,462352,0.967025123715265,1.03377483443709,1.06902582888992,0.349134209784704,0.0240992782242156,1.03128755761545
"1572","서울","금천구",2019,1656,844,812,"6",2018,1657,840,817,462528,478982,0.965647978420901,0.99939649969825,1.03494909328401,0.358032378580324,0.0125129069977002,0.516661673504559
"1573","서울","금천구",2020,1336,676,660,"6",2019,1286,656,630,417119,431843,0.965904275396382,1.03888024883359,1.07555197269135,0.320292290689228,0.0241987143994039,1.03570416300194
"1574","서울","노원구",2009,5899,2997,2902,"6",2008,6167,3105,3062,462768,488710,0.946917394773997,0.956542889573537,1.01016508393727,1.27472081042769,0.0129576440345837,0.536415329444674
"1575","서울","노원구",2010,5881,3089,2792,"6",2009,5969,3127,2842,470657,487028,0.966385916210156,0.985257162003686,1.01952764985187,1.24952991244154,0.0244003826095948,1.04466155604049
"1576","서울","노원구",2011,5545,2878,2667,"6",2010,5689,2917,2772,441332,457372,0.964930078798003,0.97468799437511,1.01011256234158,1.25642373541914,0.0127056633518628,0.525223233223267
"1577","서울","노원구",2012,4907,2527,2380,"6",2011,4974,2531,2443,407210,420797,0.967711271705834,0.986529955770004,1.01944658971575,1.20502934603767,0.0234337112878327,1.00172541375049
"1578","서울","노원구",2013,4883,2532,2351,"6",2012,4954,2583,2371,422944,435284,0.971650692421499,0.985668146951958,1.01442643394359,1.15452636755693,0.0166556983776887,0.700669904807772
"1579","서울","노원구",2014,5183,2664,2519,"6",2013,5229,2703,2526,465061,480776,0.967313260229296,0.991202906865557,1.02469690804259,1.1144774556456,0.0275241472376197,1.18340820087203
"1580","서울","노원구",2015,4895,2507,2388,"6",2014,4918,2521,2397,441255,454993,0.969806128885499,0.995323302155348,1.02631162302426,1.1093358715482,0.0291884272594608,1.25732966954446
"1581","서울","노원구",2016,4329,2220,2109,"6",2015,4288,2205,2083,422114,435131,0.970084870992873,1.00956156716418,1.04069406435635,1.02555233894161,0.0417338928816953,1.81455515552321
"1582","서울","노원구",2017,4470,2271,2199,"6",2016,4485,2291,2194,445571,460063,0.968499966308962,0.996655518394649,1.0290712989831,1.00320712075068,0.0291645341493144,1.25626842157537
"1583","서울","노원구",2018,4236,2146,2090,"6",2017,4223,2146,2077,447106,462352,0.967025123715265,1.00307838029837,1.03728264726421,0.947426337378608,0.0353225619453053,1.52978637097776
"1584","서울","노원구",2019,4318,2217,2101,"6",2018,4322,2221,2101,462528,478982,0.965647978420901,0.999074502545118,1.03461564138401,0.933565103085651,0.0323159548170438,1.39624345048037
"1585","서울","노원구",2020,3821,1979,1842,"6",2019,3764,1961,1803,417119,431843,0.965904275396382,1.01514346439957,1.0509772968786,0.916045540960733,0.046697525495875,2.03502226921521
"1586","서울","도봉구",2009,3371,1751,1620,"6",2008,3319,1711,1608,462768,488710,0.946917394773997,1.01566736968967,1.07260398351017,0.728442761815856,0.0528878462669843,2.30997455906344
"1587","서울","도봉구",2010,3432,1741,1691,"6",2009,3267,1646,1621,470657,487028,0.966385916210156,1.05050505050505,1.08704507473037,0.729193446607614,0.0634726980528589,2.78011646993389
"1588","서울","도봉구",2011,3209,1631,1578,"6",2010,3120,1595,1525,441332,457372,0.964930078798003,1.02852564102564,1.06590691245407,0.727117000353475,0.0479220364861622,2.08941074328187
"1589","서울","도봉구",2012,2781,1452,1329,"6",2011,2658,1367,1291,407210,420797,0.967711271705834,1.04627539503386,1.08118549987491,0.682940006384912,0.0554448258029351,2.42354660233879
"1590","서울","도봉구",2013,2891,1517,1374,"6",2012,2720,1405,1315,422944,435284,0.971650692421499,1.06286764705882,1.09387834058966,0.683542029204812,0.0641697914250363,2.8110789072623
"1591","서울","도봉구",2014,3151,1619,1532,"6",2013,2954,1516,1438,465061,480776,0.967313260229296,1.06668923493568,1.10273401471084,0.677545526285799,0.0696069720647073,3.05257935973855
"1592","서울","도봉구",2015,2813,1464,1349,"6",2014,2594,1360,1234,441255,454993,0.969806128885499,1.08442559753277,1.11818802256796,0.637499858358546,0.0753448476467533,3.30743562462079
"1593","서울","도봉구",2016,2684,1360,1324,"6",2015,2506,1280,1226,422114,435131,0.970084870992873,1.07102952913009,1.10405755326737,0.635847188200344,0.0661647026560671,2.89968585208749
"1594","서울","도봉구",2017,2737,1411,1326,"6",2016,2608,1328,1280,445571,460063,0.968499966308962,1.04946319018405,1.08359651697629,0.614267984226981,0.0513506639714244,2.24169832464746
"1595","서울","도봉구",2018,2572,1313,1259,"6",2017,2467,1261,1206,447106,462352,0.967025123715265,1.04256181597081,1.07811244031111,0.575255084923933,0.0449345784847818,1.9567183596919
"1596","서울","도봉구",2019,2601,1348,1253,"6",2018,2486,1304,1182,462528,478982,0.965647978420901,1.04625905068383,1.08347873558929,0.562344333748443,0.0469437939471204,2.04596064819281
"1597","서울","도봉구",2020,2214,1137,1077,"6",2019,2128,1095,1033,417119,431843,0.965904275396382,1.04041353383459,1.07713938154754,0.530783781127208,0.0409443326116189,1.77948566360869
"1598","서울","동대문구",2009,2796,1388,1408,"6",2008,3023,1529,1494,462768,488710,0.946917394773997,0.924909030764142,0.976757883917521,0.604190436676693,-0.0140426642651631,-0.662843459901284
"1599","서울","동대문구",2010,2808,1450,1358,"6",2009,2947,1515,1432,470657,487028,0.966385916210156,0.952833389888022,0.985976072193515,0.596612819951685,-0.00836685511542558,-0.41074396778042
"1600","서울","동대문구",2011,2664,1371,1293,"6",2010,2812,1459,1353,441332,457372,0.964930078798003,0.947368421052632,0.981800072221557,0.603627201290638,-0.0109859714685932,-0.527075910067373
"1601","서울","동대문구",2012,2384,1249,1135,"6",2011,2547,1311,1236,407210,420797,0.967711271705834,0.936003140950137,0.967233893328737,0.585447312197638,-0.0191828290818721,-0.891151513523877
"1602","서울","동대문구",2013,2501,1260,1241,"6",2012,2595,1318,1277,422944,435284,0.971650692421499,0.963776493256262,0.991896059739726,0.591331240069607,-0.00479211304355774,-0.25196649006649
"1603","서울","동대문구",2014,2693,1430,1263,"6",2013,2813,1463,1350,465061,480776,0.967313260229296,0.957340917170281,0.989690678843117,0.579063821735213,-0.00596975490860029,-0.304273202333449
"1604","서울","동대문구",2015,2596,1329,1267,"6",2014,2686,1357,1329,441255,454993,0.969806128885499,0.966492926284438,0.996583644398217,0.588321945360393,-0.00200991697368391,-0.128391119984095
"1605","서울","동대문구",2016,2348,1218,1130,"6",2015,2479,1254,1225,422114,435131,0.970084870992873,0.947156111335216,0.976364171483068,0.556247838261702,-0.0131473785180677,-0.623078013919679
"1606","서울","동대문구",2017,2396,1217,1179,"6",2016,2527,1284,1243,445571,460063,0.968499966308962,0.94815987336763,0.978998354518431,0.53773697121222,-0.0112933612317318,-0.540729082879563
"1607","서울","동대문구",2018,2284,1168,1116,"6",2017,2408,1235,1173,447106,462352,0.967025123715265,0.948504983388704,0.980848335919746,0.510840829691393,-0.0097834519687276,-0.473664220705762
"1608","서울","동대문구",2019,2386,1227,1159,"6",2018,2542,1287,1255,462528,478982,0.965647978420901,0.938630999213218,0.972021917084253,0.515860661408607,-0.0144327923578619,-0.680171578489625
"1609","서울","동대문구",2020,2136,1117,1019,"6",2019,2251,1175,1076,417119,431843,0.965904275396382,0.948911594846735,0.982407490076929,0.512084081521101,-0.00900884428560674,-0.439258870145883
"1610","서울","동작구",2009,3311,1731,1580,"6",2008,3498,1843,1655,462768,488710,0.946917394773997,0.946540880503145,0.999602378968926,0.715477301801335,-0.000284488822452522,-0.0517536663381084
"1611","서울","동작구",2010,3219,1675,1544,"6",2009,3354,1746,1608,470657,487028,0.966385916210156,0.959749552772809,0.993132801993459,0.6839375596241,-0.00469673464604914,-0.247730116901559
"1612","서울","동작구",2011,3075,1588,1487,"6",2010,3332,1724,1608,441332,457372,0.964930078798003,0.922869147659064,0.956410384479533,0.696754370859126,-0.0303712551379542,-1.38810207193027
"1613","서울","동작구",2012,2821,1432,1389,"6",2011,3010,1530,1480,407210,420797,0.967711271705834,0.937209302325581,0.968480299576871,0.692762947864738,-0.0218356805809402,-1.00898185241363
"1614","서울","동작구",2013,3028,1552,1476,"6",2012,3075,1562,1513,422944,435284,0.971650692421499,0.984715447154472,1.01344593775816,0.715934024362563,0.00962640433052767,0.38845337100493
"1615","서울","동작구",2014,3176,1718,1458,"6",2013,3313,1782,1531,465061,480776,0.967313260229296,0.958647751282825,0.991041672534897,0.682921165180482,-0.00611783143053664,-0.310850240953027
"1616","서울","동작구",2015,2904,1475,1429,"6",2014,3076,1587,1489,441255,454993,0.969806128885499,0.94408322496749,0.973476241125049,0.658122854131964,-0.017455891893091,-0.81444703373416
"1617","서울","동작구",2016,2807,1412,1395,"6",2015,2958,1477,1481,422114,435131,0.970084870992873,0.94895199459094,0.978215435541939,0.66498623594574,-0.014486435520683,-0.682554219227924
"1618","서울","동작구",2017,2950,1561,1389,"6",2016,3145,1637,1508,445571,460063,0.968499966308962,0.937996820349762,0.968504752689408,0.662071813470805,-0.020852115502635,-0.965295348839065
"1619","서울","동작구",2018,2801,1419,1382,"6",2017,2970,1523,1447,447106,462352,0.967025123715265,0.943097643097643,0.975256609129561,0.62647336425814,-0.0155010753217581,-0.727620952761147
"1620","서울","동작구",2019,2805,1427,1378,"6",2018,3053,1557,1496,462528,478982,0.965647978420901,0.918768424500491,0.951452749896426,0.606449771689498,-0.0294414687414651,-1.34680422837141
"1621","서울","동작구",2020,2545,1287,1258,"6",2019,2719,1353,1366,417119,431843,0.965904275396382,0.936005884516366,0.969046217475591,0.610137634583896,-0.018886067650867,-0.877970413866764
"1622","서울","마포구",2009,2926,1480,1446,"6",2008,3459,1790,1669,462768,488710,0.946917394773997,0.845909222318589,0.893329478354851,0.632282266708156,-0.0674458792167362,-3.03482655724266
"1623","서울","마포구",2010,3122,1603,1519,"6",2009,3544,1812,1732,470657,487028,0.966385916210156,0.880925507900677,0.911566997328949,0.663328071185598,-0.0586600930909393,-2.64459281932737
"1624","서울","마포구",2011,3052,1548,1504,"6",2010,3435,1743,1692,441332,457372,0.964930078798003,0.888500727802038,0.920792860876333,0.691542874751887,-0.0547751326904536,-2.47203653386498
"1625","서울","마포구",2012,2774,1427,1347,"6",2011,3042,1579,1463,407210,420797,0.967711271705834,0.91190006574622,0.942326593074365,0.681220991625942,-0.0392883354563279,-1.78416743638441
"1626","서울","마포구",2013,2813,1439,1374,"6",2012,3160,1607,1553,422944,435284,0.971650692421499,0.890189873417721,0.916162444344309,0.665099871377771,-0.0557603474832266,-2.51579631195751
"1627","서울","마포구",2014,3100,1583,1517,"6",2013,3427,1768,1659,465061,480776,0.967313260229296,0.904581266413773,0.935148212688977,0.666579222940646,-0.0432288539920941,-1.95919141893066
"1628","서울","마포구",2015,2917,1505,1412,"6",2014,3250,1690,1560,441255,454993,0.969806128885499,0.897538461538462,0.925482356530281,0.66106899638531,-0.0492613037815254,-2.22713163468485
"1629","서울","마포구",2016,2638,1363,1275,"6",2015,2985,1553,1432,422114,435131,0.970084870992873,0.883752093802345,0.911004923618521,0.62494965814922,-0.0556174425615693,-2.50944897764429
"1630","서울","마포구",2017,2676,1366,1310,"6",2016,3063,1561,1502,445571,460063,0.968499966308962,0.873653281096964,0.902068468238086,0.600577685711144,-0.0588154927037174,-2.65149512390168
"1631","서울","마포구",2018,2458,1223,1235,"6",2017,2860,1417,1443,447106,462352,0.967025123715265,0.859440559440559,0.888746877783929,0.549757775561053,-0.0611622689937289,-2.75573067785094
"1632","서울","마포구",2019,2572,1312,1260,"6",2018,2981,1522,1459,462528,478982,0.965647978420901,0.86279771888628,0.893490938900106,0.556074443060744,-0.0592269668320465,-2.669771358362
"1633","서울","마포구",2020,2211,1092,1119,"6",2019,2609,1288,1321,417119,431843,0.965904275396382,0.847451130701418,0.877365544689867,0.530064561911589,-0.0650041788292321,-2.92637480853833
"1634","서울","서대문구",2009,2657,1405,1252,"6",2008,2784,1482,1302,462768,488710,0.946917394773997,0.954382183908046,1.00788325272642,0.574153787643052,0.00452619941182305,0.161920195593767
"1635","서울","서대문구",2010,2666,1342,1324,"6",2009,2753,1412,1341,470657,487028,0.966385916210156,0.968398111151471,1.00208218570611,0.566442228629342,0.0011794379117867,0.0132688135352556
"1636","서울","서대문구",2011,2435,1235,1200,"6",2010,2586,1304,1282,441332,457372,0.964930078798003,0.941608662026295,0.975830977514186,0.55173882700552,-0.013334988116193,-0.631410972825913
"1637","서울","서대문구",2012,2166,1096,1070,"6",2011,2173,1080,1093,407210,420797,0.967711271705834,0.996778647031753,1.03003723959387,0.531912281132585,0.0159771766313026,0.670532353818269
"1638","서울","서대문구",2013,2272,1152,1120,"6",2012,2300,1160,1140,422944,435284,0.971650692421499,0.987826086956522,1.016647334954,0.537186956192782,0.00894273119265843,0.358087013312744
"1639","서울","서대문구",2014,2204,1102,1102,"6",2013,2228,1120,1108,465061,480776,0.967313260229296,0.989228007181329,1.02265527399763,0.473916324955221,0.010736704193809,0.43776898825891
"1640","서울","서대문구",2015,2109,1080,1029,"6",2014,2110,1088,1022,441255,454993,0.969806128885499,0.999526066350711,1.03064523576415,0.477954924023524,0.0146470413313362,0.611452419182156
"1641","서울","서대문구",2016,2213,1110,1103,"6",2015,2166,1081,1085,422114,435131,0.970084870992873,1.02169898430286,1.05320577080762,0.524265956589926,0.0278939743285627,1.19983462031983
"1642","서울","서대문구",2017,2288,1220,1068,"6",2016,2243,1195,1048,445571,460063,0.968499966308962,1.0200624164066,1.05323949601583,0.513498409905492,0.0273383965482978,1.17515780816083
"1643","서울","서대문구",2018,2140,1054,1086,"6",2017,2143,1035,1108,447106,462352,0.967025123715265,0.998600093327112,1.03265165385832,0.478633702075123,0.0156281819650817,0.655031237451231
"1644","서울","서대문구",2019,2243,1144,1099,"6",2018,2306,1195,1111,462528,478982,0.965647978420901,0.972679965307892,1.00728214322831,0.484943614224436,0.00353142885643789,0.117735984114249
"1645","서울","서대문구",2020,2179,1104,1075,"6",2019,2128,1088,1040,417119,431843,0.965904275396382,1.02396616541353,1.06011143287809,0.522392890278314,0.0314017851599571,1.35563924759337
"1646","서울","서초구",2009,3120,1600,1520,"6",2008,3547,1806,1741,462768,488710,0.946917394773997,0.879616577389343,0.928926411367998,0.674203920755108,-0.0479180921178312,-2.167470893935
"1647","서울","서초구",2010,3468,1819,1649,"6",2009,3909,2028,1881,470657,487028,0.966385916210156,0.887183422870299,0.918042583184094,0.736842328914687,-0.060389693878464,-2.7214156068108
"1648","서울","서초구",2011,3431,1763,1668,"6",2010,3852,1959,1893,441332,457372,0.964930078798003,0.890706126687435,0.923078413927124,0.777419267127695,-0.0598003230710751,-2.6952378271685
"1649","서울","서초구",2012,3225,1683,1542,"6",2011,3612,1880,1732,407210,420797,0.967711271705834,0.892857142857143,0.922648282563928,0.791974656810982,-0.0612605998701731,-2.76009818975231
"1650","서울","서초구",2013,3547,1804,1743,"6",2012,3859,2011,1848,422944,435284,0.971650692421499,0.919150038870174,0.945967564310085,0.838645305288643,-0.0453140485246576,-2.05180843066665
"1651","서울","서초구",2014,3840,1982,1858,"6",2013,4303,2201,2102,465061,480776,0.967313260229296,0.892400650708808,0.922555998557561,0.825698134223252,-0.0639453674978049,-2.87934613088856
"1652","서울","서초구",2015,3926,1998,1928,"6",2014,4524,2290,2234,441255,454993,0.969806128885499,0.867816091954023,0.894834612925489,0.889734960510362,-0.0935693215157968,-4.19513804099762
"1653","서울","서초구",2016,3662,1865,1797,"6",2015,4168,2108,2060,422114,435131,0.970084870992873,0.878598848368522,0.90569276425194,0.86753815320032,-0.0818151251342993,-3.67305795340316
"1654","서울","서초구",2017,4031,2064,1967,"6",2016,4561,2337,2224,445571,460063,0.968499966308962,0.88379741284806,0.912542533394491,0.904681857661293,-0.0791211833550223,-3.55340252869771
"1655","서울","서초구",2018,3861,2018,1843,"6",2017,4389,2292,2097,447106,462352,0.967025123715265,0.879699248120301,0.909696373492902,0.863553609211238,-0.0779820225950685,-3.50280501185878
"1656","서울","서초구",2019,3854,1984,1870,"6",2018,4465,2295,2170,462528,478982,0.965647978420901,0.863157894736842,0.893863927668902,0.833246852082469,-0.0884375481622843,-3.96720270667446
"1657","서울","서초구",2020,3479,1831,1648,"6",2019,4047,2114,1933,417119,431843,0.965904275396382,0.859649122807018,0.889994117123293,0.834054550380107,-0.0917509071818985,-4.1143704679614
"1658","서울","성동구",2009,2624,1321,1303,"6",2008,2868,1444,1424,462768,488710,0.946917394773997,0.914923291492329,0.966212360805449,0.567022784635066,-0.019158361262339,-0.890064738983918
"1659","서울","성동구",2010,2581,1270,1311,"6",2009,2688,1323,1365,470657,487028,0.966385916210156,0.960193452380952,0.993592141891421,0.548382367626531,-0.00351395640099749,-0.195195264688827
"1660","서울","성동구",2011,2472,1282,1190,"6",2010,2602,1355,1247,441332,457372,0.964930078798003,0.950038431975403,0.984567123411523,0.560122538134556,-0.00864430200545506,-0.423067183417469
"1661","서울","성동구",2012,2192,1127,1065,"6",2011,2295,1175,1120,407210,420797,0.967711271705834,0.955119825708061,0.986988426852177,0.538297193094472,-0.00700409330321657,-0.350214878151766
"1662","서울","성동구",2013,2223,1155,1068,"6",2012,2289,1188,1101,422944,435284,0.971650692421499,0.971166448230668,0.999501627287864,0.525601498070667,-0.000261945444096303,-0.0507523687108698
"1663","서울","성동구",2014,2396,1186,1210,"6",2013,2554,1274,1280,465061,480776,0.967313260229296,0.938136256851997,0.969837068737812,0.515201231666384,-0.0155399793369476,-0.729348932369339
"1664","서울","성동구",2015,2147,1107,1040,"6",2014,2312,1206,1106,441255,454993,0.969806128885499,0.92863321799308,0.957545214794904,0.48656672445638,-0.0206570857747428,-0.956632813850138
"1665","서울","성동구",2016,1995,1006,989,"6",2015,2095,1075,1020,422114,435131,0.970084870992873,0.952267303102625,0.981632980347367,0.472621140260688,-0.00868064177141792,-0.424681268088277
"1666","서울","성동구",2017,2111,1092,1019,"6",2016,2222,1135,1087,445571,460063,0.968499966308962,0.95004500450045,0.980944798708826,0.473774101097244,-0.00902786086295279,-0.440103519668857
"1667","서울","성동구",2018,2100,1069,1031,"6",2017,2278,1162,1116,447106,462352,0.967025123715265,0.921861281826163,0.953296102881398,0.46968727773727,-0.0219362262973578,-1.01344773972152
"1668","서울","성동구",2019,2102,1042,1060,"6",2018,2332,1176,1156,462528,478982,0.965647978420901,0.901372212692967,0.933437684162046,0.45445897329459,-0.0302498417158266,-1.38270931448414
"1669","서울","성동구",2020,1891,987,904,"6",2019,2209,1125,1084,417119,431843,0.965904275396382,0.856043458578542,0.886261175546867,0.45334784557884,-0.0515632510244979,-2.32937603993749
"1670","서울","성북구",2009,4146,2139,2007,"6",2008,4427,2298,2129,462768,488710,0.946917394773997,0.936525864016264,0.989025937410081,0.895913287003423,-0.00983180848671569,-0.475812047262984
"1671","서울","성북구",2010,4427,2315,2112,"6",2009,4561,2389,2172,470657,487028,0.966385916210156,0.970620477965358,1.00438185375446,0.94060005481699,0.00412157188164447,0.143948062957691
"1672","서울","성북구",2011,4336,2285,2051,"6",2010,4466,2361,2105,441332,457372,0.964930078798003,0.970891177787729,1.00617775227522,0.982480309608186,0.0060695199680454,0.230469069972557
"1673","서울","성북구",2012,3986,2079,1907,"6",2011,4129,2166,1963,407210,420797,0.967711271705834,0.965366916929039,0.997577423302445,0.978856118464674,-0.00237135402285173,-0.144444883267007
"1674","서울","성북구",2013,4035,2069,1966,"6",2012,4105,2099,2006,422944,435284,0.971650692421499,0.982947624847747,1.01162653669097,0.954027010668079,0.011092030043711,0.453551313551127
"1675","서울","성북구",2014,4256,2171,2085,"6",2013,4383,2221,2162,465061,480776,0.967313260229296,0.971024412502852,1.00383655680754,0.915148765430771,0.00351102022592467,0.116829504482617
"1676","서울","성북구",2015,3876,2005,1871,"6",2014,3965,2051,1914,441255,454993,0.969806128885499,0.977553593947037,1.00798867405637,0.878403644151341,0.0070172804030536,0.27256525714419
"1677","서울","성북구",2016,3592,1841,1751,"6",2015,3698,1913,1785,422114,435131,0.970084870992873,0.971335857220119,1.00128956369144,0.850954955296436,0.0010973606133994,0.00962322844030097
"1678","서울","성북구",2017,3718,1878,1840,"6",2016,3763,1918,1845,445571,460063,0.968499966308962,0.988041456284879,1.02017706830739,0.834434916096425,0.0168364503001455,0.708698269865352
"1679","서울","성북구",2018,3604,1859,1745,"6",2017,3694,1901,1793,447106,462352,0.967025123715265,0.975636166756903,1.00890467355032,0.806072832840534,0.00717781543422357,0.279695658952614
"1680","서울","성북구",2019,3539,1827,1712,"6",2018,3600,1864,1736,462528,478982,0.965647978420901,0.983055555555556,1.01802683537237,0.765142867026429,0.0137931045002278,0.573523546708407
"1681","서울","성북구",2020,3137,1558,1579,"6",2019,3251,1614,1637,417119,431843,0.965904275396382,0.964933866502615,0.998995336371847,0.752063559799482,-0.000755570904589467,-0.0726774765862834
"1682","서울","송파구",2009,5683,2996,2687,"6",2008,6057,3205,2852,462768,488710,0.946917394773997,0.938253260690111,0.990850169052017,1.22804515437541,-0.0112364055590243,-0.538199312095496
"1683","서울","송파구",2010,5705,2999,2706,"6",2009,6267,3258,3009,470657,487028,0.966385916210156,0.910323918940482,0.941987981892854,1.21213537671808,-0.0703184194224813,-3.16241469628335
"1684","서울","송파구",2011,5636,2906,2730,"6",2010,6164,3194,2970,441332,457372,0.964930078798003,0.914341336794289,0.947572634416443,1.27704313306082,-0.0669520072029506,-3.01289049833663
"1685","서울","송파구",2012,5046,2619,2427,"6",2011,5545,2856,2689,407210,420797,0.967711271705834,0.910009017132552,0.940372447588042,1.23916406768007,-0.0738883203926087,-3.32097714927431
"1686","서울","송파구",2013,5184,2699,2485,"6",2012,5702,2949,2753,422944,435284,0.971650692421499,0.90915468256752,0.935680579099646,1.22569418173564,-0.0788359399701704,-3.54073302016511
"1687","서울","송파구",2014,5697,2942,2755,"6",2013,6115,3147,2968,465061,480776,0.967313260229296,0.931643499591169,0.963124912988713,1.22500059132028,-0.0451720033938129,-2.04549928523919
"1688","서울","송파구",2015,5204,2715,2489,"6",2014,5762,3000,2762,441255,454993,0.969806128885499,0.903158625477265,0.931277498230677,1.17936340664695,-0.0810488037999704,-3.63902065333033
"1689","서울","송파구",2016,5075,2599,2476,"6",2015,5564,2819,2745,422114,435131,0.970084870992873,0.912113587347232,0.940241018720034,1.20228184803157,-0.0718471384497617,-3.23031502207051
"1690","서울","송파구",2017,5300,2705,2595,"6",2016,5707,2905,2802,445571,460063,0.968499966308962,0.928684072192045,0.958889111510598,1.18948495301534,-0.0489007832632352,-2.21111858048194
"1691","서울","송파구",2018,5216,2717,2499,"6",2017,5752,2975,2777,447106,462352,0.967025123715265,0.906815020862309,0.937736775005771,1.166613733656,-0.0726371333799815,-3.26540382006078
"1692","서울","송파구",2019,5620,2853,2767,"6",2018,5961,3019,2942,462528,478982,0.965647978420901,0.942794833081698,0.97633387543919,1.21506157465062,-0.0287557985747352,-1.31634916967673
"1693","서울","송파구",2020,4926,2515,2411,"6",2019,5528,2825,2703,417119,431843,0.965904275396382,0.8910998552822,0.922555037782098,1.18095795204726,-0.0914592439772306,-4.10141581359807
"1694","서울","양천구",2009,4225,2225,2000,"6",2008,4873,2540,2333,462768,488710,0.946917394773997,0.867022368151036,0.915626191826343,0.912984476022543,-0.0770319770454531,-3.46060732792841
"1695","서울","양천구",2010,4252,2217,2035,"6",2009,4783,2479,2304,470657,487028,0.966385916210156,0.888981810579134,0.919903524738259,0.903417988046497,-0.0723605965305782,-3.25312102522957
"1696","서울","양천구",2011,4106,2175,1931,"6",2010,4567,2442,2125,441332,457372,0.964930078798003,0.899058462885921,0.931734311781288,0.930365348535796,-0.0635120308126381,-2.86009883849979
"1697","서울","양천구",2012,3749,1976,1773,"6",2011,4062,2111,1951,407210,420797,0.967711271705834,0.922944362383063,0.953739394557367,0.920655190196704,-0.0425900665024016,-1.93081872395869
"1698","서울","양천구",2013,3764,1877,1887,"6",2012,4076,2042,2034,422944,435284,0.971650692421499,0.923454367026497,0.950397477436165,0.889952334115155,-0.0441438807336842,-1.99983369049868
"1699","서울","양천구",2014,4100,2111,1989,"6",2013,4506,2311,2195,465061,480776,0.967313260229296,0.909897913892588,0.940644516417465,0.881604778727952,-0.0523280779700712,-2.36334696451452
"1700","서울","양천구",2015,4071,2096,1975,"6",2014,4302,2220,2082,441255,454993,0.969806128885499,0.946304044630405,0.975766203620404,0.922595777951525,-0.0223579982235518,-1.03218136616653
"1701","서울","양천구",2016,3616,1854,1762,"6",2015,3910,1984,1926,422114,435131,0.970084870992873,0.924808184143223,0.953327086934867,0.856640623149197,-0.0399819133323036,-1.81497372772841
"1702","서울","양천구",2017,3815,1936,1879,"6",2016,4111,2101,2010,445571,460063,0.968499966308962,0.92799805400146,0.958180780881326,0.856204735047838,-0.0358058134254115,-1.62948604873868
"1703","서울","양천구",2018,3736,1965,1771,"6",2017,3971,2104,1867,447106,462352,0.967025123715265,0.940820951901284,0.972902284365369,0.835596033155449,-0.0226427436918722,-1.04482875899696
"1704","서울","양천구",2019,3731,1899,1832,"6",2018,4031,2050,1981,462528,478982,0.965647978420901,0.925576779955346,0.958503306214049,0.806653867441539,-0.0334734685284748,-1.52589148654386
"1705","서울","양천구",2020,3575,1850,1725,"6",2019,3707,1903,1804,417119,431843,0.965904275396382,0.964391691394659,0.998434022873433,0.857069565279932,-0.00134215133510484,-0.0987313174959626
"1706","서울","영등포구",2009,3064,1592,1472,"6",2008,3582,1872,1710,462768,488710,0.946917394773997,0.855388051367951,0.90333967470532,0.662102824741555,-0.0639990744180455,-2.88173160350733
"1707","서울","영등포구",2010,3117,1631,1486,"6",2009,3565,1861,1704,470657,487028,0.966385916210156,0.874333800841515,0.904746008996448,0.662265726420727,-0.0630834535464408,-2.84106294277241
"1708","서울","영등포구",2011,2983,1555,1428,"6",2010,3419,1779,1640,441332,457372,0.964930078798003,0.872477332553378,0.904187103007721,0.67590838643017,-0.0647607406052512,-2.91556213830765
"1709","서울","영등포구",2012,2571,1329,1242,"6",2011,2917,1517,1400,407210,420797,0.967711271705834,0.881384984573192,0.91079334336938,0.631369563615825,-0.0563223678685011,-2.54075928198546
"1710","서울","영등포구",2013,2660,1397,1263,"6",2012,2991,1564,1427,422944,435284,0.971650692421499,0.889334670678703,0.915282289834372,0.628924869486268,-0.0532810748090933,-2.40567573434664
"1711","서울","영등포구",2014,2848,1498,1350,"6",2013,3203,1689,1514,465061,480776,0.967313260229296,0.889166406493912,0.919212465135793,0.612392782882246,-0.0494737032976881,-2.23656567461444
"1712","서울","영등포구",2015,2589,1324,1265,"6",2014,2874,1471,1403,441255,454993,0.969806128885499,0.900835073068894,0.928881604516289,0.58673556107013,-0.0417276916765426,-1.89251506541743
"1713","서울","영등포구",2016,2377,1211,1166,"6",2015,2660,1361,1299,422114,435131,0.970084870992873,0.893609022556391,0.921165816803008,0.563118020250454,-0.0443929491699517,-2.01089643496909
"1714","서울","영등포구",2017,2377,1189,1188,"6",2016,2703,1353,1350,445571,460063,0.968499966308962,0.879393266740659,0.907995144379925,0.533472779871221,-0.0490820860892918,-2.21917141474101
"1715","서울","영등포구",2018,2457,1187,1270,"6",2017,2658,1303,1355,447106,462352,0.967025123715265,0.924379232505643,0.955899913907327,0.549534114952606,-0.024234501780271,-1.11552905829846
"1716","서울","영등포구",2019,2564,1285,1279,"6",2018,2794,1397,1397,462528,478982,0.965647978420901,0.917680744452398,0.950326376650275,0.554344818043448,-0.027536315697362,-1.26218402671203
"1717","서울","영등포구",2020,2265,1168,1097,"6",2019,2409,1244,1165,417119,431843,0.965904275396382,0.940224159402242,0.973413394423995,0.54301050779274,-0.014436806194312,-0.680349858996216
"1718","서울","용산구",2009,1635,840,795,"6",2008,1958,1012,946,462768,488710,0.946917394773997,0.835035750766088,0.88184645817536,0.353308785395706,-0.0417446843522644,-1.89326982034422
"1719","서울","용산구",2010,1559,795,764,"6",2009,1881,951,930,470657,487028,0.966385916210156,0.828814460393408,0.857643356024622,0.331239097686851,-0.0471540863001324,-2.13353644097191
"1720","서울","용산구",2011,1522,786,736,"6",2010,1815,932,883,441332,457372,0.964930078798003,0.838567493112948,0.86904482670655,0.344865090226859,-0.0451618676535196,-2.04504909128221
"1721","서울","용산구",2012,1428,726,702,"6",2011,1750,894,856,407210,420797,0.967711271705834,0.816,0.843226718400825,0.350679010829793,-0.0549770993157392,-2.48100718145313
"1722","서울","용산구",2013,1386,727,659,"6",2012,1698,867,831,422944,435284,0.971650692421499,0.816254416961131,0.840069814520383,0.327702958311266,-0.0524095949049399,-2.36696766023164
"1723","서울","용산구",2014,1593,777,816,"6",2013,1906,914,992,465061,480776,0.967313260229296,0.835781741867786,0.864023865102055,0.342535710369177,-0.0465766819605228,-2.10789016976656
"1724","서울","용산구",2015,1414,700,714,"6",2014,1692,834,858,441255,454993,0.969806128885499,0.835697399527187,0.861715939543061,0.320449626633126,-0.0443130755427388,-2.00734872920186
"1725","서울","용산구",2016,1286,658,628,"6",2015,1576,785,791,422114,435131,0.970084870992873,0.815989847715736,0.841153049712627,0.304657035777065,-0.0483938410167778,-2.18860198778212
"1726","서울","용산구",2017,1253,632,621,"6",2016,1549,793,756,445571,460063,0.968499966308962,0.808908973531311,0.835218380661523,0.281212197382684,-0.0463386012624502,-2.09731546200517
"1727","서울","용산구",2018,1248,660,588,"6",2017,1582,838,744,447106,462352,0.967025123715265,0.788874841972187,0.815774919002484,0.279128439341006,-0.0514224593463071,-2.32312256847106
"1728","서울","용산구",2019,1245,642,603,"6",2018,1589,809,780,462528,478982,0.965647978420901,0.78351164254248,0.811384334717643,0.269172893316729,-0.0507702243489118,-2.29415258247454
"1729","서울","용산구",2020,1090,553,537,"6",2019,1415,720,695,417119,431843,0.965904275396382,0.770318021201413,0.79750969202957,0.261316315008427,-0.0529140211037544,-2.38937249893899
"1730","서울","은평구",2009,4303,2215,2088,"6",2008,4294,2201,2093,462768,488710,0.946917394773997,1.00209594783419,1.05827177044663,0.92983957404142,0.054183398210733,2.3675184225759
"1731","서울","은평구",2010,4307,2236,2071,"6",2009,4272,2207,2065,470657,487028,0.966385916210156,1.00819288389513,1.04326115166178,0.91510378046008,0.0395884434327508,1.71926183219592
"1732","서울","은평구",2011,4155,2143,2012,"6",2010,4177,2141,2036,441332,457372,0.964930078798003,0.994733062006225,1.03088615834771,0.941468101112088,0.0290783328502646,1.25243966286674
"1733","서울","은평구",2012,3852,1988,1864,"6",2011,3776,1957,1819,407210,420797,0.967711271705834,1.02012711864407,1.0541647580955,0.945949264507257,0.0512371130826501,2.2366547932963
"1734","서울","은평구",2013,4137,2127,2010,"6",2012,4201,2127,2074,422944,435284,0.971650692421499,0.984765532016187,1.01349748391781,0.978143678595748,0.0132024785711527,0.547290018972517
"1735","서울","은평구",2014,4359,2270,2089,"6",2013,4455,2306,2149,465061,480776,0.967313260229296,0.978451178451178,1.01151428258023,0.937296397676864,0.0107922955842819,0.440238162421533
"1736","서울","은평구",2015,3960,2062,1898,"6",2014,4012,2083,1929,441255,454993,0.969806128885499,0.98703888334995,1.01776927774653,0.897440255634497,0.0159468651632838,0.669186024952839
"1737","서울","은평구",2016,3737,1924,1813,"6",2015,3804,1950,1854,422114,435131,0.970084870992873,0.982386961093586,1.01268145753899,0.885305865240196,0.0112269687390619,0.459544816092874
"1738","서울","은평구",2017,3803,1941,1862,"6",2016,3869,1976,1893,445571,460063,0.968499966308962,0.982941328508659,1.01491106112758,0.853511561569312,0.0127267630676601,0.526160408434071
"1739","서울","은평구",2018,3569,1837,1732,"6",2017,3700,1880,1820,447106,462352,0.967025123715265,0.964594594594595,0.997486591546524,0.798244711544913,-0.00200631500593979,-0.128231133237717
"1740","서울","은평구",2019,3686,1930,1756,"6",2018,3764,1953,1811,462528,478982,0.965647978420901,0.979277364505845,1.01411423871796,0.796924726719247,0.011247985833157,0.460478321538078
"1741","서울","은평구",2020,3150,1650,1500,"6",2019,3233,1684,1549,417119,431843,0.965904275396382,0.974327250231983,1.0087202997752,0.7551801764005,0.00658539752249797,0.253382537646159
"1742","서울","종로구",2009,1132,601,531,"6",2008,1305,688,617,462768,488710,0.946917394773997,0.867432950191571,0.916059790409282,0.244615012273969,-0.020533035399313,-0.951122932207146
"1743","서울","종로구",2010,1109,577,532,"6",2009,1225,650,575,470657,487028,0.966385916210156,0.90530612244898,0.936795649919329,0.23562806884844,-0.0148927189523292,-0.700599901186745
"1744","서울","종로구",2011,1065,557,508,"6",2010,1162,625,537,441332,457372,0.964930078798003,0.916523235800344,0.949833833496042,0.241314928443893,-0.0121058448802071,-0.576816750687529
"1745","서울","종로구",2012,954,490,464,"6",2011,1028,506,522,407210,420797,0.967711271705834,0.928015564202335,0.958979802484344,0.234277154293853,-0.00961009514253963,-0.46596431983089
"1746","서울","종로구",2013,988,528,460,"6",2012,1078,569,509,422944,435284,0.971650692421499,0.916512059369202,0.943252617959976,0.233600665809185,-0.0132562262274779,-0.627912646575024
"1747","서울","종로구",2014,1009,520,489,"6",2013,1092,551,541,465061,480776,0.967313260229296,0.923992673992674,0.955215556306596,0.216960785789391,-0.00971646809486166,-0.470689032475081
"1748","서울","종로구",2015,976,504,472,"6",2014,992,522,470,441255,454993,0.969806128885499,0.983870967741935,1.01450273249211,0.221187295328098,0.00320782017479696,0.103362423951227
"1749","서울","종로구",2016,876,454,422,"6",2015,894,474,420,422114,435131,0.970084870992873,0.979865771812081,1.01008252072749,0.207526876625746,0.00209239403508968,0.0538191155171255
"1750","서울","종로구",2017,926,459,467,"6",2016,982,494,488,445571,460063,0.968499966308962,0.942973523421589,0.973643320830813,0.20782322009287,-0.00547752993589504,-0.2824102992029
"1751","서울","종로구",2018,862,443,419,"6",2017,909,459,450,447106,462352,0.967025123715265,0.948294829482948,0.980631015913676,0.192795444480727,-0.00373425189606293,-0.204980016247128
"1752","서울","종로구",2019,946,478,468,"6",2018,1015,526,489,462528,478982,0.965647978420901,0.932019704433498,0.965175431690547,0.204528158295282,-0.00712260481976056,-0.355478743151982
"1753","서울","종로구",2020,764,381,383,"6",2019,862,431,431,417119,431843,0.965904275396382,0.88631090487239,0.917597040875164,0.183161160244439,-0.01509302160088,-0.709496640777163
"1754","서울","중구",2009,1173,598,575,"6",2008,979,502,477,462768,488710,0.946917394773997,1.19816138917263,1.26532831246446,0.253474743283892,0.0672540258878774,2.9480697611038
"1755","서울","중구",2010,1138,570,568,"6",2009,939,465,474,470657,487028,0.966385916210156,1.21192758253461,1.25408241387394,0.241789668484693,0.0614345026183702,2.68958699293388
"1756","서울","중구",2011,1067,541,526,"6",2010,921,464,457,441332,457372,0.964930078798003,1.1585233441911,1.20062931983036,0.241768102018435,0.0485057698646345,2.1153381281471
"1757","서울","중구",2012,976,495,481,"6",2011,797,404,393,407210,420797,0.967711271705834,1.22459222082811,1.26545205851478,0.239679772107758,0.063623488890358,2.78681406891003
"1758","서울","중구",2013,951,469,482,"6",2012,829,412,417,422944,435284,0.971650692421499,1.14716525934861,1.18063545705886,0.224852462737384,0.0406163273773771,1.7649168240329
"1759","서울","중구",2014,1089,531,558,"6",2013,960,480,480,465061,480776,0.967313260229296,1.134375,1.17270696747308,0.234162830252375,0.0404415523078023,1.75715392977187
"1760","서울","중구",2015,977,481,496,"6",2014,792,395,397,441255,454993,0.969806128885499,1.23358585858586,1.27199222797601,0.221413921655279,0.0602228658559256,2.63577034681543
"1761","서울","중구",2016,883,443,440,"6",2015,720,363,357,422114,435131,0.970084870992873,1.22638888888889,1.26420782919096,0.209185196416134,0.0552683666439905,2.41570890674748
"1762","서울","중구",2017,868,456,412,"6",2016,786,392,394,445571,460063,0.968499966308962,1.10432569974555,1.14024340543266,0.194806214946664,0.0273202869835669,1.17435344495009
"1763","서울","중구",2018,898,439,459,"6",2017,785,391,394,447106,462352,0.967025123715265,1.14394904458599,1.18295690208233,0.200847226384795,0.0367463863311896,1.59302764549582
"1764","서울","중구",2019,919,459,460,"6",2018,815,421,394,462528,478982,0.965647978420901,1.12760736196319,1.16772093678189,0.198690673861907,0.0333245859499434,1.44104330009354
"1765","서울","중구",2020,907,455,452,"6",2019,765,393,372,417119,431843,0.965904275396382,1.18562091503268,1.22747247862231,0.217443942855636,0.0494625126427785,2.15783327942814
"1766","서울","중랑구",2009,3200,1656,1544,"6",2008,3483,1817,1666,462768,488710,0.946917394773997,0.918748205569911,0.970251693168221,0.69149120077447,-0.0205706924121144,-0.952795524352436
"1767","서울","중랑구",2010,3259,1645,1614,"6",2009,3476,1746,1730,470657,487028,0.966385916210156,0.937571921749137,0.97018375994756,0.69243631774307,-0.0206458474708552,-0.956133647893774
"1768","서울","중랑구",2011,3043,1525,1518,"6",2010,3239,1624,1615,441332,457372,0.964930078798003,0.939487496140784,0.973632718871287,0.689503593666446,-0.0181803350934612,-0.846624254297009
"1769","서울","중랑구",2012,2670,1410,1260,"6",2011,2905,1524,1381,407210,420797,0.967711271705834,0.919104991394148,0.949771918822434,0.655681343778394,-0.0329336157619168,-1.50191312422073
"1770","서울","중랑구",2013,2747,1452,1295,"6",2012,2963,1577,1386,422944,435284,0.971650692421499,0.927100911238609,0.954150414824627,0.649494968601044,-0.0297790748838499,-1.36179950653999
"1771","서울","중랑구",2014,2883,1481,1402,"6",2013,3057,1557,1500,465061,480776,0.967313260229296,0.943081452404318,0.974949368708918,0.619918677334801,-0.015529354216369,-0.72887700186024
"1772","서울","중랑구",2015,2812,1423,1389,"6",2014,2964,1493,1471,441255,454993,0.969806128885499,0.948717948717949,0.978255262016353,0.637273232031365,-0.0138573394545142,-0.654611983223788
"1773","서울","중랑구",2016,2563,1281,1282,"6",2015,2745,1364,1381,422114,435131,0.970084870992873,0.933697632058288,0.962490664453571,0.607181946109345,-0.0227749913543489,-1.05070273531734
"1774","서울","중랑구",2017,2652,1358,1294,"6",2016,2788,1425,1363,445571,460063,0.968499966308962,0.951219512195122,0.982157506747576,0.595191338754093,-0.0106196974456209,-0.51080730540989
"1775","서울","중랑구",2018,2647,1368,1279,"6",2017,2856,1473,1383,447106,462352,0.967025123715265,0.926820728291317,0.958424662981366,0.592029630557407,-0.0246138314154414,-1.13237754735966
"1776","서울","중랑구",2019,2717,1416,1301,"6",2018,2865,1486,1379,462528,478982,0.965647978420901,0.948342059336824,0.982078439068057,0.587423896499239,-0.0105275531539902,-0.506714579860265
"1777","서울","중랑구",2020,2369,1218,1151,"6",2019,2559,1311,1248,417119,431843,0.965904275396382,0.925752246971473,0.958430633917184,0.567943440600884,-0.0236090487966721,-1.08774863521675
"1778","세종","세종시",2013,1182,609,573,"6",2012,1182,604,578,422944,435284,0.971650692421499,1,1.02917643943406,0.279469622455928,0.00815392851324565,0.323051170912593
"1779","세종","세종시",2014,1504,741,763,"6",2013,1447,716,731,465061,480776,0.967313260229296,1.03939184519696,1.07451421161184,0.323398435904107,0.0240977794878963,1.03122098901616
"1780","세종","세종시",2015,2578,1287,1291,"6",2014,2151,1087,1064,441255,454993,0.969806128885499,1.19851231985123,1.23582671232297,0.584242671471145,0.137780028411828,6.08058689629061
"1781","세종","세종시",2016,3248,1649,1599,"6",2015,3053,1553,1500,422114,435131,0.970084870992873,1.06387160170324,1.09667889224412,0.769460382740208,0.0743905774290585,3.26505029578392
"1782","세종","세종시",2017,3839,1968,1871,"6",2016,3682,1870,1812,445571,460063,0.968499966308962,1.04263986963607,1.07655127094083,0.861591082004888,0.065955892358762,2.89041123264355
"1783","세종","세종시",2018,4442,2310,2132,"6",2017,4229,2177,2052,447106,462352,0.967025123715265,1.05036651690707,1.08618327605762,0.99350042271855,0.0856231211945138,3.76396040776815
"1784","세종","세종시",2019,5004,2576,2428,"6",2018,4988,2542,2446,462528,478982,0.965647978420901,1.00320769847634,1.0388958718858,1.0818804483188,0.0420806833135612,1.82995836754802
"1785","세종","세종시",2020,4879,2489,2390,"6",2019,4905,2503,2402,417119,431843,0.965904275396382,0.994699286442406,1.0298114541777,1.16969018433588,0.0348701653324341,1.50969250359546
"1786","울산","남구",2009,3078,1617,1461,"6",2008,3395,1792,1603,462768,488710,0.946917394773997,0.906627393225331,0.957451408358296,0.665128098744943,-0.0283002638629219,-1.29611591896976
"1787","울산","남구",2010,3139,1664,1475,"6",2009,3336,1764,1572,470657,487028,0.966385916210156,0.940947242206235,0.973676485162694,0.66694004338616,-0.0175562061276689,-0.818902639432377
"1788","울산","남구",2011,2933,1576,1357,"6",2010,3083,1655,1428,441332,457372,0.964930078798003,0.951346091469348,0.985922309162985,0.664579047066607,-0.00935573836136155,-0.454666685667934
"1789","울산","남구",2012,2648,1402,1246,"6",2011,2834,1486,1348,407210,420797,0.967711271705834,0.934368383909668,0.965544590859843,0.65027872596449,-0.0224056195582465,-1.03429653846601
"1790","울산","남구",2013,2734,1383,1351,"6",2012,2899,1477,1422,422944,435284,0.971650692421499,0.943083822007589,0.970599650021637,0.646421275629871,-0.0190050117369779,-0.883253492086675
"1791","울산","남구",2014,2968,1563,1405,"6",2013,3174,1674,1500,465061,480776,0.967313260229296,0.935097668557026,0.966695802697222,0.638195849576722,-0.0212546004921173,-0.983172317348387
"1792","울산","남구",2015,2840,1482,1358,"6",2014,3020,1568,1452,441255,454993,0.969806128885499,0.940397350993378,0.9696756114277,0.643618769192417,-0.0195173456494163,-0.906009563637807
"1793","울산","남구",2016,2702,1411,1291,"6",2015,2855,1486,1369,422114,435131,0.970084870992873,0.946409807355517,0.975594853249154,0.640111439089914,-0.0156220136078847,-0.732992606336193
"1794","울산","남구",2017,2649,1410,1239,"6",2016,2841,1509,1332,445571,460063,0.968499966308962,0.932418162618796,0.962744651579414,0.594518045384462,-0.0221489769231237,-1.02289737470554
"1795","울산","남구",2018,2678,1414,1264,"6",2017,2868,1495,1373,447106,462352,0.967025123715265,0.933751743375174,0.96559202080267,0.598963109419243,-0.0206091102088654,-0.954501907846634
"1796","울산","남구",2019,2817,1450,1367,"6",2018,3025,1536,1489,462528,478982,0.965647978420901,0.931239669421488,0.964367647664234,0.609044209215442,-0.0217016778508224,-1.00302992215765
"1797","울산","남구",2020,2519,1270,1249,"6",2019,2669,1347,1322,417119,431843,0.965904275396382,0.943799175721244,0.977114606241838,0.60390440138186,-0.0138205900179111,-0.652979702423122
"1798","울산","동구",2009,1647,835,812,"6",2008,1719,868,851,462768,488710,0.946917394773997,0.958115183246073,1.01182551776309,0.35590187739861,0.00420872397309345,0.14781905252269
"1799","울산","동구",2010,1672,903,769,"6",2009,1704,909,795,470657,487028,0.966385916210156,0.981220657276995,1.01535074220143,0.35524808937294,0.0054533218375161,0.203099714933647
"1800","울산","동구",2011,1581,825,756,"6",2010,1620,859,761,441332,457372,0.964930078798003,0.975925925925926,1.01139548592124,0.358233710675863,0.00408224720652027,0.142201399113807
"1801","울산","동구",2012,1500,801,699,"6",2011,1542,825,717,407210,420797,0.967711271705834,0.972762645914397,1.00521991874669,0.36836030549348,0.00192281086418266,0.0462868271455401
"1802","울산","동구",2013,1650,883,767,"6",2012,1641,870,771,422944,435284,0.971650692421499,1.0054844606947,1.03482091716405,0.390122569418174,0.0135844256735357,0.564254766726987
"1803","울산","동구",2014,1879,950,929,"6",2013,1937,987,950,465061,480776,0.967313260229296,0.970056788848735,1.00283623592505,0.404033019324347,0.00114593296431395,0.01178064153747
"1804","울산","동구",2015,1775,941,834,"6",2014,1803,953,850,441255,454993,0.969806128885499,0.98447032723239,1.01512075239589,0.402261730745261,0.00608250002893994,0.231045598652942
"1805","울산","동구",2016,1772,900,872,"6",2015,1793,915,878,422114,435131,0.970084870992873,0.988287785833798,1.01876424979424,0.419791809795458,0.00787707838057861,0.310754461139998
"1806","울산","동구",2017,1890,997,893,"6",2016,1945,1027,918,445571,460063,0.968499966308962,0.97172236503856,1.00332720582519,0.424174822867736,0.00141131694154394,0.0235680649887656
"1807","울산","동구",2018,1869,975,894,"6",2017,1925,1002,923,447106,462352,0.967025123715265,0.970909090909091,1.00401640774224,0.418021677186171,0.00167894550067283,0.0354551848783679
"1808","울산","동구",2019,1920,981,939,"6",2018,1984,1014,970,462528,478982,0.965647978420901,0.967741935483871,1.00216844762249,0.4151100041511,0.000900144301573599,0.000863573078821167
"1809","울산","동구",2020,1680,867,813,"6",2019,1722,884,838,417119,431843,0.965904275396382,0.975609756097561,1.01004807717327,0.402762760746933,0.00404699130250619,0.140635455781019
"1810","울산","북구",2009,2016,1099,917,"6",2008,2130,1131,999,462768,488710,0.946917394773997,0.946478873239437,0.999536895681735,0.435639456487916,-0.000201746513506228,-0.0480785438116166
"1811","울산","북구",2010,2132,1161,971,"6",2009,2200,1196,1004,470657,487028,0.966385916210156,0.969090909090909,1.00279908143877,0.452983807741094,0.00126793856831153,0.0171997016207554
"1812","울산","북구",2011,2142,1117,1025,"6",2010,2145,1125,1020,441332,457372,0.964930078798003,0.998601398601399,1.03489508778226,0.48534889833504,0.0169362924124228,0.713132905550476
"1813","울산","북구",2012,2068,1054,1014,"6",2011,2134,1097,1037,407210,420797,0.967711271705834,0.969072164948454,1.00140630091062,0.507846074507011,0.000714184397035127,-0.00739611223691238
"1814","울산","북구",2013,2248,1152,1096,"6",2012,2262,1160,1102,422944,435284,0.971650692421499,0.993810786914235,1.02280664714756,0.531512446092154,0.0121220168125582,0.499299705448624
"1815","울산","북구",2014,2526,1284,1242,"6",2013,2577,1301,1276,465061,480776,0.967313260229296,0.980209545983702,1.01333206757793,0.543154553918733,0.00724137321810572,0.282518672308826
"1816","울산","북구",2015,2349,1211,1138,"6",2014,2397,1237,1160,441255,454993,0.969806128885499,0.979974968710889,1.0104854357201,0.532345242546827,0.00558187182162655,0.208809453378233
"1817","울산","북구",2016,2278,1223,1055,"6",2015,2344,1263,1081,422114,435131,0.970084870992873,0.971843003412969,1.00181234907653,0.539664640357818,0.000978060712586257,0.00432434618199713
"1818","울산","북구",2017,2446,1225,1221,"6",2016,2467,1236,1231,445571,460063,0.968499966308962,0.991487636805837,1.02373533432787,0.548958527372742,0.0130297141793278,0.539616431949661
"1819","울산","북구",2018,2599,1328,1271,"6",2017,2592,1326,1266,447106,462352,0.967025123715265,1.00270061728395,1.03689200279681,0.581293921351984,0.0214450969722842,0.913398155777551
"1820","울산","북구",2019,2828,1459,1369,"6",2018,2762,1414,1348,462528,478982,0.965647978420901,1.02389572773353,1.06031985838968,0.611422443614224,0.0368809152150796,1.59900294565295
"1821","울산","북구",2020,2713,1396,1317,"6",2019,2754,1409,1345,417119,431843,0.965904275396382,0.985112563543936,1.01988632687196,0.650413910658589,0.0129343436294249,0.535380407347794
"1822","울산","울주군",2009,2377,1262,1115,"6",2008,2285,1229,1056,462768,488710,0.946917394773997,1.04026258205689,1.09857796234187,0.513648307575286,0.0506344035211236,2.20988455308056
"1823","울산","울주군",2010,2381,1248,1133,"6",2009,2343,1215,1128,470657,487028,0.966385916210156,1.01621852326078,1.05156594918731,0.505888577031681,0.026086624657654,1.11955850072163
"1824","울산","울주군",2011,2323,1228,1095,"6",2010,2217,1165,1052,441332,457372,0.964930078798003,1.04781235904375,1.08589459699401,0.526361106831138,0.0452115751445804,1.96902157768464
"1825","울산","울주군",2012,2213,1157,1056,"6",2011,2125,1128,997,407210,420797,0.967711271705834,1.04141176470588,1.07615958928548,0.543454237371381,0.0413892515136594,1.79924739735982
"1826","울산","울주군",2013,2145,1160,985,"6",2012,2059,1095,964,422944,435284,0.971650692421499,1.04176784847013,1.07216292500537,0.507159340243626,0.0365981014357753,1.58644135165879
"1827","울산","울주군",2014,2461,1243,1218,"6",2013,2330,1180,1150,465061,480776,0.967313260229296,1.05622317596567,1.09191429435723,0.529177892792558,0.048639012605475,2.12125630235073
"1828","울산","울주군",2015,2325,1222,1103,"6",2014,2241,1177,1064,441255,454993,0.969806128885499,1.03748326639893,1.06978419242535,0.526906210694496,0.036769724397217,1.59406424035611
"1829","울산","울주군",2016,2179,1093,1086,"6",2015,2098,1047,1051,422114,435131,0.970084870992873,1.03860819828408,1.07063642505946,0.516211260465182,0.0364633180146996,1.58045474585456
"1830","울산","울주군",2017,2320,1183,1137,"6",2016,2257,1156,1101,445571,460063,0.968499966308962,1.0279131590607,1.06134558060768,0.520680205848226,0.0319414295386838,1.37960835406151
"1831","울산","울주군",2018,2262,1199,1063,"6",2017,2212,1165,1047,447106,462352,0.967025123715265,1.02260397830018,1.05747405441896,0.505920296305574,0.0290772906415247,1.25239337161785
"1832","울산","울주군",2019,2328,1143,1185,"6",2018,2253,1110,1143,462528,478982,0.965647978420901,1.03328894806924,1.0700472337331,0.503320880033209,0.0352562353264335,1.52684037570368
"1833","울산","울주군",2020,2032,1016,1016,"6",2019,1986,992,994,417119,431843,0.965904275396382,1.02316213494461,1.05927902071324,0.487151148712957,0.0288778430350343,1.2435346099903
"1834","울산","중구",2009,1997,1061,936,"6",2008,2137,1125,1012,462768,488710,0.946917394773997,0.934487599438465,0.986873411129491,0.431533727483318,-0.00566456582443173,-0.29071777594578
"1835","울산","중구",2010,2069,1134,935,"6",2009,2097,1154,943,470657,487028,0.966385916210156,0.986647591797806,1.02096644337193,0.439598263703716,0.00921681210234227,0.370260723934165
"1836","울산","중구",2011,1893,1003,890,"6",2010,1914,1002,912,441332,457372,0.964930078798003,0.989028213166144,1.02497396951099,0.428928788304496,0.0107120544815038,0.436674134681363
"1837","울산","중구",2012,1696,894,802,"6",2011,1744,938,806,407210,420797,0.967711271705834,0.972477064220184,1.00492480831183,0.416492718744628,0.00205114680309043,0.051987058454586
"1838","울산","중구",2013,1774,949,825,"6",2012,1786,962,824,422944,435284,0.971650692421499,0.993281075027996,1.02226148015455,0.419440871604751,0.00933737463923632,0.375615688049052
"1839","울산","중구",2014,2023,1048,975,"6",2013,2059,1058,1001,465061,480776,0.967313260229296,0.98251578436134,1.01571623667026,0.434996699357719,0.00683651107788789,0.264536119119454
"1840","울산","중구",2015,2063,1059,1004,"6",2014,2065,1068,997,441255,454993,0.969806128885499,0.999031476997579,1.03013524790327,0.467530112973224,0.014089135856694,0.586672219020693
"1841","울산","중구",2016,2079,1113,966,"6",2015,2123,1132,991,422114,435131,0.970084870992873,0.979274611398964,1.00947313032177,0.492520977745348,0.00466571540838601,0.168117005766267
"1842","울산","중구",2017,2179,1146,1033,"6",2016,2243,1181,1062,445571,460063,0.968499966308962,0.97146678555506,1.00306331373186,0.489035417475554,0.00149806890971771,0.0274212824843017
"1843","울산","중구",2018,2181,1134,1047,"6",2017,2260,1190,1070,447106,462352,0.967025123715265,0.965044247787611,0.997951577597029,0.487803787021422,-0.000999228205588714,-0.0834998774480691
"1844","울산","중구",2019,2188,1187,1001,"6",2018,2261,1217,1044,462528,478982,0.965647978420901,0.967713401149934,1.00213889820637,0.473052442230524,0.00101181102020746,0.00582341621514329
"1845","울산","중구",2020,1911,974,937,"6",2019,1970,1015,955,417119,431843,0.965904275396382,0.97005076142132,1.00429285399243,0.458142640349636,0.00196673946272586,0.0482379810850334
"1846","인천","강화군",2009,422,229,193,"6",2008,439,234,205,462768,488710,0.946917394773997,0.96127562642369,1.01516313009871,0.0911904021021333,0.00138273193082867,0.0222984192883071
"1847","인천","강화군",2010,430,230,200,"6",2009,440,239,201,470657,487028,0.966385916210156,0.977272727272727,1.01126549019388,0.0913616497789261,0.00102923376968135,0.00659727350629635
"1848","인천","강화군",2011,381,188,193,"6",2010,415,206,209,441332,457372,0.964930078798003,0.918072289156627,0.951439186454063,0.0863295659503503,-0.00419223395561662,-0.225321969538368
"1849","인천","강화군",2012,411,203,208,"6",2011,420,205,215,407210,420797,0.967711271705834,0.978571428571429,1.01122251769007,0.100930723705214,0.00113269683225283,0.0111927390759491
"1850","인천","강화군",2013,377,183,194,"6",2012,398,195,203,422944,435284,0.971650692421499,0.947236180904523,0.974873159966436,0.0891370961640312,-0.00223973355637003,-0.13859876478815
"1851","인천","강화군",2014,422,217,205,"6",2013,430,221,209,465061,480776,0.967313260229296,0.981395348837209,1.01455794021119,0.0907407845422428,0.00132099891608282,0.0195564557631173
"1852","인천","강화군",2015,382,186,196,"6",2014,373,182,191,441255,454993,0.969806128885499,1.02412868632708,1.05601383186143,0.0865712569829237,0.0048491878326743,0.17626620595271
"1853","인천","강화군",2016,394,210,184,"6",2015,413,219,194,422114,435131,0.970084870992873,0.953995157384988,0.983414117579818,0.0933397139161459,-0.00154812152014666,-0.107879789136079
"1854","인천","강화군",2017,402,213,189,"6",2016,409,217,192,445571,460063,0.968499966308962,0.982885085574572,1.01485298891691,0.0902213115305978,0.00134005614023263,0.0204029106742418
"1855","인천","강화군",2018,386,204,182,"6",2017,408,210,198,447106,462352,0.967025123715265,0.946078431372549,0.97833904018725,0.0863329948602792,-0.00187005553218283,-0.122178966361673
"1856","인천","강화군",2019,353,183,170,"6",2018,388,207,181,462528,478982,0.965647978420901,0.90979381443299,0.942158876489082,0.076319703888197,-0.00441441741891387,-0.23519057800937
"1857","인천","강화군",2020,334,166,168,"6",2019,341,164,177,417119,431843,0.965904275396382,0.979472140762463,1.01404680123246,0.0800730726723069,0.00112477053590061,0.0108406808526933
"1858","인천","계양구",2009,3533,1901,1632,"6",2008,3655,1981,1674,462768,488710,0.946917394773997,0.966621067031464,1.02080822716555,0.763449503855063,0.0158860307056417,0.666483972175792
"1859","인천","계양구",2010,3450,1737,1713,"6",2009,3513,1783,1730,470657,487028,0.966385916210156,0.982066609735269,1.01622611967133,0.733017887761151,0.011894035968037,0.489173597681288
"1860","인천","계양구",2011,3241,1688,1553,"6",2010,3368,1737,1631,441332,457372,0.964930078798003,0.96229216152019,0.997266208883136,0.734367777546156,-0.0020076081067666,-0.128288568231231
"1861","인천","계양구",2012,2837,1446,1391,"6",2011,2865,1457,1408,407210,420797,0.967711271705834,0.99022687609075,1.02326686176263,0.696692124456669,0.0162098393508446,0.680866414017371
"1862","인천","계양구",2013,2919,1512,1407,"6",2012,2932,1515,1417,422944,435284,0.971650692421499,0.995566166439291,1.02461324239701,0.690162290988878,0.0169871317613836,0.715391010732425
"1863","인천","계양구",2014,3228,1646,1582,"6",2013,3276,1670,1606,465061,480776,0.967313260229296,0.985347985347985,1.01864414131407,0.694102494081422,0.0129409449861028,0.535673616407843
"1864","인천","계양구",2015,2964,1488,1476,"6",2014,3024,1522,1502,441255,454993,0.969806128885499,0.98015873015873,1.01067491838305,0.67172043376279,0.00717056080664228,0.279373433895266
"1865","인천","계양구",2016,2720,1426,1294,"6",2015,2792,1461,1331,422114,435131,0.970084870992873,0.974212034383954,1.00425443537415,0.644375689979484,0.00274145472969163,0.0826481101411492
"1866","인천","계양구",2017,2836,1430,1406,"6",2016,2880,1461,1419,445571,460063,0.968499966308962,0.984722222222222,1.0167498776227,0.636486665424814,0.0106610737543433,0.434409749976725
"1867","인천","계양구",2018,2606,1319,1287,"6",2017,2736,1396,1340,447106,462352,0.967025123715265,0.952485380116959,0.984964461375683,0.582859545611108,-0.00876360721058751,-0.428366301274991
"1868","인천","계양구",2019,2465,1258,1207,"6",2018,2551,1294,1257,462528,478982,0.965647978420901,0.966287730301842,1.00066251045437,0.532940708454407,0.000353078790908412,-0.0234351539849514
"1869","인천","계양구",2020,2091,1085,1006,"6",2019,2128,1116,1012,417119,431843,0.965904275396382,0.982612781954887,1.0172983047949,0.501295793286808,0.00867156742467695,0.34604287187207
"1870","인천","남동구",2009,4281,2202,2079,"6",2008,4540,2365,2175,462768,488710,0.946917394773997,0.94295154185022,0.995811827995067,0.925085572036096,-0.00387441749496905,-0.211205679472377
"1871","인천","남동구",2010,4753,2476,2277,"6",2009,4994,2572,2422,470657,487028,0.966385916210156,0.95174209050861,0.984846813828813,1.00986493348659,-0.0153026713448762,-0.718808545492483
"1872","인천","남동구",2011,4547,2375,2172,"6",2010,4627,2395,2232,441332,457372,0.964930078798003,0.982710179381889,1.01842630981722,1.03029012172242,0.0189844449844786,0.804104643602165
"1873","인천","남동구",2012,4400,2279,2121,"6",2011,4624,2370,2254,407210,420797,0.967711271705834,0.951557093425606,0.983306820171937,1.08052356278087,-0.0180373741419603,-0.840274431335084
"1874","인천","남동구",2013,4671,2497,2174,"6",2012,4899,2587,2312,422944,435284,0.971650692421499,0.953459889773423,0.981278454500205,1.10440152833472,-0.0206761034627615,-0.957477512705284
"1875","인천","남동구",2014,5134,2624,2510,"6",2013,5384,2765,2619,465061,480776,0.967313260229296,0.953566121842496,0.985788328401969,1.10394120341203,-0.015688849846427,-0.735961237124735
"1876","인천","남동구",2015,4980,2508,2472,"6",2014,5165,2589,2576,441255,454993,0.969806128885499,0.964181994191675,0.994200763919395,1.12859910935853,-0.00654501267553063,-0.329824130325527
"1877","인천","남동구",2016,5079,2599,2480,"6",2015,5310,2722,2588,422114,435131,0.970084870992873,0.956497175141243,0.985993291661457,1.20322945934037,-0.0168532841013236,-0.78768131377339
"1878","인천","남동구",2017,5243,2696,2547,"6",2016,5445,2796,2649,445571,460063,0.968499966308962,0.962901744719927,0.994219698726092,1.17669237899235,-0.00680163645728724,-0.341222456685738
"1879","인천","남동구",2018,5242,2696,2546,"6",2017,5544,2870,2674,447106,462352,0.967025123715265,0.945526695526696,0.977768490537275,1.17242890947561,-0.0260648643953797,-1.19682733198817
"1880","인천","남동구",2019,5246,2679,2567,"6",2018,5556,2855,2701,462528,478982,0.965647978420901,0.944204463642909,0.977793652286148,1.13420160509202,-0.025186475220282,-1.15781237234372
"1881","인천","남동구",2020,4656,2338,2318,"6",2019,4893,2455,2438,417119,431843,0.965904275396382,0.951563458001226,0.985152962089053,1.1162282226415,-0.0165726827388278,-0.775217987557272
"1882","인천","동구",2009,756,379,377,"6",2008,622,314,308,462768,488710,0.946917394773997,1.21543408360129,1.28356928525046,0.163364796182969,0.0463252384886914,2.01848658893453
"1883","인천","동구",2010,796,377,419,"6",2009,695,333,362,470657,487028,0.966385916210156,1.14532374100719,1.18516187145894,0.1691252865675,0.0313155545718684,1.35180918796858
"1884","인천","동구",2011,859,429,430,"6",2010,754,394,360,441332,457372,0.964930078798003,1.13925729442971,1.18066305472502,0.194638050266013,0.0351639047267808,1.52273937500658
"1885","인천","동구",2012,742,382,360,"6",2011,646,344,302,407210,420797,0.967711271705834,1.14860681114551,1.18693131384199,0.182215564450775,0.0340617948652435,1.47378752884245
"1886","인천","동구",2013,747,394,353,"6",2012,639,341,298,422944,435284,0.971650692421499,1.16901408450704,1.20312175314123,0.176619126882046,0.0358751866905541,1.55433201970118
"1887","인천","동구",2014,839,415,424,"6",2013,741,370,371,465061,480776,0.967313260229296,1.13225371120108,1.1705139976399,0.180406441305549,0.0307618235069974,1.32721440041622
"1888","인천","동구",2015,754,378,376,"6",2014,653,338,315,441255,454993,0.969806128885499,1.15467075038285,1.19062018272641,0.170876250694043,0.0325724621309028,1.40763660374596
"1889","인천","동구",2016,704,332,372,"6",2015,603,290,313,422114,435131,0.970084870992873,1.16749585406302,1.20349867209876,0.166779590347631,0.0339394251689178,1.46835229705772
"1890","인천","동구",2017,714,361,353,"6",2016,613,315,298,445571,460063,0.968499966308962,1.16476345840131,1.20264687549791,0.160243821972256,0.0324729098405211,1.40321484093072
"1891","인천","동구",2018,663,345,318,"6",2017,604,318,286,447106,462352,0.967025123715265,1.0976821192053,1.13511230710124,0.14828698339991,0.0200353964402454,0.850784213202342
"1892","인천","동구",2019,658,325,333,"6",2018,568,285,283,462528,478982,0.965647978420901,1.15845070422535,1.19966150203073,0.142261657672617,0.0284041762522956,1.22249599642655
"1893","인천","동구",2020,539,286,253,"6",2019,445,237,208,417119,431843,0.965904275396382,1.21123595505618,1.25399171109282,0.129219719072974,0.0328207375542782,1.41866412537112
"1894","인천","미추홀구",2019,3144,1633,1511,"6",2018,3434,1776,1658,462528,478982,0.965647978420901,0.915550378567269,0.948120224995908,0.679742631797426,-0.0352648947983398,-1.605460344638
"1895","인천","미추홀구",2020,2815,1453,1362,"6",2019,3034,1558,1476,417119,431843,0.965904275396382,0.927818061964403,0.960569370690124,0.674867363989653,-0.0266104448628091,-1.22106009865129
"1896","인천","부평구",2009,5409,2781,2628,"6",2008,5735,2939,2796,462768,488710,0.946917394773997,0.943156059285091,0.996027810335237,1.1688362203091,-0.00464283915411216,-0.245336268590865
"1897","인천","부평구",2010,5382,2831,2551,"6",2009,5596,2904,2692,470657,487028,0.966385916210156,0.961758398856326,0.995211522357468,1.1435079049074,-0.00547566203670803,-0.282327333686626
"1898","인천","부평구",2011,4839,2526,2313,"6",2010,5081,2666,2415,441332,457372,0.964930078798003,0.95237158039756,0.986985068994754,1.09645346360563,-0.0142702661792907,-0.67295273691247
"1899","인천","부평구",2012,4485,2343,2142,"6",2011,4722,2442,2280,407210,420797,0.967711271705834,0.949809402795426,0.981500815962542,1.10139731342551,-0.0203749515994202,-0.944101405476046
"1900","인천","부평구",2013,4448,2329,2119,"6",2012,4586,2393,2193,422944,435284,0.971650692421499,0.969908416921064,0.998206891103949,1.05167587198305,-0.00188576936181524,-0.122876919440273
"1901","인천","부평구",2014,5006,2590,2416,"6",2013,5188,2678,2510,465061,480776,0.967313260229296,0.964919043947571,0.997524880118818,1.07641793227125,-0.00266426342462562,-0.157454889325445
"1902","인천","부평구",2015,4537,2358,2179,"6",2014,4666,2437,2229,441255,454993,0.969806128885499,0.97235319331333,1.00262636454026,1.0282036464176,0.00270043759711654,0.0808262732862377
"1903","인천","부평구",2016,4474,2305,2169,"6",2015,4549,2335,2214,422114,435131,0.970084870992873,0.983512859969224,1.01384207647998,1.05990324888537,0.0146712618324457,0.612528208707054
"1904","인천","부평구",2017,4338,2237,2101,"6",2016,4522,2331,2191,445571,460063,0.968499966308962,0.959310039805396,0.990511175195401,0.973582212486899,-0.0092381510471625,-0.449443870487334
"1905","인천","부평구",2018,4209,2171,2038,"6",2017,4436,2261,2175,447106,462352,0.967025123715265,0.94882777276826,0.981182132190018,0.941387500950558,-0.0177149055508564,-0.825951509986333
"1906","인천","부평구",2019,4246,2170,2076,"6",2018,4333,2210,2123,462528,478982,0.965647978420901,0.979921532425571,1.01478132230755,0.917998477929985,0.0135692313801205,0.563579889620998
"1907","인천","부평구",2020,3626,1832,1794,"6",2019,3757,1903,1854,417119,431843,0.965904275396382,0.96513175405909,0.99920020921641,0.869296291945464,-0.000695255162507372,-0.0699984633311438
"1908","인천","서구",2009,4458,2249,2209,"6",2008,4748,2404,2344,462768,488710,0.946917394773997,0.938921651221567,0.991556028438639,0.963333679078934,-0.008134362190244,-0.400417449249987
"1909","인천","서구",2010,4697,2443,2254,"6",2009,4874,2516,2358,470657,487028,0.966385916210156,0.963684858432499,0.997204990540166,0.997966672120037,-0.00278932628917424,-0.163009742176223
"1910","인천","서구",2011,4511,2310,2201,"6",2010,4628,2359,2269,441332,457372,0.964930078798003,0.974719101123595,1.01014479964993,1.02213299738066,0.0103693344740051,0.421451716599513
"1911","인천","서구",2012,4547,2382,2165,"6",2011,4568,2394,2174,407210,420797,0.967711271705834,0.995402802101576,1.02861548811654,1.11662287271924,0.0319527085449559,1.38010932787472
"1912","인천","서구",2013,5127,2642,2485,"6",2012,5251,2698,2553,422944,435284,0.971650692421499,0.976385450390402,1.00487290134802,1.21221722024665,0.00590701492662945,0.223251167233538
"1913","인천","서구",2014,5649,2854,2795,"6",2013,5927,3007,2920,465061,480776,0.967313260229296,0.953096001349755,0.985302321942562,1.21467936464249,-0.0178529662445283,-0.832083680719758
"1914","인천","서구",2015,5471,2745,2726,"6",2014,5643,2838,2805,441255,454993,0.969806128885499,0.969519758993443,0.999704714289252,1.23987263600412,-0.000366116672560018,-0.0553792885202724
"1915","인천","서구",2016,5111,2657,2454,"6",2015,5356,2794,2562,422114,435131,0.970084870992873,0.954256908140403,0.983683940111064,1.21081034981071,-0.0197556541816548,-0.916594390992015
"1916","인천","서구",2017,5554,2862,2692,"6",2016,5813,2995,2818,445571,460063,0.968499966308962,0.955444692929641,0.986520109619543,1.2464904583108,-0.0168025547383158,-0.785428093780875
"1917","인천","서구",2018,5863,3035,2828,"6",2017,5923,3081,2842,447106,462352,0.967025123715265,0.989869998311666,1.02362386874566,1.31132214732077,0.0309785022915786,1.33683851040744
"1918","인천","서구",2019,5921,3095,2826,"6",2018,6137,3199,2938,462528,478982,0.965647978420901,0.964803649991853,0.99912563537861,1.28013871592639,-0.0011193080036781,-0.0888334000020665
"1919","인천","서구",2020,5318,2705,2613,"6",2019,5628,2878,2750,417119,431843,0.965904275396382,0.944918265813788,0.9782731994079,1.27493592955488,-0.0277002787091427,-1.26946668736993
"1920","인천","연수구",2009,2692,1416,1276,"6",2008,2802,1443,1359,462768,488710,0.946917394773997,0.96074232690935,1.01459993470566,0.581716972651523,0.00849302981788619,0.33811285893312
"1921","인천","연수구",2010,2810,1408,1402,"6",2009,2821,1423,1398,470657,487028,0.966385916210156,0.996100673520028,1.03074833439875,0.597037757857633,0.0183579166272863,0.776276456205343
"1922","인천","연수구",2011,2675,1400,1275,"6",2010,2722,1404,1318,441332,457372,0.964930078798003,0.982733284349743,1.01845025452406,0.606119655950622,0.011183061924322,0.457594629713355
"1923","인천","연수구",2012,2614,1304,1310,"6",2011,2685,1353,1332,407210,420797,0.967711271705834,0.973556797020484,1.00604056755932,0.641929225706638,0.00387761685617981,0.133112438221644
"1924","인천","연수구",2013,2738,1409,1329,"6",2012,2776,1426,1350,422944,435284,0.971650692421499,0.986311239193084,1.01508828932654,0.647367027313309,0.00976766100856248,0.394727496129962
"1925","인천","연수구",2014,3203,1673,1530,"6",2013,3220,1666,1554,465061,480776,0.967313260229296,0.99472049689441,1.02833336189211,0.688726855186739,0.0195139472328212,0.827623272287943
"1926","인천","연수구",2015,3134,1630,1504,"6",2014,3209,1659,1550,441255,454993,0.969806128885499,0.976628233094422,1.00703450308853,0.710246909383463,0.00499623407767854,0.182797483292359
"1927","인천","연수구",2016,3226,1686,1540,"6",2015,3321,1730,1591,422114,435131,0.970084870992873,0.971394158386028,1.00134966272777,0.764248520541844,0.00103147774293042,0.00669694291051664
"1928","인천","연수구",2017,3514,1827,1687,"6",2016,3550,1835,1715,445571,460063,0.968499966308962,0.989859154929577,1.02205388679776,0.788650966961494,0.0173928191483154,0.73341021848011
"1929","인천","연수구",2018,3667,1873,1794,"6",2017,3689,1897,1792,447106,462352,0.967025123715265,0.994036324207102,1.02793226342255,0.820163451172653,0.0229090215677012,0.978420540651948
"1930","인천","연수구",2019,3981,2017,1964,"6",2018,4006,2026,1980,462528,478982,0.965647978420901,0.993759360958562,1.02911141861823,0.860704649232047,0.0250563333504534,1.07379658230092
"1931","인천","연수구",2020,3979,2025,1954,"6",2019,3999,2063,1936,417119,431843,0.965904275396382,0.994998749687422,1.03012148825938,0.953924419650028,0.0287336232068266,1.23712887214998
"1932","인천","옹진군",2009,118,59,59,"6",2008,137,70,67,462768,488710,0.946917394773997,0.861313868613139,0.909597683353056,0.0254987380285586,-0.00230514498935523,-0.141504110721994
"1933","인천","옹진군",2010,119,64,55,"6",2009,131,66,65,470657,487028,0.966385916210156,0.908396946564885,0.93999398307388,0.0252838054039354,-0.00151718045502528,-0.106505495780365
"1934","인천","옹진군",2011,114,53,61,"6",2010,128,60,68,441332,457372,0.964930078798003,0.890625,0.92299433872912,0.0258308937489237,-0.00198912505435371,-0.127467616010463
"1935","인천","옹진군",2012,90,51,39,"6",2011,101,60,41,407210,420797,0.967711271705834,0.891089108910891,0.920821256261821,0.0221016183296088,-0.00174997837391913,-0.116845561059454
"1936","인천","옹진군",2013,122,57,65,"6",2012,127,60,67,422944,435284,0.971650692421499,0.960629921259842,0.988657681976028,0.0288454263448589,-0.00032717399914044,-0.0536495918493831
"1937","인천","옹진군",2014,118,50,68,"6",2013,136,61,75,465061,480776,0.967313260229296,0.867647058823529,0.896965951462155,0.025373015582902,-0.00261428451912023,-0.155235002017351
"1938","인천","옹진군",2015,107,55,52,"6",2014,122,63,59,441255,454993,0.969806128885499,0.877049180327869,0.904355163578697,0.0242490170083059,-0.0023192932651368,-0.142132527401418
"1939","인천","옹진군",2016,114,62,52,"6",2015,120,66,54,422114,435131,0.970084870992873,0.95,0.979295758965588,0.0270069223006107,-0.000559157828909494,-0.0639534981510487
"1940","인천","옹진군",2017,111,57,54,"6",2016,121,66,55,445571,460063,0.968499966308962,0.917355371900826,0.947191950245438,0.0249118546763591,-0.0013155464612276,-0.0975496225137235
"1941","인천","옹진군",2018,108,63,45,"6",2017,120,67,53,447106,462352,0.967025123715265,0.9,0.930689366727353,0.0241553457122025,-0.00167422230823247,-0.113480742902105
"1942","인천","옹진군",2019,102,47,55,"6",2018,107,52,55,462528,478982,0.965647978420901,0.953271028037383,0.987182751209444,0.0220527189705272,-0.000282655185553451,-0.0516722226322341
"1943","인천","옹진군",2020,97,52,45,"6",2019,113,57,56,417119,431843,0.965904275396382,0.858407079646018,0.888708230734096,0.0232547546383646,-0.00258806278754809,-0.15407032486957
"1944","인천","중구",2009,896,489,407,"6",2008,866,451,415,462768,488710,0.946917394773997,1.03464203233256,1.09264233400159,0.193617536216852,0.0179371804587662,0.75758883447555
"1945","인천","중구",2010,938,490,448,"6",2009,824,423,401,470657,487028,0.966385916210156,1.13834951456311,1.17794505845794,0.199295877889843,0.0354637166415355,1.53605596642949
"1946","인천","중구",2011,1006,515,491,"6",2010,868,435,433,441332,457372,0.964930078798003,1.15898617511521,1.20110897212256,0.227946307994888,0.0458420476999839,1.99702495250226
"1947","인천","중구",2012,877,477,400,"6",2011,777,427,350,407210,420797,0.967711271705834,1.12870012870013,1.16636042350784,0.215367991945188,0.0358287103500348,1.55226770401835
"1948","인천","중구",2013,1066,572,494,"6",2012,915,483,432,422944,435284,0.971650692421499,1.16502732240437,1.19901867151553,0.252042823636226,0.0501612279251048,2.18886775630439
"1949","인천","중구",2014,1343,668,675,"6",2013,1196,610,586,465061,480776,0.967313260229296,1.12290969899666,1.16085423943271,0.288779321422351,0.0464513781112867,2.02408926759297
"1950","인천","중구",2015,1244,623,621,"6",2014,1139,571,568,441255,454993,0.969806128885499,1.09218612818262,1.12619016899569,0.281923151012453,0.0355759300700589,1.54104009249743
"1951","인천","중구",2016,1201,612,589,"6",2015,1085,539,546,422114,435131,0.970084870992873,1.10691244239631,1.14104701093153,0.284520295465206,0.040130737224722,1.74334861628777
"1952","인천","중구",2017,1244,643,601,"6",2016,1161,610,551,445571,460063,0.968499966308962,1.07149009474591,1.10633983688141,0.27919231727379,0.0296892654774379,1.27957514275467
"1953","인천","중구",2018,1345,690,655,"6",2017,1231,617,614,447106,462352,0.967025123715265,1.09260763606824,1.1298647876598,0.300823518360299,0.0390663823349336,1.69607371326104
"1954","인천","중구",2019,1442,746,696,"6",2018,1254,639,615,462528,478982,0.965647978420901,1.14992025518341,1.19082759026105,0.311764909367649,0.0594933463825822,2.60336765605007
"1955","인천","중구",2020,1391,714,677,"6",2019,1293,648,645,417119,431843,0.965904275396382,1.07579273008507,1.1137674379209,0.333477976308919,0.0379389349677127,1.64599646415506
"1956","전남","강진군",2009,251,134,117,"6",2008,272,144,128,462768,488710,0.946917394773997,0.922794117647059,0.974524412308747,0.0542388410607475,-0.00138176635171502,-0.100490877288111
"1957","전남","강진군",2010,257,130,127,"6",2009,278,137,141,470657,487028,0.966385916210156,0.924460431654676,0.956616209060767,0.0546045209143814,-0.00236895111968647,-0.144338154754543
"1958","전남","강진군",2011,231,119,112,"6",2010,261,141,120,441332,457372,0.964930078798003,0.885057471264368,0.917224460830228,0.0523415478596612,-0.00433259984506386,-0.231556528965437
"1959","전남","강진군",2012,227,122,105,"6",2011,238,129,109,407210,420797,0.967711271705834,0.953781512605042,0.98560545949182,0.0557451928980133,-0.00080242643730678,-0.0747586346536989
"1960","전남","강진군",2013,223,117,106,"6",2012,239,125,114,422944,435284,0.971650692421499,0.933054393305439,0.960277598300401,0.0527256563516683,-0.00209438970147597,-0.132143101633342
"1961","전남","강진군",2014,249,119,130,"6",2013,256,125,131,465061,480776,0.967313260229296,0.97265625,1.00552353615977,0.053541363391039,0.000295737656733925,-0.0259820456124987
"1962","전남","강진군",2015,239,128,111,"6",2014,255,141,114,441255,454993,0.969806128885499,0.937254901960784,0.96643532562315,0.0541636921961224,-0.00181798669161077,-0.119866251483982
"1963","전남","강진군",2016,194,96,98,"6",2015,206,102,104,422114,435131,0.970084870992873,0.941747572815534,0.970788846394093,0.0459591484764779,-0.00134251974574309,-0.0987476810015608
"1964","전남","강진군",2017,219,117,102,"6",2016,230,124,106,445571,460063,0.968499966308962,0.952173913043478,0.983142949062039,0.0491504159830869,-0.000828531065848877,-0.0759181104964994
"1965","전남","강진군",2018,223,118,105,"6",2017,234,123,111,447106,462352,0.967025123715265,0.952991452991453,0.985487790979106,0.0498763156835292,-0.000723815518391458,-0.0712670139506625
"1966","전남","강진군",2019,192,98,94,"6",2018,198,104,94,462528,478982,0.965647978420901,0.96969696969697,1.00419303034496,0.04151100041511,0.000174056884390231,-0.0313866778154927
"1967","전남","강진군",2020,181,95,86,"6",2019,197,100,97,417119,431843,0.965904275396382,0.918781725888325,0.951214058464831,0.0433928926757112,-0.0021169631251191,-0.133145733766617
"1968","전남","고흥군",2009,479,246,233,"6",2008,510,270,240,462768,488710,0.946917394773997,0.93921568627451,0.991866546604812,0.103507589115928,-0.000841874152122662,-0.0765107634882057
"1969","전남","고흥군",2010,415,227,188,"6",2009,424,228,196,470657,487028,0.966385916210156,0.97877358490566,1.01281855259655,0.0881746154843124,0.00113027094626614,0.0110849897473416
"1970","전남","고흥군",2011,371,206,165,"6",2010,385,211,174,441332,457372,0.964930078798003,0.963636363636364,0.998659265380917,0.0840636980776377,-0.000112707110220822,-0.0441237264886921
"1971","전남","고흥군",2012,384,203,181,"6",2011,393,201,192,407210,420797,0.967711271705834,0.977099236641221,1.00970120449133,0.0943002382063309,0.000914825894421107,0.00151567782771909
"1972","전남","고흥군",2013,350,179,171,"6",2012,350,183,167,422944,435284,0.971650692421499,1,1.02917643943406,0.0827532723008247,0.00241444583725548,0.0681235245662496
"1973","전남","고흥군",2014,388,203,185,"6",2013,396,205,191,465061,480776,0.967313260229296,0.97979797979798,1.01290659404971,0.0834299156454745,0.00107679605283792,0.0087098229440157
"1974","전남","고흥군",2015,312,157,155,"6",2014,326,162,164,441255,454993,0.969806128885499,0.957055214723926,0.986852099835432,0.0707074140802937,-0.000929654021222488,-0.0804096367298343
"1975","전남","고흥군",2016,319,164,155,"6",2015,337,175,162,422114,435131,0.970084870992873,0.946587537091988,0.975778063751437,0.0755720018762704,-0.00183050021162333,-0.120422058058267
"1976","전남","고흥군",2017,326,168,158,"6",2016,337,177,160,445571,460063,0.968499966308962,0.967359050445104,0.998821976351526,0.0731645461666042,-8.61895656141171e-05,-0.0429459103656901
"1977","전남","고흥군",2018,292,157,135,"6",2017,312,166,146,447106,462352,0.967025123715265,0.935897435897436,0.967810879930154,0.0653088976663252,-0.00210223594861065,-0.132491604351725
"1978","전남","고흥군",2019,310,148,162,"6",2018,323,153,170,462528,478982,0.965647978420901,0.959752321981424,0.993894611109612,0.0670229694202297,-0.000409201292899102,-0.0572929559144986
"1979","전남","고흥군",2020,260,145,115,"6",2019,271,146,125,417119,431843,0.965904275396382,0.959409594095941,0.993276061131652,0.0623323320203587,-0.000419118790026483,-0.0577334562771717
"1980","전남","곡성군",2009,207,97,110,"6",2008,231,104,127,462768,488710,0.946917394773997,0.896103896103896,0.946337981591067,0.0447308370500985,-0.00240034700122935,-0.145732649457032
"1981","전남","곡성군",2010,196,98,98,"6",2009,207,103,104,470657,487028,0.966385916210156,0.946859903381642,0.979794808159986,0.0416439147829523,-0.000841423287158748,-0.0764907376512864
"1982","전남","곡성군",2011,188,98,90,"6",2010,191,104,87,441332,457372,0.964930078798003,0.984293193717278,1.02006685804986,0.042598316006997,0.000854814360475278,-0.00114982357129061
"1983","전남","곡성군",2012,160,85,75,"6",2011,184,95,89,407210,420797,0.967711271705834,0.869565217391304,0.898579196931826,0.0392917659193045,-0.00398500245350259,-0.216117474627399
"1984","전남","곡성군",2013,177,102,75,"6",2012,187,105,82,422944,435284,0.971650692421499,0.946524064171123,0.974140266202294,0.0418495119921313,-0.00108221723968041,-0.0871859586382878
"1985","전남","곡성군",2014,154,80,74,"6",2013,154,79,75,465061,480776,0.967313260229296,1,1.03379126609198,0.033113935591245,0.00111896180891628,0.0105826776175626
"1986","전남","곡성군",2015,177,105,72,"6",2014,181,104,77,441255,454993,0.969806128885499,0.977900552486188,1.0083464347766,0.0401128599109359,0.000334799368949466,-0.0242470616567107
"1987","전남","곡성군",2016,152,84,68,"6",2015,153,86,67,422114,435131,0.970084870992873,0.993464052287582,1.02410014009473,0.0360092297341476,0.000867827481296341,-0.00057182648517486
"1988","전남","곡성군",2017,155,73,82,"6",2016,154,74,80,445571,460063,0.968499966308962,1.00649350649351,1.03922926330017,0.0347868240976186,0.00136466148190233,0.0214957934641218
"1989","전남","곡성군",2018,169,83,86,"6",2017,175,83,92,447106,462352,0.967025123715265,0.965714285714286,0.998644463345541,0.0377986428274279,-5.12374458413857e-05,-0.0413934600611092
"1990","전남","곡성군",2019,129,70,59,"6",2018,133,72,61,462528,478982,0.965647978420901,0.969924812030075,1.00442897795547,0.027890203403902,0.000123525096049569,-0.0336311222357617
"1991","전남","곡성군",2020,113,65,48,"6",2019,119,67,52,417119,431843,0.965904275396382,0.949579831932773,0.983099315450374,0.027090590455002,-0.000457849523543099,-0.0594537393225343
"1992","전남","광양시",2009,1682,862,820,"6",2008,1756,917,839,462768,488710,0.946917394773997,0.957858769931663,1.01155473034718,0.363465062407081,0.00419974078673409,0.147420050960256
"1993","전남","광양시",2010,1497,806,691,"6",2009,1533,821,712,470657,487028,0.966385916210156,0.976516634050881,1.0104830975605,0.318066022602447,0.00333431714562163,0.108980974761943
"1994","전남","광양시",2011,1518,791,727,"6",2010,1521,790,731,441332,457372,0.964930078798003,0.998027613412229,1.03430044864541,0.343958743077774,0.0117979392030804,0.484905317159356
"1995","전남","광양시",2012,1418,726,692,"6",2011,1422,724,698,407210,420797,0.967711271705834,0.9971870604782,1.0304592801946,0.348223275459836,0.0106066303175142,0.43199156387993
"1996","전남","광양시",2013,1462,730,732,"6",2012,1512,762,750,422944,435284,0.971650692421499,0.966931216931217,0.995142827018915,0.345672240296588,-0.00167898986587979,-0.113692501054968
"1997","전남","광양시",2014,1610,845,765,"6",2013,1644,860,784,465061,480776,0.967313260229296,0.979318734793187,1.01241115474944,0.346191144817562,0.00429663187121666,0.151723612363518
"1998","전남","광양시",2015,1533,785,748,"6",2014,1561,802,759,441255,454993,0.969806128885499,0.982062780269058,1.01263824904638,0.347418159567597,0.00439075722384962,0.155904329679492
"1999","전남","광양시",2016,1459,747,712,"6",2015,1485,759,726,422114,435131,0.970084870992873,0.982491582491583,1.0127893052141,0.345641224882378,0.00442051111959624,0.157225893144444
"2000","전남","광양시",2017,1652,866,786,"6",2016,1670,879,791,445571,460063,0.968499966308962,0.989221556886228,1.02139555115963,0.370760215543651,0.00793261915962044,0.313221387320751
"2001","전남","광양시",2018,1606,802,804,"6",2017,1643,823,820,447106,462352,0.967025123715265,0.977480219111382,1.01081160679254,0.359198937164789,0.0038835176689241,0.133374531582554
"2002","전남","광양시",2019,1648,835,813,"6",2018,1682,859,823,462528,478982,0.965647978420901,0.979785969084423,1.01464093642762,0.356302753563028,0.00521660596390307,0.192585627877434
"2003","전남","광양시",2020,1444,733,711,"6",2019,1494,764,730,417119,431843,0.965904275396382,0.966532797858099,1.00065070885151,0.346184182451531,0.000225265111775646,-0.0291121883505202
"2004","전남","구례군",2009,187,104,83,"6",2008,201,115,86,462768,488710,0.946917394773997,0.930348258706468,0.982502025880004,0.0404090170452581,-0.000707075934472394,-0.0705235004721471
"2005","전남","구례군",2010,180,100,80,"6",2009,194,106,88,470657,487028,0.966385916210156,0.927835051546392,0.960108209342549,0.0382444115353644,-0.00152563805878616,-0.106881152811183
"2006","전남","구례군",2011,151,76,75,"6",2010,147,75,72,441332,457372,0.964930078798003,1.02721088435374,1.06454437158112,0.0342146048779604,0.00220836017074432,0.0589699236451799
"2007","전남","구례군",2012,171,91,80,"6",2011,179,91,88,407210,420797,0.967711271705834,0.955307262569832,0.987182117746612,0.0419930748262567,-0.000538262288580679,-0.0630253916968827
"2008","전남","구례군",2013,162,83,79,"6",2012,172,86,86,422944,435284,0.971650692421499,0.941860465116279,0.969340599932082,0.0383029431792389,-0.00117434525871102,-0.091277961416216
"2009","전남","구례군",2014,184,98,86,"6",2013,184,99,85,465061,480776,0.967313260229296,1,1.03379126609198,0.0395647022648642,0.00133694138208179,0.0202645640654692
"2010","전남","구례군",2015,170,97,73,"6",2014,170,97,73,441255,454993,0.969806128885499,1,1.03113392482805,0.0385264756206729,0.00119948039586363,0.0141590302291817
"2011","전남","구례군",2016,170,87,83,"6",2015,166,87,79,422114,435131,0.970084870992873,1.02409638554217,1.05567710224572,0.0402734806237178,0.00224231069847771,0.0604778867519411
"2012","전남","구례군",2017,155,80,75,"6",2016,164,84,80,445571,460063,0.968499966308962,0.945121951219512,0.975861625294066,0.0347868240976186,-0.000839697394897718,-0.0764140795835145
"2013","전남","구례군",2018,158,75,83,"6",2017,172,88,84,447106,462352,0.967025123715265,0.918604651162791,0.949928423403888,0.0353383761345184,-0.00176944820740177,-0.117710342626833
"2014","전남","구례군",2019,136,59,77,"6",2018,143,61,82,462528,478982,0.965647978420901,0.951048951048951,0.98488162591525,0.0294036252940363,-0.000444535006643061,-0.0588623552819893
"2015","전남","구례군",2020,139,70,69,"6",2019,143,72,71,417119,431843,0.965904275396382,0.972027972027972,1.00633985870813,0.0333238236570379,0.00021126833360018,-0.0297338760387904
"2016","전남","나주시",2009,709,356,353,"6",2008,745,383,362,462768,488710,0.946917394773997,0.951677852348993,1.00502732086375,0.153208519171594,0.000770228384935818,-0.00490683528741429
"2017","전남","나주시",2010,670,326,344,"6",2009,699,350,349,470657,487028,0.966385916210156,0.958512160228898,0.991852368863015,0.142354198492745,-0.00115984950012009,-0.090634110771793
"2018","전남","나주시",2011,576,311,265,"6",2010,616,330,286,441332,457372,0.964930078798003,0.935064935064935,0.969049421932965,0.130513989468246,-0.00403948341987708,-0.21853732765468
"2019","전남","나주시",2012,551,309,242,"6",2011,578,326,252,407210,420797,0.967711271705834,0.953287197231834,0.985094650754068,0.135311018884605,-0.00201685799329794,-0.12869941567786
"2020","전남","나주시",2013,552,290,262,"6",2012,556,294,262,422944,435284,0.971650692421499,0.992805755395683,1.02177229238777,0.130513732314444,0.00284158314056972,0.0870954622037889
"2021","전남","나주시",2014,597,315,282,"6",2013,601,324,277,465061,480776,0.967313260229296,0.993344425956739,1.02691079177522,0.128370256805021,0.00345454525101185,0.114321084604948
"2022","전남","나주시",2015,630,333,297,"6",2014,609,324,285,441255,454993,0.969806128885499,1.03448275862069,1.0666902670635,0.14277458612367,0.00952167527846784,0.383801674632122
"2023","전남","나주시",2016,728,369,359,"6",2015,685,352,333,422114,435131,0.970084870992873,1.06277372262774,1.0955471571678,0.172465258200391,0.0164785651312585,0.692802268619752
"2024","전남","나주시",2017,914,479,435,"6",2016,866,457,409,445571,460063,0.968499966308962,1.0554272517321,1.08975455699232,0.205130046614344,0.0184113564596848,0.778650065720968
"2025","전남","나주시",2018,1006,475,531,"6",2017,1014,488,526,447106,462352,0.967025123715265,0.992110453648915,1.02594072203344,0.225002572096997,0.00583672917957725,0.220129321401915
"2026","전남","나주시",2019,1145,584,561,"6",2018,1180,607,573,462528,478982,0.965647978420901,0.970338983050847,1.00485788272204,0.247552580600526,0.00120258140409637,0.014296766114923
"2027","전남","나주시",2020,989,520,469,"6",2019,1012,527,485,417119,431843,0.965904275396382,0.977272727272727,1.01176975003209,0.237102601415903,0.002790638350624,0.0848326737039126
"2028","전남","담양군",2009,284,139,145,"6",2008,298,155,143,462768,488710,0.946917394773997,0.953020134228188,1.00644484881984,0.0613698440687342,0.000395519367119879,-0.0215500927670768
"2029","전남","담양군",2010,241,125,116,"6",2009,258,136,122,470657,487028,0.966385916210156,0.934108527131783,0.96659989706291,0.0512050176667934,-0.00171025286096642,-0.115081093408162
"2030","전남","담양군",2011,227,126,101,"6",2010,240,138,102,441332,457372,0.964930078798003,0.945833333333333,0.980209192474902,0.0514352007105762,-0.00101794415727781,-0.084331174236052
"2031","전남","담양군",2012,218,109,109,"6",2011,233,119,114,407210,420797,0.967711271705834,0.935622317596567,0.966840363394029,0.0535350310650524,-0.00177520217580652,-0.117965913678334
"2032","전남","담양군",2013,212,113,99,"6",2012,221,119,102,422944,435284,0.971650692421499,0.959276018099548,0.987264276742177,0.0501248392222138,-0.000638376080676971,-0.0674720944446198
"2033","전남","담양군",2014,233,117,116,"6",2013,250,124,126,465061,480776,0.967313260229296,0.932,0.963493459997721,0.0501009544984421,-0.00182901249954975,-0.120355979117224
"2034","전남","담양군",2015,241,136,105,"6",2014,249,143,106,441255,454993,0.969806128885499,0.967871485943775,0.998005124030359,0.0546169448504833,-0.000108954030817436,-0.0439570278935628
"2035","전남","담양군",2016,246,132,114,"6",2015,246,127,119,422114,435131,0.970084870992873,1,1.03083764101641,0.0582780954907916,0.00179715898786496,0.0407058124623401
"2036","전남","담양군",2017,269,130,139,"6",2016,284,140,144,445571,460063,0.968499966308962,0.947183098591549,0.977989810574126,0.060371972143609,-0.00132879854289441,-0.0981382334006669
"2037","전남","담양군",2018,221,125,96,"6",2017,241,136,105,447106,462352,0.967025123715265,0.91701244813278,0.948281927370885,0.0494289944666366,-0.00255637232580961,-0.152662745950234
"2038","전남","담양군",2019,242,126,116,"6",2018,251,128,123,462528,478982,0.965647978420901,0.964143426294821,0.998441924842487,0.0523211567732116,-8.15202945806866e-05,-0.0427385177587423
"2039","전남","담양군",2020,198,98,100,"6",2019,209,101,108,417119,431843,0.965904275396382,0.947368421052632,0.980809843360364,0.0474684682308885,-0.000910927340794345,-0.0795778634089743
"2040","전남","목포시",2009,2901,1516,1385,"6",2008,2928,1501,1427,462768,488710,0.946917394773997,0.99077868852459,1.04632008451071,0.626879991702106,0.0290371341937151,1.25060976335493
"2041","전남","목포시",2010,2887,1481,1406,"6",2009,2824,1449,1375,470657,487028,0.966385916210156,1.02230878186969,1.05786804704154,0.61339786723665,0.0354961366364315,1.53749594864739
"2042","전남","목포시",2011,2736,1421,1315,"6",2010,2680,1382,1298,441332,457372,0.964930078798003,1.02089552238806,1.05799948081189,0.619941449974169,0.0359562822322702,1.55793399861564
"2043","전남","목포시",2012,2501,1261,1240,"6",2011,2433,1236,1197,407210,420797,0.967711271705834,1.02794903411426,1.06224766019543,0.614179416026129,0.0382312315878193,1.65897925260575
"2044","전남","목포시",2013,2638,1350,1288,"6",2012,2585,1336,1249,422944,435284,0.971650692421499,1.02050290135397,1.0502775424476,0.623723235227359,0.0313592714347003,1.35375093735202
"2045","전남","목포시",2014,2741,1424,1317,"6",2013,2659,1369,1290,465061,480776,0.967313260229296,1.03083866115081,1.06567200464765,0.589385048413004,0.0387060976386347,1.68007113344208
"2046","전남","목포시",2015,2631,1358,1273,"6",2014,2543,1316,1227,441255,454993,0.969806128885499,1.03460479748329,1.06681610547487,0.596253866811708,0.0398393612546897,1.73040671987732
"2047","전남","목포시",2016,2538,1292,1246,"6",2015,2455,1250,1205,422114,435131,0.970084870992873,1.03380855397149,1.06568877103855,0.601259375429386,0.0394959894473633,1.71515535113818
"2048","전남","목포시",2017,2756,1430,1326,"6",2016,2694,1390,1304,445571,460063,0.968499966308962,1.02301410541945,1.05628718741029,0.618532175567979,0.034815436485487,1.50726164058444
"2049","전남","목포시",2018,2756,1360,1396,"6",2017,2696,1342,1354,447106,462352,0.967025123715265,1.02225519287834,1.05711337565965,0.616408636878056,0.0352051780378718,1.52457259041071
"2050","전남","목포시",2019,2762,1389,1373,"6",2018,2666,1353,1313,462528,478982,0.965647978420901,1.03600900225056,1.07286405129198,0.59715303722153,0.0435109895332739,1.89348754234128
"2051","전남","목포시",2020,2389,1210,1179,"6",2019,2322,1180,1142,417119,431843,0.965904275396382,1.02885443583118,1.06517225571754,0.572738235371681,0.0373266427348554,1.61880059536163
"2052","전남","무안군",2009,503,251,252,"6",2008,560,289,271,462768,488710,0.946917394773997,0.898214285714286,0.94856667611293,0.108693773121737,-0.00559048203747797,-0.287427234531734
"2053","전남","무안군",2010,613,327,286,"6",2009,688,356,332,470657,487028,0.966385916210156,0.890988372093023,0.921979881067786,0.130243468173213,-0.0101616108770181,-0.490460710194038
"2054","전남","무안군",2011,574,298,276,"6",2010,665,341,324,441332,457372,0.964930078798003,0.863157894736842,0.894528954690752,0.130060815893704,-0.0137176502060826,-0.64840747781226
"2055","전남","무안군",2012,529,252,277,"6",2011,652,322,330,407210,420797,0.967711271705834,0.811349693251534,0.838421249161773,0.129908401070701,-0.0209904371683952,-0.971439111035346
"2056","전남","무안군",2013,577,293,284,"6",2012,666,339,327,422944,435284,0.971650692421499,0.866366366366366,0.891643852182363,0.136424680335931,-0.014782452828454,-0.695702267546549
"2057","전남","무안군",2014,775,394,381,"6",2013,895,463,432,465061,480776,0.967313260229296,0.865921787709497,0.895182381252827,0.166644805735162,-0.0174673117137448,-0.81495426202725
"2058","전남","무안군",2015,787,408,379,"6",2014,896,472,424,441255,454993,0.969806128885499,0.878348214285714,0.905694641562135,0.178354919490997,-0.016819824611755,-0.786195160855923
"2059","전남","무안군",2016,790,413,377,"6",2015,908,468,440,422114,435131,0.970084870992873,0.870044052863436,0.896874159034099,0.187153233486688,-0.0193003345928023,-0.896370695290812
"2060","전남","무안군",2017,819,407,412,"6",2016,941,474,467,445571,460063,0.968499966308962,0.870350690754516,0.898658462603255,0.183809089909352,-0.0186274957589102,-0.866485559299016
"2061","전남","무안군",2018,777,382,395,"6",2017,908,447,461,447106,462352,0.967025123715265,0.855726872246696,0.88490655646984,0.17378429276279,-0.0200014326855229,-0.927511008229268
"2062","전남","무안군",2019,827,438,389,"6",2018,989,506,483,462528,478982,0.965647978420901,0.836198179979778,0.865945146332922,0.178799986163,-0.0239690059807565,-1.10373666809434
"2063","전남","무안군",2020,702,362,340,"6",2019,817,418,399,417119,431843,0.965904275396382,0.859241126070991,0.889571718396609,0.168297296454968,-0.0185847812460186,-0.864588330776689
"2064","전남","보성군",2009,280,140,140,"6",2008,302,145,157,462768,488710,0.946917394773997,0.927152317880795,0.979126925957549,0.0605054800677661,-0.00126293536542851,-0.0952128225648589
"2065","전남","보성군",2010,290,164,126,"6",2009,299,171,128,470657,487028,0.966385916210156,0.969899665551839,1.00363596911207,0.0616159963625315,0.000224033859583813,-0.0291668762450643
"2066","전남","보성군",2011,244,126,118,"6",2010,254,135,119,441332,457372,0.964930078798003,0.960629921259842,0.995543555297274,0.0552871760941876,-0.000246384243033603,-0.0500611948568513
"2067","전남","보성군",2012,229,122,107,"6",2011,252,130,122,407210,420797,0.967711271705834,0.908730158730159,0.939050918698398,0.0562363399720046,-0.00342755325705824,-0.191357540739681
"2068","전남","보성군",2013,252,136,116,"6",2012,261,141,120,422944,435284,0.971650692421499,0.96551724137931,0.993687596694957,0.0595823560565938,-0.000376107861293912,-0.0558230620050829
"2069","전남","보성군",2014,256,127,129,"6",2013,273,137,136,465061,480776,0.967313260229296,0.937728937728938,0.969415985785881,0.0550465422815502,-0.00168354423157701,-0.11389478997077
"2070","전남","보성군",2015,222,105,117,"6",2014,242,111,131,441255,454993,0.969806128885499,0.917355371900826,0.945916245090192,0.0503110446340551,-0.00272101020724464,-0.159975381946028
"2071","전남","보성군",2016,214,101,113,"6",2015,212,101,111,422114,435131,0.970084870992873,1.00943396226415,1.04056252442222,0.0506972050204447,0.00205640661678023,0.052220680890589
"2072","전남","보성군",2017,224,108,116,"6",2016,236,113,123,445571,460063,0.968499966308962,0.949152542372881,0.980023309644692,0.0502725715991391,-0.00100427959620107,-0.0837242424635732
"2073","전남","보성군",2018,238,122,116,"6",2017,244,125,119,447106,462352,0.967025123715265,0.975409836065574,1.00867062514167,0.053231224810224,0.000461547996161247,-0.0186173331538443
"2074","전남","보성군",2019,200,110,90,"6",2018,215,123,92,462528,478982,0.965647978420901,0.930232558139535,0.963324709342549,0.0432406254324063,-0.00158586250594345,-0.109556111066662
"2075","전남","보성군",2020,170,85,85,"6",2019,177,91,86,417119,431843,0.965904275396382,0.96045197740113,0.994355239816062,0.040755755551773,-0.00023005646620494,-0.0493359724018012
"2076","전남","순천시",2009,2994,1626,1368,"6",2008,3083,1653,1430,462768,488710,0.946917394773997,0.971132014271813,1.02557205056265,0.646976454724614,0.0165445146130637,0.695731512790956
"2077","전남","순천시",2010,2966,1552,1414,"6",2009,2988,1558,1430,470657,487028,0.966385916210156,0.992637215528782,1.02716440593585,0.630182914521616,0.0171185445039052,0.721227902843116
"2078","전남","순천시",2011,2832,1440,1392,"6",2010,2844,1454,1390,441332,457372,0.964930078798003,0.9957805907173,1.03197175898768,0.64169378155221,0.0205160789276831,0.872134439708821
"2079","전남","순천시",2012,2519,1275,1244,"6",2011,2568,1307,1261,407210,420797,0.967711271705834,0.980919003115265,1.01364842158565,0.618599739692051,0.00844291004009282,0.335886714573156
"2080","전남","순천시",2013,2593,1314,1279,"6",2012,2601,1319,1282,422944,435284,0.971650692421499,0.996924259900038,1.02601096018936,0.613083528788681,0.0159468912600743,0.669187184080541
"2081","전남","순천시",2014,2872,1524,1348,"6",2013,2915,1539,1376,465061,480776,0.967313260229296,0.9852487135506,1.01854151499696,0.617553396221141,0.0114503755574608,0.469467761697432
"2082","전남","순천시",2015,2710,1400,1310,"6",2014,2738,1408,1330,441255,454993,0.969806128885499,0.989773557341125,1.02058909287217,0.614157346658961,0.0126449426484883,0.522526233010947
"2083","전남","순천시",2016,2712,1397,1315,"6",2015,2730,1406,1324,422114,435131,0.970084870992873,0.993406593406593,1.0240409093174,0.642480467361897,0.0154458146540472,0.646931122511081
"2084","전남","순천시",2017,2761,1474,1287,"6",2016,2806,1492,1314,445571,460063,0.968499966308962,0.983962936564505,1.01596589653428,0.619654331184031,0.00989333693870281,0.400309579199415
"2085","전남","순천시",2018,2747,1408,1339,"6",2017,2798,1431,1367,447106,462352,0.967025123715265,0.981772694781987,1.01525045286317,0.614395691402039,0.00936981253106266,0.377056465185696
"2086","전남","순천시",2019,2857,1467,1390,"6",2018,2886,1481,1405,462528,478982,0.965647978420901,0.98995148995149,1.0251680861698,0.617692334301923,0.0155461338961348,0.65138695062528
"2087","전남","순천시",2020,2627,1330,1297,"6",2019,2652,1347,1305,417119,431843,0.965904275396382,0.990573152337858,1.02553967051378,0.629796293144163,0.0160847898177024,0.675312153300807
"2088","전남","신안군",2009,186,110,76,"6",2008,219,125,94,462768,488710,0.946917394773997,0.849315068493151,0.896926250568941,0.0401929260450161,-0.00414283558806507,-0.223127867685609
"2089","전남","신안군",2010,180,85,95,"6",2009,210,106,104,470657,487028,0.966385916210156,0.857142857142857,0.886957107678355,0.0382444115353644,-0.00432325889509689,-0.231141636801083
"2090","전남","신안군",2011,183,90,93,"6",2010,216,105,111,441332,457372,0.964930078798003,0.847222222222222,0.878014107796902,0.0414653820706407,-0.00505819162742946,-0.263784765503289
"2091","전남","신안군",2012,163,73,90,"6",2011,154,69,85,407210,420797,0.967711271705834,1.05844155844156,1.09375760042124,0.0400284865302915,0.00375297484557399,0.127576278223717
"2092","전남","신안군",2013,145,62,83,"6",2012,173,79,94,422944,435284,0.971650692421499,0.838150289017341,0.862604530161497,0.0342834985246274,-0.0047103973874988,-0.248336967852598
"2093","전남","신안군",2014,174,98,76,"6",2013,179,100,79,465061,480776,0.967313260229296,0.972067039106145,1.00491441508382,0.0374144467069911,0.000183870121249594,-0.030950808327453
"2094","전남","신안군",2015,173,87,86,"6",2014,194,100,94,441255,454993,0.969806128885499,0.891752577319588,0.919516335027073,0.0392063546022141,-0.00315547110861437,-0.17927260806695
"2095","전남","신안군",2016,156,75,81,"6",2015,166,81,85,422114,435131,0.970084870992873,0.939759036144578,0.96873898794313,0.036956841042941,-0.0011553082534272,-0.0904324045560503
"2096","전남","신안군",2017,160,89,71,"6",2016,171,94,77,445571,460063,0.968499966308962,0.935672514619883,0.966104849942135,0.0359089797136708,-0.00121714025581969,-0.0931787647645648
"2097","전남","신안군",2018,177,80,97,"6",2017,199,92,107,447106,462352,0.967025123715265,0.889447236180904,0.919776761087334,0.0395879276949985,-0.00317587178153321,-0.180178734250209
"2098","전남","신안군",2019,177,87,90,"6",2018,200,97,103,462528,478982,0.965647978420901,0.885,0.916483045350768,0.0382679535076795,-0.00319602293761979,-0.181073777772825
"2099","전남","신안군",2020,143,76,67,"6",2019,153,85,68,417119,431843,0.965904275396382,0.934640522875817,0.967632659553416,0.0342827826111973,-0.00110964249623284,-0.0884040921353366
"2100","전남","여수시",2009,2937,1516,1421,"6",2008,3068,1588,1480,462768,488710,0.946917394773997,0.957301173402868,1.01096587588968,0.634659267710818,0.00695959476195246,0.270003063729893
"2101","전남","여수시",2010,2940,1518,1422,"6",2009,2970,1536,1434,470657,487028,0.966385916210156,0.98989898989899,1.02433093580362,0.624658721744285,0.0151985312579327,0.635947663249899
"2102","전남","여수시",2011,2771,1469,1302,"6",2010,2840,1504,1336,441332,457372,0.964930078798003,0.975704225352113,1.01116572774634,0.627871987528663,0.00701064767229673,0.272270654557833
"2103","전남","여수시",2012,2413,1240,1173,"6",2011,2475,1279,1196,407210,420797,0.967711271705834,0.974949494949495,1.00747973435393,0.592568944770512,0.00443225829327027,0.157747661308058
"2104","전남","여수시",2013,2482,1276,1206,"6",2012,2507,1291,1216,422944,435284,0.971650692421499,0.990027921818907,1.01891341151789,0.586838919573277,0.0110991259806015,0.453866490125783
"2105","전남","여수시",2014,2677,1339,1338,"6",2013,2756,1390,1366,465061,480776,0.967313260229296,0.97133526850508,1.00415791702766,0.575623412842616,0.00239339438977526,0.0671884932644276
"2106","전남","여수시",2015,2485,1292,1193,"6",2014,2557,1322,1235,441255,454993,0.969806128885499,0.9718420023465,1.00209925819229,0.563166423043365,0.0011822317271991,0.0133929049956916
"2107","전남","여수시",2016,2367,1182,1185,"6",2015,2400,1200,1200,422114,435131,0.970084870992873,0.98625,1.01666362345243,0.56074899197847,0.00934411005366016,0.375914851482966
"2108","전남","여수시",2017,2477,1287,1190,"6",2016,2546,1325,1221,445571,460063,0.968499966308962,0.972898664571877,1.00454176398134,0.555915892192266,0.00252483877581585,0.0730267908690083
"2109","전남","여수시",2018,2614,1311,1303,"6",2017,2674,1342,1332,447106,462352,0.967025123715265,0.977561705310396,1.0108958716136,0.584648830478678,0.00637025859593996,0.243826822735765
"2110","전남","여수시",2019,2486,1209,1277,"6",2018,2545,1241,1304,462528,478982,0.965647978420901,0.976817288801572,1.01156664812672,0.53748097412481,0.00621685330250708,0.237013098816794
"2111","전남","여수시",2020,2306,1202,1104,"6",2019,2372,1236,1136,417119,431843,0.965904275396382,0.972175379426644,1.00649246948171,0.552839837072874,0.00358929577046763,0.120306229034865
"2112","전남","영광군",2009,490,257,233,"6",2008,515,274,241,462768,488710,0.946917394773997,0.951456310679612,1.00479335993896,0.105884590118591,0.000507542952427725,-0.0165743988674727
"2113","전남","영광군",2010,424,226,198,"6",2009,448,244,204,470657,487028,0.966385916210156,0.946428571428571,0.979348473061517,0.0900868360610806,-0.00186043072171813,-0.121751466111771
"2114","전남","영광군",2011,397,207,190,"6",2010,410,207,203,441332,457372,0.964930078798003,0.968292682926829,1.00348481636412,0.0899549545466905,0.000313476497637969,-0.0251941486510709
"2115","전남","영광군",2012,361,191,170,"6",2011,365,196,169,407210,420797,0.967711271705834,0.989041095890411,1.02204151672944,0.0886520468554308,0.00195402557386352,0.047673274830732
"2116","전남","영광군",2013,373,183,190,"6",2012,386,190,196,422944,435284,0.971650692421499,0.966321243523316,0.994515056758822,0.0881913444805932,-0.000483724518839258,-0.0606030156637047
"2117","전남","영광군",2014,425,219,206,"6",2013,443,226,217,465061,480776,0.967313260229296,0.959367945823928,0.991786203361376,0.0913858612096048,-0.00075062487962125,-0.0724577915423347
"2118","전남","영광군",2015,391,199,192,"6",2014,389,197,192,441255,454993,0.969806128885499,1.00514138817481,1.0364353845958,0.0886108939275476,0.0032285719996279,0.104284147068133
"2119","전남","영광군",2016,373,184,189,"6",2015,380,191,189,422114,435131,0.970084870992873,0.981578947368421,1.01184852657663,0.0883647545449807,0.00104699214266376,0.00738603801399039
"2120","전남","영광군",2017,387,200,187,"6",2016,398,203,195,445571,460063,0.968499966308962,0.972361809045226,1.00398744746578,0.0868548446824412,0.00034632913031948,-0.0237349501834435
"2121","전남","영광군",2018,372,186,186,"6",2017,384,197,187,447106,462352,0.967025123715265,0.96875,1.00178369335236,0.0832017463420307,0.000148406401854973,-0.0325259820889799
"2122","전남","영광군",2019,375,193,182,"6",2018,398,210,188,462528,478982,0.965647978420901,0.942211055276382,0.975729330285717,0.0810761726857617,-0.00196777300895433,-0.126519233205665
"2123","전남","영광군",2020,312,152,160,"6",2019,327,156,171,417119,431843,0.965904275396382,0.954128440366973,0.987808486483221,0.0747987984244304,-0.0009119105620303,-0.0796215346402803
"2124","전남","영암군",2009,543,272,271,"6",2008,589,306,283,462768,488710,0.946917394773997,0.921901528013582,0.973581785593468,0.117337413131418,-0.00309984493801366,-0.1768018890933
"2125","전남","영암군",2010,570,300,270,"6",2009,598,312,286,470657,487028,0.966385916210156,0.953177257525084,0.986331900679107,0.121107303195321,-0.00165530664855915,-0.112640575787432
"2126","전남","영암군",2011,480,246,234,"6",2010,491,257,234,441332,457372,0.964930078798003,0.977596741344195,1.01312702632503,0.108761657890205,0.00142771714627844,0.0242965044368111
"2127","전남","영암군",2012,458,227,231,"6",2011,471,228,243,407210,420797,0.967711271705834,0.9723991507431,1.00484429516771,0.112472679944009,0.000544850859952421,-0.0149173127514776
"2128","전남","영암군",2013,471,252,219,"6",2012,474,255,219,422944,435284,0.971650692421499,0.993670886075949,1.02266266450094,0.111362260724824,0.00252376555287238,0.0729791220782082
"2129","전남","영암군",2014,497,239,258,"6",2013,526,261,265,465061,480776,0.967313260229296,0.944866920152091,0.976795169672455,0.106867701226291,-0.0024798468744508,-0.149263754385697
"2130","전남","영암군",2015,445,243,202,"6",2014,459,243,216,441255,454993,0.969806128885499,0.969498910675381,0.999683216881222,0.100848715595291,-3.19471706510012e-05,-0.0405366538419303
"2131","전남","영암군",2016,453,235,218,"6",2015,458,237,221,422114,435131,0.970084870992873,0.989082969432314,1.01958395497911,0.107316980720848,0.00210169091893119,0.0542320504190784
"2132","전남","영암군",2017,448,244,204,"6",2016,451,246,205,445571,460063,0.968499966308962,0.993348115299335,1.02565632406274,0.100545143198278,0.00257961877682934,0.0754599259638559
"2133","전남","영암군",2018,413,196,217,"6",2017,428,207,221,447106,462352,0.967025123715265,0.964953271028037,0.997857498593969,0.0923718312883298,-0.000197906778412906,-0.0479079962753327
"2134","전남","영암군",2019,414,212,202,"6",2018,419,220,199,462528,478982,0.965647978420901,0.988066825775656,1.0232163768327,0.0895080946450809,0.00207805365485724,0.053182166233236
"2135","전남","영암군",2020,412,204,208,"6",2019,429,213,216,417119,431843,0.965904275396382,0.96037296037296,0.994273433543762,0.0987727722784146,-0.000565628844519229,-0.0642409179189941
"2136","전남","완도군",2009,385,196,189,"6",2008,402,207,195,462768,488710,0.946917394773997,0.95771144278607,1.01139914428824,0.0831950350931784,0.00094835220909231,0.00300479888135518
"2137","전남","완도군",2010,358,180,178,"6",2009,368,183,185,470657,487028,0.966385916210156,0.972826086956522,1.00666418108784,0.0760638851647803,0.00050690350498297,-0.0166028008753289
"2138","전남","완도군",2011,402,220,182,"6",2010,412,225,187,441332,457372,0.964930078798003,0.975728155339806,1.01119052745796,0.0910878884830468,0.0010193215171574,0.00615700609047269
"2139","전남","완도군",2012,359,177,182,"6",2011,366,179,187,407210,420797,0.967711271705834,0.980874316939891,1.01360224440793,0.0881608997814396,0.00119918610605059,0.0141459589101073
"2140","전남","완도군",2013,369,200,169,"6",2012,367,199,168,422944,435284,0.971650692421499,1.00544959128065,1.03478503038466,0.0872455927971552,0.00303484059637642,0.0956792790961687
"2141","전남","완도군",2014,376,186,190,"6",2013,384,193,191,465061,480776,0.967313260229296,0.979166666666667,1.01225394804839,0.0808496089760268,0.000990726908125047,0.00488693406650698
"2142","전남","완도군",2015,308,170,138,"6",2014,319,168,151,441255,454993,0.969806128885499,0.96551724137931,0.995577582592597,0.069800908771572,-0.000308688754003926,-0.0528285422355389
"2143","전남","완도군",2016,323,150,173,"6",2015,322,149,173,422114,435131,0.970084870992873,1.00310559006211,1.03403900015,0.0765196131850638,0.00260465112468427,0.076571774867569
"2144","전남","완도군",2017,390,198,192,"6",2016,396,200,196,445571,460063,0.968499966308962,0.984848484848485,1.01688024688512,0.0875281380520725,0.00147749657971359,0.0265075318966836
"2145","전남","완도군",2018,354,186,168,"6",2017,366,197,169,447106,462352,0.967025123715265,0.967213114754098,1.00019440140098,0.079175855389997,1.5391897211661e-05,-0.0384340188429709
"2146","전남","완도군",2019,387,191,196,"6",2018,400,204,196,462528,478982,0.965647978420901,0.9675,1.00191790551059,0.0836706102117061,0.00016047232439907,-0.0319900562209515
"2147","전남","완도군",2020,315,162,153,"6",2019,321,165,156,417119,431843,0.965904275396382,0.981308411214953,1.01594789070816,0.07551801764005,0.00120435309182079,0.0143754582562088
"2148","전남","장성군",2009,327,181,146,"6",2008,363,201,162,462768,488710,0.946917394773997,0.900826446280992,0.9513252700316,0.0706617570791412,-0.00343944194491987,-0.191885594466089
"2149","전남","장성군",2010,363,195,168,"6",2009,358,188,170,470657,487028,0.966385916210156,1.01396648044693,1.04923557291001,0.0771262299296515,0.00379735411697547,0.129547449467472
"2150","전남","장성군",2011,325,172,153,"6",2010,332,175,157,441332,457372,0.964930078798003,0.978915662650602,1.01449388319413,0.0736407058631597,0.00106733978911383,0.00828980894789417
"2151","전남","장성군",2012,331,177,154,"6",2011,344,196,148,407210,420797,0.967711271705834,0.962209302325581,0.994314451488661,0.0812848407455613,-0.000462148905295341,-0.0596447027477623
"2152","전남","장성군",2013,343,175,168,"6",2012,351,174,177,422944,435284,0.971650692421499,0.977207977207977,1.00571942656947,0.0810982068548082,0.00046383523902162,-0.0185157418655813
"2153","전남","장성군",2014,340,184,156,"6",2013,352,191,161,465061,480776,0.967313260229296,0.965909090909091,0.998548382020658,0.0731086889676838,-0.000106125887351637,-0.0438314117016573
"2154","전남","장성군",2015,346,181,165,"6",2014,350,183,167,441255,454993,0.969806128885499,0.988571428571429,1.01934953711573,0.0784127092044283,0.00151724962709578,0.0282732225305504
"2155","전남","장성군",2016,309,154,155,"6",2015,330,170,160,422114,435131,0.970084870992873,0.936363636363636,0.965238882042636,0.073202973604287,-0.00254461720028839,-0.152140624593519
"2156","전남","장성군",2017,339,187,152,"6",2016,360,198,162,445571,460063,0.968499966308962,0.941666666666667,0.972293959137077,0.0760821507683399,-0.00210793517812667,-0.132744744094194
"2157","전남","장성군",2018,366,191,175,"6",2017,375,194,181,447106,462352,0.967025123715265,0.976,1.009280913251,0.0818597826913528,0.000759733541903857,-0.00537297932581415
"2158","전남","장성군",2019,322,157,165,"6",2018,319,150,169,462528,478982,0.965647978420901,1.00940438871473,1.04531300357029,0.0696174069461741,0.00315457380950653,0.100997407564512
"2159","전남","장성군",2020,271,138,133,"6",2019,293,145,148,417119,431843,0.965904275396382,0.924914675767918,0.957563497053946,0.064969469144297,-0.0027570770687455,-0.161577345159886
"2160","전남","장흥군",2009,333,178,155,"6",2008,369,200,169,462768,488710,0.946917394773997,0.902439024390244,0.95302824657227,0.0719583030805933,-0.00338000766937952,-0.189245732856404
"2161","전남","장흥군",2010,300,146,154,"6",2009,302,146,156,470657,487028,0.966385916210156,0.993377483443709,1.02793042280604,0.063740685892274,0.00178030430691821,0.0399571867784179
"2162","전남","장흥군",2011,275,149,126,"6",2010,282,155,127,441332,457372,0.964930078798003,0.975177304964539,1.01061965668984,0.0623113664995967,0.00066172532010061,-0.00972616004215486
"2163","전남","장흥군",2012,268,135,133,"6",2011,270,136,134,407210,420797,0.967711271705834,0.992592592592593,1.02571151294218,0.0658137079148351,0.00169217000282514,0.0360425707802185
"2164","전남","장흥군",2013,246,147,99,"6",2012,252,154,98,422944,435284,0.971650692421499,0.976190476190476,1.00467223849516,0.0581637285314368,0.000271754811466387,-0.0270472793002521
"2165","전남","장흥군",2014,258,133,125,"6",2013,264,134,130,465061,480776,0.967313260229296,0.977272727272727,1.01029601004443,0.0554765933931248,0.000571187562806374,-0.0137475289834792
"2166","전남","장흥군",2015,240,116,124,"6",2014,257,122,135,441255,454993,0.969806128885499,0.933852140077821,0.962926622407515,0.0543903185233029,-0.00201643281598994,-0.128680530796325
"2167","전남","장흥군",2016,243,129,114,"6",2015,245,128,117,422114,435131,0.970084870992873,0.991836734693878,1.02242263986525,0.0575673870091966,0.00129081278689088,0.0182156940078114
"2168","전남","장흥군",2017,230,110,120,"6",2016,234,112,122,445571,460063,0.968499966308962,0.982905982905983,1.01487456592479,0.0516191583384017,0.000767812573686797,-0.00501413713158678
"2169","전남","장흥군",2018,233,129,104,"6",2017,239,137,102,447106,462352,0.967025123715265,0.97489539748954,1.00813864457217,0.0521129217679924,0.000424128547886878,-0.0202793735178773
"2170","전남","장흥군",2019,245,128,117,"6",2018,243,130,113,462528,478982,0.965647978420901,1.0082304526749,1.04409730585635,0.0529697661546977,0.00233582397926323,0.0646314179878666
"2171","전남","장흥군",2020,221,100,121,"6",2019,242,108,134,417119,431843,0.965904275396382,0.913223140495868,0.94545925901519,0.0529824822173049,-0.00288970383934633,-0.167468160130584
"2172","전남","진도군",2009,259,135,124,"6",2008,279,143,136,462768,488710,0.946917394773997,0.92831541218638,0.980355221384378,0.0559675690626837,-0.00109947050389097,-0.0879522879897793
"2173","전남","진도군",2010,229,102,127,"6",2009,249,114,135,470657,487028,0.966385916210156,0.919678714859438,0.951668168412586,0.0486553902311025,-0.00235160412646958,-0.143567662290045
"2174","전남","진도군",2011,210,104,106,"6",2010,214,101,113,441332,457372,0.964930078798003,0.981308411214953,1.01697359505815,0.0475832253269647,0.000807658398260839,-0.00324432566096723
"2175","전남","진도군",2012,197,110,87,"6",2011,202,111,91,407210,420797,0.967711271705834,0.975247524752475,1.0077877082421,0.0483779867881437,0.000376753646446439,-0.0223836001184076
"2176","전남","진도군",2013,201,111,90,"6",2012,210,115,95,422944,435284,0.971650692421499,0.957142857142857,0.985068877744031,0.0475240220927593,-0.000709586983962363,-0.0706350324642228
"2177","전남","진도군",2014,241,113,128,"6",2013,257,122,135,465061,480776,0.967313260229296,0.937743190661479,0.969430720343058,0.0518211589447406,-0.0015841354999286,-0.10947940352986
"2178","전남","진도군",2015,183,99,84,"6",2014,196,107,89,441255,454993,0.969806128885499,0.933673469387755,0.962742388997616,0.0414726178740184,-0.00154517066400071,-0.107748722478252
"2179","전남","진도군",2016,208,108,100,"6",2015,213,107,106,422114,435131,0.970084870992873,0.976525821596244,1.00663957432588,0.0492757880572547,0.000327170257272541,-0.0245859199812854
"2180","전남","진도군",2017,185,102,83,"6",2016,209,117,92,445571,460063,0.968499966308962,0.885167464114832,0.913957144973668,0.0415197577939318,-0.0035724785005917,-0.197794610649258
"2181","전남","진도군",2018,202,89,113,"6",2017,212,93,119,447106,462352,0.967025123715265,0.952830188679245,0.985321027667324,0.0451794429061565,-0.000663187792425206,-0.0685741434680033
"2182","전남","진도군",2019,199,105,94,"6",2018,209,113,96,462528,478982,0.965647978420901,0.952153110047847,0.98602506433543,0.0430244223052442,-0.000601263533721073,-0.0658236855584038
"2183","전남","진도군",2020,171,93,78,"6",2019,182,90,92,417119,431843,0.965904275396382,0.93956043956044,0.972726245750251,0.0409954952903128,-0.00111810106389474,-0.0887797919792493
"2184","전남","함평군",2009,223,123,100,"6",2008,241,134,107,462768,488710,0.946917394773997,0.925311203319502,0.977182601593615,0.0481882930539709,-0.0010995314811361,-0.0879549963846749
"2185","전남","함평군",2010,209,106,103,"6",2009,215,114,101,470657,487028,0.966385916210156,0.972093023255814,1.00590561901817,0.0444060111716175,0.000262244984095962,-0.0274696724052691
"2186","전남","함평군",2011,204,110,94,"6",2010,221,118,103,441332,457372,0.964930078798003,0.923076923076923,0.956625711395363,0.0462237046033372,-0.00200492030384062,-0.128169185472811
"2187","전남","함평군",2012,167,84,83,"6",2011,172,89,83,407210,420797,0.967711271705834,0.970930232558139,1.00332636494626,0.0410107806782741,0.000136416823267061,-0.0330585170268215
"2188","전남","함평군",2013,165,77,88,"6",2012,174,82,92,422944,435284,0.971650692421499,0.948275862068966,0.975943175325404,0.0390122569418174,-0.000938511025409596,-0.0808030337237035
"2189","전남","함평군",2014,192,97,95,"6",2013,198,101,97,465061,480776,0.967313260229296,0.96969696969697,1.00246425802858,0.0412849067111626,0.000101736662822235,-0.0345988878539862
"2190","전남","함평군",2015,162,87,75,"6",2014,171,92,79,441255,454993,0.969806128885499,0.947368421052632,0.97686371825815,0.0367134650032294,-0.000849413070034262,-0.0768456157227533
"2191","전남","함평군",2016,166,94,72,"6",2015,178,102,76,422114,435131,0.970084870992873,0.932584269662921,0.961342968588335,0.0393258693149244,-0.00152022136539805,-0.106640562330409
"2192","전남","함평군",2017,167,87,80,"6",2016,178,97,81,445571,460063,0.968499966308962,0.938202247191011,0.968716860947948,0.0374799975761439,-0.00117249197584507,-0.0911956451055483
"2193","전남","함평군",2018,164,89,75,"6",2017,182,98,84,447106,462352,0.967025123715265,0.901098901098901,0.9318257395805,0.0366803397851964,-0.00250065503679172,-0.150187979816772
"2194","전남","함평군",2019,162,87,75,"6",2018,175,96,79,462528,478982,0.965647978420901,0.925714285714286,0.958645703611457,0.0350249066002491,-0.00144843036852773,-0.103451858592777
"2195","전남","함평군",2020,152,78,74,"6",2019,155,79,76,417119,431843,0.965904275396382,0.980645161290323,1.01526122853933,0.0364404402580559,0.000556125886851995,-0.0144165156880028
"2196","전남","해남군",2009,596,302,294,"6",2008,626,314,312,462768,488710,0.946917394773997,0.952076677316294,1.0054485032916,0.128790236144245,0.000701714025557555,-0.00795000230493905
"2197","전남","해남군",2010,557,290,267,"6",2009,586,304,282,470657,487028,0.966385916210156,0.950511945392492,0.983573880215559,0.118345206806655,-0.00194395254292056,-0.125461211832717
"2198","전남","해남군",2011,537,278,259,"6",2010,547,279,268,441332,457372,0.964930078798003,0.981718464351006,1.01739855137889,0.121677104764667,0.00211700535888257,0.0549122640118906
"2199","전남","해남군",2012,493,233,260,"6",2011,506,245,261,407210,420797,0.967711271705834,0.974308300395257,1.00681714565316,0.121067753738857,0.000825336511138594,-0.00245912602500988
"2200","전남","해남군",2013,495,255,240,"6",2012,505,254,251,422944,435284,0.971650692421499,0.98019801980198,1.00879670796012,0.117036770825452,0.00102953829354706,0.00661079938601811
"2201","전남","해남군",2014,499,239,260,"6",2013,513,258,255,465061,480776,0.967313260229296,0.97270955165692,1.00557863894716,0.107297752337865,0.00059857542013526,-0.0125310566284829
"2202","전남","해남군",2015,517,274,243,"6",2014,528,281,247,441255,454993,0.969806128885499,0.979166666666667,1.0096519680608,0.117165811152282,0.00113088066705911,0.0111120714018138
"2203","전남","해남군",2016,441,221,220,"6",2015,461,229,232,422114,435131,0.970084870992873,0.956616052060738,0.98611583446472,0.104474146794468,-0.00145053634825155,-0.103545398809649
"2204","전남","해남군",2017,479,264,215,"6",2016,502,274,228,445571,460063,0.968499966308962,0.954183266932271,0.985217656298685,0.107502508017802,-0.00158913902227252,-0.109701642405136
"2205","전남","해남군",2018,415,205,210,"6",2017,431,209,222,447106,462352,0.967025123715265,0.962877030162413,0.995710459375745,0.0928191525052225,-0.000398151525380053,-0.0568021640809263
"2206","전남","해남군",2019,455,211,244,"6",2018,469,224,245,462528,478982,0.965647978420901,0.970149253731343,1.00466140395986,0.0983724228587242,0.000458553601454705,-0.0187503336414953
"2207","전남","해남군",2020,376,173,203,"6",2019,383,176,207,417119,431843,0.965904275396382,0.981723237597911,1.01637736016339,0.0901421416909803,0.00147629032037289,0.0264539540967374
"2208","전남","화순군",2009,716,354,362,"6",2008,777,385,392,462768,488710,0.946917394773997,0.921492921492922,0.973150273274742,0.154721156173288,-0.00415422076186879,-0.223633557087403
"2209","전남","화순군",2010,659,347,312,"6",2009,672,352,320,470657,487028,0.966385916210156,0.980654761904762,1.01476516312506,0.140017040010029,0.00206737443603641,0.0527078328703703
"2210","전남","화순군",2011,635,328,307,"6",2010,655,339,316,441332,457372,0.964930078798003,0.969465648854962,1.00470041317668,0.143882609917251,0.000676307715550491,-0.00907846129298348
"2211","전남","화순군",2012,561,296,265,"6",2011,572,311,261,407210,420797,0.967711271705834,0.980769230769231,1.01349365192407,0.137766754254562,0.00185897662861976,0.0434515347773895
"2212","전남","화순군",2013,513,269,244,"6",2012,531,274,257,422944,435284,0.971650692421499,0.966101694915254,0.994289102504094,0.121292653400923,-0.00069268991057913,-0.0698845238572801
"2213","전남","화순군",2014,611,298,313,"6",2013,632,308,324,465061,480776,0.967313260229296,0.966772151898734,0.999440606933856,0.131380614586044,-7.34934048252209e-05,-0.0423819915300976
"2214","전남","화순군",2015,484,242,242,"6",2014,493,250,243,441255,454993,0.969806128885499,0.981744421906694,1.01230997893869,0.109687142355327,0.00135024641223932,0.0208555267382576
"2215","전남","화순군",2016,491,262,229,"6",2015,498,263,235,422114,435131,0.970084870992873,0.985943775100402,1.01634795529931,0.116319288154385,0.00190158252319542,0.0453439388559117
"2216","전남","화순군",2017,450,237,213,"6",2016,463,246,217,445571,460063,0.968499966308962,0.971922246220302,1.00353358805409,0.100994005444699,0.000356871211174547,-0.0232667080069809
"2217","전남","화순군",2018,470,238,232,"6",2017,476,243,233,447106,462352,0.967025123715265,0.987394957983193,1.02106443128351,0.10512048596977,0.00221430325319947,0.0592338944780688
"2218","전남","화순군",2019,450,226,224,"6",2018,459,228,231,462528,478982,0.965647978420901,0.980392156862745,1.01526868876788,0.0972914072229141,0.00148551221667604,0.0268635583158159
"2219","전남","화순군",2020,378,199,179,"6",2019,383,204,179,417119,431843,0.965904275396382,0.986945169712794,1.02178362271745,0.09062162116806,0.00197406720556912,0.0485634536653194
"2220","전북","고창군",2009,391,220,171,"6",2008,429,242,187,462768,488710,0.946917394773997,0.911421911421911,0.962514699225103,0.0844915810946306,-0.00316719233027884,-0.179793223533519
"2221","전북","고창군",2010,366,202,164,"6",2009,369,199,170,470657,487028,0.966385916210156,0.991869918699187,1.02637041999636,0.0777636367885743,0.00205065976255923,0.0519654258261237
"2222","전북","고창군",2011,343,180,163,"6",2010,359,190,169,441332,457372,0.964930078798003,0.955431754874652,0.990156464046408,0.0777192680340424,-0.000765032409179967,-0.0730977233632693
"2223","전북","고창군",2012,321,169,152,"6",2011,338,175,163,407210,420797,0.967711271705834,0.949704142011834,0.981392043039596,0.0788291053756047,-0.00146684860005642,-0.104269931697712
"2224","전북","고창군",2013,335,176,159,"6",2012,350,186,164,422944,435284,0.971650692421499,0.957142857142857,0.985068877744031,0.0792067034879322,-0.0011826449732706,-0.091646605563688
"2225","전북","고창군",2014,394,205,189,"6",2013,390,209,181,465061,480776,0.967313260229296,1.01025641025641,1.04439425343651,0.0847200689801983,0.00376108421346537,0.12793646784125
"2226","전북","고창군",2015,351,177,174,"6",2014,363,185,178,441255,454993,0.969806128885499,0.966942148760331,0.997046852932905,0.0795458408403304,-0.000234910566577213,-0.0495515744783104
"2227","전북","고창군",2016,346,171,175,"6",2015,360,180,180,422114,435131,0.970084870992873,0.961111111111111,0.990749510532436,0.0819683782106256,-0.000758247619310659,-0.0727963668456213
"2228","전북","고창군",2017,348,194,154,"6",2016,354,199,155,445571,460063,0.968499966308962,0.983050847457627,1.015024142132,0.0781020308772339,0.00117341601269758,0.0130013419445239
"2229","전북","고창군",2018,362,196,166,"6",2017,377,202,175,447106,462352,0.967025123715265,0.960212201591512,0.992954762025646,0.0809651402575676,-0.000570418680741474,-0.0644536656078458
"2230","전북","고창군",2019,324,171,153,"6",2018,333,176,157,462528,478982,0.965647978420901,0.972972972972973,1.0075855743664,0.0700498132004981,0.000531368067384555,-0.0155161710057033
"2231","전북","고창군",2020,273,146,127,"6",2019,298,157,141,417119,431843,0.965904275396382,0.916107382550336,0.948445312734938,0.0654489486213766,-0.0033742000780022,-0.188987780060944
"2232","전북","군산시",2009,2691,1453,1238,"6",2008,2805,1505,1300,462768,488710,0.946917394773997,0.959358288770053,1.01313830970338,0.581500881651281,0.00763993867592184,0.300221548998577
"2233","전북","군산시",2010,2729,1395,1334,"6",2009,2744,1411,1333,470657,487028,0.966385916210156,0.994533527696793,1.02912667808428,0.579827772666719,0.0168884568787895,0.711008219287049
"2234","전북","군산시",2011,2645,1358,1287,"6",2010,2702,1382,1320,441332,457372,0.964930078798003,0.978904515173945,1.01448233056778,0.599322052332484,0.00867958007843694,0.346398765787834
"2235","전북","군산시",2012,2525,1277,1248,"6",2011,2578,1293,1285,407210,420797,0.967711271705834,0.97944142746315,1.01212154503134,0.620073180914025,0.00751624498517428,0.294727510035435
"2236","전북","군산시",2013,2525,1302,1223,"6",2012,2578,1339,1239,422944,435284,0.971650692421499,0.97944142746315,1.00801804095074,0.597005750170235,0.00478681655269206,0.173495892929205
"2237","전북","군산시",2014,2801,1417,1384,"6",2013,2852,1458,1394,465061,480776,0.967313260229296,0.982117812061711,1.01530481638276,0.602286581760242,0.00921788554363856,0.37030840242343
"2238","전북","군산시",2015,2618,1379,1239,"6",2014,2661,1401,1260,441255,454993,0.969806128885499,0.983840661405487,1.01447148260046,0.593307724558362,0.00858604241266561,0.342244151456552
"2239","전북","군산시",2016,2597,1327,1270,"6",2015,2641,1345,1296,422114,435131,0.970084870992873,0.983339644074214,1.01366351901538,0.615236642234088,0.00840629756012236,0.334260516904712
"2240","전북","군산시",2017,2708,1366,1342,"6",2016,2781,1405,1376,445571,460063,0.968499966308962,0.973750449478605,1.00542125281599,0.607759481653878,0.0032948178013633,0.107226552729079
"2241","전북","군산시",2018,2721,1402,1319,"6",2017,2805,1453,1352,447106,462352,0.967025123715265,0.970053475935829,1.00313161690043,0.608580515582435,0.00190584102786864,0.0455330866649714
"2242","전북","군산시",2019,2706,1416,1290,"6",2018,2795,1456,1339,462528,478982,0.965647978420901,0.968157423971377,1.00259871672344,0.585045662100457,0.00152036794607533,0.0284117272988181
"2243","전북","군산시",2020,2503,1277,1226,"6",2019,2581,1310,1271,417119,431843,0.965904275396382,0.969779155366137,1.0040116604393,0.600068565565222,0.00240727132534318,0.0678048579653139
"2244","전북","김제시",2009,662,332,330,"6",2008,716,362,354,462768,488710,0.946917394773997,0.924581005586592,0.976411470197212,0.143052242160219,-0.00337439207755193,-0.188996308006071
"2245","전북","김제시",2010,640,320,320,"6",2009,702,348,354,470657,487028,0.966385916210156,0.911680911680912,0.943392175308412,0.135980129903518,-0.00769753935511776,-0.381015314333732
"2246","전북","김제시",2011,632,321,311,"6",2010,679,330,349,441332,457372,0.964930078798003,0.930780559646539,0.964609332943582,0.143202849555437,-0.00506804437014681,-0.264222389702678
"2247","전북","김제시",2012,552,299,253,"6",2011,578,308,270,407210,420797,0.967711271705834,0.955017301038062,0.986882481336199,0.135556592421601,-0.00177816613109164,-0.118097562153878
"2248","전북","김제시",2013,645,347,298,"6",2012,645,353,292,422944,435284,0.971650692421499,1,1.02917643943406,0.152502458954377,0.00444947875722796,0.158512533787609
"2249","전북","김제시",2014,669,335,334,"6",2013,678,333,345,465061,480776,0.967313260229296,0.986725663716814,1.02006837317925,0.143852096821707,0.00288687756163558,0.0891072811789108
"2250","전북","김제시",2015,606,316,290,"6",2014,606,320,286,441255,454993,0.969806128885499,1,1.03113392482805,0.13733555427134,0.00427579482290207,0.150798103919027
"2251","전북","김제시",2016,591,299,292,"6",2015,613,320,293,422114,435131,0.970084870992873,0.964110929853181,0.993841836607989,0.140009570874219,-0.000862201813888835,-0.0774136467726963
"2252","전북","김제시",2017,602,299,303,"6",2016,593,293,300,445571,460063,0.968499966308962,1.01517706576728,1.04819525150446,0.135107536172686,0.00651154168599074,0.250102120989709
"2253","전북","김제시",2018,658,318,340,"6",2017,655,321,334,447106,462352,0.967025123715265,1.00458015267176,1.03883562901883,0.147168680357678,0.00571538827356108,0.214739784866569
"2254","전북","김제시",2019,607,316,291,"6",2018,596,313,283,462528,478982,0.965647978420901,1.01845637583893,1.05468700665058,0.131235298187353,0.00717686562476292,0.279653471754925
"2255","전북","김제시",2020,490,268,222,"6",2019,508,282,226,417119,431843,0.965904275396382,0.964566929133858,0.998615446378498,0.117472471884522,-0.000162646936374484,-0.046341878029345
"2256","전북","남원시",2009,845,436,409,"6",2008,870,456,414,462768,488710,0.946917394773997,0.971264367816092,1.02571182362523,0.182596895204509,0.00469489916401367,0.169413245611162
"2257","전북","남원시",2010,783,412,371,"6",2009,812,423,389,470657,487028,0.966385916210156,0.964285714285714,0.997826746138149,0.166363190178835,-0.000361549445526,-0.0551764283490966
"2258","전북","남원시",2011,780,405,375,"6",2010,793,416,377,441332,457372,0.964930078798003,0.983606557377049,1.01935526624096,0.176737694071583,0.00342080512356898,0.11282246673954
"2259","전북","남원시",2012,729,371,358,"6",2011,731,375,356,407210,420797,0.967711271705834,0.997264021887825,1.03053880950451,0.179023108469831,0.00546715260646522,0.203714029075601
"2260","전북","남원시",2013,697,354,343,"6",2012,705,353,352,422944,435284,0.971650692421499,0.988652482269504,1.01749784153978,0.164797230839071,0.0028835958314158,0.0889615182577379
"2261","전북","남원시",2014,729,365,364,"6",2013,741,369,372,465061,480776,0.967313260229296,0.983805668016194,1.01704970712692,0.156753630168946,0.00267260348546247,0.0795899798826883
"2262","전북","남원시",2015,729,382,347,"6",2014,741,395,346,441255,454993,0.969806128885499,0.983805668016194,1.01443539972962,0.165210592514532,0.00238488094251421,0.0668103558616207
"2263","전북","남원시",2016,616,332,284,"6",2015,631,344,287,422114,435131,0.970084870992873,0.976228209191759,1.00633278425691,0.145932141554177,0.000924156768610755,0.00193012246146136
"2264","전북","남원시",2017,686,348,338,"6",2016,705,349,356,445571,460063,0.968499966308962,0.973049645390071,1.00469765538397,0.153959750522363,0.000723249850956493,-0.00699345663854241
"2265","전북","남원시",2018,638,327,311,"6",2017,658,329,329,447106,462352,0.967025123715265,0.969604863221885,1.0026677068086,0.142695468188752,0.000380669672043127,-0.0222096640261232
"2266","전북","남원시",2019,572,310,262,"6",2018,595,325,270,462528,478982,0.965647978420901,0.961344537815126,0.995543468528964,0.123668188736682,-0.000551131175071026,-0.0635969824010077
"2267","전북","남원시",2020,531,276,255,"6",2019,561,291,270,417119,431843,0.965904275396382,0.946524064171123,0.979935681289633,0.127301801164656,-0.00255422391097147,-0.152567320914742
"2268","전북","무주군",2009,166,82,84,"6",2008,181,90,91,462768,488710,0.946917394773997,0.917127071823204,0.968539681375372,0.0358711060401756,-0.00112851642544174,-0.0892424057294623
"2269","전북","무주군",2010,161,84,77,"6",2009,165,87,78,470657,487028,0.966385916210156,0.975757575757576,1.00969763672071,0.0342075014288537,0.00033173192198029,-0.0243833068690911
"2270","전북","무주군",2011,177,90,87,"6",2010,182,89,93,441332,457372,0.964930078798003,0.972527472527473,1.00787351736297,0.0401058613470131,0.000315774195672657,-0.0250920929807144
"2271","전북","무주군",2012,183,88,95,"6",2011,180,82,98,407210,420797,0.967711271705834,1.01666666666667,1.05058884441279,0.0449399572702046,0.00227346050625994,0.0618614517229244
"2272","전북","무주군",2013,170,89,81,"6",2012,178,97,81,422944,435284,0.971650692421499,0.955056179775281,0.982921318560621,0.0401944465461148,-0.000686468148193233,-0.0696081750414194
"2273","전북","무주군",2014,210,100,110,"6",2013,213,101,112,465061,480776,0.967313260229296,0.985915492957746,1.01923082572448,0.0451553667153341,0.000868374987827685,-0.000547508169522723
"2274","전북","무주군",2015,167,83,84,"6",2014,186,89,97,441255,454993,0.969806128885499,0.897849462365591,0.925803040033784,0.0378465966391316,-0.00280810241569116,-0.163843711718544
"2275","전북","무주군",2016,178,75,103,"6",2015,182,79,103,422114,435131,0.970084870992873,0.978021978021978,1.00818186868638,0.0421687032413045,0.000345018792595155,-0.0237931507793575
"2276","전북","무주군",2017,164,90,74,"6",2016,173,96,77,445571,460063,0.968499966308962,0.947976878612717,0.97880940793993,0.0368067042065125,-0.000779955853915887,-0.0737605703229478
"2277","전북","무주군",2018,165,85,80,"6",2017,174,90,84,447106,462352,0.967025123715265,0.948275862068966,0.980611401724223,0.0369040003936427,-0.000715516838401462,-0.070898415755135
"2278","전북","무주군",2019,155,84,71,"6",2018,157,84,73,462528,478982,0.965647978420901,0.987261146496815,1.0223820362688,0.0335114847101148,0.000750055266203279,-0.00580285431356533
"2279","전북","무주군",2020,123,65,58,"6",2019,136,69,67,417119,431843,0.965904275396382,0.904411764705882,0.936336848011916,0.0294879878404005,-0.00187729825170619,-0.122500662504945
"2280","전북","부안군",2009,418,238,180,"6",2008,445,248,197,462768,488710,0.946917394773997,0.939325842696629,0.991982878211695,0.0903260381011652,-0.000724154848112113,-0.0712820857841195
"2281","전북","부안군",2010,399,203,196,"6",2009,419,214,205,470657,487028,0.966385916210156,0.952267303102625,0.985390295046,0.0847751122367244,-0.00123853937722075,-0.0941292385198868
"2282","전북","부안군",2011,395,204,191,"6",2010,399,209,190,441332,457372,0.964930078798003,0.989974937343358,1.02595510192464,0.0895017809721479,0.00232302784756916,0.0640630587960613
"2283","전북","부안군",2012,330,162,168,"6",2011,348,174,174,407210,420797,0.967711271705834,0.948275862068966,0.979916106998931,0.0810392672085656,-0.00162758397150191,-0.111409231916984
"2284","전북","부안군",2013,313,166,147,"6",2012,313,170,143,422944,435284,0.971650692421499,1,1.02917643943406,0.0740050692290232,0.00215920442017419,0.0567865979859435
"2285","전북","부안군",2014,353,177,176,"6",2013,374,187,187,465061,480776,0.967313260229296,0.943850267379679,0.975744162915688,0.0759040211929188,-0.00184111557209963,-0.120893555057928
"2286","전북","부안군",2015,335,173,162,"6",2014,345,177,168,441255,454993,0.969806128885499,0.971014492753623,1.00124598497796,0.0759198196054436,9.45949547577333e-05,-0.0349160974233072
"2287","전북","부안군",2016,317,156,161,"6",2015,325,166,159,422114,435131,0.970084870992873,0.975384615384615,1.00546317600677,0.0750981962218737,0.000410274663751283,-0.020894714355165
"2288","전북","부안군",2017,341,182,159,"6",2016,349,185,164,445571,460063,0.968499966308962,0.977077363896848,1.00885637365644,0.0765310130147608,0.000677787247564934,-0.00901274568141561
"2289","전북","부안군",2018,328,173,155,"6",2017,347,187,160,447106,462352,0.967025123715265,0.945244956772334,0.977477144689631,0.0733606795703927,-0.00165229197143428,-0.112506674426051
"2290","전북","부안군",2019,306,167,139,"6",2018,318,175,143,462528,478982,0.965647978420901,0.962264150943396,0.996495796032175,0.0661581569115816,-0.000231831675953562,-0.0494148209790223
"2291","전북","부안군",2020,279,146,133,"6",2019,298,154,144,417119,431843,0.965904275396382,0.936241610738255,0.969290264663178,0.0668873870526157,-0.00205409395375739,-0.130353306158109
"2292","전북","순창군",2009,219,112,107,"6",2008,224,114,110,462768,488710,0.946917394773997,0.977678571428571,1.03248559676308,0.0473239290530028,0.00153734607646047,0.0291658361728724
"2293","전북","순창군",2010,211,102,109,"6",2009,226,114,112,470657,487028,0.966385916210156,0.933628318584071,0.966102985280922,0.044830949077566,-0.0015196353407525,-0.106614533175514
"2294","전북","순창군",2011,201,109,92,"6",2010,207,108,99,441332,457372,0.964930078798003,0.971014492753623,1.00630554906445,0.0455439442415234,0.000287179575003325,-0.0263621655215539
"2295","전북","순창군",2012,188,103,85,"6",2011,198,105,93,407210,420797,0.967711271705834,0.94949494949495,0.981175870589195,0.0461678249551828,-0.000869069111571735,-0.0777186679974114
"2296","전북","순창군",2013,177,96,81,"6",2012,187,103,84,422944,435284,0.971650692421499,0.946524064171123,0.974140266202294,0.0418495119921313,-0.00108221723968041,-0.0871859586382878
"2297","전북","순창군",2014,208,111,97,"6",2013,215,116,99,465061,480776,0.967313260229296,0.967441860465116,1.00013294580061,0.0447253156037595,5.94604289041051e-06,-0.038853570490007
"2298","전북","순창군",2015,187,85,102,"6",2014,197,92,105,441255,454993,0.969806128885499,0.949238578680203,0.978792101232715,0.0423791231827401,-0.000898772154305859,-0.0790379727502964
"2299","전북","순창군",2016,181,94,87,"6",2015,191,98,93,422114,435131,0.970084870992873,0.947643979057592,0.97686708389513,0.0428794117228995,-0.000991925834012013,-0.083175531770264
"2300","전북","순창군",2017,192,104,88,"6",2016,192,101,91,445571,460063,0.968499966308962,1,1.03252455837566,0.0430907756564049,0.00140150844828909,0.023132406194965
"2301","전북","순창군",2018,160,72,88,"6",2017,169,76,93,447106,462352,0.967025123715265,0.946745562130177,0.979028919634297,0.0357856973514111,-0.00075046473509918,-0.0724506784855679
"2302","전북","순창군",2019,153,87,66,"6",2018,165,92,73,462528,478982,0.965647978420901,0.927272727272727,0.960259585267369,0.0330790784557908,-0.00131457629680638,-0.0975065312202338
"2303","전북","순창군",2020,133,74,59,"6",2019,134,77,57,417119,431843,0.965904275396382,0.992537313432836,1.02757316507945,0.0318853852257989,0.000879180990452885,-6.75435157084546e-05
"2304","전북","완주군",2009,792,422,370,"6",2008,801,416,385,462768,488710,0.946917394773997,0.98876404494382,1.04419250338073,0.171144072191681,0.00756328498892304,0.296816861657657
"2305","전북","완주군",2010,854,446,408,"6",2009,832,431,401,470657,487028,0.966385916210156,1.02644230769231,1.06214535050104,0.181448485840007,0.0112761797504107,0.461730596241656
"2306","전북","완주군",2011,843,466,377,"6",2010,826,453,373,441332,457372,0.964930078798003,1.02058111380145,1.0576736451959,0.191012661669673,0.0110163964770617,0.450191936370437
"2307","전북","완주군",2012,876,469,407,"6",2011,860,456,404,407210,420797,0.967711271705834,1.01860465116279,1.05259149184782,0.215122418408192,0.0113136089139967,0.463393068125686
"2308","전북","완주군",2013,871,444,427,"6",2012,854,431,423,422944,435284,0.971650692421499,1.01990632318501,1.04966355825184,0.205937429068624,0.010227585504783,0.415155725630332
"2309","전북","완주군",2014,916,475,441,"6",2013,921,474,447,465061,480776,0.967313260229296,0.99457111834962,1.02817893565717,0.196963409101172,0.00555021923187781,0.207403556599562
"2310","전북","완주군",2015,904,477,427,"6",2014,949,502,447,441255,454993,0.969806128885499,0.952581664910432,0.98223927085833,0.204870199771107,-0.00363864412733456,-0.200733455218848
"2311","전북","완주군",2016,848,443,405,"6",2015,925,477,448,422114,435131,0.970084870992873,0.916756756756757,0.945027372520988,0.200893597464192,-0.0110436488963176,-0.529637738672344
"2312","전북","완주군",2017,898,504,394,"6",2016,996,536,460,445571,460063,0.968499966308962,0.901606425702811,0.93093077652745,0.201539148642977,-0.0139201524960893,-0.657401917744469
"2313","전북","완주군",2018,829,451,378,"6",2017,966,532,434,447106,462352,0.967025123715265,0.858178053830228,0.88744132162063,0.185414644401999,-0.0208700273260698,-0.966090929076482
"2314","전북","완주군",2019,822,445,377,"6",2018,951,495,456,462528,478982,0.965647978420901,0.864353312302839,0.895101871094158,0.17771897052719,-0.0186423874793748,-0.86714699717807
"2315","전북","완주군",2020,702,343,359,"6",2019,824,410,414,417119,431843,0.965904275396382,0.851941747572815,0.882014677099551,0.168297296454968,-0.0198566108655121,-0.921078532029036
"2316","전북","익산시",2009,3131,1651,1480,"6",2008,3269,1708,1561,462768,488710,0.946917394773997,0.957785255429795,1.0114770947453,0.676580921757771,0.0077651833418795,0.305784476828917
"2317","전북","익산시",2010,3100,1563,1537,"6",2009,3200,1610,1590,470657,487028,0.966385916210156,0.96875,1.00244631440731,0.658653754220165,0.0016112741683758,0.0324494621605749
"2318","전북","익산시",2011,2858,1466,1392,"6",2010,2941,1498,1443,441332,457372,0.964930078798003,0.971778306698402,1.00709712346094,0.647585038021263,0.00459599096629129,0.165020091127884
"2319","전북","익산시",2012,2678,1414,1264,"6",2011,2732,1453,1279,407210,420797,0.967711271705834,0.980234260614934,1.01294083191469,0.65764593207436,0.00851048546635639,0.33888817748205
"2320","전북","익산시",2013,2643,1329,1314,"6",2012,2696,1352,1344,422944,435284,0.971650692421499,0.980341246290801,1.00894411328792,0.624905424831656,0.00558922491392872,0.209136051892381
"2321","전북","익산시",2014,2933,1492,1441,"6",2013,3005,1519,1486,465061,480776,0.967313260229296,0.97603993344426,1.00902155855167,0.630669955124166,0.00568962592693062,0.213595511983172
"2322","전북","익산시",2015,2674,1393,1281,"6",2014,2717,1413,1304,441255,454993,0.969806128885499,0.984173721015826,1.01481491166367,0.605998798880466,0.00897781867370584,0.359645475889354
"2323","전북","익산시",2016,2534,1282,1252,"6",2015,2563,1290,1273,422114,435131,0.970084870992873,0.988685134607881,1.01917385186718,0.600311764120593,0.0115102888393727,0.472128899086447
"2324","전북","익산시",2017,2651,1344,1307,"6",2016,2722,1376,1346,445571,460063,0.968499966308962,0.97391623806025,1.00559243359804,0.594966907630883,0.00332731292395741,0.108669871855262
"2325","전북","익산시",2018,2610,1309,1301,"6",2017,2696,1351,1345,447106,462352,0.967025123715265,0.968100890207715,1.00111244937289,0.583754188044893,0.000649396980415182,-0.0102737415572123
"2326","전북","익산시",2019,2591,1322,1269,"6",2018,2671,1368,1303,462528,478982,0.965647978420901,0.970048670909772,1.0045572429987,0.560182302476823,0.00255288687596,0.0742725888891238
"2327","전북","익산시",2020,2153,1149,1004,"6",2019,2230,1182,1048,417119,431843,0.965904275396382,0.965470852017937,0.999551277088749,0.516159657076278,-0.000231612663993344,-0.0494050932375703
"2328","전북","임실군",2009,174,97,77,"6",2008,196,109,87,462768,488710,0.946917394773997,0.887755102040816,0.937521168097983,0.0375998340421118,-0.00234919371066084,-0.143460600092365
"2329","전북","임실군",2010,214,122,92,"6",2009,210,119,91,470657,487028,0.966385916210156,1.01904761904762,1.05449345023982,0.0454683559364888,0.00247772759171156,0.0709342776655908
"2330","전북","임실군",2011,173,97,76,"6",2010,166,92,74,441332,457372,0.964930078798003,1.0421686746988,1.08004579564667,0.0391995141979281,0.0031377563029362,0.100250433035723
"2331","전북","임실군",2012,149,80,69,"6",2011,150,79,71,407210,420797,0.967711271705834,0.993333333333333,1.02647696929512,0.0365904570123523,0.000968804406810539,0.00391321361509575
"2332","전북","임실군",2013,166,82,84,"6",2012,169,87,82,422944,435284,0.971650692421499,0.982248520710059,1.01090703518375,0.0392486948626769,0.000428086895783612,-0.0201035576177866
"2333","전북","임실군",2014,163,84,79,"6",2013,163,82,81,465061,480776,0.967313260229296,1,1.03379126609198,0.0350491655933308,0.00118435568086594,0.0134872435519346
"2334","전북","임실군",2015,203,103,100,"6",2014,195,99,96,441255,454993,0.969806128885499,1.04102564102564,1.0734368550774,0.046005144417627,0.00337847312341227,0.110942228088376
"2335","전북","임실군",2016,163,84,79,"6",2015,170,95,75,422114,435131,0.970084870992873,0.958823529411765,0.98839138520985,0.0386151608333294,-0.000448268527173811,-0.0590281851407449
"2336","전북","임실군",2017,164,78,86,"6",2016,152,76,76,445571,460063,0.968499966308962,1.07894736842105,1.11403965508953,0.0368067042065125,0.00419742385269286,0.147317140894103
"2337","전북","임실군",2018,158,91,67,"6",2017,152,84,68,447106,462352,0.967025123715265,1.03947368421053,1.07491900543071,0.0353383761345184,0.00264751599353463,0.0784756816730865
"2338","전북","임실군",2019,144,69,75,"6",2018,150,71,79,462528,478982,0.965647978420901,0.96,0.994151100041511,0.0311332503113325,-0.000182095266453578,-0.0472057044911219
"2339","전북","임실군",2020,139,64,75,"6",2019,143,68,75,417119,431843,0.965904275396382,0.972027972027972,1.00633985870813,0.0333238236570379,0.00021126833360018,-0.0297338760387904
"2340","전북","장수군",2009,137,81,56,"6",2008,149,85,64,462768,488710,0.946917394773997,0.919463087248322,0.971006649917729,0.029604467033157,-0.000858332676691375,-0.0772417932982942
"2341","전북","장수군",2010,150,73,77,"6",2009,155,74,81,470657,487028,0.966385916210156,0.967741935483871,1.00140318608846,0.031870342946137,4.4720021856625e-05,-0.0371313666337797
"2342","전북","장수군",2011,162,82,80,"6",2010,179,90,89,441332,457372,0.964930078798003,0.905027932960894,0.937920739384839,0.0367070595379442,-0.00227874711547226,-0.140331609951901
"2343","전북","장수군",2012,156,81,75,"6",2011,158,79,79,407210,420797,0.967711271705834,0.987341772151899,1.02028549322512,0.0383094717713219,0.000777126530075212,-0.00460044392710973
"2344","전북","장수군",2013,134,71,63,"6",2012,138,72,66,422944,435284,0.971650692421499,0.971014492753623,0.999345238291046,0.0316826813951729,-2.07446066145471e-05,-0.0400390753241304
"2345","전북","장수군",2014,179,76,103,"6",2013,187,83,104,465061,480776,0.967313260229296,0.957219251336898,0.989564901767185,0.0384895744859277,-0.000401642490699921,-0.0569572204897894
"2346","전북","장수군",2015,187,92,95,"6",2014,194,97,97,441255,454993,0.969806128885499,0.963917525773196,0.993928061561056,0.0423791231827401,-0.000257323427062025,-0.0505470749604678
"2347","전북","장수군",2016,146,78,68,"6",2015,146,77,69,422114,435131,0.970084870992873,1,1.03083764101641,0.0345878127709576,0.00106660655377351,0.00825724121137888
"2348","전북","장수군",2017,165,90,75,"6",2016,179,98,81,445571,460063,0.968499966308962,0.921787709497207,0.951768447664712,0.037031135329723,-0.00178606914169067,-0.118448586105826
"2349","전북","장수군",2018,161,78,83,"6",2017,171,82,89,447106,462352,0.967025123715265,0.941520467836257,0.97362565330152,0.0360093579598574,-0.000949723291222963,-0.0813010431603324
"2350","전북","장수군",2019,150,76,74,"6",2018,153,76,77,462528,478982,0.965647978420901,0.980392156862745,1.01526868876788,0.0324304690743047,0.000495170738892013,-0.0171239291047444
"2351","전북","장수군",2020,136,75,61,"6",2019,147,82,65,417119,431843,0.965904275396382,0.925170068027211,0.957827904475881,0.0326046044414184,-0.00137500449302963,-0.10019053929305
"2352","전북","전주시",2009,7040,3699,3341,"6",2008,7221,3767,3454,462768,488710,0.946917394773997,0.974934219637169,1.02958740120078,1.52128064170383,0.0450107406850666,1.96010121692055
"2353","전북","전주시",2010,6857,3544,3313,"6",2009,6992,3612,3380,470657,487028,0.966385916210156,0.980692219679634,1.01480392380467,1.45689961054441,0.021567830825547,0.918849562133419
"2354","전북","전주시",2011,6546,3346,3200,"6",2010,6713,3439,3274,441332,457372,0.964930078798003,0.975122895873678,1.01056327012665,1.48323710947767,0.0156678342492879,0.656792452539001
"2355","전북","전주시",2012,5995,3233,2762,"6",2011,6158,3308,2850,407210,420797,0.967711271705834,0.973530367002273,1.0060132556751,1.47221335428894,0.00885279530762949,0.354092377421879
"2356","전북","전주시",2013,5965,3098,2867,"6",2012,6121,3181,2940,422944,435284,0.971650692421499,0.974513968305832,1.00294681607976,1.41035219792691,0.00415604853496914,0.1454793947139
"2357","전북","전주시",2014,6669,3510,3159,"6",2013,6814,3622,3192,465061,480776,0.967313260229296,0.978720281772821,1.01179247924382,1.43400543154554,0.0169104792870243,0.711986377252688
"2358","전북","전주시",2015,6339,3241,3098,"6",2014,6467,3320,3147,441255,454993,0.969806128885499,0.980207205814133,1.01072490327586,1.43658428799674,0.0154072275363863,0.645217218377221
"2359","전북","전주시",2016,6041,3100,2941,"6",2015,6119,3158,2961,422114,435131,0.970084870992873,0.987252819088086,1.01769736711556,1.43112997910517,0.0253272326303099,1.08582897610875
"2360","전북","전주시",2017,6505,3346,3159,"6",2016,6604,3408,3196,445571,460063,0.968499966308962,0.985009085402786,1.01704607090152,1.45992445648393,0.0248859757960908,1.06622989853817
"2361","전북","전주시",2018,6532,3266,3266,"6",2017,6539,3293,3246,447106,462352,0.967025123715265,0.998929499923536,1.0329922929879,1.46095109437136,0.0482001265464882,2.10176252628276
"2362","전북","전주시",2019,6708,3435,3273,"6",2018,6748,3469,3279,462528,478982,0.965647978420901,0.99407231772377,1.02943550852698,1.45029057700291,0.0426900406459671,1.8570238783795
"2363","전북","전주시",2020,6166,3157,3009,"6",2019,6220,3168,3052,417119,431843,0.965904275396382,0.991318327974277,1.02631115031297,1.47823522783666,0.0388940692775369,1.68842017292706
"2364","전북","정읍시",2009,1218,640,578,"6",2008,1257,656,601,462768,488710,0.946917394773997,0.968973747016706,1.0232927944554,0.263198838294783,0.00613063644129933,0.233183648891802
"2365","전북","정읍시",2010,1069,554,515,"6",2009,1108,578,530,470657,487028,0.966385916210156,0.964801444043321,0.998360414674658,0.22712931072947,-0.000372397884827038,-0.0556582778908879
"2366","전북","정읍시",2011,982,519,463,"6",2010,992,517,475,441332,457372,0.964930078798003,0.98991935483871,1.0258974993005,0.222508225100378,0.00576240660389355,0.216828173831821
"2367","전북","정읍시",2012,935,468,467,"6",2011,951,478,473,407210,420797,0.967711271705834,0.983175604626709,1.01598031703569,0.229611257090936,0.00366926068327751,0.123857989387447
"2368","전북","정읍시",2013,855,453,402,"6",2012,890,460,430,422944,435284,0.971650692421499,0.960674157303371,0.988703208669801,0.202154422334872,-0.0022836963255939,-0.140551436469169
"2369","전북","정읍시",2014,963,488,475,"6",2013,990,501,489,465061,480776,0.967313260229296,0.972727272727273,1.00559695883492,0.207069610223175,0.00115896008438228,0.0123592604209424
"2370","전북","정읍시",2015,866,453,413,"6",2014,876,455,421,441255,454993,0.969806128885499,0.988584474885845,1.01936298961312,0.196258399338251,0.00380014934787315,0.129671603798789
"2371","전북","정읍시",2016,812,458,354,"6",2015,826,463,363,422114,435131,0.970084870992873,0.983050847457627,1.0133658165924,0.192365095685052,0.00257111658770605,0.0750822886079563
"2372","전북","정읍시",2017,829,434,395,"6",2016,837,433,404,445571,460063,0.968499966308962,0.990442054958184,1.02265574539238,0.186053401141457,0.00421517848564671,0.148105739282874
"2373","전북","정읍시",2018,873,455,418,"6",2017,895,464,431,447106,462352,0.967025123715265,0.975418994413408,1.00868009578272,0.195255711173637,0.00169483827510989,0.0361610860562044
"2374","전북","정읍시",2019,858,446,412,"6",2018,869,449,420,462528,478982,0.965647978420901,0.987341772151899,1.02246553010598,0.185502283105023,0.00416740712582473,0.145983903394576
"2375","전북","정읍시",2020,698,365,333,"6",2019,735,379,356,417119,431843,0.965904275396382,0.949659863945578,0.983182172535536,0.167338337500809,-0.00281426728827882,-0.164117533689533
"2376","전북","진안군",2009,158,86,72,"6",2008,176,94,82,462768,488710,0.946917394773997,0.897727272727273,0.9480523619925,0.0341423780382395,-0.00177361589504567,-0.117895456662669
"2377","전북","진안군",2010,159,84,75,"6",2009,166,86,80,470657,487028,0.966385916210156,0.957831325301205,0.991147852255029,0.0337825635229052,-0.000299048243508625,-0.0524003446454625
"2378","전북","진안군",2011,156,82,74,"6",2010,165,85,80,441332,457372,0.964930078798003,0.945454545454545,0.97981663773222,0.0353475388143167,-0.00071343218116375,-0.0708058226081478
"2379","전북","진안군",2012,140,71,69,"6",2011,151,77,74,407210,420797,0.967711271705834,0.927152317880795,0.958087753020026,0.0343802951793915,-0.00144095542280307,-0.103119847777912
"2380","전북","진안군",2013,169,88,81,"6",2012,159,84,75,422944,435284,0.971650692421499,1.06289308176101,1.09390451738589,0.0399580086252554,0.00375223751565583,0.127543528620446
"2381","전북","진안군",2014,163,81,82,"6",2013,160,76,84,465061,480776,0.967313260229296,1.01875,1.0531748523312,0.0350491655933308,0.00186373420475713,0.0436628495866641
"2382","전북","진안군",2015,135,68,67,"6",2014,133,71,62,441255,454993,0.969806128885499,1.01503759398496,1.04663969813373,0.0305945541693579,0.00142692077099497,0.0242611322459562
"2383","전북","진안군",2016,152,80,72,"6",2015,153,77,76,422114,435131,0.970084870992873,0.993464052287582,1.02410014009473,0.0360092297341476,0.000867827481296341,-0.00057182648517486
"2384","전북","진안군",2017,166,85,81,"6",2016,174,86,88,445571,460063,0.968499966308962,0.954022988505747,0.985052164887121,0.0372555664529334,-0.000556890064375343,-0.0638527720215706
"2385","전북","진안군",2018,146,85,61,"6",2017,162,92,70,447106,462352,0.967025123715265,0.901234567901235,0.931966032525333,0.0326544488331626,-0.00222161170981856,-0.137793856062117
"2386","전북","진안군",2019,148,67,81,"6",2018,149,70,79,462528,478982,0.965647978420901,0.993288590604027,1.02862390104966,0.0319980628199806,0.000915909383939989,0.00156380262371246
"2387","전북","진안군",2020,116,50,66,"6",2019,119,50,69,417119,431843,0.965904275396382,0.974789915966387,1.00919929727649,0.0278098096706216,0.000255830706362662,-0.0277545720761753
"2388","제주","서귀포시",2009,1479,779,700,"6",2008,1592,838,754,462768,488710,0.946917394773997,0.929020100502513,0.981099413348768,0.31959858935795,-0.0060406008317713,-0.307419929219266
"2389","제주","서귀포시",2010,1382,729,653,"6",2009,1418,742,676,470657,487028,0.966385916210156,0.974612129760226,1.00851234834043,0.293632093010409,0.00249949865963503,0.0719012719780563
"2390","제주","서귀포시",2011,1385,763,622,"6",2010,1410,780,630,441332,457372,0.964930078798003,0.982269503546099,1.0179696178294,0.313822700370696,0.00563927399185296,0.211359056012667
"2391","제주","서귀포시",2012,1289,706,583,"6",2011,1304,716,588,407210,420797,0.967711271705834,0.988496932515337,1.02147919675759,0.316544289187397,0.00679911706994624,0.262875208725578
"2392","제주","서귀포시",2013,1314,703,611,"6",2012,1357,732,625,422944,435284,0.971650692421499,0.96831245394252,0.996564363608222,0.310679428009382,-0.00106738154904567,-0.0865270094073305
"2393","제주","서귀포시",2014,1431,720,711,"6",2013,1486,745,741,465061,480776,0.967313260229296,0.962987886944818,0.995528466875919,0.307701570331634,-0.0013758977640695,-0.100230215252819
"2394","제주","서귀포시",2015,1407,723,684,"6",2014,1429,725,704,441255,454993,0.969806128885499,0.984604618614416,1.01525922479571,0.318863242342863,0.00486560589399713,0.176995438527644
"2395","제주","서귀포시",2016,1412,708,704,"6",2015,1446,725,721,422114,435131,0.970084870992873,0.976486860304288,1.00659941155959,0.334506792004056,0.00220754798991315,0.0589338494274522
"2396","제주","서귀포시",2017,1515,769,746,"6",2016,1613,813,800,445571,460063,0.968499966308962,0.939243645381277,0.969792130154446,0.34001315166382,-0.0102710730312374,-0.495322634328048
"2397","제주","서귀포시",2018,1618,882,736,"6",2017,1714,924,790,447106,462352,0.967025123715265,0.943990665110852,0.976180082565057,0.361882864466144,-0.00862001995270413,-0.421988659985008
"2398","제주","서귀포시",2019,1624,828,796,"6",2018,1778,919,859,462528,478982,0.965647978420901,0.913385826771654,0.945878671299338,0.351113878511139,-0.0190027496302657,-0.883153017257759
"2399","제주","서귀포시",2020,1437,706,731,"6",2019,1558,776,782,417119,431843,0.965904275396382,0.922336328626444,0.954894136117102,0.344506004281752,-0.0155392409359737,-0.729316135193536
"2400","제주","제주시",2009,4834,2651,2183,"6",2008,4993,2740,2253,462768,488710,0.946917394773997,0.968155417584618,1.02242859084418,1.04458389516993,0.0234285447871848,1.00149593595182
"2401","제주","제주시",2010,5083,2663,2420,"6",2009,5198,2715,2483,470657,487028,0.966385916210156,0.97787610619469,1.01188985662125,1.0799796879681,0.0128408036438027,0.531225689976889
"2402","제주","제주시",2011,4633,2438,2195,"6",2010,4733,2498,2235,441332,457372,0.964930078798003,0.978871751531798,1.01444837614676,1.04977658542775,0.0151675669763205,0.634572338699269
"2403","제주","제주시",2012,4458,2348,2110,"6",2011,4518,2384,2134,407210,420797,0.967711271705834,0.9867197875166,1.01964275540292,1.09476682792662,0.0215042370241927,0.916024949007695
"2404","제주","제주시",2013,4623,2403,2220,"6",2012,4680,2427,2253,422944,435284,0.971650692421499,0.987820512820513,1.01664159818454,1.09305250813346,0.0181901406349661,0.768824436354403
"2405","제주","제주시",2014,5147,2655,2492,"6",2013,5172,2672,2500,465061,480776,0.967313260229296,0.995166279969064,1.02879420854126,1.10673653563726,0.0318676026073707,1.37632922127218
"2406","제주","제주시",2015,4796,2467,2329,"6",2014,4850,2492,2358,441255,454993,0.969806128885499,0.988865979381443,1.01965325844852,1.08689986515734,0.021361123957597,0.909668369627943
"2407","제주","제주시",2016,4774,2502,2272,"6",2015,4820,2533,2287,422114,435131,0.970084870992873,0.99045643153527,1.02099977141335,1.13097409704487,0.0237501975123586,1.0157826194037
"2408","제주","제주시",2017,5048,2629,2419,"6",2016,5128,2679,2449,445571,460063,0.968499966308962,0.984399375975039,1.0164165309439,1.13292830996631,0.018598752657782,0.786973546148047
"2409","제주","제주시",2018,5182,2667,2515,"6",2017,5257,2689,2568,447106,462352,0.967025123715265,0.985733307970325,1.0193461201744,1.15900927296883,0.0224223326781003,0.956803530873714
"2410","제주","제주시",2019,5533,2821,2712,"6",2018,5622,2843,2779,462528,478982,0.965647978420901,0.984169334756315,1.01918023622408,1.19625190258752,0.022944394075128,0.97999166309847
"2411","제주","제주시",2020,4989,2567,2422,"6",2019,5036,2582,2454,417119,431843,0.965904275396382,0.99066719618745,1.02563703404347,1.19606155557527,0.0306634708183658,1.32284591969416
"2412","충남","계룡시",2009,591,342,249,"6",2008,566,330,236,462768,488710,0.946917394773997,1.04416961130742,1.10270401311683,0.127709781143035,0.0131163070376618,0.543462582345385
"2413","충남","계룡시",2010,579,301,278,"6",2009,579,302,277,470657,487028,0.966385916210156,1,1.03478329229141,0.123019523772089,0.00427902405291509,0.150941534965552
"2414","충남","계룡시",2011,550,290,260,"6",2010,581,296,285,441332,457372,0.964930078798003,0.946643717728055,0.981049029902015,0.124622732999193,-0.00236172168659692,-0.144017048747961
"2415","충남","계룡시",2012,487,242,245,"6",2011,526,270,256,407210,420797,0.967711271705834,0.925855513307985,0.956747679166671,0.119594312516883,-0.00517273157482164,-0.268872227361737
"2416","충남","계룡시",2013,532,275,257,"6",2012,566,294,272,422944,435284,0.971650692421499,0.939929328621908,0.967353119750744,0.125784973897254,-0.00410648697997943,-0.221513390278786
"2417","충남","계룡시",2014,484,243,241,"6",2013,521,259,262,465061,480776,0.967313260229296,0.928982725527831,0.96037422800099,0.104072369001056,-0.00412394796543264,-0.222288945877742
"2418","충남","계룡시",2015,441,229,212,"6",2014,497,263,234,441255,454993,0.969806128885499,0.887323943661972,0.91494982062207,0.099942210286569,-0.00850010291229947,-0.416662366555278
"2419","충남","계룡시",2016,455,260,195,"6",2015,497,287,210,422114,435131,0.970084870992873,0.915492957746479,0.943724600930514,0.107790786375245,-0.00606596951928058,-0.308546717148201
"2420","충남","계룡시",2017,480,249,231,"6",2016,523,270,253,445571,460063,0.968499966308962,0.917782026768642,0.947632481874408,0.107726939141012,-0.00564139243808149,-0.289688495577908
"2421","충남","계룡시",2018,508,273,235,"6",2017,535,288,247,447106,462352,0.967025123715265,0.949532710280374,0.981911107575276,0.11361958909073,-0.00205525252440356,-0.130404765793869
"2422","충남","계룡시",2019,475,230,245,"6",2018,531,262,269,462528,478982,0.965647978420901,0.894538606403013,0.926360978734537,0.102696485401965,-0.00756246867240357,-0.375015949377241
"2423","충남","계룡시",2020,419,194,225,"6",2019,475,228,247,417119,431843,0.965904275396382,0.882105263157895,0.913242943039983,0.100450950448193,-0.00871482882972174,-0.426199737051579
"2424","충남","공주시",2009,1056,572,484,"6",2008,1094,582,512,462768,488710,0.946917394773997,0.96526508226691,1.01937622816327,0.228192096255575,0.00442150212210368,0.157269909992479
"2425","충남","공주시",2010,981,496,485,"6",2009,1028,526,502,470657,487028,0.966385916210156,0.954280155642023,0.987473161223616,0.208432042867736,-0.00261099459683654,-0.155088875233495
"2426","충남","공주시",2011,925,503,422,"6",2010,954,515,439,441332,457372,0.964930078798003,0.969601677148847,1.00484138535371,0.209592778225916,0.00101471940674581,0.00595259652227947
"2427","충남","공주시",2012,832,413,419,"6",2011,870,433,437,407210,420797,0.967711271705834,0.95632183908046,0.988230546694679,0.204317182780384,-0.00240470154220846,-0.145926062861234
"2428","충남","공주시",2013,887,436,451,"6",2012,905,453,452,422944,435284,0.971650692421499,0.980110497237569,1.00870663179891,0.209720435802376,0.00182595861523813,0.041984990680371
"2429","충남","공주시",2014,871,466,405,"6",2013,902,477,425,465061,480776,0.967313260229296,0.965631929046563,0.998261854507883,0.187287259090743,-0.000325532505119572,-0.0535766824547817
"2430","충남","공주시",2015,797,395,402,"6",2014,841,409,432,441255,454993,0.969806128885499,0.947681331747919,0.977186371091503,0.180621182762802,-0.00412062463656443,-0.222141335290824
"2431","충남","공주시",2016,731,380,351,"6",2015,741,386,355,422114,435131,0.970084870992873,0.986504723346829,1.01692620186639,0.173175966681986,0.00293121137046635,0.0910764331350748
"2432","충남","공주시",2017,749,390,359,"6",2016,771,402,369,445571,460063,0.968499966308962,0.971465629053178,1.00306211961526,0.168098911284621,0.000514738973548907,-0.0162547769030829
"2433","충남","공주시",2018,735,364,371,"6",2017,772,382,390,447106,462352,0.967025123715265,0.952072538860104,0.984537542522459,0.164390547208045,-0.00254188184591408,-0.152019129766906
"2434","충남","공주시",2019,734,389,345,"6",2018,754,401,353,462528,478982,0.965647978420901,0.973474801061008,1.00810525451822,0.158693095336931,0.00128624792799013,0.0180129390207915
"2435","충남","공주시",2020,670,353,317,"6",2019,699,371,328,417119,431843,0.965904275396382,0.958512160228898,0.99234694849606,0.160625624821694,-0.00122927617961291,-0.0937177998420272
"2436","충남","금산군",2009,405,208,197,"6",2008,424,221,203,462768,488710,0.946917394773997,0.955188679245283,1.00873495884323,0.0875168550980189,0.000764456127369822,-0.00516321867917186
"2437","충남","금산군",2010,412,206,206,"6",2009,420,215,205,470657,487028,0.966385916210156,0.980952380952381,1.01507313434301,0.0875372086253896,0.00131946010562224,0.0194881072113338
"2438","충남","금산군",2011,370,191,179,"6",2010,379,197,182,441332,457372,0.964930078798003,0.976253298153034,1.01173475633503,0.0838371112903664,0.000983808072824895,0.00457962372198689
"2439","충남","금산군",2012,371,183,188,"6",2011,372,185,187,407210,420797,0.967711271705834,0.997311827956989,1.03058821067463,0.0911077822253874,0.00278682403680873,0.0846632552914443
"2440","충남","금산군",2013,377,201,176,"6",2012,391,213,178,422944,435284,0.971650692421499,0.964194373401535,0.992326132139748,0.0891370961640312,-0.000684026297409354,-0.0694997166126367
"2441","충남","금산군",2014,454,221,233,"6",2013,467,227,240,465061,480776,0.967313260229296,0.972162740899358,1.00501335076179,0.0976216023274366,0.000489411334395566,-0.0173797416083308
"2442","충남","금산군",2015,378,200,178,"6",2014,384,200,184,441255,454993,0.969806128885499,0.984375,1.01502245725261,0.085664751674202,0.00128689507008106,0.0180416827977843
"2443","충남","금산군",2016,377,190,187,"6",2015,381,195,186,422114,435131,0.970084870992873,0.989501312335958,1.02001519859104,0.0893123658537741,0.0017876047391988,0.0402814463195064
"2444","충남","금산군",2017,400,218,182,"6",2016,418,227,191,445571,460063,0.968499966308962,0.956937799043062,0.988061778349911,0.0897724492841769,-0.00107172339762585,-0.0867198590597857
"2445","충남","금산군",2018,370,187,183,"6",2017,377,188,189,447106,462352,0.967025123715265,0.981432360742706,1.01489851367262,0.0827544251251381,0.00123291793419685,0.015644208149931
"2446","충남","금산군",2019,322,179,143,"6",2018,325,177,148,462528,478982,0.965647978420901,0.990769230769231,1.02601491735053,0.0696174069461741,0.00181109108786319,0.0413246273733195
"2447","충남","금산군",2020,298,167,131,"6",2019,312,177,135,417119,431843,0.965904275396382,0.955128205128205,0.988843542219797,0.0714424420848727,-0.000797044588834473,-0.074519591861606
"2448","충남","논산시",2009,1040,539,501,"6",2008,1082,560,522,462768,488710,0.946917394773997,0.961182994454713,1.0150653053365,0.224734640251703,0.00338569597508118,0.111263041771387
"2449","충남","논산시",2010,1068,545,523,"6",2009,1048,540,508,470657,487028,0.966385916210156,1.01908396946565,1.05453106504507,0.226916841776495,0.0123740170587352,0.510492670609987
"2450","충남","논산시",2011,985,489,496,"6",2010,1029,510,519,441332,457372,0.964930078798003,0.957240038872692,0.992030469259607,0.223187985462192,-0.00177870351102734,-0.118121430681747
"2451","충남","논산시",2012,939,483,456,"6",2011,930,473,457,407210,420797,0.967711271705834,1.00967741935484,1.04336639334068,0.230593551238918,0.0100000106448511,0.405047650271427
"2452","충남","논산시",2013,999,518,481,"6",2012,992,524,468,422944,435284,0.971650692421499,1.0070564516129,1.03643877318007,0.23620148293864,0.00860689226159693,0.343170228459445
"2453","충남","논산시",2014,1065,564,501,"6",2013,1051,558,493,465061,480776,0.967313260229296,1.01332064700285,1.04756203462222,0.22900221691348,0.0108918113694041,0.444658303801458
"2454","충남","논산시",2015,1009,512,497,"6",2014,998,498,500,441255,454993,0.969806128885499,1.01102204408818,1.04249912840832,0.228665964125052,0.00971810417196209,0.392526355639068
"2455","충남","논산시",2016,919,467,452,"6",2015,894,451,443,422114,435131,0.970084870992873,1.02796420581655,1.05966419697324,0.217713698195274,0.0129897129728959,0.537839718963082
"2456","충남","논산시",2017,918,495,423,"6",2016,903,485,418,445571,460063,0.968499966308962,1.01661129568106,1.04967612911279,0.206027771107186,0.0102346621583418,0.415470045707175
"2457","충남","논산시",2018,909,465,444,"6",2017,922,477,445,447106,462352,0.967025123715265,0.98590021691974,1.01951872060155,0.203307493077704,0.00396830215358475,0.137140360376087
"2458","충남","논산시",2019,905,466,439,"6",2018,913,458,455,462528,478982,0.965647978420901,0.991237677984666,1.02650002913651,0.195663830081638,0.0051850971981244,0.191186119253976
"2459","충남","논산시",2020,794,409,385,"6",2019,802,413,389,417119,431843,0.965904275396382,0.99002493765586,1.02497210424871,0.190353352400634,0.00475352376024101,0.172017144111764
"2460","충남","당진시",2013,1533,818,715,"6",2012,1543,827,716,422944,435284,0.971650692421499,0.99351911860013,1.02250646899055,0.362459332677612,0.00815767973124383,0.323217786830645
"2461","충남","당진시",2014,1773,923,850,"6",2013,1800,936,864,465061,480776,0.967313260229296,0.985,1.0182843971006,0.381240310410892,0.00697074922630704,0.270498505828894
"2462","충남","당진시",2015,1734,925,809,"6",2014,1764,947,817,441255,454993,0.969806128885499,0.982993197278912,1.01359763358948,0.392970051330863,0.00534346276963433,0.198220161289891
"2463","충남","당진시",2016,1691,845,846,"6",2015,1722,865,857,422114,435131,0.970084870992873,0.981997677119628,1.01228016896559,0.400602680792393,0.00491946860819882,0.179387830966549
"2464","충남","당진시",2017,1862,989,873,"6",2016,1908,1002,906,445571,460063,0.968499966308962,0.975890985324948,1.00763140864543,0.417890751417844,0.00318909509321393,0.102530721645447
"2465","충남","당진시",2018,1865,967,898,"6",2017,1896,972,924,447106,462352,0.967025123715265,0.983649789029536,1.01719155470377,0.417127034752385,0.00717106223636718,0.279395705641135
"2466","충남","당진시",2019,1871,975,896,"6",2018,1892,982,910,462528,478982,0.965647978420901,0.988900634249471,1.02407984726131,0.404516050920161,0.00974068472090674,0.393529304253191
"2467","충남","당진시",2020,1703,850,853,"6",2019,1751,882,869,417119,431843,0.965904275396382,0.972587093089663,1.00691871634023,0.408276774733349,0.00282475119268303,0.0863478462424885
"2468","충남","보령시",2009,900,468,432,"6",2008,956,517,439,462768,488710,0.946917394773997,0.941422594142259,0.994197170036095,0.19448190021782,-0.00112854539802115,-0.089243692589602
"2469","충남","보령시",2010,900,435,465,"6",2009,918,452,466,470657,487028,0.966385916210156,0.980392156862745,1.01449342381511,0.191222057676822,0.00277146232470793,0.0839809420359154
"2470","충남","보령시",2011,888,471,417,"6",2010,915,477,438,441332,457372,0.964930078798003,0.970491803278689,1.00576386269108,0.201209067096879,0.001159741434947,0.0123939652666018
"2471","충남","보령시",2012,779,426,353,"6",2011,810,449,361,407210,420797,0.967711271705834,0.961728395061728,0.993817498236267,0.191301785319614,-0.00118272362514385,-0.0916500990034389
"2472","충남","보령시",2013,813,434,379,"6",2012,842,446,396,422944,435284,0.971650692421499,0.965558194774347,0.993729744964243,0.192224029658773,-0.00120529368996141,-0.0926525819494881
"2473","충남","보령시",2014,828,422,406,"6",2013,869,444,425,465061,480776,0.967313260229296,0.952819332566168,0.985016304170489,0.178041160191889,-0.00266771458944842,-0.157608177936126
"2474","충남","보령시",2015,836,424,412,"6",2014,867,442,425,441255,454993,0.969806128885499,0.964244521337947,0.994265237781139,0.189459609522838,-0.00108650581069172,-0.0873764418884028
"2475","충남","보령시",2016,768,388,380,"6",2015,807,400,407,422114,435131,0.970084870992873,0.951672862453532,0.981020208550931,0.181941371288325,-0.00345320928301004,-0.192497091232246
"2476","충남","보령시",2017,797,412,385,"6",2016,832,436,396,445571,460063,0.968499966308962,0.957932692307692,0.989089030078604,0.178871605198723,-0.00195166270411501,-0.125803670091973
"2477","충남","보령시",2018,811,401,410,"6",2017,840,417,423,447106,462352,0.967025123715265,0.96547619047619,0.998398249227359,0.181388753449965,-0.000290539575986853,-0.0520224195418738
"2478","충남","보령시",2019,726,374,352,"6",2018,768,397,371,462528,478982,0.965647978420901,0.9453125,0.978941105997907,0.156963470319635,-0.00330547708366185,-0.18593534621175
"2479","충남","보령시",2020,644,341,303,"6",2019,663,345,318,417119,431843,0.965904275396382,0.971342383107089,1.00563006899258,0.154392391619658,0.000869239816747607,-0.000509095508749257
"2480","충남","부여군",2009,528,261,267,"6",2008,545,271,274,462768,488710,0.946917394773997,0.968807339449541,1.02311705835837,0.114096048127788,0.00263756500302925,0.0780336936522908
"2481","충남","부여군",2010,536,279,257,"6",2009,545,281,264,470657,487028,0.966385916210156,0.98348623853211,1.01769512783156,0.113883358794196,0.00201518059175024,0.0503895657670819
"2482","충남","부여군",2011,451,248,203,"6",2010,454,246,208,441332,457372,0.964930078798003,0.993392070484581,1.02949642913198,0.102190641059339,0.00301425900195815,0.0947651170158379
"2483","충남","부여군",2012,451,220,231,"6",2011,469,233,236,407210,420797,0.967711271705834,0.961620469083156,0.99370597119124,0.11075366518504,-0.000697086759350443,-0.0700798164249014
"2484","충남","부여군",2013,455,243,212,"6",2012,460,248,212,422944,435284,0.971650692421499,0.989130434782609,1.01798973900543,0.107579253991072,0.00193532270169837,0.0468425589892288
"2485","충남","부여군",2014,442,230,212,"6",2013,458,235,223,465061,480776,0.967313260229296,0.965065502183406,0.997676287363871,0.095041295657989,-0.000220848659674527,-0.0489269940009027
"2486","충남","부여군",2015,408,210,198,"6",2014,413,217,196,441255,454993,0.969806128885499,0.987893462469734,1.01865046326839,0.0924635414896148,0.00172448788421692,0.0374780174751917
"2487","충남","부여군",2016,377,200,177,"6",2015,398,202,196,422114,435131,0.970084870992873,0.947236180904523,0.976446710209009,0.0893123658537741,-0.00210360003487291,-0.13255219226877
"2488","충남","부여군",2017,380,212,168,"6",2016,408,225,183,445571,460063,0.968499966308962,0.931372549019608,0.961665029859681,0.0852838268199681,-0.00326935295459564,-0.184330839373933
"2489","충남","부여군",2018,359,198,161,"6",2017,375,208,167,447106,462352,0.967025123715265,0.957333333333333,0.98997772638554,0.0802941584322286,-0.000804730025450583,-0.0748609519419987
"2490","충남","부여군",2019,370,190,180,"6",2018,389,202,187,462528,478982,0.965647978420901,0.951156812339332,0.98499332426992,0.0799951570499516,-0.00120046138182542,-0.0924379478075151
"2491","충남","부여군",2020,314,176,138,"6",2019,341,185,156,417119,431843,0.965904275396382,0.920821114369501,0.953325435889203,0.0752782779015101,-0.0035135808080644,-0.195178582170938
"2492","충남","서산시",2009,1769,965,804,"6",2008,1821,992,829,462768,488710,0.946917394773997,0.971444261394838,1.02590180173709,0.382264979428137,0.00990135170818175,0.400665567087978
"2493","충남","서산시",2010,1714,911,803,"6",2009,1739,927,812,470657,487028,0.966385916210156,0.985623921794135,1.01990716675531,0.364171785397859,0.00724962845949394,0.282885341114348
"2494","충남","서산시",2011,1711,912,799,"6",2010,1736,925,811,441332,457372,0.964930078798003,0.985599078341014,1.0214202044243,0.387689993021127,0.00830439890376881,0.329734536760416
"2495","충남","서산시",2012,1492,762,730,"6",2011,1524,788,736,407210,420797,0.967711271705834,0.979002624671916,1.01166810111262,0.366395717197515,0.00427514227549,0.150769120056668
"2496","충남","서산시",2013,1599,831,768,"6",2012,1627,836,791,422944,435284,0.971650692421499,0.98279041180086,1.01146473672715,0.378064235454339,0.00433440692543352,0.153401447493572
"2497","충남","서산시",2014,1873,967,906,"6",2013,1909,983,926,465061,480776,0.967313260229296,0.981141959140912,1.01429598815624,0.402742865989623,0.00575760724219928,0.216615003054984
"2498","충남","서산시",2015,1724,901,823,"6",2014,1756,918,838,441255,454993,0.969806128885499,0.981776765375854,1.01234332938699,0.390703788059059,0.00482258554875748,0.17508462600741
"2499","충남","서산시",2016,1641,884,757,"6",2015,1667,888,779,422114,435131,0.970084870992873,0.984403119376125,1.01475978938688,0.388757539432476,0.00573797940458419,0.215743203499422
"2500","충남","서산시",2017,1716,889,827,"6",2016,1748,899,849,445571,460063,0.968499966308962,0.981693363844394,1.01362250696375,0.385123807429119,0.00524635174860751,0.193906831078403
"2501","충남","서산시",2018,1716,904,812,"6",2017,1746,921,825,447106,462352,0.967025123715265,0.982817869415808,1.01633126721658,0.383801604093884,0.00626796655461031,0.239283369813567
"2502","충남","서산시",2019,1834,948,886,"6",2018,1861,977,884,462528,478982,0.965647978420901,0.985491671144546,1.02054961348968,0.396516535215165,0.00814826154094062,0.322799463922052
"2503","충남","서산시",2020,1655,816,839,"6",2019,1675,827,848,417119,431843,0.965904275396382,0.988059701492537,1.02293749666556,0.396769267283437,0.00910089374531061,0.365112037964603
"2504","충남","서천군",2009,419,227,192,"6",2008,424,226,198,462768,488710,0.946917394773997,0.988207547169811,1.04360480927238,0.0905421291014072,0.00394807227058162,0.136241820080561
"2505","충남","서천군",2010,405,215,190,"6",2009,413,219,194,470657,487028,0.966385916210156,0.980629539951574,1.0147390638693,0.0860499259545699,0.0012682953545933,0.0172155488132976
"2506","충남","서천군",2011,339,164,175,"6",2010,356,169,187,441332,457372,0.964930078798003,0.952247191011236,0.986856158735807,0.0768129208849574,-0.00100961683915093,-0.0839613040351462
"2507","충남","서천군",2012,360,180,180,"6",2011,366,184,182,407210,420797,0.967711271705834,0.983606557377049,1.01642564898846,0.0884064733184352,0.00145213369903613,0.0253810018868075
"2508","충남","서천군",2013,310,160,150,"6",2012,322,172,150,422944,435284,0.971650692421499,0.962732919254658,0.99082203796447,0.0732957554664447,-0.000672705661036529,-0.0689968937366762
"2509","충남","서천군",2014,328,166,162,"6",2013,342,171,171,465061,480776,0.967313260229296,0.95906432748538,0.99147232537476,0.0705283822982361,-0.000601443096083915,-0.0658316610874045
"2510","충남","서천군",2015,315,154,161,"6",2014,332,157,175,441255,454993,0.969806128885499,0.948795180722892,0.978334898556732,0.071387293061835,-0.00154661294594499,-0.107812783572637
"2511","충남","서천군",2016,293,149,144,"6",2015,315,164,151,422114,435131,0.970084870992873,0.93015873015873,0.958842631167643,0.0694125283691136,-0.00285683703167406,-0.166008332059692
"2512","충남","서천군",2017,316,154,162,"6",2016,327,159,168,445571,460063,0.968499966308962,0.966360856269113,0.997791316350788,0.0709202349344998,-0.000156640363298104,-0.0460750871662286
"2513","충남","서천군",2018,306,156,150,"6",2017,329,163,166,447106,462352,0.967025123715265,0.930091185410334,0.96180664038693,0.0684401461845737,-0.00261395911519848,-0.155220548718933
"2514","충남","서천군",2019,266,133,133,"6",2018,277,142,135,462528,478982,0.965647978420901,0.96028880866426,0.994450182803256,0.0575100318251003,-0.000319170163608215,-0.0532940896082998
"2515","충남","서천군",2020,261,127,134,"6",2019,274,130,144,417119,431843,0.965904275396382,0.952554744525547,0.986179240313066,0.0625720717588985,-0.000864793566893297,-0.0775287633312152
"2516","충남","아산시",2009,2806,1476,1330,"6",2008,2856,1489,1367,462768,488710,0.946917394773997,0.98249299719888,1.0375699111889,0.606351346679114,0.0227805662440037,0.972715006690177
"2517","충남","아산시",2010,3124,1649,1475,"6",2009,3165,1671,1494,470657,487028,0.966385916210156,0.987045813586098,1.02137851662508,0.663753009091547,0.0141900547398102,0.591154681081661
"2518","충남","아산시",2011,3259,1634,1625,"6",2010,3342,1682,1660,441332,457372,0.964930078798003,0.975164572112508,1.01060646106841,0.738446339717038,0.00783230235331569,0.308765667395464
"2519","충남","아산시",2012,2953,1548,1405,"6",2011,3081,1596,1485,407210,420797,0.967711271705834,0.958455047062642,0.990434931457525,0.725178654748164,-0.0069363835382063,-0.34720744838794
"2520","충남","아산시",2013,3235,1662,1573,"6",2012,3338,1718,1620,422944,435284,0.971650692421499,0.969143199520671,0.997419347384419,0.76487667398048,-0.00197388098930449,-0.126790528223439
"2521","충남","아산시",2014,3701,1934,1767,"6",2013,3803,1991,1812,465061,480776,0.967313260229296,0.97317906915593,1.00606402203692,0.795809581968817,0.00482580684224952,0.175227704541569
"2522","충남","아산시",2015,3494,1782,1712,"6",2014,3695,1889,1806,441255,454993,0.969806128885499,0.945602165087957,0.975042471813044,0.791832387168417,-0.0197621791221006,-0.916884205911633
"2523","충남","아산시",2016,3564,1817,1747,"6",2015,3696,1879,1817,422114,435131,0.970084870992873,0.964285714285714,0.994022010980108,0.844321676134883,-0.00504734570919151,-0.263303027938258
"2524","충남","아산시",2017,3824,1990,1834,"6",2016,3977,2091,1886,445571,460063,0.968499966308962,0.961528790545637,0.992802089823614,0.858224615156731,-0.00617742369106144,-0.313497119700409
"2525","충남","아산시",2018,3957,2034,1923,"6",2017,4097,2093,2004,447106,462352,0.967025123715265,0.965828655113498,0.998762732660792,0.885025027622085,-0.00109501256105889,-0.0877542818387228
"2526","충남","아산시",2019,4141,2111,2030,"6",2018,4225,2150,2075,462528,478982,0.965647978420901,0.980118343195266,1.01498513443587,0.895297149577971,0.0134161481464789,0.556780470465926
"2527","충남","아산시",2020,3646,1895,1751,"6",2019,3764,1952,1812,417119,431843,0.965904275396382,0.96865037194474,1.00284303177686,0.874091086716261,0.00248506873540477,0.0712603454645287
"2528","충남","연기군",2009,733,377,356,"6",2008,781,401,380,462768,488710,0.946917394773997,0.93854033290653,0.991153334056699,0.158394703177402,-0.00140126502619886,-0.101356939871388
"2529","충남","연기군",2010,736,382,354,"6",2009,756,389,367,470657,487028,0.966385916210156,0.973544973544973,1.00740807291863,0.156377149389046,0.0011584533254808,0.0123367519717818
"2530","충남","연기군",2011,719,371,348,"6",2010,749,378,371,441332,457372,0.964930078798003,0.959946595460614,0.994835394349406,0.162915900048036,-0.000841396377959707,-0.0764895424392501
"2531","충남","연기군",2012,783,388,395,"6",2011,720,358,362,407210,420797,0.967711271705834,1.0875,1.12378560816286,0.192284079467597,0.023802001716933,1.01808358008057
"2532","충남","예산군",2009,635,334,301,"6",2008,663,338,325,462768,488710,0.946917394773997,0.957767722473605,1.01145857892092,0.137217785153684,0.00157232082053707,0.0307192913695071
"2533","충남","예산군",2010,580,282,298,"6",2009,607,296,311,470657,487028,0.966385916210156,0.955518945634267,0.988755040410247,0.123231992725063,-0.00138573877835803,-0.100667318516625
"2534","충남","예산군",2011,560,293,267,"6",2010,581,305,276,441332,457372,0.964930078798003,0.963855421686747,0.998886284991142,0.126888600871906,-0.000141317739243997,-0.0453945100643404
"2535","충남","예산군",2012,539,281,258,"6",2011,557,290,267,407210,420797,0.967711271705834,0.967684021543986,0.999971840607167,0.132364136440657,-3.72729371501334e-06,-0.0392832261005122
"2536","충남","예산군",2013,557,271,286,"6",2012,578,281,297,422944,435284,0.971650692421499,0.963667820069204,0.991784215856008,0.131695921918741,-0.00108198526712839,-0.0871756552329041
"2537","충남","예산군",2014,614,338,276,"6",2013,632,353,279,465061,480776,0.967313260229296,0.971518987341772,1.00434784395644,0.132025691253405,0.000574027103811453,-0.0136214065529409
"2538","충남","예산군",2015,512,256,256,"6",2014,528,265,263,441255,454993,0.969806128885499,0.96969696969697,0.9998874422575,0.116032679516379,-1.30603764625468e-05,-0.0396977688306327
"2539","충남","예산군",2016,484,264,220,"6",2015,498,267,231,422114,435131,0.970084870992873,0.971887550200803,1.00185826958221,0.114660968363996,0.000213070989777739,-0.0296538083876693
"2540","충남","예산군",2017,496,259,237,"6",2016,504,263,241,445571,460063,0.968499966308962,0.984126984126984,1.01613527967128,0.111317837112379,0.00179614443421042,0.0406607495551332
"2541","충남","예산군",2018,497,262,235,"6",2017,494,258,236,447106,462352,0.967025123715265,1.00607287449393,1.0403792516048,0.111159322397821,0.00448853024732078,0.160247063712637
"2542","충남","예산군",2019,486,265,221,"6",2018,483,259,224,462528,478982,0.965647978420901,1.00621118012422,1.04200619957767,0.105074719800747,0.004413789650518,0.156927349113765
"2543","충남","예산군",2020,441,229,212,"6",2019,443,229,214,417119,431843,0.965904275396382,0.99548532731377,1.03062524172517,0.10572522469607,0.00323786056276482,0.104696712393636
"2544","충남","천안시",2009,6119,3227,2892,"6",2008,6463,3406,3057,462768,488710,0.946917394773997,0.94677394398886,0.999848507603801,1.32226083048093,-0.000200312461609994,-0.0480148482670382
"2545","충남","천안시",2010,6122,3184,2938,"6",2009,6228,3209,3019,470657,487028,0.966385916210156,0.982980089916506,1.01717137370071,1.30073493010834,0.02233540557046,0.952942534298688
"2546","충남","천안시",2011,6315,3307,3008,"6",2010,6381,3328,3053,441332,457372,0.964930078798003,0.989656793606018,1.02562539540566,1.43089556161801,0.0366672645506683,1.58951333411592
"2547","충남","천안시",2012,6027,3089,2938,"6",2011,5982,3070,2912,407210,420797,0.967711271705834,1.00752256770311,1.04113964274395,1.4800717074728,0.0608896212808646,2.66538527916454
"2548","충남","천안시",2013,6104,3190,2914,"6",2012,6108,3193,2915,422944,435284,0.971650692421499,0.999345121152587,1.02850245355362,1.44321706892638,0.0411352274748668,1.78796454244405
"2549","충남","천안시",2014,6797,3506,3291,"6",2013,6840,3538,3302,465061,480776,0.967313260229296,0.993713450292398,1.0272922859104,1.46152870268631,0.039888459219975,1.73258747891731
"2550","충남","천안시",2015,6599,3425,3174,"6",2014,6577,3438,3139,441255,454993,0.969806128885499,1.00334499011707,1.03458305761598,1.49550713306365,0.0517192093478456,2.2580678148414
"2551","충남","천안시",2016,6326,3273,3053,"6",2015,6256,3234,3022,422114,435131,0.970084870992873,1.01118925831202,1.04237194965949,1.4986472848567,0.0635006073112858,2.78135610109296
"2552","충남","천안시",2017,6857,3517,3340,"6",2016,6714,3442,3272,445571,460063,0.968499966308962,1.02129877867143,1.05451607041732,1.538924211854,0.0838961007003505,3.68725222784617
"2553","충남","천안시",2018,7076,3700,3376,"6",2017,6980,3660,3320,447106,462352,0.967025123715265,1.01375358166189,1.04832186548277,1.58262246536615,0.0764752698814306,3.3576450068826
"2554","충남","천안시",2019,7491,3751,3740,"6",2018,7474,3743,3731,462528,478982,0.965647978420901,1.0022745517795,1.03792952937,1.61957762557078,0.0614298171160894,2.68937887939197
"2555","충남","천안시",2020,6790,3458,3332,"6",2019,6782,3438,3344,417119,431843,0.965904275396382,1.0011795930404,1.03652051092697,1.62783282468552,0.0594492864612047,2.60141066921187
"2556","충남","청양군",2009,194,94,100,"6",2008,216,107,109,462768,488710,0.946917394773997,0.898148148148148,0.948496830985465,0.0419216540469523,-0.00215909803374907,-0.135017218304934
"2557","충남","청양군",2010,189,103,86,"6",2009,195,101,94,470657,487028,0.966385916210156,0.969230769230769,1.00294380637475,0.0401566321121326,0.000118213349600383,-0.0338670513423943
"2558","충남","청양군",2011,196,96,100,"6",2010,198,99,99,441332,457372,0.964930078798003,0.98989898989899,1.02587639420681,0.0444110103051671,0.0011491968097793,0.011925610080715
"2559","충남","청양군",2012,159,86,73,"6",2011,174,93,81,407210,420797,0.967711271705834,0.913793103448276,0.944282794017151,0.0390461923823089,-0.00217554474381105,-0.135747723356161
"2560","충남","청양군",2013,173,88,85,"6",2012,184,93,91,422944,435284,0.971650692421499,0.940217391304348,0.967649587076591,0.0409037603086933,-0.00132325353610637,-0.097891943689686
"2561","충남","청양군",2014,162,76,86,"6",2013,165,78,87,465061,480776,0.967313260229296,0.981818181818182,1.01499506125394,0.0348341400375435,0.000522340063591258,-0.0159171632010207
"2562","충남","청양군",2015,171,99,72,"6",2014,179,105,74,441255,454993,0.969806128885499,0.955307262569832,0.985049727070369,0.0387531019478533,-0.000579369450990214,-0.0648512273605877
"2563","충남","청양군",2016,144,63,81,"6",2015,151,66,85,422114,435131,0.970084870992873,0.95364238410596,0.983050465605051,0.0341140071165609,-0.000578216536971679,-0.0648000189723449
"2564","충남","청양군",2017,165,88,77,"6",2016,176,93,83,445571,460063,0.968499966308962,0.9375,0.967991773477179,0.037031135329723,-0.00118530096803102,-0.0917645755151989
"2565","충남","청양군",2018,169,89,80,"6",2017,176,94,82,447106,462352,0.967025123715265,0.960227272727273,0.992970347076532,0.0377986428274279,-0.000265711340054948,-0.0509196365723338
"2566","충남","청양군",2019,159,80,79,"6",2018,171,88,83,462528,478982,0.965647978420901,0.929824561403509,0.962902198505119,0.034376297218763,-0.00127528505035071,-0.0957613521603058
"2567","충남","청양군",2020,143,74,69,"6",2019,152,81,71,417119,431843,0.965904275396382,0.940789473684211,0.973998663892584,0.0342827826111973,-0.000891398153371231,-0.0787104455481873
"2568","충남","태안군",2009,457,240,217,"6",2008,498,266,232,462768,488710,0.946917394773997,0.917670682730924,0.969113766201271,0.098753587110604,-0.00305012637996128,-0.174593565503955
"2569","충남","태안군",2010,442,217,225,"6",2009,447,220,227,470657,487028,0.966385916210156,0.988814317673378,1.02320853510695,0.093911277214617,0.0021795431741736,0.0576899739484456
"2570","충남","태안군",2011,436,219,217,"6",2010,437,217,220,441332,457372,0.964930078798003,0.997711670480549,1.03397302291932,0.0987918392502696,0.00335625741909128,0.109955484590017
"2571","충남","태안군",2012,414,209,205,"6",2011,435,222,213,407210,420797,0.967711271705834,0.951724137931034,0.983479438297108,0.1016674443162,-0.00167960328700108,-0.113719747065017
"2572","충남","태안군",2013,429,212,217,"6",2012,433,217,216,422944,435284,0.971650692421499,0.990762124711316,1.01966903583652,0.101431868048725,0.00199506704761544,0.0494961928351597
"2573","충남","태안군",2014,438,235,203,"6",2013,447,238,209,465061,480776,0.967313260229296,0.979865771812081,1.0129766768418,0.0941811934348397,0.00122215891177908,0.0151663301917967
"2574","충남","태안군",2015,429,217,212,"6",2014,444,220,224,441255,454993,0.969806128885499,0.966216216216216,0.996298319259532,0.0972226943604039,-0.000359887375250298,-0.0551026050295805
"2575","충남","태안군",2016,429,224,205,"6",2015,420,225,195,422114,435131,0.970084870992873,1.02142857142857,1.05292701903819,0.101631312868088,0.00537904243104533,0.199800484788252
"2576","충남","태안군",2017,349,189,160,"6",2016,375,208,167,445571,460063,0.968499966308962,0.930666666666667,0.960936188994945,0.0783264620004444,-0.00305973010827998,-0.175020129359035
"2577","충남","태안군",2018,422,221,201,"6",2017,433,227,206,447106,462352,0.967025123715265,0.97459584295612,1.00782887543994,0.0943847767643467,0.000738926660714219,-0.00629714785265221
"2578","충남","태안군",2019,392,186,206,"6",2018,405,190,215,462528,478982,0.965647978420901,0.967901234567901,1.0023334136221,0.0847516258475163,0.000197760598247683,-0.0303338421638362
"2579","충남","태안군",2020,356,174,182,"6",2019,382,189,193,417119,431843,0.965904275396382,0.931937172774869,0.964833883142743,0.0853473469201834,-0.00300133477525203,-0.172426413923897
"2580","충남","홍성군",2009,736,370,366,"6",2008,764,387,377,462768,488710,0.946917394773997,0.963350785340314,1.01735461895305,0.159042976178128,0.00276013024873039,0.0834776110529234
"2581","충남","홍성군",2010,749,398,351,"6",2009,768,400,368,470657,487028,0.966385916210156,0.975260416666667,1.00918318479983,0.159139245777711,0.00146140510288219,0.0257928050569238
"2582","충남","홍성군",2011,733,365,368,"6",2010,736,373,363,441332,457372,0.964930078798003,0.995923913043478,1.03212029029511,0.166088115069834,0.00533479847061079,0.197835323582034
"2583","충남","홍성군",2012,661,315,346,"6",2011,672,325,347,407210,420797,0.967711271705834,0.983630952380952,1.01645085795793,0.162324107954127,0.00267037084310062,0.0794908137566504
"2584","충남","홍성군",2013,716,378,338,"6",2012,685,352,333,422944,435284,0.971650692421499,1.04525547445255,1.07575230749604,0.169289551335401,0.0128240741486263,0.53048262460486
"2585","충남","홍성군",2014,773,396,377,"6",2013,774,391,383,465061,480776,0.967313260229296,0.998708010335917,1.03245561846137,0.166214754623587,0.00539460265871257,0.200491615407466
"2586","충남","홍성군",2015,827,412,415,"6",2014,811,412,399,441255,454993,0.969806128885499,1.01972872996301,1.05147688758668,0.187419972578214,0.00964779685990681,0.389403551965809
"2587","충남","홍성군",2016,849,429,420,"6",2015,820,424,396,422114,435131,0.970084870992873,1.03536585365854,1.06729409417431,0.20113050029139,0.013534894827934,0.562054780664893
"2588","충남","홍성군",2017,950,478,472,"6",2016,933,470,463,445571,460063,0.968499966308962,1.01822079314041,1.05133797476621,0.21320956704992,0.0109457473731235,0.447053951503128
"2589","충남","홍성군",2018,942,490,452,"6",2017,953,502,451,447106,462352,0.967025123715265,0.988457502623295,1.02216320794819,0.210688293156433,0.00466952845347625,0.168286367826428
"2590","충남","홍성군",2019,943,482,461,"6",2018,964,503,461,462528,478982,0.965647978420901,0.978215767634855,1.01301487653348,0.203879548913795,0.00265346715681489,0.078740011427823
"2591","충남","홍성군",2020,865,462,403,"6",2019,856,452,404,417119,431843,0.965904275396382,1.01051401869159,1.04618443507448,0.207374873836963,0.00957749139680154,0.38628083041641
"2592","충북","괴산군",2009,218,111,107,"6",2008,231,124,107,462768,488710,0.946917394773997,0.943722943722944,0.996626473366438,0.0471078380527608,-0.000158919546320511,-0.0461763204648194
"2593","충북","괴산군",2010,200,112,88,"6",2009,200,113,87,470657,487028,0.966385916210156,1,1.03478329229141,0.0424937905948493,0.00147807393883077,0.0265331761592677
"2594","충북","괴산군",2011,177,88,89,"6",2010,193,94,99,441332,457372,0.964930078798003,0.917098445595855,0.95042994901586,0.0401058613470131,-0.00198804959173431,-0.12741984774113
"2595","충북","괴산군",2012,167,79,88,"6",2011,173,81,92,407210,420797,0.967711271705834,0.965317919075145,0.997526790582411,0.0410107806782741,-0.000101428248996184,-0.0436227591179755
"2596","충북","괴산군",2013,166,83,83,"6",2012,168,82,86,422944,435284,0.971650692421499,0.988095238095238,1.01692433896461,0.0392486948626769,0.000664258215774459,-0.00961365771937998
"2597","충북","괴산군",2014,191,90,101,"6",2013,202,95,107,465061,480776,0.967313260229296,0.945544554455445,0.977495702096867,0.0410698811553753,-0.000924248840366817,-0.0801695575952849
"2598","충북","괴산군",2015,189,79,110,"6",2014,188,86,102,441255,454993,0.969806128885499,1.00531914893617,1.03661867974735,0.042832375837101,0.00156846505359674,0.030548031754931
"2599","충북","괴산군",2016,182,77,105,"6",2015,179,76,103,422114,435131,0.970084870992873,1.01675977653631,1.04811424952506,0.0431163145500978,0.0020745091168645,0.0530247303145502
"2600","충북","괴산군",2017,190,104,86,"6",2016,196,108,88,445571,460063,0.968499966308962,0.969387755102041,1.0009166637315,0.042641913409984,3.90882954648905e-05,-0.0373815081247398
"2601","충북","괴산군",2018,142,61,81,"6",2017,141,63,78,447106,462352,0.967025123715265,1.00709219858156,1.04143333392659,0.0317598063993773,0.00131591466398922,0.0193306311561235
"2602","충북","괴산군",2019,170,96,74,"6",2018,170,92,78,462528,478982,0.965647978420901,1,1.03557406254324,0.0367545316175453,0.00130750800651007,0.0189572369800655
"2603","충북","괴산군",2020,143,62,81,"6",2019,139,61,78,417119,431843,0.965904275396382,1.02877697841727,1.06509206411275,0.0342827826111973,0.00223153708369163,0.0599993606520983
"2604","충북","단양군",2009,209,101,108,"6",2008,221,105,116,462768,488710,0.946917394773997,0.945701357466063,0.99871579367467,0.0451630190505826,-5.79986347357472e-05,-0.0416937683064068
"2605","충북","단양군",2010,203,103,100,"6",2009,217,111,106,470657,487028,0.966385916210156,0.935483870967742,0.968023079885516,0.0431311974537721,-0.00137920285542129,-0.100377015793362
"2606","충북","단양군",2011,205,114,91,"6",2010,209,120,89,441332,457372,0.964930078798003,0.980861244019139,1.01651017578495,0.0464502913906084,0.000766902476120876,-0.00505456046649751
"2607","충북","단양군",2012,200,106,94,"6",2011,205,104,101,407210,420797,0.967711271705834,0.975609756097561,1.00816202582595,0.0491147073991307,0.000400875510225717,-0.0213121917170088
"2608","충북","단양군",2013,184,95,89,"6",2012,198,102,96,422944,435284,0.971650692421499,0.929292929292929,0.956406388160947,0.0435045774381478,-0.00189652166206065,-0.12335449882314
"2609","충북","단양군",2014,211,108,103,"6",2013,219,106,113,465061,480776,0.967313260229296,0.963470319634703,0.9960272015772,0.0453703922711214,-0.000180247422856542,-0.0471236297736601
"2610","충북","단양군",2015,182,86,96,"6",2014,182,84,98,441255,454993,0.969806128885499,1,1.03113392482805,0.041245991546838,0.00128414960027753,0.017919738679361
"2611","충북","단양군",2016,175,100,75,"6",2015,183,106,77,422114,435131,0.970084870992873,0.956284153005464,0.985773700425527,0.0414579947597095,-0.000589793853208571,-0.0653142426656448
"2612","충북","단양군",2017,152,88,64,"6",2016,156,89,67,445571,460063,0.968499966308962,0.974358974358974,1.00604956969936,0.0341135307279872,0.000206372181830161,-0.0299513458905781
"2613","충북","단양군",2018,164,92,72,"6",2017,162,94,68,447106,462352,0.967025123715265,1.01234567901235,1.04686595434352,0.0366803397851964,0.00171905912967799,0.0372368912804928
"2614","충북","단양군",2019,155,78,77,"6",2018,163,83,80,462528,478982,0.965647978420901,0.950920245398773,0.984748341682223,0.0335114847101148,-0.00051110571452009,-0.0618191921317099
"2615","충북","단양군",2020,117,60,57,"6",2019,125,64,61,417119,431843,0.965904275396382,0.936,0.969040125240039,0.0280495494091614,-0.000868410536780963,-0.0776894164200772
"2616","충북","보은군",2009,244,116,128,"6",2008,260,122,138,462768,488710,0.946917394773997,0.938461538461538,0.991070122526922,0.0527262040590533,-0.000470838541867875,-0.0600306658604846
"2617","충북","보은군",2010,209,90,119,"6",2009,211,91,120,470657,487028,0.966385916210156,0.990521327014218,1.02497491985263,0.0444060111716175,0.00110903656998625,0.0101418333912281
"2618","충북","보은군",2011,210,113,97,"6",2010,215,113,102,441332,457372,0.964930078798003,0.976744186046512,1.0122434853137,0.0475832253269647,0.000582584520469092,-0.0132413161840889
"2619","충북","보은군",2012,199,108,91,"6",2011,203,112,91,407210,420797,0.967711271705834,0.980295566502463,1.01300418333915,0.048869133862135,0.000635503176368867,-0.0108908554966168
"2620","충북","보은군",2013,188,103,85,"6",2012,189,103,86,422944,435284,0.971650692421499,0.994708994708995,1.02373106144764,0.0444503291215858,0.00105485349175212,0.00773521150807288
"2621","충북","보은군",2014,191,115,76,"6",2013,198,116,82,465061,480776,0.967313260229296,0.964646464646465,0.997243090018016,0.0410698811553753,-0.00011322596531614,-0.0441467722082649
"2622","충북","보은군",2015,180,100,80,"6",2014,185,100,85,441255,454993,0.969806128885499,0.972972972972973,1.00326544037324,0.0407927388924771,0.000133206256514331,-0.0332011191169253
"2623","충북","보은군",2016,196,101,95,"6",2015,194,94,100,422114,435131,0.970084870992873,1.01030927835052,1.04146483319183,0.0464329541308746,0.00192533469764083,0.046398926956548
"2624","충북","보은군",2017,185,110,75,"6",2016,184,111,73,445571,460063,0.968499966308962,1.0054347826087,1.03813610488857,0.0415197577939318,0.00158340183817734,0.0312114712236209
"2625","충북","보은군",2018,202,101,101,"6",2017,203,101,102,447106,462352,0.967025123715265,0.995073891625616,1.02900521115996,0.0451794429061565,0.00131043928158258,0.0190874339154366
"2626","충북","보은군",2019,184,93,91,"6",2018,186,96,90,462528,478982,0.965647978420901,0.989247311827957,1.02443885756966,0.0397813753978138,0.000972211367272246,0.00406453882343402
"2627","충북","보은군",2020,146,67,79,"6",2019,147,68,79,417119,431843,0.965904275396382,0.993197278911565,1.02825642686381,0.0350020018268168,0.000989031504706491,0.00481163020595037
"2628","충북","영동군",2009,360,195,165,"6",2008,374,200,174,462768,488710,0.946917394773997,0.962566844919786,1.01652673214386,0.0777927600871279,0.00128566010869134,0.0179868301537074
"2629","충북","영동군",2010,339,163,176,"6",2009,343,162,181,470657,487028,0.966385916210156,0.988338192419825,1.02271584864953,0.0720269750582696,0.00163615386410724,0.0335545307935306
"2630","충북","영동군",2011,320,162,158,"6",2010,333,170,163,441332,457372,0.964930078798003,0.960960960960961,0.995886626477655,0.0725077719268034,-0.000298251549207909,-0.0523649582849829
"2631","충북","영동군",2012,295,154,141,"6",2011,300,162,138,407210,420797,0.967711271705834,0.983333333333333,1.01614330853041,0.0724441934137177,0.00116948896551406,0.0128269163120931
"2632","충북","영동군",2013,296,150,146,"6",2012,304,154,150,422944,435284,0.971650692421499,0.973684210526316,1.00209284892264,0.0699856245744118,0.00014646933899081,-0.0326120196126842
"2633","충북","영동군",2014,343,178,165,"6",2013,348,184,164,465061,480776,0.967313260229296,0.985632183908046,1.0189379433033,0.0737537656350457,0.00139674463200117,0.0229208142201364
"2634","충북","영동군",2015,294,159,135,"6",2014,308,165,143,441255,454993,0.969806128885499,0.954545454545455,0.984264200972227,0.066628140191046,-0.00104844702364058,-0.0856860043431639
"2635","충북","영동군",2016,272,143,129,"6",2015,284,151,133,422114,435131,0.970084870992873,0.957746478873239,0.987281120973461,0.0644375689979484,-0.000819573644849159,-0.0755202533407763
"2636","충북","영동군",2017,298,181,117,"6",2016,315,187,128,445571,460063,0.968499966308962,0.946031746031746,0.976801010780781,0.0668804747167118,-0.00155155941192928,-0.108032488204969
"2637","충북","영동군",2018,279,141,138,"6",2017,297,152,145,447106,462352,0.967025123715265,0.939393939393939,0.971426611735621,0.0624013097565231,-0.0017830168518789,-0.118313014121101
"2638","충북","영동군",2019,266,132,134,"6",2018,288,139,149,462528,478982,0.965647978420901,0.923611111111111,0.95646771054341,0.0575100318251003,-0.00250354335206799,-0.150316268628996
"2639","충북","영동군",2020,224,113,111,"6",2019,235,121,114,417119,431843,0.965904275396382,0.953191489361702,0.98683846178291,0.0537017014329244,-0.000706796995732203,-0.0705111109937697
"2640","충북","옥천군",2009,410,208,202,"6",2008,429,229,200,462768,488710,0.946917394773997,0.955710955710956,1.00928651325394,0.088597310099229,0.000822760094500289,-0.00257356139605091
"2641","충북","옥천군",2010,408,221,187,"6",2009,408,218,190,470657,487028,0.966385916210156,1,1.03478329229141,0.0866873328134926,0.00301527083521478,0.0948100590925317
"2642","충북","옥천군",2011,392,191,201,"6",2010,400,202,198,441332,457372,0.964930078798003,0.98,1.01561763026474,0.0888220206103342,0.00138718947725967,0.0224964078326206
"2643","충북","옥천군",2012,354,176,178,"6",2011,363,172,191,407210,420797,0.967711271705834,0.975206611570248,1.00774542994751,0.0869330320964613,0.000673333710227792,-0.00921055615587219
"2644","충북","옥천군",2013,374,198,176,"6",2012,388,208,180,422944,435284,0.971650692421499,0.963917525773196,0.992041207083349,0.0884277824014527,-0.000703778408211869,-0.0703770359463672
"2645","충북","옥천군",2014,396,200,196,"6",2013,410,213,197,465061,480776,0.967313260229296,0.965853658536585,0.998491076518103,0.0851501200917729,-0.000128485015692856,-0.0448245255908632
"2646","충북","옥천군",2015,357,183,174,"6",2014,372,191,181,441255,454993,0.969806128885499,0.959677419354839,0.989555943988207,0.080905598803413,-0.000844982605570524,-0.0766488300642328
"2647","충북","옥천군",2016,350,179,171,"6",2015,362,182,180,422114,435131,0.970084870992873,0.966850828729282,0.996666227502052,0.0829159895194189,-0.00027642304549999,-0.0513954128768574
"2648","충북","옥천군",2017,362,195,167,"6",2016,364,196,168,445571,460063,0.968499966308962,0.994505494505495,1.02685134651645,0.0812440666021801,0.00218151258474071,0.0577774482434138
"2649","충북","옥천군",2018,379,210,169,"6",2017,386,212,174,447106,462352,0.967025123715265,0.981865284974093,1.01534620031568,0.084767370601155,0.00130085704947872,0.0186618248466612
"2650","충북","옥천군",2019,334,163,171,"6",2018,336,169,167,462528,478982,0.965647978420901,0.994047619047619,1.02940993121858,0.0722118444721185,0.00212374537909169,0.0552116320185971
"2651","충북","옥천군",2020,272,148,124,"6",2019,285,151,134,417119,431843,0.965904275396382,0.954385964912281,0.988075101459329,0.0652092088828368,-0.000777613199845224,-0.0736565178634925
"2652","충북","음성군",2009,892,445,447,"6",2008,971,483,488,462768,488710,0.946917394773997,0.918640576725026,0.970138030830324,0.192753172215884,-0.00575598928606798,-0.294778484760751
"2653","충북","음성군",2010,824,427,397,"6",2009,861,445,416,470657,487028,0.966385916210156,0.957026713124274,0.990315253017567,0.175074417250779,-0.00169555143417075,-0.114428107705003
"2654","충북","음성군",2011,786,443,343,"6",2010,838,462,376,441332,457372,0.964930078798003,0.937947494033413,0.97203674612548,0.178097214795211,-0.00498017763166349,-0.260319658028378
"2655","충북","음성군",2012,720,376,344,"6",2011,746,389,357,407210,420797,0.967711271705834,0.96514745308311,0.99735063680905,0.17681294663687,-0.000468441712503051,-0.0599242071248874
"2656","충북","음성군",2013,727,349,378,"6",2012,757,370,387,422944,435284,0.971650692421499,0.960369881109643,0.988390054780136,0.171890368464856,-0.00199563776169916,-0.127756887578763
"2657","충북","음성군",2014,836,436,400,"6",2013,882,464,418,465061,480776,0.967313260229296,0.947845804988662,0.979874714799196,0.179761364638187,-0.00361774873142919,-0.199805355179464
"2658","충북","음성군",2015,797,413,384,"6",2014,842,440,402,441255,454993,0.969806128885499,0.946555819477435,0.976025817206596,0.180621182762802,-0.00433024525191628,-0.231451946214151
"2659","충북","음성군",2016,785,427,358,"6",2015,802,437,365,422114,435131,0.970084870992873,0.978802992518703,1.00898696782778,0.185968719350697,0.0016712948977783,0.0351153719894482
"2660","충북","음성군",2017,823,454,369,"6",2016,834,459,375,445571,460063,0.968499966308962,0.986810551558753,1.01890612894864,0.184706814402194,0.00349209085078041,0.115988728174933
"2661","충북","음성군",2018,801,428,373,"6",2017,841,459,382,447106,462352,0.967025123715265,0.95243757431629,0.984915025430849,0.179152147365502,-0.00270250558701731,-0.159153471758752
"2662","충북","음성군",2019,756,411,345,"6",2018,790,437,353,462528,478982,0.965647978420901,0.956962025316456,0.99100505225657,0.163449564134496,-0.00147022028807627,-0.104419690228165
"2663","충북","음성군",2020,670,340,330,"6",2019,679,348,331,417119,431843,0.965904275396382,0.986745213549337,1.02157660824558,0.160625624821694,0.00346575618097858,0.114819034707964
"2664","충북","제천시",2009,1186,623,563,"6",2008,1257,672,585,462768,488710,0.946917394773997,0.94351630867144,0.996408254699589,0.256283926287038,-0.000920506587812364,-0.0800033398907293
"2665","충북","제천시",2010,1162,605,557,"6",2009,1182,616,566,470657,487028,0.966385916210156,0.983079526226734,1.01727426873318,0.246888923356075,0.00426482560929918,0.150310890007265
"2666","충북","제천시",2011,1162,618,544,"6",2010,1198,633,565,441332,457372,0.964930078798003,0.969949916527546,1.00520228132571,0.263293846809205,0.00136972866242894,0.0217208598121157
"2667","충북","제천시",2012,1053,536,517,"6",2011,1065,546,519,407210,420797,0.967711271705834,0.988732394366197,1.02172251504657,0.258588934456423,0.00561720201960542,0.210378696587796
"2668","충북","제천시",2013,1082,562,520,"6",2012,1098,567,531,422944,435284,0.971650692421499,0.985428051001822,1.0141793328485,0.255825830369978,0.0036274396000604,0.122000443870881
"2669","충북","제천시",2014,1105,568,537,"6",2013,1122,573,549,465061,480776,0.967313260229296,0.984848484848485,1.01812776206028,0.237603239144972,0.0043072149839715,0.152193677032743
"2670","충북","제천시",2015,1079,572,507,"6",2014,1103,582,521,441255,454993,0.969806128885499,0.978241160471441,1.00869764722526,0.244529807027682,0.00212683399758796,0.0553488175957936
"2671","충북","제천시",2016,993,496,497,"6",2015,1014,507,507,422114,435131,0.970084870992873,0.979289940828402,1.00948893247465,0.235244507407951,0.00223221924582585,0.0600296598963198
"2672","충북","제천시",2017,1061,511,550,"6",2016,1098,535,563,445571,460063,0.968499966308962,0.966302367941712,0.997730925716368,0.238121421726279,-0.000540315194420909,-0.0631165745583991
"2673","충북","제천시",2018,1057,524,533,"6",2017,1094,546,548,447106,462352,0.967025123715265,0.96617915904936,0.99912518853424,0.236409263127759,-0.000206813533996133,-0.0483036030513428
"2674","충북","제천시",2019,1078,536,542,"6",2018,1127,563,564,462528,478982,0.965647978420901,0.956521739130435,0.99054910330223,0.23306697108067,-0.00220269186734553,-0.136953503162183
"2675","충북","제천시",2020,931,477,454,"6",2019,970,487,483,417119,431843,0.965904275396382,0.95979381443299,0.993673844169615,0.223197696580592,-0.00141198340955184,-0.101833012785109
"2676","충북","증평군",2009,345,167,178,"6",2008,356,176,180,462768,488710,0.946917394773997,0.969101123595506,1.02342731155214,0.0745513950834976,0.00174653875926759,0.0384574398367331
"2677","충북","증평군",2010,311,165,146,"6",2009,319,155,164,470657,487028,0.966385916210156,0.974921630094044,1.00883261411483,0.0660778443749907,0.000583640100903866,-0.0131944310115119
"2678","충북","증평군",2011,332,165,167,"6",2010,352,175,177,441332,457372,0.964930078798003,0.943181818181818,0.977461309276133,0.0752268133740585,-0.00169551388077994,-0.114426439715382
"2679","충북","증평군",2012,319,163,156,"6",2011,336,171,165,407210,420797,0.967711271705834,0.949404761904762,0.981082673792977,0.0783379583016134,-0.00148194471158381,-0.104940447909348
"2680","충북","증평군",2013,323,172,151,"6",2012,324,169,155,422944,435284,0.971650692421499,0.996913580246914,1.02599996894198,0.0763694484376182,0.00198560328749436,0.0490758458754333
"2681","충북","증평군",2014,367,192,175,"6",2013,387,204,183,465061,480776,0.967313260229296,0.948320413436692,0.980365360867584,0.0789143789739411,-0.00154945535351209,-0.107939033325784
"2682","충북","증평군",2015,352,183,169,"6",2014,377,193,184,441255,454993,0.969806128885499,0.93368700265252,0.962756343606028,0.0797724671675109,-0.00297101835688617,-0.171079865181448
"2683","충북","증평군",2016,341,193,148,"6",2015,379,208,171,422114,435131,0.970084870992873,0.899736147757256,0.92748188809128,0.0807838640746339,-0.00585829329538313,-0.299322469258797
"2684","충북","증평군",2017,397,214,183,"6",2016,440,234,206,445571,460063,0.968499966308962,0.902272727272727,0.931618749261673,0.0890991559145456,-0.00609271172116588,-0.309734511757854
"2685","충북","증평군",2018,381,192,189,"6",2017,397,209,188,447106,462352,0.967025123715265,0.959697732997481,0.992422750414558,0.0852146918180476,-0.000645692988251872,-0.0677970857603714
"2686","충북","증평군",2019,369,188,181,"6",2018,403,208,195,462528,478982,0.965647978420901,0.915632754342432,0.948205531212049,0.0797789539227895,-0.0041321085388893,-0.222651409866499
"2687","충북","증평군",2020,355,184,171,"6",2019,389,209,180,417119,431843,0.965904275396382,0.912596401028278,0.944810396096209,0.0851076071816436,-0.00469705512955436,-0.24774435165237
"2688","충북","진천군",2009,637,327,310,"6",2008,655,335,320,462768,488710,0.946917394773997,0.972519083969466,1.02703687706738,0.137649967154168,0.00372162524027621,0.126183838949375
"2689","충북","진천군",2010,632,336,296,"6",2009,601,331,270,470657,487028,0.966385916210156,1.05158069883527,1.08815813765087,0.134280378279724,0.0118379080721949,0.486680593835968
"2690","충북","진천군",2011,644,356,288,"6",2010,669,378,291,441332,457372,0.964930078798003,0.962630792227205,0.997617146960885,0.145921891002692,-0.000347710421449222,-0.0545617475433889
"2691","충북","진천군",2012,598,325,273,"6",2011,579,313,266,407210,420797,0.967711271705834,1.03281519861831,1.06727618951644,0.146852975123401,0.00987970858545437,0.3997042556514
"2692","충북","진천군",2013,564,300,264,"6",2012,557,294,263,422944,435284,0.971650692421499,1.01256732495512,1.04211043418458,0.133350987364758,0.0056154679768724,0.210301676504707
"2693","충북","진천군",2014,698,355,343,"6",2013,689,345,344,465061,480776,0.967313260229296,1.01306240928882,1.04729507072888,0.150087837939539,0.00709841491089524,0.276168966796989
"2694","충북","진천군",2015,670,369,301,"6",2014,636,352,284,441255,454993,0.969806128885499,1.05345911949686,1.08625743653269,0.151839639210887,0.0130972980423799,0.542618269591047
"2695","충북","진천군",2016,681,325,356,"6",2015,635,308,327,422114,435131,0.970084870992873,1.07244094488189,1.10551249375145,0.161330825322069,0.0170224176987119,0.716958288039462
"2696","충북","진천군",2017,767,392,375,"6",2016,725,376,349,445571,460063,0.968499966308962,1.05793103448276,1.09233977417121,0.172138671502409,0.015895246052665,0.666893285498882
"2697","충북","진천군",2018,852,437,415,"6",2017,806,413,393,447106,462352,0.967025123715265,1.05707196029777,1.09311737034974,0.190558838396264,0.0177443379283621,0.749023447111101
"2698","충북","진천군",2019,904,455,449,"6",2018,850,428,422,462528,478982,0.965647978420901,1.06352941176471,1.1013634735754,0.195447626954476,0.0198112503701746,0.840828432636966
"2699","충북","진천군",2020,837,415,422,"6",2019,807,410,397,417119,431843,0.965904275396382,1.03717472118959,1.07378624115103,0.200662161157847,0.0148061066130798,0.618517539887188
"2700","충북","청원군",2009,1495,795,700,"6",2008,1563,819,744,462768,488710,0.946917394773997,0.956493921944978,1.01011337126536,0.323056045361823,0.0032671857262644,0.105999233079157
"2701","충북","청원군",2010,1453,777,676,"6",2009,1537,819,718,470657,487028,0.966385916210156,0.945348080676643,0.978230399283946,0.30871738867158,-0.00672065428548328,-0.337625513264276
"2702","충북","청원군",2011,1558,793,765,"6",2010,1565,812,753,441332,457372,0.964930078798003,0.995527156549521,1.03170911387655,0.353022214568624,0.0111940216027098,0.458081420104378
"2703","충북","청원군",2012,1530,813,717,"6",2011,1544,831,713,407210,420797,0.967711271705834,0.990932642487047,1.02399617681447,0.37572751160335,0.00901602380249609,0.361342413420258
"2704","충북","청원군",2013,1618,825,793,"6",2012,1649,823,826,422944,435284,0.971650692421499,0.981200727713766,1.00982867131856,0.38255655595067,0.00376002264920106,0.127889316887998
"2705","충북","청원군",2014,1759,922,837,"6",2013,1781,930,851,465061,480776,0.967313260229296,0.987647389107243,1.02102124483761,0.37822995262987,0.00795086443915027,0.314031778505819
"2706","충북","청주시",2009,7078,3735,3343,"6",2008,7313,3847,3466,462768,488710,0.946917394773997,0.967865445097771,1.02212236298476,1.52949209971303,0.0338359794121754,1.46375760015217
"2707","충북","청주시",2010,7191,3773,3418,"6",2009,7343,3846,3497,470657,487028,0.966385916210156,0.979300013618412,1.01336329223309,1.52786424083781,0.020417296342799,0.867746864506294
"2708","충북","청주시",2011,6977,3643,3334,"6",2010,7026,3657,3369,441332,457372,0.964930078798003,0.993025903785938,1.02911695428018,1.58089601479159,0.0460308769844112,2.00541208558686
"2709","충북","청주시",2012,6402,3293,3109,"6",2011,6521,3341,3180,407210,420797,0.967711271705834,0.981751265143383,1.01450845293225,1.57216178384617,0.022809635242809,0.974006149440389
"2710","충북","청주시",2013,6508,3290,3218,"6",2012,6596,3355,3241,422944,435284,0.971650692421499,0.986658580958157,1.01544576528758,1.53873798895362,0.0237669858164603,1.01652829686148
"2711","충북","청주시",2014,7226,3741,3485,"6",2013,7346,3810,3536,465061,480776,0.967313260229296,0.983664579362919,1.01690385090942,1.55377466611907,0.0262647753029132,1.12747132618951
"2712","충북","청주시",2015,8391,4303,4088,"6",2014,8590,4378,4212,441255,454993,0.969806128885499,0.976833527357392,1.00724618896765,1.90162151137098,0.0137795088163492,0.572919674218966
"2713","충북","청주시",2016,8134,4263,3871,"6",2015,8302,4353,3949,422114,435131,0.970084870992873,0.979763912310287,1.00997752011894,1.9269675964313,0.0192263579619439,0.814849567743823
"2714","충북","청주시",2017,8554,4407,4147,"6",2016,8696,4474,4222,445571,460063,0.968499966308962,0.983670653173873,1.01566410675545,1.91978382794212,0.0300716988282675,1.29656148795599
"2715","충북","청주시",2018,8496,4284,4212,"6",2017,8688,4388,4300,447106,462352,0.967025123715265,0.977900552486188,1.01124627323967,1.90022052935993,0.0213703992888039,0.910080347237621
"2716","충북","청주시",2019,8854,4511,4343,"6",2018,9005,4595,4410,462528,478982,0.965647978420901,0.983231538034425,1.01820907826295,1.91426248789262,0.0348569554578637,1.50910576739939
"2717","충북","청주시",2020,8056,4118,3938,"6",2019,8194,4185,4009,417119,431843,0.965904275396382,0.983158408591652,1.0178631916586,1.93134333367696,0.0344999561280376,1.49324911201117
"2718","충북","충주시",2009,1850,967,883,"6",2008,1965,1052,913,462768,488710,0.946917394773997,0.94147582697201,0.994253387009238,0.399768350447741,-0.00229731399597842,-0.141156285521919
"2719","충북","충주시",2010,1918,977,941,"6",2009,1955,994,961,470657,487028,0.966385916210156,0.981074168797954,1.01519915837081,0.407515451804605,0.00619389189053001,0.235993233605494
"2720","충북","충주시",2011,1818,948,870,"6",2010,1863,975,888,441332,457372,0.964930078798003,0.975845410628019,1.01131204433342,0.411934779259152,0.00465982448545858,0.16785535167626
"2721","충북","충주시",2012,1624,845,779,"6",2011,1659,858,801,407210,420797,0.967711271705834,0.978902953586498,1.01156510439414,0.398811424080941,0.00461229575307148,0.16574429244579
"2722","충북","충주시",2013,1676,865,811,"6",2012,1703,874,829,422944,435284,0.971650692421499,0.984145625366999,1.01285949059982,0.396269955360521,0.0050958297659485,0.187221173689251
"2723","충북","충주시",2014,1837,957,880,"6",2013,1888,981,907,465061,480776,0.967313260229296,0.972987288135593,1.00586576049309,0.39500194598128,0.00231698680943157,0.0637947371160693
"2724","충북","충주시",2015,1701,902,799,"6",2014,1742,925,817,441255,454993,0.969806128885499,0.97646383467279,1.0068649862988,0.385491382533909,0.00264639305940048,0.0784258048859294
"2725","충북","충주시",2016,1594,789,805,"6",2015,1627,813,814,422114,435131,0.970084870992873,0.979717271051014,1.00992944055326,0.377623106554154,0.0037495861880669,0.127425765968288
"2726","충북","충주시",2017,1738,874,864,"6",2016,1787,891,896,445571,460063,0.968499966308962,0.972579742585339,1.00421246919804,0.390061292139749,0.00164312117848528,0.033863994408288
"2727","충북","충주시",2018,1735,914,821,"6",2017,1755,923,832,447106,462352,0.967025123715265,0.988603988603989,1.02231468899776,0.388051155654364,0.0086592408536475,0.345495368914494
"2728","충북","충주시",2019,1682,828,854,"6",2018,1720,842,878,462528,478982,0.965647978420901,0.977906976744186,1.01269510069636,0.363653659886537,0.00461661983085767,0.16593635278204
"2729","충북","충주시",2020,1598,806,792,"6",2019,1623,819,804,417119,431843,0.965904275396382,0.984596426370918,1.01935197042881,0.383104102186666,0.00741381925667356,0.290178119199005
